date,close,daily change,daily change pct,high to date,off from high,buy,shares bought,shares owned,cash spend,cash balance,market value,current gain
1928-01-03,17.76,0.1,0.57,17.76,0.0,True,1,1,-17.76,-17.76,17.76,0.0
1928-01-04,17.72,-0.04,-0.22,17.76,-0.22,True,1,2,-17.72,-35.48,35.44,-0.04
1928-01-05,17.55,-0.17,-0.96,17.76,-1.18,True,1,3,-17.55,-53.03,52.65,-0.38
1928-01-06,17.66,0.11,0.63,17.76,-0.56,True,1,4,-17.66,-70.69,70.64,-0.05
1928-01-09,17.5,-0.16,-0.91,17.76,-1.46,True,1,5,-17.5,-88.19,87.5,-0.69
1928-01-10,17.37,-0.13,-0.74,17.76,-2.2,True,1,6,-17.37,-105.56,104.22,-1.34
1928-01-11,17.35,-0.02,-0.12,17.76,-2.31,True,1,7,-17.35,-122.91,121.45,-1.46
1928-01-12,17.47,0.12,0.69,17.76,-1.63,True,1,8,-17.47,-140.38,139.76,-0.62
1928-01-13,17.58,0.11,0.63,17.76,-1.01,True,1,9,-17.58,-157.96,158.22,0.26
1928-01-16,17.29,-0.29,-1.65,17.76,-2.65,True,1,10,-17.29,-175.25,172.9,-2.35
1928-01-17,17.3,0.01,0.06,17.76,-2.59,True,1,11,-17.3,-192.55,190.3,-2.25
1928-01-18,17.26,-0.04,-0.23,17.76,-2.82,True,1,12,-17.26,-209.81,207.12,-2.69
1928-01-19,17.38,0.12,0.7,17.76,-2.14,True,1,13,-17.38,-227.19,225.94,-1.25
1928-01-20,17.48,0.1,0.57,17.76,-1.58,True,1,14,-17.48,-244.67,244.72,0.05
1928-01-23,17.64,0.16,0.92,17.76,-0.68,True,1,15,-17.64,-262.31,264.6,2.29
1928-01-24,17.71,0.07,0.4,17.76,-0.28,True,1,16,-17.71,-280.02,283.36,3.34
1928-01-25,17.52,-0.19,-1.07,17.76,-1.35,True,1,17,-17.52,-297.54,297.84,0.3
1928-01-26,17.63,0.11,0.63,17.76,-0.73,True,1,18,-17.63,-315.17,317.34,2.17
1928-01-27,17.69,0.06,0.34,17.76,-0.39,True,1,19,-17.69,-332.86,336.11,3.25
1928-01-30,17.49,-0.2,-1.13,17.76,-1.52,True,1,20,-17.49,-350.35,349.8,-0.55
1928-01-31,17.57,0.08,0.46,17.76,-1.07,True,1,21,-17.57,-367.92,368.97,1.05
1928-02-01,17.53,-0.04,-0.23,17.76,-1.3,True,1,22,-17.53,-385.45,385.66,0.21
1928-02-02,17.63,0.1,0.57,17.76,-0.73,True,1,23,-17.63,-403.08,405.49,2.41
1928-02-03,17.4,-0.23,-1.3,17.76,-2.03,True,1,24,-17.4,-420.48,417.6,-2.88
1928-02-06,17.45,0.05,0.29,17.76,-1.74,True,1,25,-17.45,-437.93,436.25,-1.68
1928-02-07,17.44,-0.01,-0.06,17.76,-1.8,True,1,26,-17.44,-455.37,453.44,-1.93
1928-02-08,17.49,0.05,0.29,17.76,-1.52,True,1,27,-17.49,-472.86,472.23,-0.63
1928-02-09,17.55,0.06,0.34,17.76,-1.18,True,1,28,-17.55,-490.41,491.4,0.99
1928-02-10,17.54,-0.01,-0.06,17.76,-1.24,True,1,29,-17.54,-507.95,508.66,0.71
1928-02-14,17.44,-0.1,-0.57,17.76,-1.8,True,1,30,-17.44,-525.39,523.2,-2.19
1928-02-15,17.4,-0.04,-0.23,17.76,-2.03,True,1,31,-17.4,-542.79,539.4,-3.39
1928-02-16,17.35,-0.05,-0.29,17.76,-2.31,True,1,32,-17.35,-560.14,555.2,-4.94
1928-02-17,17.04,-0.31,-1.79,17.76,-4.05,True,1,33,-17.04,-577.18,562.32,-14.86
1928-02-20,16.95,-0.09,-0.53,17.76,-4.56,True,1,34,-16.95,-594.13,576.3,-17.83
1928-02-21,17.11,0.16,0.94,17.76,-3.66,True,1,35,-17.11,-611.24,598.85,-12.39
1928-02-23,17.13,0.02,0.12,17.76,-3.55,True,1,36,-17.13,-628.37,616.68,-11.69
1928-02-24,17.18,0.05,0.29,17.76,-3.27,True,1,37,-17.18,-645.55,635.66,-9.89
1928-02-27,17.11,-0.07,-0.41,17.76,-3.66,True,1,38,-17.11,-662.66,650.18,-12.48
1928-02-28,17.16,0.05,0.29,17.76,-3.38,True,1,39,-17.16,-679.82,669.24,-10.58
1928-02-29,17.26,0.1,0.58,17.76,-2.82,True,1,40,-17.26,-697.08,690.4,-6.68
1928-03-01,17.3,0.04,0.23,17.76,-2.59,True,1,41,-17.3,-714.38,709.3,-5.08
1928-03-02,17.3,0.0,0.0,17.76,-2.59,True,1,42,-17.3,-731.68,726.6,-5.08
1928-03-05,17.57,0.27,1.56,17.76,-1.07,True,1,43,-17.57,-749.25,755.51,6.26
1928-03-06,17.67,0.1,0.57,17.76,-0.51,True,1,44,-17.67,-766.92,777.48,10.56
1928-03-07,17.58,-0.09,-0.51,17.76,-1.01,True,1,45,-17.58,-784.5,791.1,6.6
1928-03-08,17.64,0.06,0.34,17.76,-0.68,True,1,46,-17.64,-802.14,811.44,9.3
1928-03-09,17.93,0.29,1.64,17.93,0.0,True,1,47,-17.93,-820.07,842.71,22.64
1928-03-12,18.0,0.07,0.39,18.0,0.0,True,1,48,-18.0,-838.07,864.0,25.93
1928-03-13,17.92,-0.08,-0.44,18.0,-0.44,True,1,49,-17.92,-855.99,878.08,22.09
1928-03-14,17.93,0.01,0.06,18.0,-0.39,True,1,50,-17.93,-873.92,896.5,22.58
1928-03-15,18.07,0.14,0.78,18.07,0.0,True,1,51,-18.07,-891.99,921.57,29.58
1928-03-16,18.26,0.19,1.05,18.26,0.0,True,1,52,-18.26,-910.25,949.52,39.27
1928-03-19,18.36,0.1,0.55,18.36,0.0,True,1,53,-18.36,-928.61,973.08,44.47
1928-03-20,18.46,0.1,0.55,18.46,0.0,True,1,54,-18.46,-947.07,996.84,49.77
1928-03-21,18.65,0.19,1.03,18.65,0.0,True,1,55,-18.65,-965.72,1025.75,60.03
1928-03-22,18.6,-0.05,-0.27,18.65,-0.27,True,1,56,-18.6,-984.32,1041.6,57.28
1928-03-23,18.78,0.18,0.97,18.78,0.0,True,1,57,-18.78,-1003.1,1070.46,67.36
1928-03-26,19.05,0.27,1.44,19.05,0.0,True,1,58,-19.05,-1022.15,1104.9,82.75
1928-03-27,18.94,-0.11,-0.58,19.05,-0.58,True,1,59,-18.94,-1041.09,1117.46,76.37
1928-03-28,18.89,-0.05,-0.26,19.05,-0.84,True,1,60,-18.89,-1059.98,1133.4,73.42
1928-03-29,18.95,0.06,0.32,19.05,-0.52,True,1,61,-18.95,-1078.93,1155.95,77.02
1928-03-30,19.28,0.33,1.74,19.28,0.0,True,1,62,-19.28,-1098.21,1195.36,97.15
1928-04-02,18.91,-0.37,-1.92,19.28,-1.92,True,1,63,-18.91,-1117.12,1191.33,74.21
1928-04-03,19.02,0.11,0.58,19.28,-1.35,True,1,64,-19.02,-1136.14,1217.28,81.14
1928-04-04,18.99,-0.03,-0.16,19.28,-1.5,True,1,65,-18.99,-1155.13,1234.35,79.22
1928-04-05,19.23,0.24,1.26,19.28,-0.26,True,1,66,-19.23,-1174.36,1269.18,94.82
1928-04-09,19.27,0.04,0.21,19.28,-0.05,True,1,67,-19.27,-1193.63,1291.09,97.46
1928-04-10,19.1,-0.17,-0.88,19.28,-0.93,True,1,68,-19.1,-1212.73,1298.8,86.07
1928-04-11,19.44,0.34,1.78,19.44,0.0,True,1,69,-19.44,-1232.17,1341.36,109.19
1928-04-12,19.41,-0.03,-0.15,19.44,-0.15,True,1,70,-19.41,-1251.58,1358.7,107.12
1928-04-13,19.73,0.32,1.65,19.73,0.0,True,1,71,-19.73,-1271.31,1400.83,129.52
1928-04-16,19.68,-0.05,-0.25,19.73,-0.25,True,1,72,-19.68,-1290.99,1416.96,125.97
1928-04-17,19.52,-0.16,-0.81,19.73,-1.06,True,1,73,-19.52,-1310.51,1424.96,114.45
1928-04-18,19.52,0.0,0.0,19.73,-1.06,True,1,74,-19.52,-1330.03,1444.48,114.45
1928-04-19,19.63,0.11,0.56,19.73,-0.51,True,1,75,-19.63,-1349.66,1472.25,122.59
1928-04-20,19.34,-0.29,-1.48,19.73,-1.98,True,1,76,-19.34,-1369.0,1469.84,100.84
1928-04-23,19.15,-0.19,-0.98,19.73,-2.94,True,1,77,-19.15,-1388.15,1474.55,86.4
1928-04-24,19.25,0.1,0.52,19.73,-2.43,True,1,78,-19.25,-1407.4,1501.5,94.1
1928-04-25,19.33,0.08,0.42,19.73,-2.03,True,1,79,-19.33,-1426.73,1527.07,100.34
1928-04-26,19.47,0.14,0.72,19.73,-1.32,True,1,80,-19.47,-1446.2,1557.6,111.4
1928-04-27,19.68,0.21,1.08,19.73,-0.25,True,1,81,-19.68,-1465.88,1594.08,128.2
1928-04-30,19.75,0.07,0.36,19.75,0.0,True,1,82,-19.75,-1485.63,1619.5,133.87
1928-05-01,19.78,0.03,0.15,19.78,0.0,True,1,83,-19.78,-1505.41,1641.74,136.33
1928-05-02,19.83,0.05,0.25,19.83,0.0,True,1,84,-19.83,-1525.24,1665.72,140.48
1928-05-03,19.93,0.1,0.5,19.93,0.0,True,1,85,-19.93,-1545.17,1694.05,148.88
1928-05-04,20.24,0.31,1.56,20.24,0.0,True,1,86,-20.24,-1565.41,1740.64,175.23
1928-05-07,20.41,0.17,0.84,20.41,0.0,True,1,87,-20.41,-1585.82,1775.67,189.85
1928-05-08,20.27,-0.14,-0.69,20.41,-0.69,True,1,88,-20.27,-1606.09,1783.76,177.67
1928-05-09,20.24,-0.03,-0.15,20.41,-0.83,True,1,89,-20.24,-1626.33,1801.36,175.03
1928-05-10,20.21,-0.03,-0.15,20.41,-0.98,True,1,90,-20.21,-1646.54,1818.9,172.36
1928-05-11,20.36,0.15,0.74,20.41,-0.24,True,1,91,-20.36,-1666.9,1852.76,185.86
1928-05-14,20.44,0.08,0.39,20.44,0.0,True,1,92,-20.44,-1687.34,1880.48,193.14
1928-05-15,20.39,-0.05,-0.24,20.44,-0.24,True,1,93,-20.39,-1707.73,1896.27,188.54
1928-05-16,20.05,-0.34,-1.67,20.44,-1.91,True,1,94,-20.05,-1727.78,1884.7,156.92
1928-05-17,20.12,0.07,0.35,20.44,-1.57,True,1,95,-20.12,-1747.9,1911.4,163.5
1928-05-18,19.92,-0.2,-0.99,20.44,-2.54,True,1,96,-19.92,-1767.82,1912.32,144.5
1928-05-21,19.63,-0.29,-1.46,20.44,-3.96,True,1,97,-19.63,-1787.45,1904.11,116.66
1928-05-22,19.36,-0.27,-1.38,20.44,-5.28,True,1,98,-19.36,-1806.81,1897.28,90.47
1928-05-23,19.75,0.39,2.01,20.44,-3.38,True,1,99,-19.75,-1826.56,1955.25,128.69
1928-05-24,19.87,0.12,0.61,20.44,-2.79,True,1,100,-19.87,-1846.43,1987.0,140.57
1928-05-25,19.9,0.03,0.15,20.44,-2.64,True,1,101,-19.9,-1866.33,2009.9,143.57
1928-05-28,19.57,-0.33,-1.66,20.44,-4.26,True,1,102,-19.57,-1885.9,1996.14,110.24
1928-05-29,19.82,0.25,1.28,20.44,-3.03,True,1,103,-19.82,-1905.72,2041.46,135.74
1928-05-31,20.0,0.18,0.91,20.44,-2.15,True,1,104,-20.0,-1925.72,2080.0,154.28
1928-06-01,20.07,0.07,0.35,20.44,-1.81,True,1,105,-20.07,-1945.79,2107.35,161.56
1928-06-04,19.8,-0.27,-1.34,20.44,-3.13,True,1,106,-19.8,-1965.59,2098.8,133.21
1928-06-05,19.85,0.05,0.25,20.44,-2.89,True,1,107,-19.85,-1985.44,2123.95,138.51
1928-06-06,19.66,-0.19,-0.96,20.44,-3.82,True,1,108,-19.66,-2005.1,2123.28,118.18
1928-06-07,19.61,-0.05,-0.25,20.44,-4.06,True,1,109,-19.61,-2024.71,2137.49,112.78
1928-06-08,19.37,-0.24,-1.22,20.44,-5.24,True,1,110,-19.37,-2044.08,2130.7,86.62
1928-06-11,18.68,-0.69,-3.56,20.44,-8.61,True,1,111,-18.68,-2062.76,2073.48,10.72
1928-06-12,18.34,-0.34,-1.82,20.44,-10.27,True,1,112,-18.34,-2081.1,2054.08,-27.02
1928-06-13,18.89,0.55,3.0,20.44,-7.58,True,1,113,-18.89,-2099.99,2134.57,34.58
1928-06-14,19.05,0.16,0.85,20.44,-6.8,True,1,114,-19.05,-2119.04,2171.7,52.66
1928-06-15,18.74,-0.31,-1.63,20.44,-8.32,True,1,115,-18.74,-2137.78,2155.1,17.32
1928-06-18,18.4,-0.34,-1.81,20.44,-9.98,True,1,116,-18.4,-2156.18,2134.4,-21.78
1928-06-19,18.34,-0.06,-0.33,20.44,-10.27,True,1,117,-18.34,-2174.52,2145.78,-28.74
1928-06-20,18.57,0.23,1.25,20.44,-9.15,True,1,118,-18.57,-2193.09,2191.26,-1.83
1928-06-21,18.56,-0.01,-0.05,20.44,-9.2,True,1,119,-18.56,-2211.65,2208.64,-3.01
1928-06-22,18.54,-0.02,-0.11,20.44,-9.3,True,1,120,-18.54,-2230.19,2224.8,-5.39
1928-06-25,18.47,-0.07,-0.38,20.44,-9.64,True,1,121,-18.47,-2248.66,2234.87,-13.79
1928-06-26,18.68,0.21,1.14,20.44,-8.61,True,1,122,-18.68,-2267.34,2278.96,11.62
1928-06-27,18.86,0.18,0.96,20.44,-7.73,True,1,123,-18.86,-2286.2,2319.78,33.58
1928-06-28,19.07,0.21,1.11,20.44,-6.7,True,1,124,-19.07,-2305.27,2364.68,59.41
1928-06-29,19.14,0.07,0.37,20.44,-6.36,True,1,125,-19.14,-2324.41,2392.5,68.09
1928-07-02,18.98,-0.16,-0.84,20.44,-7.14,True,1,126,-18.98,-2343.39,2391.48,48.09
1928-07-03,19.29,0.31,1.63,20.44,-5.63,True,1,127,-19.29,-2362.68,2449.83,87.15
1928-07-05,19.48,0.19,0.98,20.44,-4.7,True,1,128,-19.48,-2382.16,2493.44,111.28
1928-07-06,19.39,-0.09,-0.46,20.44,-5.14,True,1,129,-19.39,-2401.55,2501.31,99.76
1928-07-09,19.46,0.07,0.36,20.44,-4.8,True,1,130,-19.46,-2421.01,2529.8,108.79
1928-07-10,19.43,-0.03,-0.15,20.44,-4.94,True,1,131,-19.43,-2440.44,2545.33,104.89
1928-07-11,18.95,-0.48,-2.47,20.44,-7.29,True,1,132,-18.95,-2459.39,2501.4,42.01
1928-07-12,18.81,-0.14,-0.74,20.44,-7.98,True,1,133,-18.81,-2478.2,2501.73,23.53
1928-07-13,18.96,0.15,0.8,20.44,-7.24,True,1,134,-18.96,-2497.16,2540.64,43.48
1928-07-16,18.7,-0.26,-1.37,20.44,-8.51,True,1,135,-18.7,-2515.86,2524.5,8.64
1928-07-17,18.8,0.1,0.54,20.44,-8.02,True,1,136,-18.8,-2534.66,2556.8,22.14
1928-07-18,19.03,0.23,1.22,20.44,-6.9,True,1,137,-19.03,-2553.69,2607.11,53.42
1928-07-19,18.99,-0.04,-0.21,20.44,-7.09,True,1,138,-18.99,-2572.68,2620.62,47.94
1928-07-20,19.03,0.04,0.21,20.44,-6.9,True,1,139,-19.03,-2591.71,2645.17,53.46
1928-07-23,19.12,0.09,0.47,20.44,-6.46,True,1,140,-19.12,-2610.83,2676.8,65.97
1928-07-24,19.09,-0.03,-0.16,20.44,-6.6,True,1,141,-19.09,-2629.92,2691.69,61.77
1928-07-25,19.2,0.11,0.58,20.44,-6.07,True,1,142,-19.2,-2649.12,2726.4,77.28
1928-07-26,19.24,0.04,0.21,20.44,-5.87,True,1,143,-19.24,-2668.36,2751.32,82.96
1928-07-27,19.42,0.18,0.94,20.44,-4.99,True,1,144,-19.42,-2687.78,2796.48,108.7
1928-07-30,19.47,0.05,0.26,20.44,-4.75,True,1,145,-19.47,-2707.25,2823.15,115.9
1928-07-31,19.43,-0.04,-0.2,20.44,-4.94,True,1,146,-19.43,-2726.68,2836.78,110.1
1928-08-01,19.42,-0.01,-0.05,20.44,-4.99,True,1,147,-19.42,-2746.1,2854.74,108.64
1928-08-02,19.33,-0.09,-0.46,20.44,-5.43,True,1,148,-19.33,-2765.43,2860.84,95.41
1928-08-03,19.36,0.03,0.16,20.44,-5.28,True,1,149,-19.36,-2784.79,2884.64,99.85
1928-08-06,19.58,0.22,1.14,20.44,-4.21,True,1,150,-19.58,-2804.37,2937.0,132.63
1928-08-07,19.49,-0.09,-0.46,20.44,-4.65,True,1,151,-19.49,-2823.86,2942.99,119.13
1928-08-08,19.25,-0.24,-1.23,20.44,-5.82,True,1,152,-19.25,-2843.11,2926.0,82.89
1928-08-09,19.3,0.05,0.26,20.44,-5.58,True,1,153,-19.3,-2862.41,2952.9,90.49
1928-08-10,19.25,-0.05,-0.26,20.44,-5.82,True,1,154,-19.25,-2881.66,2964.5,82.84
1928-08-13,19.29,0.04,0.21,20.44,-5.63,True,1,155,-19.29,-2900.95,2989.95,89.0
1928-08-14,19.13,-0.16,-0.83,20.44,-6.41,True,1,156,-19.13,-2920.08,2984.28,64.2
1928-08-15,19.47,0.34,1.78,20.44,-4.75,True,1,157,-19.47,-2939.55,3056.79,117.24
1928-08-16,19.61,0.14,0.72,20.44,-4.06,True,1,158,-19.61,-2959.16,3098.38,139.22
1928-08-17,19.64,0.03,0.15,20.44,-3.91,True,1,159,-19.64,-2978.8,3122.76,143.96
1928-08-20,19.77,0.13,0.66,20.44,-3.28,True,1,160,-19.77,-2998.57,3163.2,164.63
1928-08-21,20.02,0.25,1.26,20.44,-2.06,True,1,161,-20.02,-3018.59,3223.22,204.63
1928-08-22,20.0,-0.02,-0.1,20.44,-2.15,True,1,162,-20.0,-3038.59,3240.0,201.41
1928-08-23,20.02,0.02,0.1,20.44,-2.06,True,1,163,-20.02,-3058.61,3263.26,204.65
1928-08-24,20.34,0.32,1.6,20.44,-0.49,True,1,164,-20.34,-3078.95,3335.76,256.81
1928-08-27,20.38,0.04,0.2,20.44,-0.29,True,1,165,-20.38,-3099.33,3362.7,263.37
1928-08-28,20.54,0.16,0.78,20.54,0.0,True,1,166,-20.54,-3119.87,3409.64,289.77
1928-08-29,20.58,0.04,0.2,20.58,0.0,True,1,167,-20.58,-3140.45,3436.86,296.41
1928-08-30,20.61,0.03,0.15,20.61,0.0,True,1,168,-20.61,-3161.06,3462.48,301.42
1928-08-31,20.87,0.26,1.26,20.87,0.0,True,1,169,-20.87,-3181.93,3527.03,345.1
1928-09-04,20.97,0.1,0.48,20.97,0.0,True,1,170,-20.97,-3202.9,3564.9,362.0
1928-09-05,21.07,0.1,0.48,21.07,0.0,True,1,171,-21.07,-3223.97,3602.97,379.0
1928-09-06,20.94,-0.13,-0.62,21.07,-0.62,True,1,172,-20.94,-3244.91,3601.68,356.77
1928-09-07,21.09,0.15,0.72,21.09,0.0,True,1,173,-21.09,-3266.0,3648.57,382.57
1928-09-10,20.92,-0.17,-0.81,21.09,-0.81,True,1,174,-20.92,-3286.92,3640.08,353.16
1928-09-11,21.08,0.16,0.76,21.09,-0.05,True,1,175,-21.08,-3308.0,3689.0,381.0
1928-09-12,21.16,0.08,0.38,21.16,0.0,True,1,176,-21.16,-3329.16,3724.16,395.0
1928-09-13,21.14,-0.02,-0.1,21.16,-0.1,True,1,177,-21.14,-3350.3,3741.78,391.48
1928-09-14,21.14,0.0,0.0,21.16,-0.1,True,1,178,-21.14,-3371.44,3762.92,391.48
1928-09-17,21.33,0.19,0.9,21.33,0.0,True,1,179,-21.33,-3392.77,3818.07,425.3
1928-09-18,21.18,-0.15,-0.7,21.33,-0.7,True,1,180,-21.18,-3413.95,3812.4,398.45
1928-09-19,21.18,0.0,0.0,21.33,-0.7,True,1,181,-21.18,-3435.13,3833.58,398.45
1928-09-20,21.22,0.04,0.19,21.33,-0.52,True,1,182,-21.22,-3456.35,3862.04,405.69
1928-09-21,21.36,0.14,0.66,21.36,0.0,True,1,183,-21.36,-3477.71,3908.88,431.17
1928-09-24,21.43,0.07,0.33,21.43,0.0,True,1,184,-21.43,-3499.14,3943.12,443.98
1928-09-25,21.41,-0.02,-0.09,21.43,-0.09,True,1,185,-21.41,-3520.55,3960.85,440.3
1928-09-26,21.4,-0.01,-0.05,21.43,-0.14,True,1,186,-21.4,-3541.95,3980.4,438.45
1928-09-27,21.13,-0.27,-1.26,21.43,-1.4,True,1,187,-21.13,-3563.08,3951.31,388.23
1928-09-28,21.14,0.01,0.05,21.43,-1.35,True,1,188,-21.14,-3584.22,3974.32,390.1
1928-10-01,21.36,0.22,1.04,21.43,-0.33,True,1,189,-21.36,-3605.58,4037.04,431.46
1928-10-02,21.26,-0.1,-0.47,21.43,-0.79,True,1,190,-21.26,-3626.84,4039.4,412.56
1928-10-03,21.19,-0.07,-0.33,21.43,-1.12,True,1,191,-21.19,-3648.03,4047.29,399.26
1928-10-04,21.26,0.07,0.33,21.43,-0.79,True,1,192,-21.26,-3669.29,4081.92,412.63
1928-10-05,21.22,-0.04,-0.19,21.43,-0.98,True,1,193,-21.22,-3690.51,4095.46,404.95
1928-10-08,21.11,-0.11,-0.52,21.43,-1.49,True,1,194,-21.11,-3711.62,4095.34,383.72
1928-10-09,21.18,0.07,0.33,21.43,-1.17,True,1,195,-21.18,-3732.8,4130.1,397.3
1928-10-10,21.41,0.23,1.09,21.43,-0.09,True,1,196,-21.41,-3754.21,4196.36,442.15
1928-10-11,21.51,0.1,0.47,21.51,0.0,True,1,197,-21.51,-3775.72,4237.47,461.75
1928-10-15,21.65,0.14,0.65,21.65,0.0,True,1,198,-21.65,-3797.37,4286.7,489.33
1928-10-16,21.72,0.07,0.32,21.72,0.0,True,1,199,-21.72,-3819.09,4322.28,503.19
1928-10-17,21.79,0.07,0.32,21.79,0.0,True,1,200,-21.79,-3840.88,4358.0,517.12
1928-10-18,21.84,0.05,0.23,21.84,0.0,True,1,201,-21.84,-3862.72,4389.84,527.12
1928-10-19,21.96,0.12,0.55,21.96,0.0,True,1,202,-21.96,-3884.68,4435.92,551.24
1928-10-22,21.81,-0.15,-0.68,21.96,-0.68,True,1,203,-21.81,-3906.49,4427.43,520.94
1928-10-23,21.95,0.14,0.64,21.96,-0.05,True,1,204,-21.95,-3928.44,4477.8,549.36
1928-10-24,21.99,0.04,0.18,21.99,0.0,True,1,205,-21.99,-3950.43,4507.95,557.52
1928-10-25,21.91,-0.08,-0.36,21.99,-0.36,True,1,206,-21.91,-3972.34,4513.46,541.12
1928-10-26,21.65,-0.26,-1.19,21.99,-1.55,True,1,207,-21.65,-3993.99,4481.55,487.56
1928-10-29,22.0,0.35,1.62,22.0,0.0,True,1,208,-22.0,-4015.99,4576.0,560.01
1928-10-30,21.76,-0.24,-1.09,22.0,-1.09,True,1,209,-21.76,-4037.75,4547.84,510.09
1928-10-31,21.68,-0.08,-0.37,22.0,-1.46,True,1,210,-21.68,-4059.43,4552.8,493.37
1928-11-01,21.99,0.31,1.43,22.0,-0.04,True,1,211,-21.99,-4081.42,4639.89,558.47
1928-11-02,21.95,-0.04,-0.18,22.0,-0.23,True,1,212,-21.95,-4103.37,4653.4,550.03
1928-11-05,22.24,0.29,1.32,22.24,0.0,True,1,213,-22.24,-4125.61,4737.12,611.51
1928-11-07,22.24,0.0,0.0,22.24,0.0,True,1,214,-22.24,-4147.85,4759.36,611.51
1928-11-08,22.39,0.15,0.67,22.39,0.0,True,1,215,-22.39,-4170.24,4813.85,643.61
1928-11-09,22.55,0.16,0.72,22.55,0.0,True,1,216,-22.55,-4192.79,4870.8,678.01
1928-11-12,22.84,0.29,1.29,22.84,0.0,True,1,217,-22.84,-4215.63,4956.28,740.65
1928-11-13,22.91,0.07,0.31,22.91,0.0,True,1,218,-22.91,-4238.54,4994.38,755.84
1928-11-14,22.91,0.0,0.0,22.91,0.0,True,1,219,-22.91,-4261.45,5017.29,755.84
1928-11-15,23.03,0.12,0.52,23.03,0.0,True,1,220,-23.03,-4284.48,5066.6,782.12
1928-11-16,23.37,0.34,1.48,23.37,0.0,True,1,221,-23.37,-4307.85,5164.77,856.92
1928-11-19,23.37,0.0,0.0,23.37,0.0,True,1,222,-23.37,-4331.22,5188.14,856.92
1928-11-20,23.57,0.2,0.86,23.57,0.0,True,1,223,-23.57,-4354.79,5256.11,901.32
1928-11-21,23.22,-0.35,-1.48,23.57,-1.48,True,1,224,-23.22,-4378.01,5201.28,823.27
1928-11-22,23.52,0.3,1.29,23.57,-0.21,True,1,225,-23.52,-4401.53,5292.0,890.47
1928-11-23,23.7,0.18,0.76,23.7,0.0,True,1,226,-23.7,-4425.23,5356.2,930.97
1928-11-26,23.8,0.1,0.42,23.8,0.0,True,1,227,-23.8,-4449.03,5402.6,953.57
1928-11-27,23.91,0.11,0.46,23.91,0.0,True,1,228,-23.91,-4472.94,5451.48,978.54
1928-11-28,24.19,0.28,1.17,24.19,0.0,True,1,229,-24.19,-4497.13,5539.51,1042.38
1928-11-30,24.28,0.09,0.37,24.28,0.0,True,1,230,-24.28,-4521.41,5584.4,1062.99
1928-12-03,23.85,-0.43,-1.77,24.28,-1.77,True,1,231,-23.85,-4545.26,5509.35,964.09
1928-12-04,23.91,0.06,0.25,24.28,-1.52,True,1,232,-23.91,-4569.17,5547.12,977.95
1928-12-05,23.81,-0.1,-0.42,24.28,-1.94,True,1,233,-23.81,-4592.98,5547.73,954.75
1928-12-06,22.91,-0.9,-3.78,24.28,-5.64,True,1,234,-22.91,-4615.89,5360.94,745.05
1928-12-07,22.36,-0.55,-2.4,24.28,-7.91,True,1,235,-22.36,-4638.25,5254.6,616.35
1928-12-10,22.31,-0.05,-0.22,24.28,-8.11,True,1,236,-22.31,-4660.56,5265.16,604.6
1928-12-11,22.74,0.43,1.93,24.28,-6.34,True,1,237,-22.74,-4683.3,5389.38,706.08
1928-12-12,22.52,-0.22,-0.97,24.28,-7.25,True,1,238,-22.52,-4705.82,5359.76,653.94
1928-12-13,22.48,-0.04,-0.18,24.28,-7.41,True,1,239,-22.48,-4728.3,5372.72,644.42
1928-12-14,22.53,0.05,0.22,24.28,-7.21,True,1,240,-22.53,-4750.83,5407.2,656.37
1928-12-17,22.44,-0.09,-0.4,24.28,-7.58,True,1,241,-22.44,-4773.27,5408.04,634.77
1928-12-18,22.7,0.26,1.16,24.28,-6.51,True,1,242,-22.7,-4795.97,5493.4,697.43
1928-12-19,22.98,0.28,1.23,24.28,-5.35,True,1,243,-22.98,-4818.95,5584.14,765.19
1928-12-20,23.07,0.09,0.39,24.28,-4.98,True,1,244,-23.07,-4842.02,5629.08,787.06
1928-12-21,23.33,0.26,1.13,24.28,-3.91,True,1,245,-23.33,-4865.35,5715.85,850.5
1928-12-24,23.54,0.21,0.9,24.28,-3.05,True,1,246,-23.54,-4888.89,5790.84,901.95
1928-12-26,23.44,-0.1,-0.42,24.28,-3.46,True,1,247,-23.44,-4912.33,5789.68,877.35
1928-12-27,23.64,0.2,0.85,24.28,-2.64,True,1,248,-23.64,-4935.97,5862.72,926.75
1928-12-28,23.98,0.34,1.44,24.28,-1.24,True,1,249,-23.98,-4959.95,5971.02,1011.07
1928-12-31,24.35,0.37,1.54,24.35,0.0,True,1,250,-24.35,-4984.3,6087.5,1103.2
1929-01-02,24.81,0.46,1.89,24.81,0.0,True,1,251,-24.81,-5009.11,6227.31,1218.2
1929-01-03,24.86,0.05,0.2,24.86,0.0,True,1,252,-24.86,-5033.97,6264.72,1230.75
1929-01-04,24.85,-0.01,-0.04,24.86,-0.04,True,1,253,-24.85,-5058.82,6287.05,1228.23
1929-01-07,24.25,-0.6,-2.41,24.86,-2.45,True,1,254,-24.25,-5083.07,6159.5,1076.43
1929-01-08,24.17,-0.08,-0.33,24.86,-2.78,True,1,255,-24.17,-5107.24,6163.35,1056.11
1929-01-09,24.54,0.37,1.53,24.86,-1.29,True,1,256,-24.54,-5131.78,6282.24,1150.46
1929-01-10,24.58,0.04,0.16,24.86,-1.13,True,1,257,-24.58,-5156.36,6317.06,1160.7
1929-01-11,24.54,-0.04,-0.16,24.86,-1.29,True,1,258,-24.54,-5180.9,6331.32,1150.42
1929-01-14,24.59,0.05,0.2,24.86,-1.09,True,1,259,-24.59,-5205.49,6368.81,1163.32
1929-01-15,24.23,-0.36,-1.46,24.86,-2.53,True,1,260,-24.23,-5229.72,6299.8,1070.08
1929-01-16,24.56,0.33,1.36,24.86,-1.21,True,1,261,-24.56,-5254.28,6410.16,1155.88
1929-01-17,24.69,0.13,0.53,24.86,-0.68,True,1,262,-24.69,-5278.97,6468.78,1189.81
1929-01-18,24.77,0.08,0.32,24.86,-0.36,True,1,263,-24.77,-5303.74,6514.51,1210.77
1929-01-21,24.86,0.09,0.36,24.86,0.0,True,1,264,-24.86,-5328.6,6563.04,1234.44
1929-01-22,25.07,0.21,0.84,25.07,0.0,True,1,265,-25.07,-5353.67,6643.55,1289.88
1929-01-23,25.22,0.15,0.6,25.22,0.0,True,1,266,-25.22,-5378.89,6708.52,1329.63
1929-01-24,25.06,-0.16,-0.63,25.22,-0.63,True,1,267,-25.06,-5403.95,6691.02,1287.07
1929-01-25,25.48,0.42,1.68,25.48,0.0,True,1,268,-25.48,-5429.43,6828.64,1399.21
1929-01-28,25.35,-0.13,-0.51,25.48,-0.51,True,1,269,-25.35,-5454.78,6819.15,1364.37
1929-01-29,25.36,0.01,0.04,25.48,-0.47,True,1,270,-25.36,-5480.14,6847.2,1367.06
1929-01-30,25.45,0.09,0.36,25.48,-0.12,True,1,271,-25.45,-5505.59,6896.95,1391.36
1929-01-31,25.74,0.29,1.14,25.74,0.0,True,1,272,-25.74,-5531.33,7001.28,1469.95
1929-02-01,25.84,0.1,0.39,25.84,0.0,True,1,273,-25.84,-5557.17,7054.32,1497.15
1929-02-04,25.64,-0.2,-0.77,25.84,-0.77,True,1,274,-25.64,-5582.81,7025.36,1442.55
1929-02-05,25.7,0.06,0.23,25.84,-0.54,True,1,275,-25.7,-5608.51,7067.5,1458.99
1929-02-06,25.49,-0.21,-0.82,25.84,-1.35,True,1,276,-25.49,-5634.0,7035.24,1401.24
1929-02-07,24.71,-0.78,-3.06,25.84,-4.37,True,1,277,-24.71,-5658.71,6844.67,1185.96
1929-02-08,24.44,-0.27,-1.09,25.84,-5.42,True,1,278,-24.44,-5683.15,6794.32,1111.17
1929-02-11,24.98,0.54,2.21,25.84,-3.33,True,1,279,-24.98,-5708.13,6969.42,1261.29
1929-02-13,24.95,-0.03,-0.12,25.84,-3.44,True,1,280,-24.95,-5733.08,6986.0,1252.92
1929-02-14,24.85,-0.1,-0.4,25.84,-3.83,True,1,281,-24.85,-5757.93,6982.85,1224.92
1929-02-15,24.35,-0.5,-2.01,25.84,-5.77,True,1,282,-24.35,-5782.28,6866.7,1084.42
1929-02-18,24.39,0.04,0.16,25.84,-5.61,True,1,283,-24.39,-5806.67,6902.37,1095.7
1929-02-19,24.38,-0.01,-0.04,25.84,-5.65,True,1,284,-24.38,-5831.05,6923.92,1092.87
1929-02-20,24.59,0.21,0.86,25.84,-4.84,True,1,285,-24.59,-5855.64,7008.15,1152.51
1929-02-21,24.86,0.27,1.1,25.84,-3.79,True,1,286,-24.86,-5880.5,7109.96,1229.46
1929-02-25,24.91,0.05,0.2,25.84,-3.6,True,1,287,-24.91,-5905.41,7149.17,1243.76
1929-02-26,24.95,0.04,0.16,25.84,-3.44,True,1,288,-24.95,-5930.36,7185.6,1255.24
1929-02-27,25.25,0.3,1.2,25.84,-2.28,True,1,289,-25.25,-5955.61,7297.25,1341.64
1929-02-28,25.59,0.34,1.35,25.84,-0.97,True,1,290,-25.59,-5981.2,7421.1,1439.9
1929-03-01,25.83,0.24,0.94,25.84,-0.04,True,1,291,-25.83,-6007.03,7516.53,1509.5
1929-03-04,25.49,-0.34,-1.32,25.84,-1.35,True,1,292,-25.49,-6032.52,7443.08,1410.56
1929-03-05,25.32,-0.17,-0.67,25.84,-2.01,True,1,293,-25.32,-6057.84,7418.76,1360.92
1929-03-06,24.92,-0.4,-1.58,25.84,-3.56,True,1,294,-24.92,-6082.76,7326.48,1243.72
1929-03-07,25.15,0.23,0.92,25.84,-2.67,True,1,295,-25.15,-6107.91,7419.25,1311.34
1929-03-08,25.31,0.16,0.64,25.84,-2.05,True,1,296,-25.31,-6133.22,7491.76,1358.54
1929-03-11,24.95,-0.36,-1.42,25.84,-3.44,True,1,297,-24.95,-6158.17,7410.15,1251.98
1929-03-12,24.97,0.02,0.08,25.84,-3.37,True,1,298,-24.97,-6183.14,7441.06,1257.92
1929-03-13,25.24,0.27,1.08,25.84,-2.32,True,1,299,-25.24,-6208.38,7546.76,1338.38
1929-03-14,25.73,0.49,1.94,25.84,-0.43,True,1,300,-25.73,-6234.11,7719.0,1484.89
1929-03-15,26.08,0.35,1.36,26.08,0.0,True,1,301,-26.08,-6260.19,7850.08,1589.89
1929-03-18,26.04,-0.04,-0.15,26.08,-0.15,True,1,302,-26.04,-6286.23,7864.08,1577.85
1929-03-19,26.03,-0.01,-0.04,26.08,-0.19,True,1,303,-26.03,-6312.26,7887.09,1574.83
1929-03-20,26.02,-0.01,-0.04,26.08,-0.23,True,1,304,-26.02,-6338.28,7910.08,1571.8
1929-03-21,25.9,-0.12,-0.46,26.08,-0.69,True,1,305,-25.9,-6364.18,7899.5,1535.32
1929-03-22,25.55,-0.35,-1.35,26.08,-2.03,True,1,306,-25.55,-6389.73,7818.3,1428.57
1929-03-25,24.51,-1.04,-4.07,26.08,-6.02,True,1,307,-24.51,-6414.24,7524.57,1110.33
1929-03-26,24.35,-0.16,-0.65,26.08,-6.63,True,1,308,-24.35,-6438.59,7499.8,1061.21
1929-03-27,25.09,0.74,3.04,26.08,-3.8,True,1,309,-25.09,-6463.68,7752.81,1289.13
1929-03-28,25.53,0.44,1.75,26.08,-2.11,True,1,310,-25.53,-6489.21,7914.3,1425.09
1929-04-01,24.88,-0.65,-2.55,26.08,-4.6,True,1,311,-24.88,-6514.09,7737.68,1223.59
1929-04-02,25.17,0.29,1.17,26.08,-3.49,True,1,312,-25.17,-6539.26,7853.04,1313.78
1929-04-03,24.86,-0.31,-1.23,26.08,-4.68,True,1,313,-24.86,-6564.12,7781.18,1217.06
1929-04-04,25.3,0.44,1.77,26.08,-2.99,True,1,314,-25.3,-6589.42,7944.2,1354.78
1929-04-05,25.05,-0.25,-0.99,26.08,-3.95,True,1,315,-25.05,-6614.47,7890.75,1276.28
1929-04-08,24.83,-0.22,-0.88,26.08,-4.79,True,1,316,-24.83,-6639.3,7846.28,1206.98
1929-04-09,24.63,-0.2,-0.8,26.08,-5.56,True,1,317,-24.63,-6663.93,7807.71,1143.78
1929-04-10,24.78,0.15,0.61,26.08,-4.99,True,1,318,-24.78,-6688.71,7880.04,1191.33
1929-04-11,25.06,0.28,1.13,26.08,-3.91,True,1,319,-25.06,-6713.77,7994.14,1280.37
1929-04-12,25.15,0.09,0.36,26.08,-3.57,True,1,320,-25.15,-6738.92,8048.0,1309.08
1929-04-15,25.0,-0.15,-0.6,26.08,-4.14,True,1,321,-25.0,-6763.92,8025.0,1261.08
1929-04-16,25.06,0.06,0.24,26.08,-3.91,True,1,322,-25.06,-6788.98,8069.32,1280.34
1929-04-17,25.32,0.26,1.04,26.08,-2.91,True,1,323,-25.32,-6814.3,8178.36,1364.06
1929-04-18,25.43,0.11,0.43,26.08,-2.49,True,1,324,-25.43,-6839.73,8239.32,1399.59
1929-04-19,25.41,-0.02,-0.08,26.08,-2.57,True,1,325,-25.41,-6865.14,8258.25,1393.11
1929-04-22,25.7,0.29,1.14,26.08,-1.46,True,1,326,-25.7,-6890.84,8378.2,1487.36
1929-04-23,25.85,0.15,0.58,26.08,-0.88,True,1,327,-25.85,-6916.69,8452.95,1536.26
1929-04-24,25.75,-0.1,-0.39,26.08,-1.26,True,1,328,-25.75,-6942.44,8446.0,1503.56
1929-04-25,25.63,-0.12,-0.47,26.08,-1.72,True,1,329,-25.63,-6968.07,8432.27,1464.2
1929-04-26,25.58,-0.05,-0.2,26.08,-1.92,True,1,330,-25.58,-6993.65,8441.4,1447.75
1929-04-29,25.53,-0.05,-0.2,26.08,-2.11,True,1,331,-25.53,-7019.18,8450.43,1431.25
1929-04-30,25.94,0.41,1.61,26.08,-0.54,True,1,332,-25.94,-7045.12,8612.08,1566.96
1929-05-01,25.99,0.05,0.19,26.08,-0.34,True,1,333,-25.99,-7071.11,8654.67,1583.56
1929-05-02,26.11,0.12,0.46,26.11,0.0,True,1,334,-26.11,-7097.22,8720.74,1623.52
1929-05-03,26.37,0.26,1.0,26.37,0.0,True,1,335,-26.37,-7123.59,8833.95,1710.36
1929-05-06,26.32,-0.05,-0.19,26.37,-0.19,True,1,336,-26.32,-7149.91,8843.52,1693.61
1929-05-07,26.07,-0.25,-0.95,26.37,-1.14,True,1,337,-26.07,-7175.98,8785.59,1609.61
1929-05-08,26.18,0.11,0.42,26.37,-0.72,True,1,338,-26.18,-7202.16,8848.84,1646.68
1929-05-09,26.02,-0.16,-0.61,26.37,-1.33,True,1,339,-26.02,-7228.18,8820.78,1592.6
1929-05-10,26.34,0.32,1.23,26.37,-0.11,True,1,340,-26.34,-7254.52,8955.6,1701.08
1929-05-13,25.64,-0.7,-2.66,26.37,-2.77,True,1,341,-25.64,-7280.16,8743.24,1463.08
1929-05-14,25.95,0.31,1.21,26.37,-1.59,True,1,342,-25.95,-7306.11,8874.9,1568.79
1929-05-15,25.84,-0.11,-0.42,26.37,-2.01,True,1,343,-25.84,-7331.95,8863.12,1531.17
1929-05-16,25.97,0.13,0.5,26.37,-1.52,True,1,344,-25.97,-7357.92,8933.68,1575.76
1929-05-17,26.09,0.12,0.46,26.37,-1.06,True,1,345,-26.09,-7384.01,9001.05,1617.04
1929-05-20,25.39,-0.7,-2.68,26.37,-3.72,True,1,346,-25.39,-7409.4,8784.94,1375.54
1929-05-21,25.7,0.31,1.22,26.37,-2.54,True,1,347,-25.7,-7435.1,8917.9,1482.8
1929-05-22,24.76,-0.94,-3.66,26.37,-6.1,True,1,348,-24.76,-7459.86,8616.48,1156.62
1929-05-23,25.31,0.55,2.22,26.37,-4.02,True,1,349,-25.31,-7485.17,8833.19,1348.02
1929-05-24,25.12,-0.19,-0.75,26.37,-4.74,True,1,350,-25.12,-7510.29,8792.0,1281.71
1929-05-27,24.2,-0.92,-3.66,26.37,-8.23,True,1,351,-24.2,-7534.49,8494.2,959.71
1929-05-28,24.59,0.39,1.61,26.37,-6.75,True,1,352,-24.59,-7559.08,8655.68,1096.6
1929-05-29,24.62,0.03,0.12,26.37,-6.64,True,1,353,-24.62,-7583.7,8690.86,1107.16
1929-05-31,24.83,0.21,0.85,26.37,-5.84,True,1,354,-24.83,-7608.53,8789.82,1181.29
1929-06-03,25.27,0.44,1.77,26.37,-4.17,True,1,355,-25.27,-7633.8,8970.85,1337.05
1929-06-04,25.64,0.37,1.46,26.37,-2.77,True,1,356,-25.64,-7659.44,9127.84,1468.4
1929-06-05,25.59,-0.05,-0.2,26.37,-2.96,True,1,357,-25.59,-7685.03,9135.63,1450.6
1929-06-06,25.64,0.05,0.2,26.37,-2.77,True,1,358,-25.64,-7710.67,9179.12,1468.45
1929-06-07,25.53,-0.11,-0.43,26.37,-3.18,True,1,359,-25.53,-7736.2,9165.27,1429.07
1929-06-10,25.27,-0.26,-1.02,26.37,-4.17,True,1,360,-25.27,-7761.47,9097.2,1335.73
1929-06-11,25.43,0.16,0.63,26.37,-3.56,True,1,361,-25.43,-7786.9,9180.23,1393.33
1929-06-12,25.45,0.02,0.08,26.37,-3.49,True,1,362,-25.45,-7812.35,9212.9,1400.55
1929-06-13,25.84,0.39,1.53,26.37,-2.01,True,1,363,-25.84,-7838.19,9379.92,1541.73
1929-06-14,25.93,0.09,0.35,26.37,-1.67,True,1,364,-25.93,-7864.12,9438.52,1574.4
1929-06-17,26.41,0.48,1.85,26.41,0.0,True,1,365,-26.41,-7890.53,9639.65,1749.12
1929-06-18,26.42,0.01,0.04,26.42,0.0,True,1,366,-26.42,-7916.95,9669.72,1752.77
1929-06-19,26.32,-0.1,-0.38,26.42,-0.38,True,1,367,-26.32,-7943.27,9659.44,1716.17
1929-06-20,26.47,0.15,0.57,26.47,0.0,True,1,368,-26.47,-7969.74,9740.96,1771.22
1929-06-21,26.62,0.15,0.57,26.62,0.0,True,1,369,-26.62,-7996.36,9822.78,1826.42
1929-06-24,26.62,0.0,0.0,26.62,0.0,True,1,370,-26.62,-8022.98,9849.4,1826.42
1929-06-25,26.9,0.28,1.05,26.9,0.0,True,1,371,-26.9,-8049.88,9979.9,1930.02
1929-06-26,27.06,0.16,0.6,27.06,0.0,True,1,372,-27.06,-8076.94,10066.32,1989.38
1929-06-27,27.11,0.05,0.18,27.11,0.0,True,1,373,-27.11,-8104.05,10112.03,2007.98
1929-06-28,27.41,0.3,1.11,27.41,0.0,True,1,374,-27.41,-8131.46,10251.34,2119.88
1929-07-01,27.77,0.36,1.31,27.77,0.0,True,1,375,-27.77,-8159.23,10413.75,2254.52
1929-07-02,28.06,0.29,1.04,28.06,0.0,True,1,376,-28.06,-8187.29,10550.56,2363.27
1929-07-03,28.18,0.12,0.43,28.18,0.0,True,1,377,-28.18,-8215.47,10623.86,2408.39
1929-07-05,28.32,0.14,0.5,28.32,0.0,True,1,378,-28.32,-8243.79,10704.96,2461.17
1929-07-08,28.37,0.05,0.18,28.37,0.0,True,1,379,-28.37,-8272.16,10752.23,2480.07
1929-07-09,28.28,-0.09,-0.32,28.37,-0.32,True,1,380,-28.28,-8300.44,10746.4,2445.96
1929-07-10,28.2,-0.08,-0.28,28.37,-0.6,True,1,381,-28.2,-8328.64,10744.2,2415.56
1929-07-11,28.26,0.06,0.21,28.37,-0.39,True,1,382,-28.26,-8356.9,10795.32,2438.42
1929-07-12,28.57,0.31,1.1,28.57,0.0,True,1,383,-28.57,-8385.47,10942.31,2556.84
1929-07-15,28.45,-0.12,-0.42,28.57,-0.42,True,1,384,-28.45,-8413.92,10924.8,2510.88
1929-07-16,28.65,0.2,0.7,28.65,0.0,True,1,385,-28.65,-8442.57,11030.25,2587.68
1929-07-17,28.72,0.07,0.24,28.72,0.0,True,1,386,-28.72,-8471.29,11085.92,2614.63
1929-07-18,28.66,-0.06,-0.21,28.72,-0.21,True,1,387,-28.66,-8499.95,11091.42,2591.47
1929-07-19,28.76,0.1,0.35,28.76,0.0,True,1,388,-28.76,-8528.71,11158.88,2630.17
1929-07-22,28.43,-0.33,-1.15,28.76,-1.15,True,1,389,-28.43,-8557.14,11059.27,2502.13
1929-07-23,28.83,0.4,1.41,28.83,0.0,True,1,390,-28.83,-8585.97,11243.7,2657.73
1929-07-24,28.64,-0.19,-0.66,28.83,-0.66,True,1,391,-28.64,-8614.61,11198.24,2583.63
1929-07-25,28.77,0.13,0.45,28.83,-0.21,True,1,392,-28.77,-8643.38,11277.84,2634.46
1929-07-26,28.66,-0.11,-0.38,28.83,-0.59,True,1,393,-28.66,-8672.04,11263.38,2591.34
1929-07-29,28.18,-0.48,-1.68,28.83,-2.26,True,1,394,-28.18,-8700.22,11102.92,2402.7
1929-07-30,28.5,0.32,1.14,28.83,-1.14,True,1,395,-28.5,-8728.72,11257.5,2528.78
1929-07-31,28.88,0.38,1.33,28.88,0.0,True,1,396,-28.88,-8757.6,11436.48,2678.88
1929-08-01,29.08,0.2,0.69,29.08,0.0,True,1,397,-29.08,-8786.68,11544.76,2758.08
1929-08-02,29.56,0.48,1.65,29.56,0.0,True,1,398,-29.56,-8816.24,11764.88,2948.64
1929-08-05,29.54,-0.02,-0.07,29.56,-0.07,True,1,399,-29.54,-8845.78,11786.46,2940.68
1929-08-06,29.43,-0.11,-0.37,29.56,-0.44,True,1,400,-29.43,-8875.21,11772.0,2896.79
1929-08-07,29.13,-0.3,-1.02,29.56,-1.46,True,1,401,-29.13,-8904.34,11681.13,2776.79
1929-08-08,29.47,0.34,1.17,29.56,-0.3,True,1,402,-29.47,-8933.81,11846.94,2913.13
1929-08-09,28.38,-1.09,-3.7,29.56,-3.99,True,1,403,-28.38,-8962.19,11437.14,2474.95
1929-08-12,29.27,0.89,3.14,29.56,-0.98,True,1,404,-29.27,-8991.46,11825.08,2833.62
1929-08-13,29.53,0.26,0.89,29.56,-0.1,True,1,405,-29.53,-9020.99,11959.65,2938.66
1929-08-14,29.62,0.09,0.3,29.62,0.0,True,1,406,-29.62,-9050.61,12025.72,2975.11
1929-08-15,29.67,0.05,0.17,29.67,0.0,True,1,407,-29.67,-9080.28,12075.69,2995.41
1929-08-16,30.22,0.55,1.85,30.22,0.0,True,1,408,-30.22,-9110.5,12329.76,3219.26
1929-08-19,30.5,0.28,0.93,30.5,0.0,True,1,409,-30.5,-9141.0,12474.5,3333.5
1929-08-20,30.68,0.18,0.59,30.68,0.0,True,1,410,-30.68,-9171.68,12578.8,3407.12
1929-08-21,30.55,-0.13,-0.42,30.68,-0.42,True,1,411,-30.55,-9202.23,12556.05,3353.82
1929-08-22,30.79,0.24,0.79,30.79,0.0,True,1,412,-30.79,-9233.02,12685.48,3452.46
1929-08-23,31.09,0.3,0.97,31.09,0.0,True,1,413,-31.09,-9264.11,12840.17,3576.06
1929-08-26,31.07,-0.02,-0.06,31.09,-0.06,True,1,414,-31.07,-9295.18,12862.98,3567.8
1929-08-27,31.05,-0.02,-0.06,31.09,-0.13,True,1,415,-31.05,-9326.23,12885.75,3559.52
1929-08-28,30.99,-0.06,-0.19,31.09,-0.32,True,1,416,-30.99,-9357.22,12891.84,3534.62
1929-08-29,31.29,0.3,0.97,31.29,0.0,True,1,417,-31.29,-9388.51,13047.93,3659.42
1929-08-30,31.71,0.42,1.34,31.71,0.0,True,1,418,-31.71,-9420.22,13254.78,3834.56
1929-09-03,31.82,0.11,0.35,31.82,0.0,True,1,419,-31.82,-9452.04,13332.58,3880.54
1929-09-04,31.72,-0.1,-0.31,31.82,-0.31,True,1,420,-31.72,-9483.76,13322.4,3838.64
1929-09-05,31.02,-0.7,-2.21,31.82,-2.51,True,1,421,-31.02,-9514.78,13059.42,3544.64
1929-09-06,31.83,0.81,2.61,31.83,0.0,True,1,422,-31.83,-9546.61,13432.26,3885.65
1929-09-09,31.67,-0.16,-0.5,31.83,-0.5,True,1,423,-31.67,-9578.28,13396.41,3818.13
1929-09-10,31.1,-0.57,-1.8,31.83,-2.29,True,1,424,-31.1,-9609.38,13186.4,3577.02
1929-09-11,31.53,0.43,1.38,31.83,-0.94,True,1,425,-31.53,-9640.91,13400.25,3759.34
1929-09-12,31.17,-0.36,-1.14,31.83,-2.07,True,1,426,-31.17,-9672.08,13278.42,3606.34
1929-09-13,31.38,0.21,0.67,31.83,-1.41,True,1,427,-31.38,-9703.46,13399.26,3695.8
1929-09-16,31.86,0.48,1.53,31.86,0.0,True,1,428,-31.86,-9735.32,13636.08,3900.76
1929-09-17,31.6,-0.26,-0.82,31.86,-0.82,True,1,429,-31.6,-9766.92,13556.4,3789.48
1929-09-18,31.68,0.08,0.25,31.86,-0.56,True,1,430,-31.68,-9798.6,13622.4,3823.8
1929-09-19,31.73,0.05,0.16,31.86,-0.41,True,1,431,-31.73,-9830.33,13675.63,3845.3
1929-09-20,31.39,-0.34,-1.07,31.86,-1.48,True,1,432,-31.39,-9861.72,13560.48,3698.76
1929-09-23,31.38,-0.01,-0.03,31.86,-1.51,True,1,433,-31.38,-9893.1,13587.54,3694.44
1929-09-24,30.8,-0.58,-1.85,31.86,-3.33,True,1,434,-30.8,-9923.9,13367.2,3443.3
1929-09-25,30.85,0.05,0.16,31.86,-3.17,True,1,435,-30.85,-9954.75,13419.75,3465.0
1929-09-26,31.13,0.28,0.91,31.86,-2.29,True,1,436,-31.13,-9985.88,13572.68,3586.8
1929-09-27,30.27,-0.86,-2.76,31.86,-4.99,True,1,437,-30.27,-10016.15,13227.99,3211.84
1929-09-30,30.16,-0.11,-0.36,31.86,-5.34,True,1,438,-30.16,-10046.31,13210.08,3163.77
1929-10-01,29.98,-0.18,-0.6,31.86,-5.9,True,1,439,-29.98,-10076.29,13161.22,3084.93
1929-10-02,30.2,0.22,0.73,31.86,-5.21,True,1,440,-30.2,-10106.49,13288.0,3181.51
1929-10-03,28.95,-1.25,-4.14,31.86,-9.13,True,1,441,-28.95,-10135.44,12766.95,2631.51
1929-10-04,28.65,-0.3,-1.04,31.86,-10.07,True,1,442,-28.65,-10164.09,12663.3,2499.21
1929-10-07,30.44,1.79,6.25,31.86,-4.46,True,1,443,-30.44,-10194.53,13484.92,3290.39
1929-10-08,30.34,-0.1,-0.33,31.86,-4.77,True,1,444,-30.34,-10224.87,13470.96,3246.09
1929-10-09,30.27,-0.07,-0.23,31.86,-4.99,True,1,445,-30.27,-10255.14,13470.15,3215.01
1929-10-10,30.81,0.54,1.78,31.86,-3.3,True,1,446,-30.81,-10285.95,13741.26,3455.31
1929-10-11,30.76,-0.05,-0.16,31.86,-3.45,True,1,447,-30.76,-10316.71,13749.72,3433.01
1929-10-14,30.55,-0.21,-0.68,31.86,-4.11,True,1,448,-30.55,-10347.26,13686.4,3339.14
1929-10-15,30.3,-0.25,-0.82,31.86,-4.9,True,1,449,-30.3,-10377.56,13604.7,3227.14
1929-10-16,29.24,-1.06,-3.5,31.86,-8.22,True,1,450,-29.24,-10406.8,13158.0,2751.2
1929-10-17,29.69,0.45,1.54,31.86,-6.81,True,1,451,-29.69,-10436.49,13390.19,2953.7
1929-10-18,28.84,-0.85,-2.86,31.86,-9.48,True,1,452,-28.84,-10465.33,13035.68,2570.35
1929-10-21,27.73,-1.11,-3.85,31.86,-12.96,True,1,453,-27.73,-10493.06,12561.69,2068.63
1929-10-22,28.27,0.54,1.95,31.86,-11.27,True,1,454,-28.27,-10521.33,12834.58,2313.25
1929-10-23,26.6,-1.67,-5.91,31.86,-16.51,True,1,455,-26.6,-10547.93,12103.0,1555.07
1929-10-24,25.75,-0.85,-3.2,31.86,-19.18,True,1,456,-25.75,-10573.68,11742.0,1168.32
1929-10-25,26.12,0.37,1.44,31.86,-18.02,True,1,457,-26.12,-10599.8,11936.84,1337.04
1929-10-28,22.74,-3.38,-12.94,31.86,-28.62,True,1,458,-22.74,-10622.54,10414.92,-207.62
1929-10-29,20.43,-2.31,-10.16,31.86,-35.88,True,1,459,-20.43,-10642.97,9377.37,-1265.6
1929-10-30,22.99,2.56,12.53,31.86,-27.84,True,1,460,-22.99,-10665.96,10575.4,-90.56
1929-10-31,24.15,1.16,5.05,31.86,-24.2,True,1,461,-24.15,-10690.11,11133.15,443.04
1929-11-04,22.88,-1.27,-5.26,31.86,-28.19,True,1,462,-22.88,-10712.99,10570.56,-142.43
1929-11-06,20.61,-2.27,-9.92,31.86,-35.31,True,1,463,-20.61,-10733.6,9542.43,-1191.17
1929-11-07,21.37,0.76,3.69,31.86,-32.92,True,1,464,-21.37,-10754.97,9915.68,-839.29
1929-11-08,21.18,-0.19,-0.89,31.86,-33.52,True,1,465,-21.18,-10776.15,9848.7,-927.45
1929-11-11,19.86,-1.32,-6.23,31.86,-37.66,True,1,466,-19.86,-10796.01,9254.76,-1541.25
1929-11-12,18.73,-1.13,-5.69,31.86,-41.21,True,1,467,-18.73,-10814.74,8746.91,-2067.83
1929-11-13,17.66,-1.07,-5.71,31.86,-44.57,True,1,468,-17.66,-10832.4,8264.88,-2567.52
1929-11-14,19.24,1.58,8.95,31.86,-39.61,True,1,469,-19.24,-10851.64,9023.56,-1828.08
1929-11-15,20.3,1.06,5.51,31.86,-36.28,True,1,470,-20.3,-10871.94,9541.0,-1330.94
1929-11-18,20.09,-0.21,-1.03,31.86,-36.94,True,1,471,-20.09,-10892.03,9462.39,-1429.64
1929-11-19,20.7,0.61,3.04,31.86,-35.03,True,1,472,-20.7,-10912.73,9770.4,-1142.33
1929-11-20,21.27,0.57,2.75,31.86,-33.24,True,1,473,-21.27,-10934.0,10060.71,-873.29
1929-11-21,21.61,0.34,1.6,31.86,-32.17,True,1,474,-21.61,-10955.61,10243.14,-712.47
1929-11-22,21.53,-0.08,-0.37,31.86,-32.42,True,1,475,-21.53,-10977.14,10226.75,-750.39
1929-11-25,21.28,-0.25,-1.16,31.86,-33.21,True,1,476,-21.28,-10998.42,10129.28,-869.14
1929-11-26,20.66,-0.62,-2.91,31.86,-35.15,True,1,477,-20.66,-11019.08,9854.82,-1164.26
1929-11-27,20.92,0.26,1.26,31.86,-34.34,True,1,478,-20.92,-11040.0,9999.76,-1040.24
1929-12-02,20.95,0.03,0.14,31.86,-34.24,True,1,479,-20.95,-11060.95,10035.05,-1025.9
1929-12-03,21.65,0.7,3.34,31.86,-32.05,True,1,480,-21.65,-11082.6,10392.0,-690.6
1929-12-04,22.05,0.4,1.85,31.86,-30.79,True,1,481,-22.05,-11104.65,10606.05,-498.6
1929-12-05,21.87,-0.18,-0.82,31.86,-31.36,True,1,482,-21.87,-11126.52,10541.34,-585.18
1929-12-06,22.45,0.58,2.65,31.86,-29.54,True,1,483,-22.45,-11148.97,10843.35,-305.62
1929-12-09,22.4,-0.05,-0.22,31.86,-29.69,True,1,484,-22.4,-11171.37,10841.6,-329.77
1929-12-10,22.57,0.17,0.76,31.86,-29.16,True,1,485,-22.57,-11193.94,10946.45,-247.49
1929-12-11,22.38,-0.19,-0.84,31.86,-29.76,True,1,486,-22.38,-11216.32,10876.68,-339.64
1929-12-12,21.17,-1.21,-5.41,31.86,-33.55,True,1,487,-21.17,-11237.49,10309.79,-927.7
1929-12-13,21.7,0.53,2.5,31.86,-31.89,True,1,488,-21.7,-11259.19,10589.6,-669.59
1929-12-16,21.33,-0.37,-1.7,31.86,-33.05,True,1,489,-21.33,-11280.52,10430.37,-850.15
1929-12-17,21.56,0.23,1.08,31.86,-32.33,True,1,490,-21.56,-11302.08,10564.4,-737.68
1929-12-18,21.42,-0.14,-0.65,31.86,-32.77,True,1,491,-21.42,-11323.5,10517.22,-806.28
1929-12-19,20.85,-0.57,-2.66,31.86,-34.56,True,1,492,-20.85,-11344.35,10258.2,-1086.15
1929-12-20,20.16,-0.69,-3.31,31.86,-36.72,True,1,493,-20.16,-11364.51,9938.88,-1425.63
1929-12-23,20.26,0.1,0.5,31.86,-36.41,True,1,494,-20.26,-11384.77,10008.44,-1376.33
1929-12-24,20.39,0.13,0.64,31.86,-36.0,True,1,495,-20.39,-11405.16,10093.05,-1312.11
1929-12-26,20.84,0.45,2.21,31.86,-34.59,True,1,496,-20.84,-11426.0,10336.64,-1089.36
1929-12-27,20.82,-0.02,-0.1,31.86,-34.65,True,1,497,-20.82,-11446.82,10347.54,-1099.28
1929-12-30,20.89,0.07,0.34,31.86,-34.43,True,1,498,-20.89,-11467.71,10403.22,-1064.49
1929-12-31,21.45,0.56,2.68,31.86,-32.67,True,1,499,-21.45,-11489.16,10703.55,-785.61
1930-01-02,21.18,-0.27,-1.26,31.86,-33.52,True,1,500,-21.18,-11510.34,10590.0,-920.34
1930-01-03,21.23,0.05,0.24,31.86,-33.36,True,1,501,-21.23,-11531.57,10636.23,-895.34
1930-01-06,21.5,0.27,1.27,31.86,-32.52,True,1,502,-21.5,-11553.07,10793.0,-760.07
1930-01-07,21.31,-0.19,-0.88,31.86,-33.11,True,1,503,-21.31,-11574.38,10718.93,-855.45
1930-01-08,21.29,-0.02,-0.09,31.86,-33.18,True,1,504,-21.29,-11595.67,10730.16,-865.51
1930-01-09,21.62,0.33,1.55,31.86,-32.14,True,1,505,-21.62,-11617.29,10918.1,-699.19
1930-01-10,21.55,-0.07,-0.32,31.86,-32.36,True,1,506,-21.55,-11638.84,10904.3,-734.54
1930-01-13,21.52,-0.03,-0.14,31.86,-32.45,True,1,507,-21.52,-11660.36,10910.64,-749.72
1930-01-14,21.56,0.04,0.19,31.86,-32.33,True,1,508,-21.56,-11681.92,10952.48,-729.44
1930-01-15,21.65,0.09,0.42,31.86,-32.05,True,1,509,-21.65,-11703.57,11019.85,-683.72
1930-01-16,21.5,-0.15,-0.69,31.86,-32.52,True,1,510,-21.5,-11725.07,10965.0,-760.07
1930-01-17,21.31,-0.19,-0.88,31.86,-33.11,True,1,511,-21.31,-11746.38,10889.41,-856.97
1930-01-20,21.5,0.19,0.89,31.86,-32.52,True,1,512,-21.5,-11767.88,11008.0,-759.88
1930-01-21,21.61,0.11,0.51,31.86,-32.17,True,1,513,-21.61,-11789.49,11085.93,-703.56
1930-01-22,21.63,0.02,0.09,31.86,-32.11,True,1,514,-21.63,-11811.12,11117.82,-693.3
1930-01-23,21.84,0.21,0.97,31.86,-31.45,True,1,515,-21.84,-11832.96,11247.6,-585.36
1930-01-24,22.04,0.2,0.92,31.86,-30.82,True,1,516,-22.04,-11855.0,11372.64,-482.36
1930-01-27,22.21,0.17,0.77,31.86,-30.29,True,1,517,-22.21,-11877.21,11482.57,-394.64
1930-01-28,22.1,-0.11,-0.5,31.86,-30.63,True,1,518,-22.1,-11899.31,11447.8,-451.51
1930-01-29,22.35,0.25,1.13,31.86,-29.85,True,1,519,-22.35,-11921.66,11599.65,-322.01
1930-01-30,22.47,0.12,0.54,31.86,-29.47,True,1,520,-22.47,-11944.13,11684.4,-259.73
1930-01-31,22.79,0.32,1.42,31.86,-28.47,True,1,521,-22.79,-11966.92,11873.59,-93.33
1930-02-03,22.74,-0.05,-0.22,31.86,-28.62,True,1,522,-22.74,-11989.66,11870.28,-119.38
1930-02-04,23.01,0.27,1.19,31.86,-27.78,True,1,523,-23.01,-12012.67,12034.23,21.56
1930-02-05,23.31,0.3,1.3,31.86,-26.84,True,1,524,-23.31,-12035.98,12214.44,178.46
1930-02-06,23.06,-0.25,-1.07,31.86,-27.62,True,1,525,-23.06,-12059.04,12106.5,47.46
1930-02-07,22.97,-0.09,-0.39,31.86,-27.9,True,1,526,-22.97,-12082.01,12082.22,0.21
1930-02-10,23.12,0.15,0.65,31.86,-27.43,True,1,527,-23.12,-12105.13,12184.24,79.11
1930-02-11,23.32,0.2,0.86,31.86,-26.8,True,1,528,-23.32,-12128.45,12312.96,184.51
1930-02-13,23.36,0.04,0.17,31.86,-26.68,True,1,529,-23.36,-12151.81,12357.44,205.63
1930-02-14,23.35,-0.01,-0.04,31.86,-26.71,True,1,530,-23.35,-12175.16,12375.5,200.34
1930-02-17,23.26,-0.09,-0.38,31.86,-26.99,True,1,531,-23.26,-12198.42,12351.06,152.64
1930-02-18,23.28,0.02,0.09,31.86,-26.93,True,1,532,-23.28,-12221.7,12384.96,163.26
1930-02-19,23.07,-0.21,-0.9,31.86,-27.59,True,1,533,-23.07,-12244.77,12296.31,51.54
1930-02-20,22.64,-0.43,-1.86,31.86,-28.94,True,1,534,-22.64,-12267.41,12089.76,-177.65
1930-02-21,22.92,0.28,1.24,31.86,-28.06,True,1,535,-22.92,-12290.33,12262.2,-28.13
1930-02-24,22.68,-0.24,-1.05,31.86,-28.81,True,1,536,-22.68,-12313.01,12156.48,-156.53
1930-02-25,22.89,0.21,0.93,31.86,-28.15,True,1,537,-22.89,-12335.9,12291.93,-43.97
1930-02-26,23.11,0.22,0.96,31.86,-27.46,True,1,538,-23.11,-12359.01,12433.18,74.17
1930-02-27,23.08,-0.03,-0.13,31.86,-27.56,True,1,539,-23.08,-12382.09,12440.12,58.03
1930-02-28,23.28,0.2,0.87,31.86,-26.93,True,1,540,-23.28,-12405.37,12571.2,165.83
1930-03-03,23.36,0.08,0.34,31.86,-26.68,True,1,541,-23.36,-12428.73,12637.76,209.03
1930-03-04,23.54,0.18,0.77,31.86,-26.11,True,1,542,-23.54,-12452.27,12758.68,306.41
1930-03-05,23.36,-0.18,-0.76,31.86,-26.68,True,1,543,-23.36,-12475.63,12684.48,208.85
1930-03-06,23.59,0.23,0.98,31.86,-25.96,True,1,544,-23.59,-12499.22,12832.96,333.74
1930-03-07,23.59,0.0,0.0,31.86,-25.96,True,1,545,-23.59,-12522.81,12856.55,333.74
1930-03-10,23.67,0.08,0.34,31.86,-25.71,True,1,546,-23.67,-12546.48,12923.82,377.34
1930-03-11,23.72,0.05,0.21,31.86,-25.55,True,1,547,-23.72,-12570.2,12974.84,404.64
1930-03-12,23.46,-0.26,-1.1,31.86,-26.36,True,1,548,-23.46,-12593.66,12856.08,262.42
1930-03-13,23.6,0.14,0.6,31.86,-25.93,True,1,549,-23.6,-12617.26,12956.4,339.14
1930-03-14,23.45,-0.15,-0.64,31.86,-26.4,True,1,550,-23.45,-12640.71,12897.5,256.79
1930-03-17,23.67,0.22,0.94,31.86,-25.71,True,1,551,-23.67,-12664.38,13042.17,377.79
1930-03-18,23.9,0.23,0.97,31.86,-24.98,True,1,552,-23.9,-12688.28,13192.8,504.52
1930-03-19,24.03,0.13,0.54,31.86,-24.58,True,1,553,-24.03,-12712.31,13288.59,576.28
1930-03-20,24.14,0.11,0.46,31.86,-24.23,True,1,554,-24.14,-12736.45,13373.56,637.11
1930-03-21,24.29,0.15,0.62,31.86,-23.76,True,1,555,-24.29,-12760.74,13480.95,720.21
1930-03-24,24.28,-0.01,-0.04,31.86,-23.79,True,1,556,-24.28,-12785.02,13499.68,714.66
1930-03-25,24.25,-0.03,-0.12,31.86,-23.89,True,1,557,-24.25,-12809.27,13507.25,697.98
1930-03-26,24.62,0.37,1.53,31.86,-22.72,True,1,558,-24.62,-12833.89,13737.96,904.07
1930-03-27,24.57,-0.05,-0.2,31.86,-22.88,True,1,559,-24.57,-12858.46,13734.63,876.17
1930-03-28,24.85,0.28,1.14,31.86,-22.0,True,1,560,-24.85,-12883.31,13916.0,1032.69
1930-03-31,24.15,-0.7,-2.82,31.86,-24.2,True,1,561,-24.15,-12907.46,13548.15,640.69
1930-04-01,25.37,1.22,5.05,31.86,-20.37,True,1,562,-25.37,-12932.83,14257.94,1325.11
1930-04-02,25.11,-0.26,-1.02,31.86,-21.19,True,1,563,-25.11,-12957.94,14136.93,1178.99
1930-04-03,25.16,0.05,0.2,31.86,-21.03,True,1,564,-25.16,-12983.1,14190.24,1207.14
1930-04-04,25.54,0.38,1.51,31.86,-19.84,True,1,565,-25.54,-13008.64,14430.1,1421.46
1930-04-07,25.6,0.06,0.24,31.86,-19.65,True,1,566,-25.6,-13034.24,14489.6,1455.36
1930-04-08,25.46,-0.14,-0.55,31.86,-20.09,True,1,567,-25.46,-13059.7,14435.82,1376.12
1930-04-09,25.87,0.41,1.61,31.86,-18.8,True,1,568,-25.87,-13085.57,14694.16,1608.59
1930-04-10,25.92,0.05,0.19,31.86,-18.64,True,1,569,-25.92,-13111.49,14748.48,1636.99
1930-04-11,25.84,-0.08,-0.31,31.86,-18.9,True,1,570,-25.84,-13137.33,14728.8,1591.47
1930-04-14,25.73,-0.11,-0.43,31.86,-19.24,True,1,571,-25.73,-13163.06,14691.83,1528.77
1930-04-15,25.74,0.01,0.04,31.86,-19.21,True,1,572,-25.74,-13188.8,14723.28,1534.48
1930-04-16,25.56,-0.18,-0.7,31.86,-19.77,True,1,573,-25.56,-13214.36,14645.88,1431.52
1930-04-17,25.75,0.19,0.74,31.86,-19.18,True,1,574,-25.75,-13240.11,14780.5,1540.39
1930-04-21,25.29,-0.46,-1.79,31.86,-20.62,True,1,575,-25.29,-13265.4,14541.75,1276.35
1930-04-22,25.5,0.21,0.83,31.86,-19.96,True,1,576,-25.5,-13290.9,14688.0,1397.1
1930-04-23,25.55,0.05,0.2,31.86,-19.8,True,1,577,-25.55,-13316.45,14742.35,1425.9
1930-04-24,25.35,-0.2,-0.78,31.86,-20.43,True,1,578,-25.35,-13341.8,14652.3,1310.5
1930-04-25,25.32,-0.03,-0.12,31.86,-20.53,True,1,579,-25.32,-13367.12,14660.28,1293.16
1930-04-28,24.76,-0.56,-2.21,31.86,-22.28,True,1,580,-24.76,-13391.88,14360.8,968.92
1930-04-29,24.73,-0.03,-0.12,31.86,-22.38,True,1,581,-24.73,-13416.61,14368.13,951.52
1930-04-30,24.9,0.17,0.69,31.86,-21.85,True,1,582,-24.9,-13441.51,14491.8,1050.29
1930-05-01,24.3,-0.6,-2.41,31.86,-23.73,True,1,583,-24.3,-13465.81,14166.9,701.09
1930-05-02,23.57,-0.73,-3.0,31.86,-26.02,True,1,584,-23.57,-13489.38,13764.88,275.5
1930-05-05,22.98,-0.59,-2.5,31.86,-27.87,True,1,585,-22.98,-13512.36,13443.3,-69.06
1930-05-06,23.76,0.78,3.39,31.86,-25.42,True,1,586,-23.76,-13536.12,13923.36,387.24
1930-05-07,23.31,-0.45,-1.89,31.86,-26.84,True,1,587,-23.31,-13559.43,13682.97,123.54
1930-05-08,23.4,0.09,0.39,31.86,-26.55,True,1,588,-23.4,-13582.83,13759.2,176.37
1930-05-09,23.69,0.29,1.24,31.86,-25.64,True,1,589,-23.69,-13606.52,13953.41,346.89
1930-05-12,24.09,0.4,1.69,31.86,-24.39,True,1,590,-24.09,-13630.61,14213.1,582.49
1930-05-13,24.42,0.33,1.37,31.86,-23.35,True,1,591,-24.42,-13655.03,14432.22,777.19
1930-05-14,24.57,0.15,0.61,31.86,-22.88,True,1,592,-24.57,-13679.6,14545.44,865.84
1930-05-15,24.17,-0.4,-1.63,31.86,-24.14,True,1,593,-24.17,-13703.77,14332.81,629.04
1930-05-16,24.28,0.11,0.46,31.86,-23.79,True,1,594,-24.28,-13728.05,14422.32,694.27
1930-05-19,23.75,-0.53,-2.18,31.86,-25.46,True,1,595,-23.75,-13751.8,14131.25,379.45
1930-05-20,23.86,0.11,0.46,31.86,-25.11,True,1,596,-23.86,-13775.66,14220.56,444.9
1930-05-21,23.74,-0.12,-0.5,31.86,-25.49,True,1,597,-23.74,-13799.4,14172.78,373.38
1930-05-22,23.79,0.05,0.21,31.86,-25.33,True,1,598,-23.79,-13823.19,14226.42,403.23
1930-05-23,24.03,0.24,1.01,31.86,-24.58,True,1,599,-24.03,-13847.22,14393.97,546.75
1930-05-26,24.23,0.2,0.83,31.86,-23.95,True,1,600,-24.23,-13871.45,14538.0,666.55
1930-05-27,24.24,0.01,0.04,31.86,-23.92,True,1,601,-24.24,-13895.69,14568.24,672.55
1930-05-28,24.38,0.14,0.58,31.86,-23.48,True,1,602,-24.38,-13920.07,14676.76,756.69
1930-05-29,24.49,0.11,0.45,31.86,-23.13,True,1,603,-24.49,-13944.56,14767.47,822.91
1930-06-02,24.4,-0.09,-0.37,31.86,-23.42,True,1,604,-24.4,-13968.96,14737.6,768.64
1930-06-03,24.18,-0.22,-0.9,31.86,-24.1,True,1,605,-24.18,-13993.14,14628.9,635.76
1930-06-04,24.29,0.11,0.46,31.86,-23.76,True,1,606,-24.29,-14017.43,14719.74,702.31
1930-06-05,23.91,-0.38,-1.56,31.86,-24.95,True,1,607,-23.91,-14041.34,14513.37,472.03
1930-06-06,23.52,-0.39,-1.63,31.86,-26.18,True,1,608,-23.52,-14064.86,14300.16,235.3
1930-06-09,22.38,-1.14,-4.85,31.86,-29.76,True,1,609,-22.38,-14087.24,13629.42,-457.82
1930-06-10,23.01,0.63,2.82,31.86,-27.78,True,1,610,-23.01,-14110.25,14036.1,-74.15
1930-06-11,22.2,-0.81,-3.52,31.86,-30.32,True,1,611,-22.2,-14132.45,13564.2,-568.25
1930-06-12,22.13,-0.07,-0.32,31.86,-30.54,True,1,612,-22.13,-14154.58,13543.56,-611.02
1930-06-13,22.26,0.13,0.59,31.86,-30.13,True,1,613,-22.26,-14176.84,13645.38,-531.46
1930-06-16,20.56,-1.7,-7.64,31.86,-35.47,True,1,614,-20.56,-14197.4,12623.84,-1573.56
1930-06-17,20.58,0.02,0.1,31.86,-35.4,True,1,615,-20.58,-14217.98,12656.7,-1561.28
1930-06-18,19.86,-0.72,-3.5,31.86,-37.66,True,1,616,-19.86,-14237.84,12233.76,-2004.08
1930-06-19,20.79,0.93,4.68,31.86,-34.75,True,1,617,-20.79,-14258.63,12827.43,-1431.2
1930-06-20,20.25,-0.54,-2.6,31.86,-36.44,True,1,618,-20.25,-14278.88,12514.5,-1764.38
1930-06-23,20.09,-0.16,-0.79,31.86,-36.94,True,1,619,-20.09,-14298.97,12435.71,-1863.26
1930-06-24,19.39,-0.7,-3.48,31.86,-39.14,True,1,620,-19.39,-14318.36,12021.8,-2296.56
1930-06-25,19.54,0.15,0.77,31.86,-38.67,True,1,621,-19.54,-14337.9,12134.34,-2203.56
1930-06-26,20.0,0.46,2.35,31.86,-37.22,True,1,622,-20.0,-14357.9,12440.0,-1917.9
1930-06-27,19.81,-0.19,-0.95,31.86,-37.82,True,1,623,-19.81,-14377.71,12341.63,-2036.08
1930-06-30,20.46,0.65,3.28,31.86,-35.78,True,1,624,-20.46,-14398.17,12767.04,-1631.13
1930-07-01,20.24,-0.22,-1.08,31.86,-36.47,True,1,625,-20.24,-14418.41,12650.0,-1768.41
1930-07-02,20.46,0.22,1.09,31.86,-35.78,True,1,626,-20.46,-14438.87,12807.96,-1630.91
1930-07-03,20.25,-0.21,-1.03,31.86,-36.44,True,1,627,-20.25,-14459.12,12696.75,-1762.37
1930-07-07,19.83,-0.42,-2.07,31.86,-37.76,True,1,628,-19.83,-14478.95,12453.24,-2025.71
1930-07-08,19.97,0.14,0.71,31.86,-37.32,True,1,629,-19.97,-14498.92,12561.13,-1937.79
1930-07-09,20.26,0.29,1.45,31.86,-36.41,True,1,630,-20.26,-14519.18,12763.8,-1755.38
1930-07-10,20.77,0.51,2.52,31.86,-34.81,True,1,631,-20.77,-14539.95,13105.87,-1434.08
1930-07-11,20.55,-0.22,-1.06,31.86,-35.5,True,1,632,-20.55,-14560.5,12987.6,-1572.9
1930-07-14,21.36,0.81,3.94,31.86,-32.96,True,1,633,-21.36,-14581.86,13520.88,-1060.98
1930-07-15,21.32,-0.04,-0.19,31.86,-33.08,True,1,634,-21.32,-14603.18,13516.88,-1086.3
1930-07-16,21.48,0.16,0.75,31.86,-32.58,True,1,635,-21.48,-14624.66,13639.8,-984.86
1930-07-17,21.58,0.1,0.47,31.86,-32.27,True,1,636,-21.58,-14646.24,13724.88,-921.36
1930-07-18,21.77,0.19,0.88,31.86,-31.67,True,1,637,-21.77,-14668.01,13867.49,-800.52
1930-07-21,20.94,-0.83,-3.81,31.86,-34.28,True,1,638,-20.94,-14688.95,13359.72,-1329.23
1930-07-22,21.32,0.38,1.82,31.86,-33.08,True,1,639,-21.32,-14710.27,13623.48,-1086.79
1930-07-23,21.66,0.34,1.6,31.86,-32.02,True,1,640,-21.66,-14731.93,13862.4,-869.53
1930-07-24,21.38,-0.28,-1.29,31.86,-32.89,True,1,641,-21.38,-14753.31,13704.58,-1048.73
1930-07-25,21.5,0.12,0.56,31.86,-32.52,True,1,642,-21.5,-14774.81,13803.0,-971.81
1930-07-28,21.82,0.32,1.49,31.86,-31.51,True,1,643,-21.82,-14796.63,14030.26,-766.37
1930-07-29,21.65,-0.17,-0.78,31.86,-32.05,True,1,644,-21.65,-14818.28,13942.6,-875.68
1930-07-30,21.08,-0.57,-2.63,31.86,-33.84,True,1,645,-21.08,-14839.36,13596.6,-1242.76
1930-07-31,21.21,0.13,0.62,31.86,-33.43,True,1,646,-21.21,-14860.57,13701.66,-1158.91
1930-08-01,21.11,-0.1,-0.47,31.86,-33.74,True,1,647,-21.11,-14881.68,13658.17,-1223.51
1930-08-04,21.52,0.41,1.94,31.86,-32.45,True,1,648,-21.52,-14903.2,13944.96,-958.24
1930-08-05,21.52,0.0,0.0,31.86,-32.45,True,1,649,-21.52,-14924.72,13966.48,-958.24
1930-08-06,21.18,-0.34,-1.58,31.86,-33.52,True,1,650,-21.18,-14945.9,13767.0,-1178.9
1930-08-07,21.06,-0.12,-0.57,31.86,-33.9,True,1,651,-21.06,-14966.96,13710.06,-1256.9
1930-08-08,20.27,-0.79,-3.75,31.86,-36.38,True,1,652,-20.27,-14987.23,13216.04,-1771.19
1930-08-11,20.4,0.13,0.64,31.86,-35.97,True,1,653,-20.4,-15007.63,13321.2,-1686.43
1930-08-12,19.88,-0.52,-2.55,31.86,-37.6,True,1,654,-19.88,-15027.51,13001.52,-2025.99
1930-08-13,20.15,0.27,1.36,31.86,-36.76,True,1,655,-20.15,-15047.66,13198.25,-1849.41
1930-08-14,20.16,0.01,0.05,31.86,-36.72,True,1,656,-20.16,-15067.82,13224.96,-1842.86
1930-08-15,20.7,0.54,2.68,31.86,-35.03,True,1,657,-20.7,-15088.52,13599.9,-1488.62
1930-08-18,20.54,-0.16,-0.77,31.86,-35.53,True,1,658,-20.54,-15109.06,13515.32,-1593.74
1930-08-19,20.74,0.2,0.97,31.86,-34.9,True,1,659,-20.74,-15129.8,13667.66,-1462.14
1930-08-20,20.85,0.11,0.53,31.86,-34.56,True,1,660,-20.85,-15150.65,13761.0,-1389.65
1930-08-21,20.64,-0.21,-1.01,31.86,-35.22,True,1,661,-20.64,-15171.29,13643.04,-1528.25
1930-08-22,20.79,0.15,0.73,31.86,-34.75,True,1,662,-20.79,-15192.08,13762.98,-1429.1
1930-08-25,20.68,-0.11,-0.53,31.86,-35.09,True,1,663,-20.68,-15212.76,13710.84,-1501.92
1930-08-26,20.98,0.3,1.45,31.86,-34.15,True,1,664,-20.98,-15233.74,13930.72,-1303.02
1930-08-27,21.14,0.16,0.76,31.86,-33.65,True,1,665,-21.14,-15254.88,14058.1,-1196.78
1930-08-28,21.13,-0.01,-0.05,31.86,-33.68,True,1,666,-21.13,-15276.01,14072.58,-1203.43
1930-08-29,21.37,0.24,1.14,31.86,-32.92,True,1,667,-21.37,-15297.38,14253.79,-1043.59
1930-09-02,21.38,0.01,0.05,31.86,-32.89,True,1,668,-21.38,-15318.76,14281.84,-1036.92
1930-09-03,21.17,-0.21,-0.98,31.86,-33.55,True,1,669,-21.17,-15339.93,14162.73,-1177.2
1930-09-04,21.02,-0.15,-0.71,31.86,-34.02,True,1,670,-21.02,-15360.95,14083.4,-1277.55
1930-09-05,21.34,0.32,1.52,31.86,-33.02,True,1,671,-21.34,-15382.29,14319.14,-1063.15
1930-09-08,21.63,0.29,1.36,31.86,-32.11,True,1,672,-21.63,-15403.92,14535.36,-868.56
1930-09-09,21.76,0.13,0.6,31.86,-31.7,True,1,673,-21.76,-15425.68,14644.48,-781.2
1930-09-10,21.86,0.1,0.46,31.86,-31.39,True,1,674,-21.86,-15447.54,14733.64,-713.9
1930-09-11,21.72,-0.14,-0.64,31.86,-31.83,True,1,675,-21.72,-15469.26,14661.0,-808.26
1930-09-12,21.5,-0.22,-1.01,31.86,-32.52,True,1,676,-21.5,-15490.76,14534.0,-956.76
1930-09-15,21.19,-0.31,-1.44,31.86,-33.49,True,1,677,-21.19,-15511.95,14345.63,-1166.32
1930-09-16,21.22,0.03,0.14,31.86,-33.4,True,1,678,-21.22,-15533.17,14387.16,-1146.01
1930-09-17,21.29,0.07,0.33,31.86,-33.18,True,1,679,-21.29,-15554.46,14455.91,-1098.55
1930-09-18,21.06,-0.23,-1.08,31.86,-33.9,True,1,680,-21.06,-15575.52,14320.8,-1254.72
1930-09-19,20.68,-0.38,-1.8,31.86,-35.09,True,1,681,-20.68,-15596.2,14083.08,-1513.12
1930-09-22,20.17,-0.51,-2.47,31.86,-36.69,True,1,682,-20.17,-15616.37,13755.94,-1860.43
1930-09-23,20.44,0.27,1.34,31.86,-35.84,True,1,683,-20.44,-15636.81,13960.52,-1676.29
1930-09-24,20.11,-0.33,-1.61,31.86,-36.88,True,1,684,-20.11,-15656.92,13755.24,-1901.68
1930-09-25,19.73,-0.38,-1.89,31.86,-38.07,True,1,685,-19.73,-15676.65,13515.05,-2161.6
1930-09-26,19.43,-0.3,-1.52,31.86,-39.01,True,1,686,-19.43,-15696.08,13328.98,-2367.1
1930-09-29,18.88,-0.55,-2.83,31.86,-40.74,True,1,687,-18.88,-15714.96,12970.56,-2744.4
1930-09-30,18.59,-0.29,-1.54,31.86,-41.65,True,1,688,-18.59,-15733.55,12789.92,-2943.63
1930-10-01,19.42,0.83,4.46,31.86,-39.05,True,1,689,-19.42,-15752.97,13380.38,-2372.59
1930-10-02,19.18,-0.24,-1.24,31.86,-39.8,True,1,690,-19.18,-15772.15,13234.2,-2537.95
1930-10-03,19.42,0.24,1.25,31.86,-39.05,True,1,691,-19.42,-15791.57,13419.22,-2372.35
1930-10-06,18.61,-0.81,-4.17,31.86,-41.59,True,1,692,-18.61,-15810.18,12878.12,-2932.06
1930-10-07,18.62,0.01,0.05,31.86,-41.56,True,1,693,-18.62,-15828.8,12903.66,-2925.14
1930-10-08,18.4,-0.22,-1.18,31.86,-42.25,True,1,694,-18.4,-15847.2,12769.6,-3077.6
1930-10-09,17.67,-0.73,-3.97,31.86,-44.54,True,1,695,-17.67,-15864.87,12280.65,-3584.22
1930-10-10,18.11,0.44,2.49,31.86,-43.16,True,1,696,-18.11,-15882.98,12604.56,-3278.42
1930-10-14,17.91,-0.2,-1.1,31.86,-43.78,True,1,697,-17.91,-15900.89,12483.27,-3417.62
1930-10-15,18.2,0.29,1.62,31.86,-42.88,True,1,698,-18.2,-15919.09,12703.6,-3215.49
1930-10-16,17.88,-0.32,-1.76,31.86,-43.88,True,1,699,-17.88,-15936.97,12498.12,-3438.85
1930-10-17,17.16,-0.72,-4.03,31.86,-46.14,True,1,700,-17.16,-15954.13,12012.0,-3942.13
1930-10-20,17.57,0.41,2.39,31.86,-44.85,True,1,701,-17.57,-15971.7,12316.57,-3655.13
1930-10-21,17.05,-0.52,-2.96,31.86,-46.48,True,1,702,-17.05,-15988.75,11969.1,-4019.65
1930-10-22,16.9,-0.15,-0.88,31.86,-46.96,True,1,703,-16.9,-16005.65,11880.7,-4124.95
1930-10-23,17.14,0.24,1.42,31.86,-46.2,True,1,704,-17.14,-16022.79,12066.56,-3956.23
1930-10-24,17.74,0.6,3.5,31.86,-44.32,True,1,705,-17.74,-16040.53,12506.7,-3533.83
1930-10-27,17.78,0.04,0.22,31.86,-44.19,True,1,706,-17.78,-16058.31,12552.68,-3505.63
1930-10-28,17.86,0.08,0.45,31.86,-43.94,True,1,707,-17.86,-16076.17,12627.02,-3449.15
1930-10-29,17.55,-0.31,-1.74,31.86,-44.92,True,1,708,-17.55,-16093.72,12425.4,-3668.32
1930-10-30,17.34,-0.21,-1.2,31.86,-45.57,True,1,709,-17.34,-16111.06,12294.06,-3817.0
1930-10-31,16.94,-0.4,-2.31,31.86,-46.83,True,1,710,-16.94,-16128.0,12027.4,-4100.6
1930-11-03,17.13,0.19,1.12,31.86,-46.23,True,1,711,-17.13,-16145.13,12179.43,-3965.7
1930-11-05,16.62,-0.51,-2.98,31.86,-47.83,True,1,712,-16.62,-16161.75,11833.44,-4328.31
1930-11-06,16.65,0.03,0.18,31.86,-47.74,True,1,713,-16.65,-16178.4,11871.45,-4306.95
1930-11-07,16.09,-0.56,-3.36,31.86,-49.5,True,1,714,-16.09,-16194.49,11488.26,-4706.23
1930-11-10,15.54,-0.55,-3.42,31.86,-51.22,True,1,715,-15.54,-16210.03,11111.1,-5098.93
1930-11-11,15.79,0.25,1.61,31.86,-50.44,True,1,716,-15.79,-16225.82,11305.64,-4920.18
1930-11-12,16.14,0.35,2.22,31.86,-49.34,True,1,717,-16.14,-16241.96,11572.38,-4669.58
1930-11-13,16.56,0.42,2.6,31.86,-48.02,True,1,718,-16.56,-16258.52,11890.08,-4368.44
1930-11-14,16.89,0.33,1.99,31.86,-46.99,True,1,719,-16.89,-16275.41,12143.91,-4131.5
1930-11-17,16.48,-0.41,-2.43,31.86,-48.27,True,1,720,-16.48,-16291.89,11865.6,-4426.29
1930-11-18,16.66,0.18,1.09,31.86,-47.71,True,1,721,-16.66,-16308.55,12011.86,-4296.69
1930-11-19,17.01,0.35,2.1,31.86,-46.61,True,1,722,-17.01,-16325.56,12281.22,-4044.34
1930-11-20,16.94,-0.07,-0.41,31.86,-46.83,True,1,723,-16.94,-16342.5,12247.62,-4094.88
1930-11-21,17.2,0.26,1.54,31.86,-46.01,True,1,724,-17.2,-16359.7,12452.8,-3906.9
1930-11-24,17.05,-0.15,-0.87,31.86,-46.48,True,1,725,-17.05,-16376.75,12361.25,-4015.5
1930-11-25,16.85,-0.2,-1.17,31.86,-47.11,True,1,726,-16.85,-16393.6,12233.1,-4160.5
1930-11-26,16.61,-0.24,-1.42,31.86,-47.87,True,1,727,-16.61,-16410.21,12075.47,-4334.74
1930-11-28,16.38,-0.23,-1.38,31.86,-48.59,True,1,728,-16.38,-16426.59,11924.64,-4501.95
1930-12-01,16.8,0.42,2.56,31.86,-47.27,True,1,729,-16.8,-16443.39,12247.2,-4196.19
1930-12-02,16.96,0.16,0.95,31.86,-46.77,True,1,730,-16.96,-16460.35,12380.8,-4079.55
1930-12-03,16.67,-0.29,-1.71,31.86,-47.68,True,1,731,-16.67,-16477.02,12185.77,-4291.25
1930-12-04,16.42,-0.25,-1.5,31.86,-48.46,True,1,732,-16.42,-16493.44,12019.44,-4474.0
1930-12-05,16.43,0.01,0.06,31.86,-48.43,True,1,733,-16.43,-16509.87,12043.19,-4466.68
1930-12-08,15.97,-0.46,-2.8,31.86,-49.87,True,1,734,-15.97,-16525.84,11721.98,-4803.86
1930-12-09,15.98,0.01,0.06,31.86,-49.84,True,1,735,-15.98,-16541.82,11745.3,-4796.52
1930-12-10,15.73,-0.25,-1.56,31.86,-50.63,True,1,736,-15.73,-16557.55,11577.28,-4980.27
1930-12-11,15.55,-0.18,-1.14,31.86,-51.19,True,1,737,-15.55,-16573.1,11460.35,-5112.75
1930-12-12,15.43,-0.12,-0.77,31.86,-51.57,True,1,738,-15.43,-16588.53,11387.34,-5201.19
1930-12-15,14.94,-0.49,-3.18,31.86,-53.11,True,1,739,-14.94,-16603.47,11040.66,-5562.81
1930-12-16,14.44,-0.5,-3.35,31.86,-54.68,True,1,740,-14.44,-16617.91,10685.6,-5932.31
1930-12-17,15.11,0.67,4.64,31.86,-52.57,True,1,741,-15.11,-16633.02,11196.51,-5436.51
1930-12-18,15.22,0.11,0.73,31.86,-52.23,True,1,742,-15.22,-16648.24,11293.24,-5355.0
1930-12-19,15.39,0.17,1.12,31.86,-51.7,True,1,743,-15.39,-16663.63,11434.77,-5228.86
1930-12-22,14.88,-0.51,-3.31,31.86,-53.3,True,1,744,-14.88,-16678.51,11070.72,-5607.79
1930-12-23,14.96,0.08,0.54,31.86,-53.04,True,1,745,-14.96,-16693.47,11145.2,-5548.27
1930-12-24,15.16,0.2,1.34,31.86,-52.42,True,1,746,-15.16,-16708.63,11309.36,-5399.27
1930-12-26,14.85,-0.31,-2.04,31.86,-53.39,True,1,747,-14.85,-16723.48,11092.95,-5630.53
1930-12-29,14.72,-0.13,-0.88,31.86,-53.8,True,1,748,-14.72,-16738.2,11010.56,-5727.64
1930-12-30,15.06,0.34,2.31,31.86,-52.73,True,1,749,-15.06,-16753.26,11279.94,-5473.32
1930-12-31,15.34,0.28,1.86,31.86,-51.85,True,1,750,-15.34,-16768.6,11505.0,-5263.6
1931-01-02,15.85,0.51,3.32,31.86,-50.25,True,1,751,-15.85,-16784.45,11903.35,-4881.1
1931-01-05,15.93,0.08,0.5,31.86,-50.0,True,1,752,-15.93,-16800.38,11979.36,-4821.02
1931-01-06,16.13,0.2,1.25,31.86,-49.37,True,1,753,-16.13,-16816.51,12145.89,-4670.62
1931-01-07,15.09,-1.04,-6.45,31.86,-52.64,True,1,754,-15.09,-16831.6,11377.86,-5453.74
1931-01-08,16.23,1.14,7.56,31.86,-49.06,True,1,755,-16.23,-16847.83,12253.65,-4594.18
1931-01-09,16.07,-0.16,-0.99,31.86,-49.56,True,1,756,-16.07,-16863.9,12148.92,-4714.98
1931-01-12,15.84,-0.23,-1.43,31.86,-50.28,True,1,757,-15.84,-16879.74,11990.88,-4888.86
1931-01-13,15.65,-0.19,-1.2,31.86,-50.88,True,1,758,-15.65,-16895.39,11862.7,-5032.69
1931-01-14,15.83,0.18,1.15,31.86,-50.31,True,1,759,-15.83,-16911.22,12014.97,-4896.25
1931-01-15,15.46,-0.37,-2.34,31.86,-51.48,True,1,760,-15.46,-16926.68,11749.6,-5177.08
1931-01-16,15.65,0.19,1.23,31.86,-50.88,True,1,761,-15.65,-16942.33,11909.65,-5032.68
1931-01-19,15.46,-0.19,-1.21,31.86,-51.48,True,1,762,-15.46,-16957.79,11780.52,-5177.27
1931-01-20,15.78,0.32,2.07,31.86,-50.47,True,1,763,-15.78,-16973.57,12040.14,-4933.43
1931-01-21,15.78,0.0,0.0,31.86,-50.47,True,1,764,-15.78,-16989.35,12055.92,-4933.43
1931-01-22,16.07,0.29,1.84,31.86,-49.56,True,1,765,-16.07,-17005.42,12293.55,-4711.87
1931-01-23,16.42,0.35,2.18,31.86,-48.46,True,1,766,-16.42,-17021.84,12577.72,-4444.12
1931-01-26,16.4,-0.02,-0.12,31.86,-48.52,True,1,767,-16.4,-17038.24,12578.8,-4459.44
1931-01-27,16.32,-0.08,-0.49,31.86,-48.78,True,1,768,-16.32,-17054.56,12533.76,-4520.8
1931-01-28,16.02,-0.3,-1.84,31.86,-49.72,True,1,769,-16.02,-17070.58,12319.38,-4751.2
1931-01-29,16.17,0.15,0.94,31.86,-49.25,True,1,770,-16.17,-17086.75,12450.9,-4635.85
1931-01-30,16.19,0.02,0.12,31.86,-49.18,True,1,771,-16.19,-17102.94,12482.49,-4620.45
1931-02-02,16.16,-0.03,-0.18,31.86,-49.28,True,1,772,-16.16,-17119.1,12475.52,-4643.58
1931-02-03,16.24,0.08,0.5,31.86,-49.03,True,1,773,-16.24,-17135.34,12553.52,-4581.82
1931-02-04,16.33,0.09,0.55,31.86,-48.74,True,1,774,-16.33,-17151.67,12639.42,-4512.25
1931-02-05,16.22,-0.11,-0.67,31.86,-49.09,True,1,775,-16.22,-17167.89,12570.5,-4597.39
1931-02-06,16.27,0.05,0.31,31.86,-48.93,True,1,776,-16.27,-17184.16,12625.52,-4558.64
1931-02-09,16.96,0.69,4.24,31.86,-46.77,True,1,777,-16.96,-17201.12,13177.92,-4023.2
1931-02-10,17.23,0.27,1.59,31.86,-45.92,True,1,778,-17.23,-17218.35,13404.94,-3813.41
1931-02-11,17.28,0.05,0.29,31.86,-45.76,True,1,779,-17.28,-17235.63,13461.12,-3774.51
1931-02-13,17.18,-0.1,-0.58,31.86,-46.08,True,1,780,-17.18,-17252.81,13400.4,-3852.41
1931-02-16,17.34,0.16,0.93,31.86,-45.57,True,1,781,-17.34,-17270.15,13542.54,-3727.61
1931-02-17,17.05,-0.29,-1.67,31.86,-46.48,True,1,782,-17.05,-17287.2,13333.1,-3954.1
1931-02-18,17.2,0.15,0.88,31.86,-46.01,True,1,783,-17.2,-17304.4,13467.6,-3836.8
1931-02-19,17.43,0.23,1.34,31.86,-45.29,True,1,784,-17.43,-17321.83,13665.12,-3656.71
1931-02-20,17.71,0.28,1.61,31.86,-44.41,True,1,785,-17.71,-17339.54,13902.35,-3437.19
1931-02-24,18.17,0.46,2.6,31.86,-42.97,True,1,786,-18.17,-17357.71,14281.62,-3076.09
1931-02-25,17.97,-0.2,-1.1,31.86,-43.6,True,1,787,-17.97,-17375.68,14142.39,-3233.29
1931-02-26,18.17,0.2,1.11,31.86,-42.97,True,1,788,-18.17,-17393.85,14317.96,-3075.89
1931-02-27,18.03,-0.14,-0.77,31.86,-43.41,True,1,789,-18.03,-17411.88,14225.67,-3186.21
1931-03-02,17.52,-0.51,-2.83,31.86,-45.01,True,1,790,-17.52,-17429.4,13840.8,-3588.6
1931-03-03,17.5,-0.02,-0.11,31.86,-45.07,True,1,791,-17.5,-17446.9,13842.5,-3604.4
1931-03-04,17.34,-0.16,-0.91,31.86,-45.57,True,1,792,-17.34,-17464.24,13733.28,-3730.96
1931-03-05,17.69,0.35,2.02,31.86,-44.48,True,1,793,-17.69,-17481.93,14028.17,-3453.76
1931-03-06,17.32,-0.37,-2.09,31.86,-45.64,True,1,794,-17.32,-17499.25,13752.08,-3747.17
1931-03-09,17.76,0.44,2.54,31.86,-44.26,True,1,795,-17.76,-17517.01,14119.2,-3397.81
1931-03-10,17.72,-0.04,-0.22,31.86,-44.38,True,1,796,-17.72,-17534.73,14105.12,-3429.61
1931-03-11,17.52,-0.2,-1.13,31.86,-45.01,True,1,797,-17.52,-17552.25,13963.44,-3588.81
1931-03-12,17.4,-0.12,-0.68,31.86,-45.39,True,1,798,-17.4,-17569.65,13885.2,-3684.45
1931-03-13,17.32,-0.08,-0.46,31.86,-45.64,True,1,799,-17.32,-17586.97,13838.68,-3748.29
1931-03-16,17.77,0.45,2.6,31.86,-44.22,True,1,800,-17.77,-17604.74,14216.0,-3388.74
1931-03-17,17.58,-0.19,-1.07,31.86,-44.82,True,1,801,-17.58,-17622.32,14081.58,-3540.74
1931-03-18,17.81,0.23,1.31,31.86,-44.1,True,1,802,-17.81,-17640.13,14283.62,-3356.51
1931-03-19,18.01,0.2,1.12,31.86,-43.47,True,1,803,-18.01,-17658.14,14462.03,-3196.11
1931-03-20,18.06,0.05,0.28,31.86,-43.32,True,1,804,-18.06,-17676.2,14520.24,-3155.96
1931-03-23,17.76,-0.3,-1.66,31.86,-44.26,True,1,805,-17.76,-17693.96,14296.8,-3397.16
1931-03-24,17.88,0.12,0.68,31.86,-43.88,True,1,806,-17.88,-17711.84,14411.28,-3300.56
1931-03-25,17.78,-0.1,-0.56,31.86,-44.19,True,1,807,-17.78,-17729.62,14348.46,-3381.16
1931-03-26,17.54,-0.24,-1.35,31.86,-44.95,True,1,808,-17.54,-17747.16,14172.32,-3574.84
1931-03-27,17.21,-0.33,-1.88,31.86,-45.98,True,1,809,-17.21,-17764.37,13922.89,-3841.48
1931-03-30,16.66,-0.55,-3.2,31.86,-47.71,True,1,810,-16.66,-17781.03,13494.6,-4286.43
1931-03-31,16.69,0.03,0.18,31.86,-47.62,True,1,811,-16.69,-17797.72,13535.59,-4262.13
1931-04-01,16.52,-0.17,-1.02,31.86,-48.15,True,1,812,-16.52,-17814.24,13414.24,-4400.0
1931-04-02,16.45,-0.07,-0.42,31.86,-48.37,True,1,813,-16.45,-17830.69,13373.85,-4456.84
1931-04-06,16.5,0.05,0.3,31.86,-48.21,True,1,814,-16.5,-17847.19,13431.0,-4416.19
1931-04-07,16.28,-0.22,-1.33,31.86,-48.9,True,1,815,-16.28,-17863.47,13268.2,-4595.27
1931-04-08,16.5,0.22,1.35,31.86,-48.21,True,1,816,-16.5,-17879.97,13464.0,-4415.97
1931-04-09,16.41,-0.09,-0.55,31.86,-48.49,True,1,817,-16.41,-17896.38,13406.97,-4489.41
1931-04-10,16.46,0.05,0.3,31.86,-48.34,True,1,818,-16.46,-17912.84,13464.28,-4448.56
1931-04-13,16.72,0.26,1.58,31.86,-47.52,True,1,819,-16.72,-17929.56,13693.68,-4235.88
1931-04-14,16.51,-0.21,-1.26,31.86,-48.18,True,1,820,-16.51,-17946.07,13538.2,-4407.87
1931-04-15,16.18,-0.33,-2.0,31.86,-49.22,True,1,821,-16.18,-17962.25,13283.78,-4678.47
1931-04-16,15.98,-0.2,-1.24,31.86,-49.84,True,1,822,-15.98,-17978.23,13135.56,-4842.67
1931-04-17,15.73,-0.25,-1.56,31.86,-50.63,True,1,823,-15.73,-17993.96,12945.79,-5048.17
1931-04-20,15.96,0.23,1.46,31.86,-49.91,True,1,824,-15.96,-18009.92,13151.04,-4858.88
1931-04-21,15.54,-0.42,-2.63,31.86,-51.22,True,1,825,-15.54,-18025.46,12820.5,-5204.96
1931-04-22,15.22,-0.32,-2.06,31.86,-52.23,True,1,826,-15.22,-18040.68,12571.72,-5468.96
1931-04-23,15.29,0.07,0.46,31.86,-52.01,True,1,827,-15.29,-18055.97,12644.83,-5411.14
1931-04-24,15.29,0.0,0.0,31.86,-52.01,True,1,828,-15.29,-18071.26,12660.12,-5411.14
1931-04-27,14.76,-0.53,-3.47,31.86,-53.67,True,1,829,-14.76,-18086.02,12236.04,-5849.98
1931-04-28,14.67,-0.09,-0.61,31.86,-53.96,True,1,830,-14.67,-18100.69,12176.1,-5924.59
1931-04-29,14.37,-0.3,-2.04,31.86,-54.9,True,1,831,-14.37,-18115.06,11941.47,-6173.59
1931-04-30,15.09,0.72,5.01,31.86,-52.64,True,1,832,-15.09,-18130.15,12554.88,-5575.27
1931-05-01,14.65,-0.44,-2.92,31.86,-54.02,True,1,833,-14.65,-18144.8,12203.45,-5941.35
1931-05-04,15.06,0.41,2.8,31.86,-52.73,True,1,834,-15.06,-18159.86,12560.04,-5599.82
1931-05-05,14.94,-0.12,-0.8,31.86,-53.11,True,1,835,-14.94,-18174.8,12474.9,-5699.9
1931-05-06,15.01,0.07,0.47,31.86,-52.89,True,1,836,-15.01,-18189.81,12548.36,-5641.45
1931-05-07,14.95,-0.06,-0.4,31.86,-53.08,True,1,837,-14.95,-18204.76,12513.15,-5691.61
1931-05-08,15.44,0.49,3.28,31.86,-51.54,True,1,838,-15.44,-18220.2,12938.72,-5281.48
1931-05-11,15.19,-0.25,-1.62,31.86,-52.32,True,1,839,-15.19,-18235.39,12744.41,-5490.98
1931-05-12,15.04,-0.15,-0.99,31.86,-52.79,True,1,840,-15.04,-18250.43,12633.6,-5616.83
1931-05-13,14.99,-0.05,-0.33,31.86,-52.95,True,1,841,-14.99,-18265.42,12606.59,-5658.83
1931-05-14,14.66,-0.33,-2.2,31.86,-53.99,True,1,842,-14.66,-18280.08,12343.72,-5936.36
1931-05-15,14.44,-0.22,-1.5,31.86,-54.68,True,1,843,-14.44,-18294.52,12172.92,-6121.6
1931-05-18,13.84,-0.6,-4.16,31.86,-56.56,True,1,844,-13.84,-18308.36,11680.96,-6627.4
1931-05-19,13.83,-0.01,-0.07,31.86,-56.59,True,1,845,-13.83,-18322.19,11686.35,-6635.84
1931-05-20,13.75,-0.08,-0.58,31.86,-56.84,True,1,846,-13.75,-18335.94,11632.5,-6703.44
1931-05-21,13.89,0.14,1.02,31.86,-56.4,True,1,847,-13.89,-18349.83,11764.83,-6585.0
1931-05-22,13.94,0.05,0.36,31.86,-56.25,True,1,848,-13.94,-18363.77,11821.12,-6542.65
1931-05-25,13.4,-0.54,-3.87,31.86,-57.94,True,1,849,-13.4,-18377.17,11376.6,-7000.57
1931-05-26,13.41,0.01,0.08,31.86,-57.91,True,1,850,-13.41,-18390.58,11398.5,-6992.08
1931-05-27,13.26,-0.15,-1.12,31.86,-58.38,True,1,851,-13.26,-18403.84,11284.26,-7119.58
1931-05-28,13.31,0.05,0.38,31.86,-58.22,True,1,852,-13.31,-18417.15,11340.12,-7077.03
1931-05-29,13.02,-0.29,-2.18,31.86,-59.13,True,1,853,-13.02,-18430.17,11106.06,-7324.11
1931-06-01,12.4,-0.62,-4.76,31.86,-61.08,True,1,854,-12.4,-18442.57,10589.6,-7852.97
1931-06-02,12.2,-0.2,-1.61,31.86,-61.71,True,1,855,-12.2,-18454.77,10431.0,-8023.77
1931-06-03,13.12,0.92,7.54,31.86,-58.82,True,1,856,-13.12,-18467.89,11230.72,-7237.17
1931-06-04,13.55,0.43,3.28,31.86,-57.47,True,1,857,-13.55,-18481.44,11612.35,-6869.09
1931-06-05,13.4,-0.15,-1.11,31.86,-57.94,True,1,858,-13.4,-18494.84,11497.2,-6997.64
1931-06-08,13.56,0.16,1.19,31.86,-57.44,True,1,859,-13.56,-18508.4,11648.04,-6860.36
1931-06-09,13.34,-0.22,-1.62,31.86,-58.13,True,1,860,-13.34,-18521.74,11472.4,-7049.34
1931-06-10,13.7,0.36,2.7,31.86,-57.0,True,1,861,-13.7,-18535.44,11795.7,-6739.74
1931-06-11,13.73,0.03,0.22,31.86,-56.9,True,1,862,-13.73,-18549.17,11835.26,-6713.91
1931-06-12,13.75,0.02,0.15,31.86,-56.84,True,1,863,-13.75,-18562.92,11866.25,-6696.67
1931-06-15,13.63,-0.12,-0.87,31.86,-57.22,True,1,864,-13.63,-18576.55,11776.32,-6800.23
1931-06-16,13.66,0.03,0.22,31.86,-57.12,True,1,865,-13.66,-18590.21,11815.9,-6774.31
1931-06-17,13.51,-0.15,-1.1,31.86,-57.6,True,1,866,-13.51,-18603.72,11699.66,-6904.06
1931-06-18,13.27,-0.24,-1.78,31.86,-58.35,True,1,867,-13.27,-18616.99,11505.09,-7111.9
1931-06-19,13.22,-0.05,-0.38,31.86,-58.51,True,1,868,-13.22,-18630.21,11474.96,-7155.25
1931-06-22,14.61,1.39,10.51,31.86,-54.14,True,1,869,-14.61,-18644.82,12696.09,-5948.73
1931-06-23,14.41,-0.2,-1.37,31.86,-54.77,True,1,870,-14.41,-18659.23,12536.7,-6122.53
1931-06-24,15.09,0.68,4.72,31.86,-52.64,True,1,871,-15.09,-18674.32,13143.39,-5530.93
1931-06-25,14.99,-0.1,-0.66,31.86,-52.95,True,1,872,-14.99,-18689.31,13071.28,-5618.03
1931-06-26,15.35,0.36,2.4,31.86,-51.82,True,1,873,-15.35,-18704.66,13400.55,-5304.11
1931-06-29,15.09,-0.26,-1.69,31.86,-52.64,True,1,874,-15.09,-18719.75,13188.66,-5531.09
1931-06-30,14.83,-0.26,-1.72,31.86,-53.45,True,1,875,-14.83,-18734.58,12976.25,-5758.33
1931-07-01,15.07,0.24,1.62,31.86,-52.7,True,1,876,-15.07,-18749.65,13201.32,-5548.33
1931-07-02,14.94,-0.13,-0.86,31.86,-53.11,True,1,877,-14.94,-18764.59,13102.38,-5662.21
1931-07-03,15.26,0.32,2.14,31.86,-52.1,True,1,878,-15.26,-18779.85,13398.28,-5381.57
1931-07-06,15.1,-0.16,-1.05,31.86,-52.6,True,1,879,-15.1,-18794.95,13272.9,-5522.05
1931-07-07,14.51,-0.59,-3.91,31.86,-54.46,True,1,880,-14.51,-18809.46,12768.8,-6040.66
1931-07-08,14.37,-0.14,-0.96,31.86,-54.9,True,1,881,-14.37,-18823.83,12659.97,-6163.86
1931-07-09,14.49,0.12,0.84,31.86,-54.52,True,1,882,-14.49,-18838.32,12780.18,-6058.14
1931-07-10,14.63,0.14,0.97,31.86,-54.08,True,1,883,-14.63,-18852.95,12918.29,-5934.66
1931-07-13,14.23,-0.4,-2.73,31.86,-55.34,True,1,884,-14.23,-18867.18,12579.32,-6287.86
1931-07-14,14.09,-0.14,-0.98,31.86,-55.78,True,1,885,-14.09,-18881.27,12469.65,-6411.62
1931-07-15,13.8,-0.29,-2.06,31.86,-56.69,True,1,886,-13.8,-18895.07,12226.8,-6668.27
1931-07-16,14.14,0.34,2.46,31.86,-55.62,True,1,887,-14.14,-18909.21,12542.18,-6367.03
1931-07-17,14.27,0.13,0.92,31.86,-55.21,True,1,888,-14.27,-18923.48,12671.76,-6251.72
1931-07-20,14.46,0.19,1.33,31.86,-54.61,True,1,889,-14.46,-18937.94,12854.94,-6083.0
1931-07-21,14.62,0.16,1.11,31.86,-54.11,True,1,890,-14.62,-18952.56,13011.8,-5940.76
1931-07-22,14.28,-0.34,-2.33,31.86,-55.18,True,1,891,-14.28,-18966.84,12723.48,-6243.36
1931-07-23,14.28,0.0,0.0,31.86,-55.18,True,1,892,-14.28,-18981.12,12737.76,-6243.36
1931-07-24,13.97,-0.31,-2.17,31.86,-56.15,True,1,893,-13.97,-18995.09,12475.21,-6519.88
1931-07-27,14.03,0.06,0.43,31.86,-55.96,True,1,894,-14.03,-19009.12,12542.82,-6466.3
1931-07-28,14.18,0.15,1.07,31.86,-55.49,True,1,895,-14.18,-19023.3,12691.1,-6332.2
1931-07-29,13.74,-0.44,-3.1,31.86,-56.87,True,1,896,-13.74,-19037.04,12311.04,-6726.0
1931-07-30,13.8,0.06,0.44,31.86,-56.69,True,1,897,-13.8,-19050.84,12378.6,-6672.24
1931-07-31,13.73,-0.07,-0.51,31.86,-56.9,True,1,898,-13.73,-19064.57,12329.54,-6735.03
1931-08-03,13.93,0.2,1.46,31.86,-56.28,True,1,899,-13.93,-19078.5,12523.07,-6555.43
1931-08-04,13.84,-0.09,-0.65,31.86,-56.56,True,1,900,-13.84,-19092.34,12456.0,-6636.34
1931-08-05,13.64,-0.2,-1.44,31.86,-57.19,True,1,901,-13.64,-19105.98,12289.64,-6816.34
1931-08-06,13.55,-0.09,-0.66,31.86,-57.47,True,1,902,-13.55,-19119.53,12222.1,-6897.43
1931-08-07,13.61,0.06,0.44,31.86,-57.28,True,1,903,-13.61,-19133.14,12289.83,-6843.31
1931-08-10,13.55,-0.06,-0.44,31.86,-57.47,True,1,904,-13.55,-19146.69,12249.2,-6897.49
1931-08-11,13.99,0.44,3.25,31.86,-56.09,True,1,905,-13.99,-19160.68,12660.95,-6499.73
1931-08-12,13.8,-0.19,-1.36,31.86,-56.69,True,1,906,-13.8,-19174.48,12502.8,-6671.68
1931-08-13,14.02,0.22,1.59,31.86,-56.0,True,1,907,-14.02,-19188.5,12716.14,-6472.36
1931-08-14,14.29,0.27,1.93,31.86,-55.15,True,1,908,-14.29,-19202.79,12975.32,-6227.47
1931-08-17,14.05,-0.24,-1.68,31.86,-55.9,True,1,909,-14.05,-19216.84,12771.45,-6445.39
1931-08-18,14.1,0.05,0.36,31.86,-55.74,True,1,910,-14.1,-19230.94,12831.0,-6399.94
1931-08-19,14.14,0.04,0.28,31.86,-55.62,True,1,911,-14.14,-19245.08,12881.54,-6363.54
1931-08-20,14.17,0.03,0.21,31.86,-55.52,True,1,912,-14.17,-19259.25,12923.04,-6336.21
1931-08-21,13.86,-0.31,-2.19,31.86,-56.5,True,1,913,-13.86,-19273.11,12654.18,-6618.93
1931-08-24,13.75,-0.11,-0.79,31.86,-56.84,True,1,914,-13.75,-19286.86,12567.5,-6719.36
1931-08-25,13.7,-0.05,-0.36,31.86,-57.0,True,1,915,-13.7,-19300.56,12535.5,-6765.06
1931-08-26,13.93,0.23,1.68,31.86,-56.28,True,1,916,-13.93,-19314.49,12759.88,-6554.61
1931-08-27,13.85,-0.08,-0.57,31.86,-56.53,True,1,917,-13.85,-19328.34,12700.45,-6627.89
1931-08-28,13.99,0.14,1.01,31.86,-56.09,True,1,918,-13.99,-19342.33,12842.82,-6499.51
1931-08-31,13.86,-0.13,-0.93,31.86,-56.5,True,1,919,-13.86,-19356.19,12737.34,-6618.85
1931-09-01,13.92,0.06,0.43,31.86,-56.31,True,1,920,-13.92,-19370.11,12806.4,-6563.71
1931-09-02,13.66,-0.26,-1.87,31.86,-57.12,True,1,921,-13.66,-19383.77,12580.86,-6802.91
1931-09-03,13.35,-0.31,-2.27,31.86,-58.1,True,1,922,-13.35,-19397.12,12308.7,-7088.42
1931-09-04,13.29,-0.06,-0.45,31.86,-58.29,True,1,923,-13.29,-19410.41,12266.67,-7143.74
1931-09-08,12.87,-0.42,-3.16,31.86,-59.6,True,1,924,-12.87,-19423.28,11891.88,-7531.4
1931-09-09,12.76,-0.11,-0.86,31.86,-59.95,True,1,925,-12.76,-19436.04,11803.0,-7633.04
1931-09-10,12.62,-0.14,-1.1,31.86,-60.39,True,1,926,-12.62,-19448.66,11686.12,-7762.54
1931-09-11,12.69,0.07,0.56,31.86,-60.17,True,1,927,-12.69,-19461.35,11763.63,-7697.72
1931-09-14,12.1,-0.59,-4.65,31.86,-62.02,True,1,928,-12.1,-19473.45,11228.8,-8244.65
1931-09-15,11.99,-0.11,-0.91,31.86,-62.37,True,1,929,-11.99,-19485.44,11138.71,-8346.73
1931-09-16,11.82,-0.17,-1.42,31.86,-62.9,True,1,930,-11.82,-19497.26,10992.6,-8504.66
1931-09-17,12.04,0.22,1.86,31.86,-62.21,True,1,931,-12.04,-19509.3,11209.24,-8300.06
1931-09-18,11.46,-0.58,-4.82,31.86,-64.03,True,1,932,-11.46,-19520.76,10680.72,-8840.04
1931-09-21,10.93,-0.53,-4.62,31.86,-65.69,True,1,933,-10.93,-19531.69,10197.69,-9334.0
1931-09-22,10.8,-0.13,-1.19,31.86,-66.1,True,1,934,-10.8,-19542.49,10087.2,-9455.29
1931-09-23,11.52,0.72,6.67,31.86,-63.84,True,1,935,-11.52,-19554.01,10771.2,-8782.81
1931-09-24,10.68,-0.84,-7.29,31.86,-66.48,True,1,936,-10.68,-19564.69,9996.48,-9568.21
1931-09-25,10.92,0.24,2.25,31.86,-65.72,True,1,937,-10.92,-19575.61,10232.04,-9343.57
1931-09-28,10.5,-0.42,-3.85,31.86,-67.04,True,1,938,-10.5,-19586.11,9849.0,-9737.11
1931-09-29,10.06,-0.44,-4.19,31.86,-68.42,True,1,939,-10.06,-19596.17,9446.34,-10149.83
1931-09-30,9.71,-0.35,-3.48,31.86,-69.52,True,1,940,-9.71,-19605.88,9127.4,-10478.48
1931-10-01,9.53,-0.18,-1.85,31.86,-70.09,True,1,941,-9.53,-19615.41,8967.73,-10647.68
1931-10-02,9.7,0.17,1.78,31.86,-69.55,True,1,942,-9.7,-19625.11,9137.4,-10487.71
1931-10-05,8.82,-0.88,-9.07,31.86,-72.32,True,1,943,-8.82,-19633.93,8317.26,-11316.67
1931-10-06,9.91,1.09,12.36,31.86,-68.9,True,1,944,-9.91,-19643.84,9355.04,-10288.8
1931-10-07,9.78,-0.13,-1.31,31.86,-69.3,True,1,945,-9.78,-19653.62,9242.1,-10411.52
1931-10-08,10.62,0.84,8.59,31.86,-66.67,True,1,946,-10.62,-19664.24,10046.52,-9617.72
1931-10-09,10.55,-0.07,-0.66,31.86,-66.89,True,1,947,-10.55,-19674.79,9990.85,-9683.94
1931-10-13,10.1,-0.45,-4.26,31.86,-68.3,True,1,948,-10.1,-19684.89,9574.8,-10110.09
1931-10-14,9.87,-0.23,-2.28,31.86,-69.02,True,1,949,-9.87,-19694.76,9366.63,-10328.13
1931-10-15,10.05,0.18,1.82,31.86,-68.46,True,1,950,-10.05,-19704.81,9547.5,-10157.31
1931-10-16,10.36,0.31,3.08,31.86,-67.48,True,1,951,-10.36,-19715.17,9852.36,-9862.81
1931-10-19,10.49,0.13,1.25,31.86,-67.08,True,1,952,-10.49,-19725.66,9986.48,-9739.18
1931-10-20,10.96,0.47,4.48,31.86,-65.6,True,1,953,-10.96,-19736.62,10444.88,-9291.74
1931-10-21,10.86,-0.1,-0.91,31.86,-65.91,True,1,954,-10.86,-19747.48,10360.44,-9387.04
1931-10-22,10.5,-0.36,-3.32,31.86,-67.04,True,1,955,-10.5,-19757.98,10027.5,-9730.48
1931-10-23,10.84,0.34,3.24,31.86,-65.98,True,1,956,-10.84,-19768.82,10363.04,-9405.78
1931-10-26,10.64,-0.2,-1.84,31.86,-66.6,True,1,957,-10.64,-19779.46,10182.48,-9596.98
1931-10-27,10.41,-0.23,-2.16,31.86,-67.33,True,1,958,-10.41,-19789.87,9972.78,-9817.09
1931-10-28,10.07,-0.34,-3.27,31.86,-68.39,True,1,959,-10.07,-19799.94,9657.13,-10142.81
1931-10-29,10.11,0.04,0.4,31.86,-68.27,True,1,960,-10.11,-19810.05,9705.6,-10104.45
1931-10-30,10.43,0.32,3.16,31.86,-67.26,True,1,961,-10.43,-19820.48,10023.23,-9797.25
1931-11-02,10.5,0.07,0.67,31.86,-67.04,True,1,962,-10.5,-19830.98,10101.0,-9729.98
1931-11-04,10.82,0.32,3.05,31.86,-66.04,True,1,963,-10.82,-19841.8,10419.66,-9422.14
1931-11-05,10.78,-0.04,-0.37,31.86,-66.16,True,1,964,-10.78,-19852.58,10391.92,-9460.66
1931-11-06,11.11,0.33,3.06,31.86,-65.13,True,1,965,-11.11,-19863.69,10721.15,-9142.54
1931-11-09,11.52,0.41,3.69,31.86,-63.84,True,1,966,-11.52,-19875.21,11128.32,-8746.89
1931-11-10,11.28,-0.24,-2.08,31.86,-64.6,True,1,967,-11.28,-19886.49,10907.76,-8978.73
1931-11-11,11.11,-0.17,-1.51,31.86,-65.13,True,1,968,-11.11,-19897.6,10754.48,-9143.12
1931-11-12,11.07,-0.04,-0.36,31.86,-65.25,True,1,969,-11.07,-19908.67,10726.83,-9181.84
1931-11-13,10.72,-0.35,-3.16,31.86,-66.35,True,1,970,-10.72,-19919.39,10398.4,-9520.99
1931-11-16,10.43,-0.29,-2.7,31.86,-67.26,True,1,971,-10.43,-19929.82,10127.53,-9802.29
1931-11-17,10.6,0.17,1.63,31.86,-66.73,True,1,972,-10.6,-19940.42,10303.2,-9637.22
1931-11-18,10.21,-0.39,-3.68,31.86,-67.95,True,1,973,-10.21,-19950.63,9934.33,-10016.3
1931-11-19,10.16,-0.05,-0.49,31.86,-68.11,True,1,974,-10.16,-19960.79,9895.84,-10064.95
1931-11-20,9.85,-0.31,-3.05,31.86,-69.08,True,1,975,-9.85,-19970.64,9603.75,-10366.89
1931-11-23,9.7,-0.15,-1.52,31.86,-69.55,True,1,976,-9.7,-19980.34,9467.2,-10513.14
1931-11-24,9.87,0.17,1.75,31.86,-69.02,True,1,977,-9.87,-19990.21,9642.99,-10347.22
1931-11-25,9.53,-0.34,-3.44,31.86,-70.09,True,1,978,-9.53,-19999.74,9320.34,-10679.4
1931-11-27,9.31,-0.22,-2.31,31.86,-70.78,True,1,979,-9.31,-20009.05,9114.49,-10894.56
1931-11-30,9.5,0.19,2.04,31.86,-70.18,True,1,980,-9.5,-20018.55,9310.0,-10708.55
1931-12-01,9.38,-0.12,-1.26,31.86,-70.56,True,1,981,-9.38,-20027.93,9201.78,-10826.15
1931-12-02,9.05,-0.33,-3.52,31.86,-71.59,True,1,982,-9.05,-20036.98,8887.1,-11149.88
1931-12-03,9.22,0.17,1.88,31.86,-71.06,True,1,983,-9.22,-20046.2,9063.26,-10982.94
1931-12-04,9.02,-0.2,-2.17,31.86,-71.69,True,1,984,-9.02,-20055.22,8875.68,-11179.54
1931-12-07,9.29,0.27,2.99,31.86,-70.84,True,1,985,-9.29,-20064.51,9150.65,-10913.86
1931-12-08,9.02,-0.27,-2.91,31.86,-71.69,True,1,986,-9.02,-20073.53,8893.72,-11179.81
1931-12-09,8.78,-0.24,-2.66,31.86,-72.44,True,1,987,-8.78,-20082.31,8665.86,-11416.45
1931-12-10,8.58,-0.2,-2.28,31.86,-73.07,True,1,988,-8.58,-20090.89,8477.04,-11613.85
1931-12-11,8.31,-0.27,-3.15,31.86,-73.92,True,1,989,-8.31,-20099.2,8218.59,-11880.61
1931-12-14,8.01,-0.3,-3.61,31.86,-74.86,True,1,990,-8.01,-20107.21,7929.9,-12177.31
1931-12-15,8.12,0.11,1.37,31.86,-74.51,True,1,991,-8.12,-20115.33,8046.92,-12068.41
1931-12-16,7.93,-0.19,-2.34,31.86,-75.11,True,1,992,-7.93,-20123.26,7866.56,-12256.7
1931-12-17,7.72,-0.21,-2.65,31.86,-75.77,True,1,993,-7.72,-20130.98,7665.96,-12465.02
1931-12-18,8.36,0.64,8.29,31.86,-73.76,True,1,994,-8.36,-20139.34,8309.84,-11829.5
1931-12-21,8.15,-0.21,-2.51,31.86,-74.42,True,1,995,-8.15,-20147.49,8109.25,-12038.24
1931-12-22,8.29,0.14,1.72,31.86,-73.98,True,1,996,-8.29,-20155.78,8256.84,-11898.94
1931-12-23,7.95,-0.34,-4.1,31.86,-75.05,True,1,997,-7.95,-20163.73,7926.15,-12237.58
1931-12-24,7.96,0.01,0.13,31.86,-75.02,True,1,998,-7.96,-20171.69,7944.08,-12227.61
1931-12-28,7.76,-0.2,-2.51,31.86,-75.64,True,1,999,-7.76,-20179.45,7752.24,-12427.21
1931-12-29,7.96,0.2,2.58,31.86,-75.02,True,1,1000,-7.96,-20187.41,7960.0,-12227.41
1931-12-30,8.1,0.14,1.76,31.86,-74.58,True,1,1001,-8.1,-20195.51,8108.1,-12087.41
1931-12-31,8.12,0.02,0.25,31.86,-74.51,True,1,1002,-8.12,-20203.63,8136.24,-12067.39
1932-01-04,7.56,-0.56,-6.9,31.86,-76.27,True,1,1003,-7.56,-20211.19,7582.68,-12628.51
1932-01-05,7.55,-0.01,-0.13,31.86,-76.3,True,1,1004,-7.55,-20218.74,7580.2,-12638.54
1932-01-06,8.08,0.53,7.02,31.86,-74.64,True,1,1005,-8.08,-20226.82,8120.4,-12106.42
1932-01-07,8.22,0.14,1.73,31.86,-74.2,True,1,1006,-8.22,-20235.04,8269.32,-11965.72
1932-01-08,8.57,0.35,4.26,31.86,-73.1,True,1,1007,-8.57,-20243.61,8629.99,-11613.62
1932-01-11,8.48,-0.09,-1.05,31.86,-73.38,True,1,1008,-8.48,-20252.09,8547.84,-11704.25
1932-01-12,8.39,-0.09,-1.06,31.86,-73.67,True,1,1009,-8.39,-20260.48,8465.51,-11794.97
1932-01-13,8.8,0.41,4.89,31.86,-72.38,True,1,1010,-8.8,-20269.28,8888.0,-11381.28
1932-01-14,8.9,0.1,1.14,31.86,-72.06,True,1,1011,-8.9,-20278.18,8997.9,-11280.28
1932-01-15,8.92,0.02,0.22,31.86,-72.0,True,1,1012,-8.92,-20287.1,9027.04,-11260.06
1932-01-18,8.51,-0.41,-4.6,31.86,-73.29,True,1,1013,-8.51,-20295.61,8620.63,-11674.98
1932-01-19,8.48,-0.03,-0.35,31.86,-73.38,True,1,1014,-8.48,-20304.09,8598.72,-11705.37
1932-01-20,8.63,0.15,1.77,31.86,-72.91,True,1,1015,-8.63,-20312.72,8759.45,-11553.27
1932-01-21,8.58,-0.05,-0.58,31.86,-73.07,True,1,1016,-8.58,-20321.3,8717.28,-11604.02
1932-01-22,8.21,-0.37,-4.31,31.86,-74.23,True,1,1017,-8.21,-20329.51,8349.57,-11979.94
1932-01-25,8.2,-0.01,-0.12,31.86,-74.26,True,1,1018,-8.2,-20337.71,8347.6,-11990.11
1932-01-26,8.31,0.11,1.34,31.86,-73.92,True,1,1019,-8.31,-20346.02,8467.89,-11878.13
1932-01-27,8.15,-0.16,-1.92,31.86,-74.42,True,1,1020,-8.15,-20354.17,8313.0,-12041.17
1932-01-28,8.03,-0.12,-1.47,31.86,-74.8,True,1,1021,-8.03,-20362.2,8198.63,-12163.57
1932-01-29,7.94,-0.09,-1.12,31.86,-75.08,True,1,1022,-7.94,-20370.14,8114.68,-12255.46
1932-02-01,8.23,0.29,3.65,31.86,-74.17,True,1,1023,-8.23,-20378.37,8419.29,-11959.08
1932-02-02,8.05,-0.18,-2.19,31.86,-74.73,True,1,1024,-8.05,-20386.42,8243.2,-12143.22
1932-02-03,8.09,0.04,0.5,31.86,-74.61,True,1,1025,-8.09,-20394.51,8292.25,-12102.26
1932-02-04,8.04,-0.05,-0.62,31.86,-74.76,True,1,1026,-8.04,-20402.55,8249.04,-12153.51
1932-02-05,7.78,-0.26,-3.23,31.86,-75.58,True,1,1027,-7.78,-20410.33,7990.06,-12420.27
1932-02-08,7.62,-0.16,-2.06,31.86,-76.08,True,1,1028,-7.62,-20417.95,7833.36,-12584.59
1932-02-09,7.53,-0.09,-1.18,31.86,-76.36,True,1,1029,-7.53,-20425.48,7748.37,-12677.11
1932-02-10,7.5,-0.03,-0.4,31.86,-76.46,True,1,1030,-7.5,-20432.98,7725.0,-12707.98
1932-02-11,8.12,0.62,8.27,31.86,-74.51,True,1,1031,-8.12,-20441.1,8371.72,-12069.38
1932-02-15,8.5,0.38,4.68,31.86,-73.32,True,1,1032,-8.5,-20449.6,8772.0,-11677.6
1932-02-16,8.84,0.34,4.0,31.86,-72.25,True,1,1033,-8.84,-20458.44,9131.72,-11326.72
1932-02-17,8.48,-0.36,-4.07,31.86,-73.38,True,1,1034,-8.48,-20466.92,8768.32,-11698.6
1932-02-18,8.71,0.23,2.71,31.86,-72.66,True,1,1035,-8.71,-20475.63,9014.85,-11460.78
1932-02-19,8.72,0.01,0.12,31.86,-72.63,True,1,1036,-8.72,-20484.35,9033.92,-11450.43
1932-02-23,8.22,-0.5,-5.73,31.86,-74.2,True,1,1037,-8.22,-20492.57,8524.14,-11968.43
1932-02-24,8.43,0.21,2.56,31.86,-73.54,True,1,1038,-8.43,-20501.0,8750.34,-11750.66
1932-02-25,8.35,-0.08,-0.95,31.86,-73.79,True,1,1039,-8.35,-20509.35,8675.65,-11833.7
1932-02-26,8.34,-0.01,-0.12,31.86,-73.82,True,1,1040,-8.34,-20517.69,8673.6,-11844.09
1932-02-29,8.29,-0.05,-0.6,31.86,-73.98,True,1,1041,-8.29,-20525.98,8629.89,-11896.09
1932-03-01,8.35,0.06,0.72,31.86,-73.79,True,1,1042,-8.35,-20534.33,8700.7,-11833.63
1932-03-02,8.71,0.36,4.31,31.86,-72.66,True,1,1043,-8.71,-20543.04,9084.53,-11458.51
1932-03-03,8.71,0.0,0.0,31.86,-72.66,True,1,1044,-8.71,-20551.75,9093.24,-11458.51
1932-03-04,8.72,0.01,0.12,31.86,-72.63,True,1,1045,-8.72,-20560.47,9112.4,-11448.07
1932-03-07,8.82,0.1,1.15,31.86,-72.32,True,1,1046,-8.82,-20569.29,9225.72,-11343.57
1932-03-08,8.98,0.16,1.81,31.86,-71.81,True,1,1047,-8.98,-20578.27,9402.06,-11176.21
1932-03-09,8.81,-0.17,-1.89,31.86,-72.35,True,1,1048,-8.81,-20587.08,9232.88,-11354.2
1932-03-10,8.73,-0.08,-0.91,31.86,-72.6,True,1,1049,-8.73,-20595.81,9157.77,-11438.04
1932-03-11,8.52,-0.21,-2.4,31.86,-73.26,True,1,1050,-8.52,-20604.33,8946.0,-11658.33
1932-03-14,8.31,-0.21,-2.46,31.86,-73.92,True,1,1051,-8.31,-20612.64,8733.81,-11878.83
1932-03-15,8.31,0.0,0.0,31.86,-73.92,True,1,1052,-8.31,-20620.95,8742.12,-11878.83
1932-03-16,8.11,-0.2,-2.41,31.86,-74.54,True,1,1053,-8.11,-20629.06,8539.83,-12089.23
1932-03-17,8.28,0.17,2.1,31.86,-74.01,True,1,1054,-8.28,-20637.34,8727.12,-11910.22
1932-03-18,8.02,-0.26,-3.14,31.86,-74.83,True,1,1055,-8.02,-20645.36,8461.1,-12184.26
1932-03-21,8.06,0.04,0.5,31.86,-74.7,True,1,1056,-8.06,-20653.42,8511.36,-12142.06
1932-03-22,8.05,-0.01,-0.12,31.86,-74.73,True,1,1057,-8.05,-20661.47,8508.85,-12152.62
1932-03-23,7.94,-0.11,-1.37,31.86,-75.08,True,1,1058,-7.94,-20669.41,8400.52,-12268.89
1932-03-24,7.86,-0.08,-1.01,31.86,-75.33,True,1,1059,-7.86,-20677.27,8323.74,-12353.53
1932-03-28,7.59,-0.27,-3.44,31.86,-76.18,True,1,1060,-7.59,-20684.86,8045.4,-12639.46
1932-03-29,7.58,-0.01,-0.13,31.86,-76.21,True,1,1061,-7.58,-20692.44,8042.38,-12650.06
1932-03-30,7.74,0.16,2.11,31.86,-75.71,True,1,1062,-7.74,-20700.18,8219.88,-12480.3
1932-03-31,7.31,-0.43,-5.56,31.86,-77.06,True,1,1063,-7.31,-20707.49,7770.53,-12936.96
1932-04-01,7.18,-0.13,-1.78,31.86,-77.46,True,1,1064,-7.18,-20714.67,7639.52,-13075.15
1932-04-04,7.06,-0.12,-1.67,31.86,-77.84,True,1,1065,-7.06,-20721.73,7518.9,-13202.83
1932-04-05,6.73,-0.33,-4.67,31.86,-78.88,True,1,1066,-6.73,-20728.46,7174.18,-13554.28
1932-04-06,6.53,-0.2,-2.97,31.86,-79.5,True,1,1067,-6.53,-20734.99,6967.51,-13767.48
1932-04-07,6.46,-0.07,-1.07,31.86,-79.72,True,1,1068,-6.46,-20741.45,6899.28,-13842.17
1932-04-08,6.26,-0.2,-3.1,31.86,-80.35,True,1,1069,-6.26,-20747.71,6691.94,-14055.77
1932-04-11,6.07,-0.19,-3.04,31.86,-80.95,True,1,1070,-6.07,-20753.78,6494.9,-14258.88
1932-04-12,6.06,-0.01,-0.16,31.86,-80.98,True,1,1071,-6.06,-20759.84,6490.26,-14269.58
1932-04-13,5.98,-0.08,-1.32,31.86,-81.23,True,1,1072,-5.98,-20765.82,6410.56,-14355.26
1932-04-14,6.25,0.27,4.51,31.86,-80.38,True,1,1073,-6.25,-20772.07,6706.25,-14065.82
1932-04-15,6.42,0.17,2.72,31.86,-79.85,True,1,1074,-6.42,-20778.49,6895.08,-13883.41
1932-04-18,6.12,-0.3,-4.67,31.86,-80.79,True,1,1075,-6.12,-20784.61,6579.0,-14205.61
1932-04-19,6.03,-0.09,-1.47,31.86,-81.07,True,1,1076,-6.03,-20790.64,6488.28,-14302.36
1932-04-20,6.03,0.0,0.0,31.86,-81.07,True,1,1077,-6.03,-20796.67,6494.31,-14302.36
1932-04-21,6.24,0.21,3.48,31.86,-80.41,True,1,1078,-6.24,-20802.91,6726.72,-14076.19
1932-04-22,5.96,-0.28,-4.49,31.86,-81.29,True,1,1079,-5.96,-20808.87,6430.84,-14378.03
1932-04-25,6.03,0.07,1.17,31.86,-81.07,True,1,1080,-6.03,-20814.9,6512.4,-14302.5
1932-04-26,6.12,0.09,1.49,31.86,-80.79,True,1,1081,-6.12,-20821.02,6615.72,-14205.3
1932-04-27,6.27,0.15,2.45,31.86,-80.32,True,1,1082,-6.27,-20827.29,6784.14,-14043.15
1932-04-28,6.03,-0.24,-3.83,31.86,-81.07,True,1,1083,-6.03,-20833.32,6530.49,-14302.83
1932-04-29,5.83,-0.2,-3.32,31.86,-81.7,True,1,1084,-5.83,-20839.15,6319.72,-14519.43
1932-05-02,5.74,-0.09,-1.54,31.86,-81.98,True,1,1085,-5.74,-20844.89,6227.9,-14616.99
1932-05-03,5.66,-0.08,-1.39,31.86,-82.24,True,1,1086,-5.66,-20850.55,6146.76,-14703.79
1932-05-04,5.74,0.08,1.41,31.86,-81.98,True,1,1087,-5.74,-20856.29,6239.38,-14616.91
1932-05-05,5.68,-0.06,-1.04,31.86,-82.17,True,1,1088,-5.68,-20861.97,6179.84,-14682.13
1932-05-06,6.09,0.41,7.22,31.86,-80.89,True,1,1089,-6.09,-20868.06,6632.01,-14236.05
1932-05-09,5.96,-0.13,-2.13,31.86,-81.29,True,1,1090,-5.96,-20874.02,6496.4,-14377.62
1932-05-10,6.01,0.05,0.84,31.86,-81.14,True,1,1091,-6.01,-20880.03,6556.91,-14323.12
1932-05-11,6.0,-0.01,-0.17,31.86,-81.17,True,1,1092,-6.0,-20886.03,6552.0,-14334.03
1932-05-12,5.8,-0.2,-3.33,31.86,-81.8,True,1,1093,-5.8,-20891.83,6339.4,-14552.43
1932-05-13,5.6,-0.2,-3.45,31.86,-82.42,True,1,1094,-5.6,-20897.43,6126.4,-14771.03
1932-05-16,5.61,0.01,0.18,31.86,-82.39,True,1,1095,-5.61,-20903.04,6142.95,-14760.09
1932-05-17,5.59,-0.02,-0.36,31.86,-82.45,True,1,1096,-5.59,-20908.63,6126.64,-14781.99
1932-05-18,5.45,-0.14,-2.5,31.86,-82.89,True,1,1097,-5.45,-20914.08,5978.65,-14935.43
1932-05-19,5.48,0.03,0.55,31.86,-82.8,True,1,1098,-5.48,-20919.56,6017.04,-14902.52
1932-05-20,5.48,0.0,0.0,31.86,-82.8,True,1,1099,-5.48,-20925.04,6022.52,-14902.52
1932-05-23,5.43,-0.05,-0.91,31.86,-82.96,True,1,1100,-5.43,-20930.47,5973.0,-14957.47
1932-05-24,5.21,-0.22,-4.05,31.86,-83.65,True,1,1101,-5.21,-20935.68,5736.21,-15199.47
1932-05-25,5.03,-0.18,-3.46,31.86,-84.21,True,1,1102,-5.03,-20940.71,5543.06,-15397.65
1932-05-26,5.11,0.08,1.59,31.86,-83.96,True,1,1103,-5.11,-20945.82,5636.33,-15309.49
1932-05-27,4.83,-0.28,-5.48,31.86,-84.84,True,1,1104,-4.83,-20950.65,5332.32,-15618.33
1932-05-31,4.47,-0.36,-7.45,31.86,-85.97,True,1,1105,-4.47,-20955.12,4939.35,-16015.77
1932-06-01,4.4,-0.07,-1.57,31.86,-86.19,True,1,1106,-4.4,-20959.52,4866.4,-16093.12
1932-06-02,4.64,0.24,5.46,31.86,-85.44,True,1,1107,-4.64,-20964.16,5136.48,-15827.68
1932-06-03,4.89,0.25,5.39,31.86,-84.65,True,1,1108,-4.89,-20969.05,5418.12,-15550.93
1932-06-06,5.07,0.18,3.68,31.86,-84.09,True,1,1109,-5.07,-20974.12,5622.63,-15351.49
1932-06-07,4.85,-0.22,-4.34,31.86,-84.78,True,1,1110,-4.85,-20978.97,5383.5,-15595.47
1932-06-08,4.57,-0.28,-5.77,31.86,-85.66,True,1,1111,-4.57,-20983.54,5077.27,-15906.27
1932-06-09,4.57,0.0,0.0,31.86,-85.66,True,1,1112,-4.57,-20988.11,5081.84,-15906.27
1932-06-10,4.92,0.35,7.66,31.86,-84.56,True,1,1113,-4.92,-20993.03,5475.96,-15517.07
1932-06-13,4.82,-0.1,-2.03,31.86,-84.87,True,1,1114,-4.82,-20997.85,5369.48,-15628.37
1932-06-14,4.94,0.12,2.49,31.86,-84.5,True,1,1115,-4.94,-21002.79,5508.1,-15494.69
1932-06-15,5.12,0.18,3.64,31.86,-83.93,True,1,1116,-5.12,-21007.91,5713.92,-15293.99
1932-06-16,5.12,0.0,0.0,31.86,-83.93,True,1,1117,-5.12,-21013.03,5719.04,-15293.99
1932-06-17,4.83,-0.29,-5.66,31.86,-84.84,True,1,1118,-4.83,-21017.86,5399.94,-15617.92
1932-06-20,4.89,0.06,1.24,31.86,-84.65,True,1,1119,-4.89,-21022.75,5471.91,-15550.84
1932-06-21,4.77,-0.12,-2.45,31.86,-85.03,True,1,1120,-4.77,-21027.52,5342.4,-15685.12
1932-06-22,4.77,0.0,0.0,31.86,-85.03,True,1,1121,-4.77,-21032.29,5347.17,-15685.12
1932-06-23,4.8,0.03,0.63,31.86,-84.93,True,1,1122,-4.8,-21037.09,5385.6,-15651.49
1932-06-24,4.6,-0.2,-4.17,31.86,-85.56,True,1,1123,-4.6,-21041.69,5165.8,-15875.89
1932-06-27,4.44,-0.16,-3.48,31.86,-86.06,True,1,1124,-4.44,-21046.13,4990.56,-16055.57
1932-06-28,4.44,0.0,0.0,31.86,-86.06,True,1,1125,-4.44,-21050.57,4995.0,-16055.57
1932-06-29,4.51,0.07,1.58,31.86,-85.84,True,1,1126,-4.51,-21055.08,5078.26,-15976.82
1932-06-30,4.43,-0.08,-1.77,31.86,-86.1,True,1,1127,-4.43,-21059.51,4992.61,-16066.9
1932-07-01,4.6,0.17,3.84,31.86,-85.56,True,1,1128,-4.6,-21064.11,5188.8,-15875.31
1932-07-05,4.5,-0.1,-2.17,31.86,-85.88,True,1,1129,-4.5,-21068.61,5080.5,-15988.11
1932-07-06,4.6,0.1,2.22,31.86,-85.56,True,1,1130,-4.6,-21073.21,5198.0,-15875.21
1932-07-07,4.45,-0.15,-3.26,31.86,-86.03,True,1,1131,-4.45,-21077.66,5032.95,-16044.71
1932-07-08,4.41,-0.04,-0.9,31.86,-86.16,True,1,1132,-4.41,-21082.07,4992.12,-16089.95
1932-07-11,4.6,0.19,4.31,31.86,-85.56,True,1,1133,-4.6,-21086.67,5211.8,-15874.87
1932-07-12,4.6,0.0,0.0,31.86,-85.56,True,1,1134,-4.6,-21091.27,5216.4,-15874.87
1932-07-13,4.82,0.22,4.78,31.86,-84.87,True,1,1135,-4.82,-21096.09,5470.7,-15625.39
1932-07-14,4.79,-0.03,-0.62,31.86,-84.96,True,1,1136,-4.79,-21100.88,5441.44,-15659.44
1932-07-15,4.93,0.14,2.92,31.86,-84.53,True,1,1137,-4.93,-21105.81,5605.41,-15500.4
1932-07-18,4.8,-0.13,-2.64,31.86,-84.93,True,1,1138,-4.8,-21110.61,5462.4,-15648.21
1932-07-19,4.78,-0.02,-0.42,31.86,-85.0,True,1,1139,-4.78,-21115.39,5444.42,-15670.97
1932-07-20,4.93,0.15,3.14,31.86,-84.53,True,1,1140,-4.93,-21120.32,5620.2,-15500.12
1932-07-21,5.05,0.12,2.43,31.86,-84.15,True,1,1141,-5.05,-21125.37,5762.05,-15363.32
1932-07-22,5.2,0.15,2.97,31.86,-83.68,True,1,1142,-5.2,-21130.57,5938.4,-15192.17
1932-07-25,5.48,0.28,5.38,31.86,-82.8,True,1,1143,-5.48,-21136.05,6263.64,-14872.41
1932-07-26,5.4,-0.08,-1.46,31.86,-83.05,True,1,1144,-5.4,-21141.45,6177.6,-14963.85
1932-07-27,5.67,0.27,5.0,31.86,-82.2,True,1,1145,-5.67,-21147.12,6492.15,-14654.97
1932-07-28,5.85,0.18,3.18,31.86,-81.64,True,1,1146,-5.85,-21152.97,6704.1,-14448.87
1932-07-29,6.03,0.18,3.08,31.86,-81.07,True,1,1147,-6.03,-21159.0,6916.41,-14242.59
1932-08-01,6.11,0.08,1.33,31.86,-80.82,True,1,1148,-6.11,-21165.11,7014.28,-14150.83
1932-08-02,5.87,-0.24,-3.93,31.86,-81.58,True,1,1149,-5.87,-21170.98,6744.63,-14426.35
1932-08-03,6.39,0.52,8.86,31.86,-79.94,True,1,1150,-6.39,-21177.37,7348.5,-13828.87
1932-08-04,6.52,0.13,2.03,31.86,-79.54,True,1,1151,-6.52,-21183.89,7504.52,-13679.37
1932-08-05,6.8,0.28,4.29,31.86,-78.66,True,1,1152,-6.8,-21190.69,7833.6,-13357.09
1932-08-08,7.43,0.63,9.26,31.86,-76.68,True,1,1153,-7.43,-21198.12,8566.79,-12631.33
1932-08-09,7.39,-0.04,-0.54,31.86,-76.81,True,1,1154,-7.39,-21205.51,8528.06,-12677.45
1932-08-10,7.65,0.26,3.52,31.86,-75.99,True,1,1155,-7.65,-21213.16,8835.75,-12377.41
1932-08-11,7.61,-0.04,-0.52,31.86,-76.11,True,1,1156,-7.61,-21220.77,8797.16,-12423.61
1932-08-12,7.0,-0.61,-8.02,31.86,-78.03,True,1,1157,-7.0,-21227.77,8099.0,-13128.77
1932-08-15,7.44,0.44,6.29,31.86,-76.65,True,1,1158,-7.44,-21235.21,8615.52,-12619.69
1932-08-16,7.68,0.24,3.23,31.86,-75.9,True,1,1159,-7.68,-21242.89,8901.12,-12341.77
1932-08-17,7.51,-0.17,-2.21,31.86,-76.43,True,1,1160,-7.51,-21250.4,8711.6,-12538.8
1932-08-18,7.6,0.09,1.2,31.86,-76.15,True,1,1161,-7.6,-21258.0,8823.6,-12434.4
1932-08-19,7.53,-0.07,-0.92,31.86,-76.36,True,1,1162,-7.53,-21265.53,8749.86,-12515.67
1932-08-22,7.77,0.24,3.19,31.86,-75.61,True,1,1163,-7.77,-21273.3,9036.51,-12236.79
1932-08-23,8.15,0.38,4.89,31.86,-74.42,True,1,1164,-8.15,-21281.45,9486.6,-11794.85
1932-08-24,8.33,0.18,2.21,31.86,-73.85,True,1,1165,-8.33,-21289.78,9704.45,-11585.33
1932-08-25,8.26,-0.07,-0.84,31.86,-74.07,True,1,1166,-8.26,-21298.04,9631.16,-11666.88
1932-08-26,8.39,0.13,1.57,31.86,-73.67,True,1,1167,-8.39,-21306.43,9791.13,-11515.3
1932-08-29,8.58,0.19,2.26,31.86,-73.07,True,1,1168,-8.58,-21315.01,10021.44,-11293.57
1932-08-30,8.47,-0.11,-1.28,31.86,-73.42,True,1,1169,-8.47,-21323.48,9901.43,-11422.05
1932-08-31,8.39,-0.08,-0.94,31.86,-73.67,True,1,1170,-8.39,-21331.87,9816.3,-11515.57
1932-09-01,8.47,0.08,0.95,31.86,-73.42,True,1,1171,-8.47,-21340.34,9918.37,-11421.97
1932-09-02,8.84,0.37,4.37,31.86,-72.25,True,1,1172,-8.84,-21349.18,10360.48,-10988.7
1932-09-06,8.91,0.07,0.79,31.86,-72.03,True,1,1173,-8.91,-21358.09,10451.43,-10906.66
1932-09-07,9.31,0.4,4.49,31.86,-70.78,True,1,1174,-9.31,-21367.4,10929.94,-10437.46
1932-09-08,8.97,-0.34,-3.65,31.86,-71.85,True,1,1175,-8.97,-21376.37,10539.75,-10836.62
1932-09-09,8.75,-0.22,-2.45,31.86,-72.54,True,1,1176,-8.75,-21385.12,10290.0,-11095.12
1932-09-12,8.15,-0.6,-6.86,31.86,-74.42,True,1,1177,-8.15,-21393.27,9592.55,-11800.72
1932-09-13,7.8,-0.35,-4.29,31.86,-75.52,True,1,1178,-7.8,-21401.07,9188.4,-12212.67
1932-09-14,7.35,-0.45,-5.77,31.86,-76.93,True,1,1179,-7.35,-21408.42,8665.65,-12742.77
1932-09-15,7.66,0.31,4.22,31.86,-75.96,True,1,1180,-7.66,-21416.08,9038.8,-12377.28
1932-09-16,7.57,-0.09,-1.18,31.86,-76.24,True,1,1181,-7.57,-21423.65,8940.17,-12483.48
1932-09-19,7.34,-0.23,-3.04,31.86,-76.96,True,1,1182,-7.34,-21430.99,8675.88,-12755.11
1932-09-20,7.62,0.28,3.82,31.86,-76.08,True,1,1183,-7.62,-21438.61,9014.46,-12424.15
1932-09-21,8.52,0.9,11.81,31.86,-73.26,True,1,1184,-8.52,-21447.13,10087.68,-11359.45
1932-09-22,8.26,-0.26,-3.05,31.86,-74.07,True,1,1185,-8.26,-21455.39,9788.1,-11667.29
1932-09-23,8.4,0.14,1.7,31.86,-73.64,True,1,1186,-8.4,-21463.79,9962.4,-11501.39
1932-09-26,8.04,-0.36,-4.29,31.86,-74.76,True,1,1187,-8.04,-21471.83,9543.48,-11928.35
1932-09-27,8.13,0.09,1.12,31.86,-74.48,True,1,1188,-8.13,-21479.96,9658.44,-11821.52
1932-09-28,8.36,0.23,2.83,31.86,-73.76,True,1,1189,-8.36,-21488.32,9940.04,-11548.28
1932-09-29,8.1,-0.26,-3.11,31.86,-74.58,True,1,1190,-8.1,-21496.42,9639.0,-11857.42
1932-09-30,8.08,-0.02,-0.25,31.86,-74.64,True,1,1191,-8.08,-21504.5,9623.28,-11881.22
1932-10-03,8.06,-0.02,-0.25,31.86,-74.7,True,1,1192,-8.06,-21512.56,9607.52,-11905.04
1932-10-04,8.05,-0.01,-0.12,31.86,-74.73,True,1,1193,-8.05,-21520.61,9603.65,-11916.96
1932-10-05,7.39,-0.66,-8.2,31.86,-76.81,True,1,1194,-7.39,-21528.0,8823.66,-12704.34
1932-10-06,7.43,0.04,0.54,31.86,-76.68,True,1,1195,-7.43,-21535.43,8878.85,-12656.58
1932-10-07,7.02,-0.41,-5.52,31.86,-77.97,True,1,1196,-7.02,-21542.45,8395.92,-13146.53
1932-10-10,6.42,-0.6,-8.55,31.86,-79.85,True,1,1197,-6.42,-21548.87,7684.74,-13864.13
1932-10-11,6.88,0.46,7.16,31.86,-78.41,True,1,1198,-6.88,-21555.75,8242.24,-13313.51
1932-10-13,6.67,-0.21,-3.05,31.86,-79.06,True,1,1199,-6.67,-21562.42,7997.33,-13565.09
1932-10-14,7.13,0.46,6.9,31.86,-77.62,True,1,1200,-7.13,-21569.55,8556.0,-13013.55
1932-10-17,7.0,-0.13,-1.82,31.86,-78.03,True,1,1201,-7.0,-21576.55,8407.0,-13169.55
1932-10-18,7.13,0.13,1.86,31.86,-77.62,True,1,1202,-7.13,-21583.68,8570.26,-13013.42
1932-10-19,7.4,0.27,3.79,31.86,-76.77,True,1,1203,-7.4,-21591.08,8902.2,-12688.88
1932-10-20,7.23,-0.17,-2.3,31.86,-77.31,True,1,1204,-7.23,-21598.31,8704.92,-12893.39
1932-10-21,6.82,-0.41,-5.67,31.86,-78.59,True,1,1205,-6.82,-21605.13,8218.1,-13387.03
1932-10-24,6.83,0.01,0.15,31.86,-78.56,True,1,1206,-6.83,-21611.96,8236.98,-13374.98
1932-10-25,6.76,-0.07,-1.02,31.86,-78.78,True,1,1207,-6.76,-21618.72,8159.32,-13459.4
1932-10-26,6.89,0.13,1.92,31.86,-78.37,True,1,1208,-6.89,-21625.61,8323.12,-13302.49
1932-10-27,6.95,0.06,0.87,31.86,-78.19,True,1,1209,-6.95,-21632.56,8402.55,-13230.01
1932-10-28,7.09,0.14,2.01,31.86,-77.75,True,1,1210,-7.09,-21639.65,8578.9,-13060.75
1932-10-31,6.96,-0.13,-1.83,31.86,-78.15,True,1,1211,-6.96,-21646.61,8428.56,-13218.05
1932-11-01,6.76,-0.2,-2.87,31.86,-78.78,True,1,1212,-6.76,-21653.37,8193.12,-13460.25
1932-11-02,6.52,-0.24,-3.55,31.86,-79.54,True,1,1213,-6.52,-21659.89,7908.76,-13751.13
1932-11-03,6.48,-0.04,-0.61,31.86,-79.66,True,1,1214,-6.48,-21666.37,7866.72,-13799.65
1932-11-04,6.88,0.4,6.17,31.86,-78.41,True,1,1215,-6.88,-21673.25,8359.2,-13314.05
1932-11-07,7.24,0.36,5.23,31.86,-77.28,True,1,1216,-7.24,-21680.49,8803.84,-12876.65
1932-11-09,6.92,-0.32,-4.42,31.86,-78.28,True,1,1217,-6.92,-21687.41,8421.64,-13265.77
1932-11-10,7.44,0.52,7.51,31.86,-76.65,True,1,1218,-7.44,-21694.85,9061.92,-12632.93
1932-11-11,7.68,0.24,3.23,31.86,-75.9,True,1,1219,-7.68,-21702.53,9361.92,-12340.61
1932-11-14,7.43,-0.25,-3.26,31.86,-76.68,True,1,1220,-7.43,-21709.96,9064.6,-12645.36
1932-11-15,7.43,0.0,0.0,31.86,-76.68,True,1,1221,-7.43,-21717.39,9072.03,-12645.36
1932-11-16,7.2,-0.23,-3.1,31.86,-77.4,True,1,1222,-7.2,-21724.59,8798.4,-12926.19
1932-11-17,7.15,-0.05,-0.69,31.86,-77.56,True,1,1223,-7.15,-21731.74,8744.45,-12987.29
1932-11-18,7.13,-0.02,-0.28,31.86,-77.62,True,1,1224,-7.13,-21738.87,8727.12,-13011.75
1932-11-21,7.2,0.07,0.98,31.86,-77.4,True,1,1225,-7.2,-21746.07,8820.0,-12926.07
1932-11-22,7.17,-0.03,-0.42,31.86,-77.5,True,1,1226,-7.17,-21753.24,8790.42,-12962.82
1932-11-23,6.85,-0.32,-4.46,31.86,-78.5,True,1,1227,-6.85,-21760.09,8404.95,-13355.14
1932-11-25,6.78,-0.07,-1.02,31.86,-78.72,True,1,1228,-6.78,-21766.87,8325.84,-13441.03
1932-11-28,6.8,0.02,0.3,31.86,-78.66,True,1,1229,-6.8,-21773.67,8357.2,-13416.47
1932-11-29,6.78,-0.02,-0.29,31.86,-78.72,True,1,1230,-6.78,-21780.45,8339.4,-13441.05
1932-11-30,6.55,-0.23,-3.39,31.86,-79.44,True,1,1231,-6.55,-21787.0,8063.05,-13723.95
1932-12-01,6.73,0.18,2.75,31.86,-78.88,True,1,1232,-6.73,-21793.73,8291.36,-13502.37
1932-12-02,6.47,-0.26,-3.86,31.86,-79.69,True,1,1233,-6.47,-21800.2,7977.51,-13822.69
1932-12-05,6.54,0.07,1.08,31.86,-79.47,True,1,1234,-6.54,-21806.74,8070.36,-13736.38
1932-12-06,6.87,0.33,5.05,31.86,-78.44,True,1,1235,-6.87,-21813.61,8484.45,-13329.16
1932-12-07,6.89,0.02,0.29,31.86,-78.37,True,1,1236,-6.89,-21820.5,8516.04,-13304.46
1932-12-08,6.89,0.0,0.0,31.86,-78.37,True,1,1237,-6.89,-21827.39,8522.93,-13304.46
1932-12-09,7.08,0.19,2.76,31.86,-77.78,True,1,1238,-7.08,-21834.47,8765.04,-13069.43
1932-12-12,7.07,-0.01,-0.14,31.86,-77.81,True,1,1239,-7.07,-21841.54,8759.73,-13081.81
1932-12-13,6.99,-0.08,-1.13,31.86,-78.06,True,1,1240,-6.99,-21848.53,8667.6,-13180.93
1932-12-14,7.12,0.13,1.86,31.86,-77.65,True,1,1241,-7.12,-21855.65,8835.92,-13019.73
1932-12-15,7.05,-0.07,-0.98,31.86,-77.87,True,1,1242,-7.05,-21862.7,8756.1,-13106.6
1932-12-16,7.0,-0.05,-0.71,31.86,-78.03,True,1,1243,-7.0,-21869.7,8701.0,-13168.7
1932-12-19,6.97,-0.03,-0.43,31.86,-78.12,True,1,1244,-6.97,-21876.67,8670.68,-13205.99
1932-12-20,6.82,-0.15,-2.15,31.86,-78.59,True,1,1245,-6.82,-21883.49,8490.9,-13392.59
1932-12-21,6.8,-0.02,-0.29,31.86,-78.66,True,1,1246,-6.8,-21890.29,8472.8,-13417.49
1932-12-22,6.57,-0.23,-3.38,31.86,-79.38,True,1,1247,-6.57,-21896.86,8192.79,-13704.07
1932-12-23,6.57,0.0,0.0,31.86,-79.38,True,1,1248,-6.57,-21903.43,8199.36,-13704.07
1932-12-27,6.61,0.04,0.61,31.86,-79.25,True,1,1249,-6.61,-21910.04,8255.89,-13654.15
1932-12-28,6.6,-0.01,-0.15,31.86,-79.28,True,1,1250,-6.6,-21916.64,8250.0,-13666.64
1932-12-29,6.75,0.15,2.27,31.86,-78.81,True,1,1251,-6.75,-21923.39,8444.25,-13479.14
1932-12-30,6.92,0.17,2.52,31.86,-78.28,True,1,1252,-6.92,-21930.31,8663.84,-13266.47
1933-01-03,6.83,-0.09,-1.3,31.86,-78.56,True,1,1253,-6.83,-21937.14,8557.99,-13379.15
1933-01-04,7.15,0.32,4.68,31.86,-77.56,True,1,1254,-7.15,-21944.29,8966.1,-12978.19
1933-01-05,7.12,-0.03,-0.42,31.86,-77.65,True,1,1255,-7.12,-21951.41,8935.6,-13015.81
1933-01-06,7.23,0.11,1.54,31.86,-77.31,True,1,1256,-7.23,-21958.64,9080.88,-12877.76
1933-01-09,7.13,-0.1,-1.38,31.86,-77.62,True,1,1257,-7.13,-21965.77,8962.41,-13003.36
1933-01-10,7.34,0.21,2.94,31.86,-76.96,True,1,1258,-7.34,-21973.11,9233.72,-12739.39
1933-01-11,7.32,-0.02,-0.27,31.86,-77.02,True,1,1259,-7.32,-21980.43,9215.88,-12764.55
1933-01-12,7.23,-0.09,-1.23,31.86,-77.31,True,1,1260,-7.23,-21987.66,9109.8,-12877.86
1933-01-13,7.25,0.02,0.28,31.86,-77.24,True,1,1261,-7.25,-21994.91,9142.25,-12852.66
1933-01-16,7.06,-0.19,-2.62,31.86,-77.84,True,1,1262,-7.06,-22001.97,8909.72,-13092.25
1933-01-17,7.08,0.02,0.28,31.86,-77.78,True,1,1263,-7.08,-22009.05,8942.04,-13067.01
1933-01-18,6.95,-0.13,-1.84,31.86,-78.19,True,1,1264,-6.95,-22016.0,8784.8,-13231.2
1933-01-19,6.98,0.03,0.43,31.86,-78.09,True,1,1265,-6.98,-22022.98,8829.7,-13193.28
1933-01-20,7.06,0.08,1.15,31.86,-77.84,True,1,1266,-7.06,-22030.04,8937.96,-13092.08
1933-01-23,7.03,-0.03,-0.42,31.86,-77.94,True,1,1267,-7.03,-22037.07,8907.01,-13130.06
1933-01-24,6.98,-0.05,-0.71,31.86,-78.09,True,1,1268,-6.98,-22044.05,8850.64,-13193.41
1933-01-25,7.1,0.12,1.72,31.86,-77.72,True,1,1269,-7.1,-22051.15,9009.9,-13041.25
1933-01-26,7.05,-0.05,-0.7,31.86,-77.87,True,1,1270,-7.05,-22058.2,8953.5,-13104.7
1933-01-27,7.04,-0.01,-0.14,31.86,-77.9,True,1,1271,-7.04,-22065.24,8947.84,-13117.4
1933-01-30,6.98,-0.06,-0.85,31.86,-78.09,True,1,1272,-6.98,-22072.22,8878.56,-13193.66
1933-01-31,6.94,-0.04,-0.57,31.86,-78.22,True,1,1273,-6.94,-22079.16,8834.62,-13244.54
1933-02-01,6.67,-0.27,-3.89,31.86,-79.06,True,1,1274,-6.67,-22085.83,8497.58,-13588.25
1933-02-02,6.55,-0.12,-1.8,31.86,-79.44,True,1,1275,-6.55,-22092.38,8351.25,-13741.13
1933-02-03,6.53,-0.02,-0.3,31.86,-79.5,True,1,1276,-6.53,-22098.91,8332.28,-13766.63
1933-02-06,6.48,-0.05,-0.77,31.86,-79.66,True,1,1277,-6.48,-22105.39,8274.96,-13830.43
1933-02-07,6.54,0.06,0.93,31.86,-79.47,True,1,1278,-6.54,-22111.93,8358.12,-13753.81
1933-02-08,6.62,0.08,1.22,31.86,-79.22,True,1,1279,-6.62,-22118.55,8466.98,-13651.57
1933-02-09,6.76,0.14,2.12,31.86,-78.78,True,1,1280,-6.76,-22125.31,8652.8,-13472.51
1933-02-10,6.66,-0.1,-1.48,31.86,-79.1,True,1,1281,-6.66,-22131.97,8531.46,-13600.51
1933-02-14,6.32,-0.34,-5.11,31.86,-80.16,True,1,1282,-6.32,-22138.29,8102.24,-14036.05
1933-02-15,6.28,-0.04,-0.63,31.86,-80.29,True,1,1283,-6.28,-22144.57,8057.24,-14087.33
1933-02-16,6.13,-0.15,-2.39,31.86,-80.76,True,1,1284,-6.13,-22150.7,7870.92,-14279.78
1933-02-17,6.23,0.1,1.63,31.86,-80.45,True,1,1285,-6.23,-22156.93,8005.55,-14151.38
1933-02-20,6.0,-0.23,-3.69,31.86,-81.17,True,1,1286,-6.0,-22162.93,7716.0,-14446.93
1933-02-21,5.96,-0.04,-0.67,31.86,-81.29,True,1,1287,-5.96,-22168.89,7670.52,-14498.37
1933-02-23,5.68,-0.28,-4.7,31.86,-82.17,True,1,1288,-5.68,-22174.57,7315.84,-14858.73
1933-02-24,5.9,0.22,3.87,31.86,-81.48,True,1,1289,-5.9,-22180.47,7605.1,-14575.37
1933-02-27,5.53,-0.37,-6.27,31.86,-82.64,True,1,1290,-5.53,-22186.0,7133.7,-15052.3
1933-02-28,5.66,0.13,2.35,31.86,-82.24,True,1,1291,-5.66,-22191.66,7307.06,-14884.6
1933-03-01,5.77,0.11,1.94,31.86,-81.89,True,1,1292,-5.77,-22197.43,7454.84,-14742.59
1933-03-02,5.65,-0.12,-2.08,31.86,-82.27,True,1,1293,-5.65,-22203.08,7305.45,-14897.63
1933-03-03,5.84,0.19,3.36,31.86,-81.67,True,1,1294,-5.84,-22208.92,7556.96,-14651.96
1933-03-15,6.81,0.97,16.61,31.86,-78.62,True,1,1295,-6.81,-22215.73,8818.95,-13396.78
1933-03-16,6.93,0.12,1.76,31.86,-78.25,True,1,1296,-6.93,-22222.66,8981.28,-13241.38
1933-03-17,6.63,-0.3,-4.33,31.86,-79.19,True,1,1297,-6.63,-22229.29,8599.11,-13630.18
1933-03-20,6.5,-0.13,-1.96,31.86,-79.6,True,1,1298,-6.5,-22235.79,8437.0,-13798.79
1933-03-21,6.2,-0.3,-4.62,31.86,-80.54,True,1,1299,-6.2,-22241.99,8053.8,-14188.19
1933-03-22,6.12,-0.08,-1.29,31.86,-80.79,True,1,1300,-6.12,-22248.11,7956.0,-14292.11
1933-03-23,6.25,0.13,2.12,31.86,-80.38,True,1,1301,-6.25,-22254.36,8131.25,-14123.11
1933-03-24,6.25,0.0,0.0,31.86,-80.38,True,1,1302,-6.25,-22260.61,8137.5,-14123.11
1933-03-27,6.09,-0.16,-2.56,31.86,-80.89,True,1,1303,-6.09,-22266.7,7935.27,-14331.43
1933-03-28,6.21,0.12,1.97,31.86,-80.51,True,1,1304,-6.21,-22272.91,8097.84,-14175.07
1933-03-29,6.07,-0.14,-2.25,31.86,-80.95,True,1,1305,-6.07,-22278.98,7921.35,-14357.63
1933-03-30,6.05,-0.02,-0.33,31.86,-81.01,True,1,1306,-6.05,-22285.03,7901.3,-14383.73
1933-03-31,5.85,-0.2,-3.31,31.86,-81.64,True,1,1307,-5.85,-22290.88,7645.95,-14644.93
1933-04-03,5.87,0.02,0.34,31.86,-81.58,True,1,1308,-5.87,-22296.75,7677.96,-14618.79
1933-04-04,5.9,0.03,0.51,31.86,-81.48,True,1,1309,-5.9,-22302.65,7723.1,-14579.55
1933-04-05,5.95,0.05,0.85,31.86,-81.32,True,1,1310,-5.95,-22308.6,7794.5,-14514.1
1933-04-06,6.05,0.1,1.68,31.86,-81.01,True,1,1311,-6.05,-22314.65,7931.55,-14383.1
1933-04-07,6.12,0.07,1.16,31.86,-80.79,True,1,1312,-6.12,-22320.77,8029.44,-14291.33
1933-04-10,6.54,0.42,6.86,31.86,-79.47,True,1,1313,-6.54,-22327.31,8587.02,-13740.29
1933-04-11,6.51,-0.03,-0.46,31.86,-79.57,True,1,1314,-6.51,-22333.82,8554.14,-13779.68
1933-04-12,6.41,-0.1,-1.54,31.86,-79.88,True,1,1315,-6.41,-22340.23,8429.15,-13911.08
1933-04-13,6.67,0.26,4.06,31.86,-79.06,True,1,1316,-6.67,-22346.9,8777.72,-13569.18
1933-04-17,6.53,-0.14,-2.1,31.86,-79.5,True,1,1317,-6.53,-22353.43,8600.01,-13753.42
1933-04-18,6.66,0.13,1.99,31.86,-79.1,True,1,1318,-6.66,-22360.09,8777.88,-13582.21
1933-04-19,7.14,0.48,7.21,31.86,-77.59,True,1,1319,-7.14,-22367.23,9417.66,-12949.57
1933-04-20,7.82,0.68,9.52,31.86,-75.46,True,1,1320,-7.82,-22375.05,10322.4,-12052.65
1933-04-21,7.44,-0.38,-4.86,31.86,-76.65,True,1,1321,-7.44,-22382.49,9828.24,-12554.25
1933-04-24,7.91,0.47,6.32,31.86,-75.17,True,1,1322,-7.91,-22390.4,10457.02,-11933.38
1933-04-25,7.72,-0.19,-2.4,31.86,-75.77,True,1,1323,-7.72,-22398.12,10213.56,-12184.56
1933-04-26,7.77,0.05,0.65,31.86,-75.61,True,1,1324,-7.77,-22405.89,10287.48,-12118.41
1933-04-27,7.7,-0.07,-0.9,31.86,-75.83,True,1,1325,-7.7,-22413.59,10202.5,-12211.09
1933-04-28,7.83,0.13,1.69,31.86,-75.42,True,1,1326,-7.83,-22421.42,10382.58,-12038.84
1933-05-01,8.43,0.6,7.66,31.86,-73.54,True,1,1327,-8.43,-22429.85,11186.61,-11243.24
1933-05-02,8.46,0.03,0.36,31.86,-73.45,True,1,1328,-8.46,-22438.31,11234.88,-11203.43
1933-05-03,8.41,-0.05,-0.59,31.86,-73.6,True,1,1329,-8.41,-22446.72,11176.89,-11269.83
1933-05-04,8.65,0.24,2.85,31.86,-72.85,True,1,1330,-8.65,-22455.37,11504.5,-10950.87
1933-05-05,8.74,0.09,1.04,31.86,-72.57,True,1,1331,-8.74,-22464.11,11632.94,-10831.17
1933-05-08,8.34,-0.4,-4.58,31.86,-73.82,True,1,1332,-8.34,-22472.45,11108.88,-11363.57
1933-05-09,8.4,0.06,0.72,31.86,-73.64,True,1,1333,-8.4,-22480.85,11197.2,-11283.65
1933-05-10,8.82,0.42,5.0,31.86,-72.32,True,1,1334,-8.82,-22489.67,11765.88,-10723.79
1933-05-11,9.07,0.25,2.83,31.86,-71.53,True,1,1335,-9.07,-22498.74,12108.45,-10390.29
1933-05-12,9.03,-0.04,-0.44,31.86,-71.66,True,1,1336,-9.03,-22507.77,12064.08,-10443.69
1933-05-15,8.68,-0.35,-3.88,31.86,-72.76,True,1,1337,-8.68,-22516.45,11605.16,-10911.29
1933-05-16,8.85,0.17,1.96,31.86,-72.22,True,1,1338,-8.85,-22525.3,11841.3,-10684.0
1933-05-17,8.94,0.09,1.02,31.86,-71.94,True,1,1339,-8.94,-22534.24,11970.66,-10563.58
1933-05-18,8.89,-0.05,-0.56,31.86,-72.1,True,1,1340,-8.89,-22543.13,11912.6,-10630.53
1933-05-19,8.82,-0.07,-0.79,31.86,-72.32,True,1,1341,-8.82,-22551.95,11827.62,-10724.33
1933-05-22,8.64,-0.18,-2.04,31.86,-72.88,True,1,1342,-8.64,-22560.59,11594.88,-10965.71
1933-05-23,8.96,0.32,3.7,31.86,-71.88,True,1,1343,-8.96,-22569.55,12033.28,-10536.27
1933-05-24,9.15,0.19,2.12,31.86,-71.28,True,1,1344,-9.15,-22578.7,12297.6,-10281.1
1933-05-25,9.08,-0.07,-0.76,31.86,-71.5,True,1,1345,-9.08,-22587.78,12212.6,-10375.18
1933-05-26,9.34,0.26,2.86,31.86,-70.68,True,1,1346,-9.34,-22597.12,12571.64,-10025.48
1933-05-29,9.78,0.44,4.71,31.86,-69.3,True,1,1347,-9.78,-22606.9,13173.66,-9433.24
1933-05-31,9.64,-0.14,-1.43,31.86,-69.74,True,1,1348,-9.64,-22616.54,12994.72,-9621.82
1933-06-01,9.74,0.1,1.04,31.86,-69.43,True,1,1349,-9.74,-22626.28,13139.26,-9487.02
1933-06-02,10.13,0.39,4.0,31.86,-68.2,True,1,1350,-10.13,-22636.41,13675.5,-8960.91
1933-06-05,10.07,-0.06,-0.59,31.86,-68.39,True,1,1351,-10.07,-22646.48,13604.57,-9041.91
1933-06-06,10.04,-0.03,-0.3,31.86,-68.49,True,1,1352,-10.04,-22656.52,13574.08,-9082.44
1933-06-07,10.22,0.18,1.79,31.86,-67.92,True,1,1353,-10.22,-22666.74,13827.66,-8839.08
1933-06-08,10.31,0.09,0.88,31.86,-67.64,True,1,1354,-10.31,-22677.05,13959.74,-8717.31
1933-06-09,10.41,0.1,0.97,31.86,-67.33,True,1,1355,-10.41,-22687.46,14105.55,-8581.91
1933-06-12,10.89,0.48,4.61,31.86,-65.82,True,1,1356,-10.89,-22698.35,14766.84,-7931.51
1933-06-13,10.57,-0.32,-2.94,31.86,-66.82,True,1,1357,-10.57,-22708.92,14343.49,-8365.43
1933-06-14,10.47,-0.1,-0.95,31.86,-67.14,True,1,1358,-10.47,-22719.39,14218.26,-8501.13
1933-06-15,9.74,-0.73,-6.97,31.86,-69.43,True,1,1359,-9.74,-22729.13,13236.66,-9492.47
1933-06-16,9.81,0.07,0.72,31.86,-69.21,True,1,1360,-9.81,-22738.94,13341.6,-9397.34
1933-06-19,10.68,0.87,8.87,31.86,-66.48,True,1,1361,-10.68,-22749.62,14535.48,-8214.14
1933-06-20,10.52,-0.16,-1.5,31.86,-66.98,True,1,1362,-10.52,-22760.14,14328.24,-8431.9
1933-06-21,10.58,0.06,0.57,31.86,-66.79,True,1,1363,-10.58,-22770.72,14420.54,-8350.18
1933-06-22,10.22,-0.36,-3.4,31.86,-67.92,True,1,1364,-10.22,-22780.94,13940.08,-8840.86
1933-06-23,10.56,0.34,3.33,31.86,-66.86,True,1,1365,-10.56,-22791.5,14414.4,-8377.1
1933-06-26,10.87,0.31,2.94,31.86,-65.88,True,1,1366,-10.87,-22802.37,14848.42,-7953.95
1933-06-27,10.98,0.11,1.01,31.86,-65.54,True,1,1367,-10.98,-22813.35,15009.66,-7803.69
1933-06-28,10.84,-0.14,-1.27,31.86,-65.98,True,1,1368,-10.84,-22824.19,14829.12,-7995.07
1933-06-29,10.74,-0.1,-0.92,31.86,-66.29,True,1,1369,-10.74,-22834.93,14703.06,-8131.87
1933-06-30,10.91,0.17,1.58,31.86,-65.76,True,1,1370,-10.91,-22845.84,14946.7,-7899.14
1933-07-03,11.62,0.71,6.51,31.86,-63.53,True,1,1371,-11.62,-22857.46,15931.02,-6926.44
1933-07-05,11.55,-0.07,-0.6,31.86,-63.75,True,1,1372,-11.55,-22869.01,15846.6,-7022.41
1933-07-06,11.85,0.3,2.6,31.86,-62.81,True,1,1373,-11.85,-22880.86,16270.05,-6610.81
1933-07-07,11.96,0.11,0.93,31.86,-62.46,True,1,1374,-11.96,-22892.82,16433.04,-6459.78
1933-07-10,11.86,-0.1,-0.84,31.86,-62.78,True,1,1375,-11.86,-22904.68,16307.5,-6597.18
1933-07-11,11.71,-0.15,-1.26,31.86,-63.24,True,1,1376,-11.71,-22916.39,16112.96,-6803.43
1933-07-12,11.87,0.16,1.37,31.86,-62.74,True,1,1377,-11.87,-22928.26,16344.99,-6583.27
1933-07-13,12.0,0.13,1.1,31.86,-62.34,True,1,1378,-12.0,-22940.26,16536.0,-6404.26
1933-07-14,11.85,-0.15,-1.25,31.86,-62.81,True,1,1379,-11.85,-22952.11,16341.15,-6610.96
1933-07-17,12.01,0.16,1.35,31.86,-62.3,True,1,1380,-12.01,-22964.12,16573.8,-6390.32
1933-07-18,12.2,0.19,1.58,31.86,-61.71,True,1,1381,-12.2,-22976.32,16848.2,-6128.12
1933-07-19,11.6,-0.6,-4.92,31.86,-63.59,True,1,1382,-11.6,-22987.92,16031.2,-6956.72
1933-07-20,10.57,-1.03,-8.88,31.86,-66.82,True,1,1383,-10.57,-22998.49,14618.31,-8380.18
1933-07-21,9.65,-0.92,-8.7,31.86,-69.71,True,1,1384,-9.65,-23008.14,13355.6,-9652.54
1933-07-24,10.5,0.85,8.81,31.86,-67.04,True,1,1385,-10.5,-23018.64,14542.5,-8476.14
1933-07-25,10.32,-0.18,-1.71,31.86,-67.61,True,1,1386,-10.32,-23028.96,14303.52,-8725.44
1933-07-26,10.59,0.27,2.62,31.86,-66.76,True,1,1387,-10.59,-23039.55,14688.33,-8351.22
1933-07-27,10.68,0.09,0.85,31.86,-66.48,True,1,1388,-10.68,-23050.23,14823.84,-8226.39
1933-07-28,10.43,-0.25,-2.34,31.86,-67.26,True,1,1389,-10.43,-23060.66,14487.27,-8573.39
1933-07-31,9.95,-0.48,-4.6,31.86,-68.77,True,1,1390,-9.95,-23070.61,13830.5,-9240.11
1933-08-01,10.25,0.3,3.02,31.86,-67.83,True,1,1391,-10.25,-23080.86,14257.75,-8823.11
1933-08-02,10.49,0.24,2.34,31.86,-67.08,True,1,1392,-10.49,-23091.35,14602.08,-8489.27
1933-08-03,10.36,-0.13,-1.24,31.86,-67.48,True,1,1393,-10.36,-23101.71,14431.48,-8670.23
1933-08-04,10.13,-0.23,-2.22,31.86,-68.2,True,1,1394,-10.13,-23111.84,14121.22,-8990.62
1933-08-07,10.05,-0.08,-0.79,31.86,-68.46,True,1,1395,-10.05,-23121.89,14019.75,-9102.14
1933-08-08,10.39,0.34,3.38,31.86,-67.39,True,1,1396,-10.39,-23132.28,14504.44,-8627.84
1933-08-09,10.81,0.42,4.04,31.86,-66.07,True,1,1397,-10.81,-23143.09,15101.57,-8041.52
1933-08-10,10.63,-0.18,-1.66,31.86,-66.64,True,1,1398,-10.63,-23153.72,14860.74,-8292.98
1933-08-11,10.59,-0.04,-0.38,31.86,-66.76,True,1,1399,-10.59,-23164.31,14815.41,-8348.9
1933-08-14,10.46,-0.13,-1.23,31.86,-67.17,True,1,1400,-10.46,-23174.77,14644.0,-8530.77
1933-08-15,10.48,0.02,0.19,31.86,-67.11,True,1,1401,-10.48,-23185.25,14682.48,-8502.77
1933-08-16,10.2,-0.28,-2.67,31.86,-67.98,True,1,1402,-10.2,-23195.45,14300.4,-8895.05
1933-08-17,10.76,0.56,5.49,31.86,-66.23,True,1,1403,-10.76,-23206.21,15096.28,-8109.93
1933-08-18,10.58,-0.18,-1.67,31.86,-66.79,True,1,1404,-10.58,-23216.79,14854.32,-8362.47
1933-08-21,10.75,0.17,1.61,31.86,-66.26,True,1,1405,-10.75,-23227.54,15103.75,-8123.79
1933-08-22,10.92,0.17,1.58,31.86,-65.72,True,1,1406,-10.92,-23238.46,15353.52,-7884.94
1933-08-23,10.78,-0.14,-1.28,31.86,-66.16,True,1,1407,-10.78,-23249.24,15167.46,-8081.78
1933-08-24,10.88,0.1,0.93,31.86,-65.85,True,1,1408,-10.88,-23260.12,15319.04,-7941.08
1933-08-25,11.28,0.4,3.68,31.86,-64.6,True,1,1409,-11.28,-23271.4,15893.52,-7377.88
1933-08-28,11.26,-0.02,-0.18,31.86,-64.66,True,1,1410,-11.26,-23282.66,15876.6,-7406.06
1933-08-29,11.2,-0.06,-0.53,31.86,-64.85,True,1,1411,-11.2,-23293.86,15803.2,-7490.66
1933-08-30,11.1,-0.1,-0.89,31.86,-65.16,True,1,1412,-11.1,-23304.96,15673.2,-7631.76
1933-08-31,11.09,-0.01,-0.09,31.86,-65.19,True,1,1413,-11.09,-23316.05,15670.17,-7645.88
1933-09-01,11.23,0.14,1.26,31.86,-64.75,True,1,1414,-11.23,-23327.28,15879.22,-7448.06
1933-09-05,10.84,-0.39,-3.47,31.86,-65.98,True,1,1415,-10.84,-23338.12,15338.6,-7999.52
1933-09-06,10.85,0.01,0.09,31.86,-65.94,True,1,1416,-10.85,-23348.97,15363.6,-7985.37
1933-09-07,10.7,-0.15,-1.38,31.86,-66.42,True,1,1417,-10.7,-23359.67,15161.9,-8197.77
1933-09-08,10.66,-0.04,-0.37,31.86,-66.54,True,1,1418,-10.66,-23370.33,15115.88,-8254.45
1933-09-11,11.13,0.47,4.41,31.86,-65.07,True,1,1419,-11.13,-23381.46,15793.47,-7587.99
1933-09-12,11.06,-0.07,-0.63,31.86,-65.29,True,1,1420,-11.06,-23392.52,15705.2,-7687.32
1933-09-13,11.11,0.05,0.45,31.86,-65.13,True,1,1421,-11.11,-23403.63,15787.31,-7616.32
1933-09-14,11.13,0.02,0.18,31.86,-65.07,True,1,1422,-11.13,-23414.76,15826.86,-7587.9
1933-09-15,10.82,-0.31,-2.78,31.86,-66.04,True,1,1423,-10.82,-23425.58,15396.86,-8028.72
1933-09-18,11.0,0.18,1.66,31.86,-65.47,True,1,1424,-11.0,-23436.58,15664.0,-7772.58
1933-09-19,11.04,0.04,0.36,31.86,-65.35,True,1,1425,-11.04,-23447.62,15732.0,-7715.62
1933-09-20,10.69,-0.35,-3.17,31.86,-66.45,True,1,1426,-10.69,-23458.31,15243.94,-8214.37
1933-09-21,10.03,-0.66,-6.17,31.86,-68.52,True,1,1427,-10.03,-23468.34,14312.81,-9155.53
1933-09-22,10.26,0.23,2.29,31.86,-67.8,True,1,1428,-10.26,-23478.6,14651.28,-8827.32
1933-09-25,10.16,-0.1,-0.98,31.86,-68.11,True,1,1429,-10.16,-23488.76,14518.64,-8970.12
1933-09-26,10.07,-0.09,-0.89,31.86,-68.39,True,1,1430,-10.07,-23498.83,14400.1,-9098.73
1933-09-27,9.65,-0.42,-4.17,31.86,-69.71,True,1,1431,-9.65,-23508.48,13809.15,-9699.33
1933-09-28,9.79,0.14,1.45,31.86,-69.27,True,1,1432,-9.79,-23518.27,14019.28,-9498.99
1933-09-29,9.72,-0.07,-0.72,31.86,-69.49,True,1,1433,-9.72,-23527.99,13928.76,-9599.23
1933-10-02,9.62,-0.1,-1.03,31.86,-69.81,True,1,1434,-9.62,-23537.61,13795.08,-9742.53
1933-10-03,9.67,0.05,0.52,31.86,-69.65,True,1,1435,-9.67,-23547.28,13876.45,-9670.83
1933-10-04,10.29,0.62,6.41,31.86,-67.7,True,1,1436,-10.29,-23557.57,14776.44,-8781.13
1933-10-05,10.16,-0.13,-1.26,31.86,-68.11,True,1,1437,-10.16,-23567.73,14599.92,-8967.81
1933-10-06,10.05,-0.11,-1.08,31.86,-68.46,True,1,1438,-10.05,-23577.78,14451.9,-9125.88
1933-10-09,10.32,0.27,2.69,31.86,-67.61,True,1,1439,-10.32,-23588.1,14850.48,-8737.62
1933-10-10,10.23,-0.09,-0.87,31.86,-67.89,True,1,1440,-10.23,-23598.33,14731.2,-8867.13
1933-10-11,10.24,0.01,0.1,31.86,-67.86,True,1,1441,-10.24,-23608.57,14755.84,-8852.73
1933-10-13,9.85,-0.39,-3.81,31.86,-69.08,True,1,1442,-9.85,-23618.42,14203.7,-9414.72
1933-10-16,9.21,-0.64,-6.5,31.86,-71.09,True,1,1443,-9.21,-23627.63,13290.03,-10337.6
1933-10-17,9.51,0.3,3.26,31.86,-70.15,True,1,1444,-9.51,-23637.14,13732.44,-9904.7
1933-10-18,9.07,-0.44,-4.63,31.86,-71.53,True,1,1445,-9.07,-23646.21,13106.15,-10540.06
1933-10-19,8.61,-0.46,-5.07,31.86,-72.98,True,1,1446,-8.61,-23654.82,12450.06,-11204.76
1933-10-20,8.86,0.25,2.9,31.86,-72.19,True,1,1447,-8.86,-23663.68,12820.42,-10843.26
1933-10-23,9.02,0.16,1.81,31.86,-71.69,True,1,1448,-9.02,-23672.7,13060.96,-10611.74
1933-10-24,9.38,0.36,3.99,31.86,-70.56,True,1,1449,-9.38,-23682.08,13591.62,-10090.46
1933-10-25,9.63,0.25,2.66,31.86,-69.77,True,1,1450,-9.63,-23691.71,13963.5,-9728.21
1933-10-26,9.44,-0.19,-1.97,31.86,-70.37,True,1,1451,-9.44,-23701.15,13697.44,-10003.71
1933-10-27,9.54,0.1,1.06,31.86,-70.06,True,1,1452,-9.54,-23710.69,13852.08,-9858.61
1933-10-30,9.04,-0.5,-5.24,31.86,-71.63,True,1,1453,-9.04,-23719.73,13135.12,-10584.61
1933-10-31,8.96,-0.08,-0.88,31.86,-71.88,True,1,1454,-8.96,-23728.69,13027.84,-10700.85
1933-11-01,9.12,0.16,1.79,31.86,-71.38,True,1,1455,-9.12,-23737.81,13269.6,-10468.21
1933-11-02,9.22,0.1,1.1,31.86,-71.06,True,1,1456,-9.22,-23747.03,13424.32,-10322.71
1933-11-03,9.54,0.32,3.47,31.86,-70.06,True,1,1457,-9.54,-23756.57,13899.78,-9856.79
1933-11-06,9.45,-0.09,-0.94,31.86,-70.34,True,1,1458,-9.45,-23766.02,13778.1,-9987.92
1933-11-08,9.8,0.35,3.7,31.86,-69.24,True,1,1459,-9.8,-23775.82,14298.2,-9477.62
1933-11-09,9.87,0.07,0.71,31.86,-69.02,True,1,1460,-9.87,-23785.69,14410.2,-9375.49
1933-11-10,9.72,-0.15,-1.52,31.86,-69.49,True,1,1461,-9.72,-23795.41,14200.92,-9594.49
1933-11-13,9.81,0.09,0.93,31.86,-69.21,True,1,1462,-9.81,-23805.22,14342.22,-9463.0
1933-11-14,9.69,-0.12,-1.22,31.86,-69.59,True,1,1463,-9.69,-23814.91,14176.47,-9638.44
1933-11-15,9.58,-0.11,-1.14,31.86,-69.93,True,1,1464,-9.58,-23824.49,14025.12,-9799.37
1933-11-16,10.03,0.45,4.7,31.86,-68.52,True,1,1465,-10.03,-23834.52,14693.95,-9140.57
1933-11-17,9.92,-0.11,-1.1,31.86,-68.86,True,1,1466,-9.92,-23844.44,14542.72,-9301.72
1933-11-20,10.23,0.31,3.12,31.86,-67.89,True,1,1467,-10.23,-23854.67,15007.41,-8847.26
1933-11-21,10.1,-0.13,-1.27,31.86,-68.3,True,1,1468,-10.1,-23864.77,14826.8,-9037.97
1933-11-22,10.05,-0.05,-0.5,31.86,-68.46,True,1,1469,-10.05,-23874.82,14763.45,-9111.37
1933-11-23,9.87,-0.18,-1.79,31.86,-69.02,True,1,1470,-9.87,-23884.69,14508.9,-9375.79
1933-11-24,10.01,0.14,1.42,31.86,-68.58,True,1,1471,-10.01,-23894.7,14724.71,-9169.99
1933-11-27,9.69,-0.32,-3.2,31.86,-69.59,True,1,1472,-9.69,-23904.39,14263.68,-9640.71
1933-11-28,9.7,0.01,0.1,31.86,-69.55,True,1,1473,-9.7,-23914.09,14288.1,-9625.99
1933-11-29,9.88,0.18,1.86,31.86,-68.99,True,1,1474,-9.88,-23923.97,14563.12,-9360.85
1933-12-01,9.91,0.03,0.3,31.86,-68.9,True,1,1475,-9.91,-23933.88,14617.25,-9316.63
1933-12-04,9.9,-0.01,-0.1,31.86,-68.93,True,1,1476,-9.9,-23943.78,14612.4,-9331.38
1933-12-05,10.2,0.3,3.03,31.86,-67.98,True,1,1477,-10.2,-23953.98,15065.4,-8888.58
1933-12-06,10.13,-0.07,-0.69,31.86,-68.2,True,1,1478,-10.13,-23964.11,14972.14,-8991.97
1933-12-07,10.2,0.07,0.69,31.86,-67.98,True,1,1479,-10.2,-23974.31,15085.8,-8888.51
1933-12-08,10.1,-0.1,-0.98,31.86,-68.3,True,1,1480,-10.1,-23984.41,14948.0,-9036.41
1933-12-11,10.31,0.21,2.08,31.86,-67.64,True,1,1481,-10.31,-23994.72,15269.11,-8725.61
1933-12-12,10.29,-0.02,-0.19,31.86,-67.7,True,1,1482,-10.29,-24005.01,15249.78,-8755.23
1933-12-13,10.19,-0.1,-0.97,31.86,-68.02,True,1,1483,-10.19,-24015.2,15111.77,-8903.43
1933-12-14,10.23,0.04,0.39,31.86,-67.89,True,1,1484,-10.23,-24025.43,15181.32,-8844.11
1933-12-15,10.07,-0.16,-1.56,31.86,-68.39,True,1,1485,-10.07,-24035.5,14953.95,-9081.55
1933-12-18,9.77,-0.3,-2.98,31.86,-69.33,True,1,1486,-9.77,-24045.27,14518.22,-9527.05
1933-12-19,9.75,-0.02,-0.2,31.86,-69.4,True,1,1487,-9.75,-24055.02,14498.25,-9556.77
1933-12-20,9.57,-0.18,-1.85,31.86,-69.96,True,1,1488,-9.57,-24064.59,14240.16,-9824.43
1933-12-21,9.55,-0.02,-0.21,31.86,-70.03,True,1,1489,-9.55,-24074.14,14219.95,-9854.19
1933-12-22,9.86,0.31,3.25,31.86,-69.05,True,1,1490,-9.86,-24084.0,14691.4,-9392.6
1933-12-26,9.58,-0.28,-2.84,31.86,-69.93,True,1,1491,-9.58,-24093.58,14283.78,-9809.8
1933-12-27,9.71,0.13,1.36,31.86,-69.52,True,1,1492,-9.71,-24103.29,14487.32,-9615.97
1933-12-28,9.99,0.28,2.88,31.86,-68.64,True,1,1493,-9.99,-24113.28,14915.07,-9198.21
1933-12-29,9.97,-0.02,-0.2,31.86,-68.71,True,1,1494,-9.97,-24123.25,14895.18,-9228.07
1934-01-02,10.11,0.14,1.4,31.86,-68.27,True,1,1495,-10.11,-24133.36,15114.45,-9018.91
1934-01-03,9.97,-0.14,-1.38,31.86,-68.71,True,1,1496,-9.97,-24143.33,14915.12,-9228.21
1934-01-04,9.94,-0.03,-0.3,31.86,-68.8,True,1,1497,-9.94,-24153.27,14880.18,-9273.09
1934-01-05,9.81,-0.13,-1.31,31.86,-69.21,True,1,1498,-9.81,-24163.08,14695.38,-9467.7
1934-01-08,9.76,-0.05,-0.51,31.86,-69.37,True,1,1499,-9.76,-24172.84,14630.24,-9542.6
1934-01-09,9.87,0.11,1.13,31.86,-69.02,True,1,1500,-9.87,-24182.71,14805.0,-9377.71
1934-01-10,10.14,0.27,2.74,31.86,-68.17,True,1,1501,-10.14,-24192.85,15220.14,-8972.71
1934-01-11,10.19,0.05,0.49,31.86,-68.02,True,1,1502,-10.19,-24203.04,15305.38,-8897.66
1934-01-12,10.07,-0.12,-1.18,31.86,-68.39,True,1,1503,-10.07,-24213.11,15135.21,-9077.9
1934-01-15,10.64,0.57,5.66,31.86,-66.6,True,1,1504,-10.64,-24223.75,16002.56,-8221.19
1934-01-16,10.69,0.05,0.47,31.86,-66.45,True,1,1505,-10.69,-24234.44,16088.45,-8145.99
1934-01-17,10.66,-0.03,-0.28,31.86,-66.54,True,1,1506,-10.66,-24245.1,16053.96,-8191.14
1934-01-18,10.63,-0.03,-0.28,31.86,-66.64,True,1,1507,-10.63,-24255.73,16019.41,-8236.32
1934-01-19,10.93,0.3,2.82,31.86,-65.69,True,1,1508,-10.93,-24266.66,16482.44,-7784.22
1934-01-22,10.91,-0.02,-0.18,31.86,-65.76,True,1,1509,-10.91,-24277.57,16463.19,-7814.38
1934-01-23,11.05,0.14,1.28,31.86,-65.32,True,1,1510,-11.05,-24288.62,16685.5,-7603.12
1934-01-24,11.12,0.07,0.63,31.86,-65.1,True,1,1511,-11.12,-24299.74,16802.32,-7497.42
1934-01-25,11.12,0.0,0.0,31.86,-65.1,True,1,1512,-11.12,-24310.86,16813.44,-7497.42
1934-01-26,11.02,-0.1,-0.9,31.86,-65.41,True,1,1513,-11.02,-24321.88,16673.26,-7648.62
1934-01-29,11.19,0.17,1.54,31.86,-64.88,True,1,1514,-11.19,-24333.07,16941.66,-7391.41
1934-01-30,11.33,0.14,1.25,31.86,-64.44,True,1,1515,-11.33,-24344.4,17164.95,-7179.45
1934-01-31,11.17,-0.16,-1.41,31.86,-64.94,True,1,1516,-11.17,-24355.57,16933.72,-7421.85
1934-02-01,11.46,0.29,2.6,31.86,-64.03,True,1,1517,-11.46,-24367.03,17384.82,-6982.21
1934-02-02,11.45,-0.01,-0.09,31.86,-64.06,True,1,1518,-11.45,-24378.48,17381.1,-6997.38
1934-02-05,11.81,0.36,3.14,31.86,-62.93,True,1,1519,-11.81,-24390.29,17939.39,-6450.9
1934-02-06,11.82,0.01,0.08,31.86,-62.9,True,1,1520,-11.82,-24402.11,17966.4,-6435.71
1934-02-07,11.45,-0.37,-3.13,31.86,-64.06,True,1,1521,-11.45,-24413.56,17415.45,-6998.11
1934-02-08,11.5,0.05,0.44,31.86,-63.9,True,1,1522,-11.5,-24425.06,17503.0,-6922.06
1934-02-09,11.18,-0.32,-2.78,31.86,-64.91,True,1,1523,-11.18,-24436.24,17027.14,-7409.1
1934-02-13,11.22,0.04,0.36,31.86,-64.78,True,1,1524,-11.22,-24447.46,17099.28,-7348.18
1934-02-14,11.29,0.07,0.62,31.86,-64.56,True,1,1525,-11.29,-24458.75,17217.25,-7241.5
1934-02-15,11.51,0.22,1.95,31.86,-63.87,True,1,1526,-11.51,-24470.26,17564.26,-6906.0
1934-02-16,11.54,0.03,0.26,31.86,-63.78,True,1,1527,-11.54,-24481.8,17621.58,-6860.22
1934-02-19,11.36,-0.18,-1.56,31.86,-64.34,True,1,1528,-11.36,-24493.16,17358.08,-7135.08
1934-02-20,11.4,0.04,0.35,31.86,-64.22,True,1,1529,-11.4,-24504.56,17430.6,-7073.96
1934-02-21,11.43,0.03,0.26,31.86,-64.12,True,1,1530,-11.43,-24515.99,17487.9,-7028.09
1934-02-23,11.13,-0.3,-2.62,31.86,-65.07,True,1,1531,-11.13,-24527.12,17040.03,-7487.09
1934-02-26,10.69,-0.44,-3.95,31.86,-66.45,True,1,1532,-10.69,-24537.81,16377.08,-8160.73
1934-02-27,10.81,0.12,1.12,31.86,-66.07,True,1,1533,-10.81,-24548.62,16571.73,-7976.89
1934-02-28,10.76,-0.05,-0.46,31.86,-66.23,True,1,1534,-10.76,-24559.38,16505.84,-8053.54
1934-03-01,10.72,-0.04,-0.37,31.86,-66.35,True,1,1535,-10.72,-24570.1,16455.2,-8114.9
1934-03-02,11.07,0.35,3.26,31.86,-65.25,True,1,1536,-11.07,-24581.17,17003.52,-7577.65
1934-03-05,11.01,-0.06,-0.54,31.86,-65.44,True,1,1537,-11.01,-24592.18,16922.37,-7669.81
1934-03-06,10.88,-0.13,-1.18,31.86,-65.85,True,1,1538,-10.88,-24603.06,16733.44,-7869.62
1934-03-07,10.6,-0.28,-2.57,31.86,-66.73,True,1,1539,-10.6,-24613.66,16313.4,-8300.26
1934-03-08,10.8,0.2,1.89,31.86,-66.1,True,1,1540,-10.8,-24624.46,16632.0,-7992.46
1934-03-09,10.73,-0.07,-0.65,31.86,-66.32,True,1,1541,-10.73,-24635.19,16534.93,-8100.26
1934-03-12,10.96,0.23,2.14,31.86,-65.6,True,1,1542,-10.96,-24646.15,16900.32,-7745.83
1934-03-13,10.96,0.0,0.0,31.86,-65.6,True,1,1543,-10.96,-24657.11,16911.28,-7745.83
1934-03-14,10.97,0.01,0.09,31.86,-65.57,True,1,1544,-10.97,-24668.08,16937.68,-7730.4
1934-03-15,10.79,-0.18,-1.64,31.86,-66.13,True,1,1545,-10.79,-24678.87,16670.55,-8008.32
1934-03-16,10.82,0.03,0.28,31.86,-66.04,True,1,1546,-10.82,-24689.69,16727.72,-7961.97
1934-03-19,10.45,-0.37,-3.42,31.86,-67.2,True,1,1547,-10.45,-24700.14,16166.15,-8533.99
1934-03-20,10.66,0.21,2.01,31.86,-66.54,True,1,1548,-10.66,-24710.8,16501.68,-8209.12
1934-03-21,10.45,-0.21,-1.97,31.86,-67.2,True,1,1549,-10.45,-24721.25,16187.05,-8534.2
1934-03-22,10.64,0.19,1.82,31.86,-66.6,True,1,1550,-10.64,-24731.89,16492.0,-8239.89
1934-03-23,10.53,-0.11,-1.03,31.86,-66.95,True,1,1551,-10.53,-24742.42,16332.03,-8410.39
1934-03-26,10.71,0.18,1.71,31.86,-66.38,True,1,1552,-10.71,-24753.13,16621.92,-8131.21
1934-03-27,10.42,-0.29,-2.71,31.86,-67.29,True,1,1553,-10.42,-24763.55,16182.26,-8581.29
1934-03-28,10.45,0.03,0.29,31.86,-67.2,True,1,1554,-10.45,-24774.0,16239.3,-8534.7
1934-03-29,10.62,0.17,1.63,31.86,-66.67,True,1,1555,-10.62,-24784.62,16514.1,-8270.52
1934-04-02,10.76,0.14,1.32,31.86,-66.23,True,1,1556,-10.76,-24795.38,16742.56,-8052.82
1934-04-03,10.84,0.08,0.74,31.86,-65.98,True,1,1557,-10.84,-24806.22,16877.88,-7928.34
1934-04-04,10.87,0.03,0.28,31.86,-65.88,True,1,1558,-10.87,-24817.09,16935.46,-7881.63
1934-04-05,10.9,0.03,0.28,31.86,-65.79,True,1,1559,-10.9,-24827.99,16993.1,-7834.89
1934-04-06,10.95,0.05,0.46,31.86,-65.63,True,1,1560,-10.95,-24838.94,17082.0,-7756.94
1934-04-09,10.87,-0.08,-0.73,31.86,-65.88,True,1,1561,-10.87,-24849.81,16968.07,-7881.74
1934-04-10,11.03,0.16,1.47,31.86,-65.38,True,1,1562,-11.03,-24860.84,17228.86,-7631.98
1934-04-11,11.02,-0.01,-0.09,31.86,-65.41,True,1,1563,-11.02,-24871.86,17224.26,-7647.6
1934-04-12,10.99,-0.03,-0.27,31.86,-65.5,True,1,1564,-10.99,-24882.85,17188.36,-7694.49
1934-04-13,10.95,-0.04,-0.36,31.86,-65.63,True,1,1565,-10.95,-24893.8,17136.75,-7757.05
1934-04-16,10.78,-0.17,-1.55,31.86,-66.16,True,1,1566,-10.78,-24904.58,16881.48,-8023.1
1934-04-17,10.89,0.11,1.02,31.86,-65.82,True,1,1567,-10.89,-24915.47,17064.63,-7850.84
1934-04-18,11.03,0.14,1.29,31.86,-65.38,True,1,1568,-11.03,-24926.5,17295.04,-7631.46
1934-04-19,11.05,0.02,0.18,31.86,-65.32,True,1,1569,-11.05,-24937.55,17337.45,-7600.1
1934-04-20,11.16,0.11,1.0,31.86,-64.97,True,1,1570,-11.16,-24948.71,17521.2,-7427.51
1934-04-23,11.09,-0.07,-0.63,31.86,-65.19,True,1,1571,-11.09,-24959.8,17422.39,-7537.41
1934-04-24,11.0,-0.09,-0.81,31.86,-65.47,True,1,1572,-11.0,-24970.8,17292.0,-7678.8
1934-04-25,10.94,-0.06,-0.55,31.86,-65.66,True,1,1573,-10.94,-24981.74,17208.62,-7773.12
1934-04-26,10.79,-0.15,-1.37,31.86,-66.13,True,1,1574,-10.79,-24992.53,16983.46,-8009.07
1934-04-27,10.8,0.01,0.09,31.86,-66.1,True,1,1575,-10.8,-25003.33,17010.0,-7993.33
1934-04-30,10.46,-0.34,-3.15,31.86,-67.17,True,1,1576,-10.46,-25013.79,16484.96,-8528.83
1934-05-01,10.46,0.0,0.0,31.86,-67.17,True,1,1577,-10.46,-25024.25,16495.42,-8528.83
1934-05-02,10.25,-0.21,-2.01,31.86,-67.83,True,1,1578,-10.25,-25034.5,16174.5,-8860.0
1934-05-03,10.29,0.04,0.39,31.86,-67.7,True,1,1579,-10.29,-25044.79,16247.91,-8796.88
1934-05-04,10.32,0.03,0.29,31.86,-67.61,True,1,1580,-10.32,-25055.11,16305.6,-8749.51
1934-05-07,9.81,-0.51,-4.94,31.86,-69.21,True,1,1581,-9.81,-25064.92,15509.61,-9555.31
1934-05-08,10.05,0.24,2.45,31.86,-68.46,True,1,1582,-10.05,-25074.97,15899.1,-9175.87
1934-05-09,9.88,-0.17,-1.69,31.86,-68.99,True,1,1583,-9.88,-25084.85,15640.04,-9444.81
1934-05-10,9.65,-0.23,-2.33,31.86,-69.71,True,1,1584,-9.65,-25094.5,15285.6,-9808.9
1934-05-11,9.55,-0.1,-1.04,31.86,-70.03,True,1,1585,-9.55,-25104.05,15136.75,-9967.3
1934-05-14,9.45,-0.1,-1.05,31.86,-70.34,True,1,1586,-9.45,-25113.5,14987.7,-10125.8
1934-05-15,9.63,0.18,1.9,31.86,-69.77,True,1,1587,-9.63,-25123.13,15282.81,-9840.32
1934-05-16,9.56,-0.07,-0.73,31.86,-69.99,True,1,1588,-9.56,-25132.69,15181.28,-9951.41
1934-05-17,9.59,0.03,0.31,31.86,-69.9,True,1,1589,-9.59,-25142.28,15238.51,-9903.77
1934-05-18,9.85,0.26,2.71,31.86,-69.08,True,1,1590,-9.85,-25152.13,15661.5,-9490.63
1934-05-21,9.87,0.02,0.2,31.86,-69.02,True,1,1591,-9.87,-25162.0,15703.17,-9458.83
1934-05-22,9.65,-0.22,-2.23,31.86,-69.71,True,1,1592,-9.65,-25171.65,15362.8,-9808.85
1934-05-23,9.56,-0.09,-0.93,31.86,-69.99,True,1,1593,-9.56,-25181.21,15229.08,-9952.13
1934-05-24,9.59,0.03,0.31,31.86,-69.9,True,1,1594,-9.59,-25190.8,15286.46,-9904.34
1934-05-25,9.7,0.11,1.15,31.86,-69.55,True,1,1595,-9.7,-25200.5,15471.5,-9729.0
1934-05-28,9.83,0.13,1.34,31.86,-69.15,True,1,1596,-9.83,-25210.33,15688.68,-9521.65
1934-05-29,9.79,-0.04,-0.41,31.86,-69.27,True,1,1597,-9.79,-25220.12,15634.63,-9585.49
1934-05-31,9.61,-0.18,-1.84,31.86,-69.84,True,1,1598,-9.61,-25229.73,15356.78,-9872.95
1934-06-01,9.38,-0.23,-2.39,31.86,-70.56,True,1,1599,-9.38,-25239.11,14998.62,-10240.49
1934-06-04,9.49,0.11,1.17,31.86,-70.21,True,1,1600,-9.49,-25248.6,15184.0,-10064.6
1934-06-05,9.72,0.23,2.42,31.86,-69.49,True,1,1601,-9.72,-25258.32,15561.72,-9696.6
1934-06-06,9.74,0.02,0.21,31.86,-69.43,True,1,1602,-9.74,-25268.06,15603.48,-9664.58
1934-06-07,9.71,-0.03,-0.31,31.86,-69.52,True,1,1603,-9.71,-25277.77,15565.13,-9712.64
1934-06-08,10.17,0.46,4.74,31.86,-68.08,True,1,1604,-10.17,-25287.94,16312.68,-8975.26
1934-06-11,10.09,-0.08,-0.79,31.86,-68.33,True,1,1605,-10.09,-25298.03,16194.45,-9103.58
1934-06-12,10.2,0.11,1.09,31.86,-67.98,True,1,1606,-10.2,-25308.23,16381.2,-8927.03
1934-06-13,10.2,0.0,0.0,31.86,-67.98,True,1,1607,-10.2,-25318.43,16391.4,-8927.03
1934-06-14,10.05,-0.15,-1.47,31.86,-68.46,True,1,1608,-10.05,-25328.48,16160.4,-9168.08
1934-06-15,10.23,0.18,1.79,31.86,-67.89,True,1,1609,-10.23,-25338.71,16460.07,-8878.64
1934-06-18,10.37,0.14,1.37,31.86,-67.45,True,1,1610,-10.37,-25349.08,16695.7,-8653.38
1934-06-19,10.19,-0.18,-1.74,31.86,-68.02,True,1,1611,-10.19,-25359.27,16416.09,-8943.18
1934-06-20,10.08,-0.11,-1.08,31.86,-68.36,True,1,1612,-10.08,-25369.35,16248.96,-9120.39
1934-06-21,9.98,-0.1,-0.99,31.86,-68.68,True,1,1613,-9.98,-25379.33,16097.74,-9281.59
1934-06-22,9.76,-0.22,-2.2,31.86,-69.37,True,1,1614,-9.76,-25389.09,15752.64,-9636.45
1934-06-25,9.73,-0.03,-0.31,31.86,-69.46,True,1,1615,-9.73,-25398.82,15713.95,-9684.87
1934-06-26,9.96,0.23,2.36,31.86,-68.74,True,1,1616,-9.96,-25408.78,16095.36,-9313.42
1934-06-27,9.93,-0.03,-0.3,31.86,-68.83,True,1,1617,-9.93,-25418.71,16056.81,-9361.9
1934-06-28,9.98,0.05,0.5,31.86,-68.68,True,1,1618,-9.98,-25428.69,16147.64,-9281.05
1934-06-29,9.81,-0.17,-1.7,31.86,-69.21,True,1,1619,-9.81,-25438.5,15882.39,-9556.11
1934-07-02,9.69,-0.12,-1.22,31.86,-69.59,True,1,1620,-9.69,-25448.19,15697.8,-9750.39
1934-07-03,9.66,-0.03,-0.31,31.86,-69.68,True,1,1621,-9.66,-25457.85,15658.86,-9798.99
1934-07-05,9.82,0.16,1.66,31.86,-69.18,True,1,1622,-9.82,-25467.67,15928.04,-9539.63
1934-07-06,9.91,0.09,0.92,31.86,-68.9,True,1,1623,-9.91,-25477.58,16083.93,-9393.65
1934-07-09,9.88,-0.03,-0.3,31.86,-68.99,True,1,1624,-9.88,-25487.46,16045.12,-9442.34
1934-07-10,9.94,0.06,0.61,31.86,-68.8,True,1,1625,-9.94,-25497.4,16152.5,-9344.9
1934-07-11,9.99,0.05,0.5,31.86,-68.64,True,1,1626,-9.99,-25507.39,16243.74,-9263.65
1934-07-12,9.91,-0.08,-0.8,31.86,-68.9,True,1,1627,-9.91,-25517.3,16123.57,-9393.73
1934-07-13,9.93,0.02,0.2,31.86,-68.83,True,1,1628,-9.93,-25527.23,16166.04,-9361.19
1934-07-16,9.72,-0.21,-2.12,31.86,-69.49,True,1,1629,-9.72,-25536.95,15833.88,-9703.07
1934-07-17,9.68,-0.04,-0.41,31.86,-69.62,True,1,1630,-9.68,-25546.63,15778.4,-9768.23
1934-07-18,9.84,0.16,1.65,31.86,-69.11,True,1,1631,-9.84,-25556.47,16049.04,-9507.43
1934-07-19,9.74,-0.1,-1.02,31.86,-69.43,True,1,1632,-9.74,-25566.21,15895.68,-9670.53
1934-07-20,9.47,-0.27,-2.77,31.86,-70.28,True,1,1633,-9.47,-25575.68,15464.51,-10111.17
1934-07-23,9.09,-0.38,-4.01,31.86,-71.47,True,1,1634,-9.09,-25584.77,14853.06,-10731.71
1934-07-24,8.99,-0.1,-1.1,31.86,-71.78,True,1,1635,-8.99,-25593.76,14698.65,-10895.11
1934-07-25,9.07,0.08,0.89,31.86,-71.53,True,1,1636,-9.07,-25602.83,14838.52,-10764.31
1934-07-26,8.36,-0.71,-7.83,31.86,-73.76,True,1,1637,-8.36,-25611.19,13685.32,-11925.87
1934-07-27,8.6,0.24,2.87,31.86,-73.01,True,1,1638,-8.6,-25619.79,14086.8,-11532.99
1934-07-30,8.67,0.07,0.81,31.86,-72.79,True,1,1639,-8.67,-25628.46,14210.13,-11418.33
1934-07-31,8.68,0.01,0.12,31.86,-72.76,True,1,1640,-8.68,-25637.14,14235.2,-11401.94
1934-08-01,8.95,0.27,3.11,31.86,-71.91,True,1,1641,-8.95,-25646.09,14686.95,-10959.14
1934-08-02,9.01,0.06,0.67,31.86,-71.72,True,1,1642,-9.01,-25655.1,14794.42,-10860.68
1934-08-03,8.9,-0.11,-1.22,31.86,-72.06,True,1,1643,-8.9,-25664.0,14622.7,-11041.3
1934-08-06,8.71,-0.19,-2.13,31.86,-72.66,True,1,1644,-8.71,-25672.71,14319.24,-11353.47
1934-08-07,8.69,-0.02,-0.23,31.86,-72.72,True,1,1645,-8.69,-25681.4,14295.05,-11386.35
1934-08-08,8.83,0.14,1.61,31.86,-72.28,True,1,1646,-8.83,-25690.23,14534.18,-11156.05
1934-08-09,9.13,0.3,3.4,31.86,-71.34,True,1,1647,-9.13,-25699.36,15037.11,-10662.25
1934-08-10,8.93,-0.2,-2.19,31.86,-71.97,True,1,1648,-8.93,-25708.29,14716.64,-10991.65
1934-08-13,9.17,0.24,2.69,31.86,-71.22,True,1,1649,-9.17,-25717.46,15121.33,-10596.13
1934-08-14,9.1,-0.07,-0.76,31.86,-71.44,True,1,1650,-9.1,-25726.56,15015.0,-10711.56
1934-08-15,9.04,-0.06,-0.66,31.86,-71.63,True,1,1651,-9.04,-25735.6,14925.04,-10810.56
1934-08-16,9.11,0.07,0.77,31.86,-71.41,True,1,1652,-9.11,-25744.71,15049.72,-10694.99
1934-08-17,9.06,-0.05,-0.55,31.86,-71.56,True,1,1653,-9.06,-25753.77,14976.18,-10777.59
1934-08-20,8.97,-0.09,-0.99,31.86,-71.85,True,1,1654,-8.97,-25762.74,14836.38,-10926.36
1934-08-21,9.19,0.22,2.45,31.86,-71.16,True,1,1655,-9.19,-25771.93,15209.45,-10562.48
1934-08-22,9.4,0.21,2.28,31.86,-70.5,True,1,1656,-9.4,-25781.33,15566.4,-10214.93
1934-08-23,9.35,-0.05,-0.53,31.86,-70.65,True,1,1657,-9.35,-25790.68,15492.95,-10297.73
1934-08-24,9.52,0.17,1.82,31.86,-70.12,True,1,1658,-9.52,-25800.2,15784.16,-10016.04
1934-08-27,9.39,-0.13,-1.37,31.86,-70.53,True,1,1659,-9.39,-25809.59,15578.01,-10231.58
1934-08-28,9.34,-0.05,-0.53,31.86,-70.68,True,1,1660,-9.34,-25818.93,15504.4,-10314.53
1934-08-29,9.26,-0.08,-0.86,31.86,-70.94,True,1,1661,-9.26,-25828.19,15380.86,-10447.33
1934-08-30,9.16,-0.1,-1.08,31.86,-71.25,True,1,1662,-9.16,-25837.35,15223.92,-10613.43
1934-08-31,9.15,-0.01,-0.11,31.86,-71.28,True,1,1663,-9.15,-25846.5,15216.45,-10630.05
1934-09-04,9.06,-0.09,-0.98,31.86,-71.56,True,1,1664,-9.06,-25855.56,15075.84,-10779.72
1934-09-05,9.21,0.15,1.66,31.86,-71.09,True,1,1665,-9.21,-25864.77,15334.65,-10530.12
1934-09-06,9.02,-0.19,-2.06,31.86,-71.69,True,1,1666,-9.02,-25873.79,15027.32,-10846.47
1934-09-07,8.92,-0.1,-1.11,31.86,-72.0,True,1,1667,-8.92,-25882.71,14869.64,-11013.07
1934-09-10,8.7,-0.22,-2.47,31.86,-72.69,True,1,1668,-8.7,-25891.41,14511.6,-11379.81
1934-09-11,8.72,0.02,0.23,31.86,-72.63,True,1,1669,-8.72,-25900.13,14553.68,-11346.45
1934-09-12,8.75,0.03,0.34,31.86,-72.54,True,1,1670,-8.75,-25908.88,14612.5,-11296.38
1934-09-13,8.72,-0.03,-0.34,31.86,-72.63,True,1,1671,-8.72,-25917.6,14571.12,-11346.48
1934-09-14,8.47,-0.25,-2.87,31.86,-73.42,True,1,1672,-8.47,-25926.07,14161.84,-11764.23
1934-09-17,8.45,-0.02,-0.24,31.86,-73.48,True,1,1673,-8.45,-25934.52,14136.85,-11797.67
1934-09-18,8.52,0.07,0.83,31.86,-73.26,True,1,1674,-8.52,-25943.04,14262.48,-11680.56
1934-09-19,8.74,0.22,2.58,31.86,-72.57,True,1,1675,-8.74,-25951.78,14639.5,-11312.28
1934-09-20,8.77,0.03,0.34,31.86,-72.47,True,1,1676,-8.77,-25960.55,14698.52,-11262.03
1934-09-21,8.95,0.18,2.05,31.86,-71.91,True,1,1677,-8.95,-25969.5,15009.15,-10960.35
1934-09-24,8.9,-0.05,-0.56,31.86,-72.06,True,1,1678,-8.9,-25978.4,14934.2,-11044.2
1934-09-25,9.15,0.25,2.81,31.86,-71.28,True,1,1679,-9.15,-25987.55,15362.85,-10624.7
1934-09-26,9.09,-0.06,-0.66,31.86,-71.47,True,1,1680,-9.09,-25996.64,15271.2,-10725.44
1934-09-27,9.18,0.09,0.99,31.86,-71.19,True,1,1681,-9.18,-26005.82,15431.58,-10574.24
1934-09-28,9.08,-0.1,-1.09,31.86,-71.5,True,1,1682,-9.08,-26014.9,15272.56,-10742.34
1934-10-01,8.83,-0.25,-2.75,31.86,-72.28,True,1,1683,-8.83,-26023.73,14860.89,-11162.84
1934-10-02,8.86,0.03,0.34,31.86,-72.19,True,1,1684,-8.86,-26032.59,14920.24,-11112.35
1934-10-03,8.83,-0.03,-0.34,31.86,-72.28,True,1,1685,-8.83,-26041.42,14878.55,-11162.87
1934-10-04,8.82,-0.01,-0.11,31.86,-72.32,True,1,1686,-8.82,-26050.24,14870.52,-11179.72
1934-10-05,9.0,0.18,2.04,31.86,-71.75,True,1,1687,-9.0,-26059.24,15183.0,-10876.24
1934-10-08,8.92,-0.08,-0.89,31.86,-72.0,True,1,1688,-8.92,-26068.16,15056.96,-11011.2
1934-10-09,8.83,-0.09,-1.01,31.86,-72.28,True,1,1689,-8.83,-26076.99,14913.87,-11163.12
1934-10-10,9.07,0.24,2.72,31.86,-71.53,True,1,1690,-9.07,-26086.06,15328.3,-10757.76
1934-10-11,9.19,0.12,1.32,31.86,-71.16,True,1,1691,-9.19,-26095.25,15540.29,-10554.96
1934-10-15,9.0,-0.19,-2.07,31.86,-71.75,True,1,1692,-9.0,-26104.25,15228.0,-10876.25
1934-10-16,9.09,0.09,1.0,31.86,-71.47,True,1,1693,-9.09,-26113.34,15389.37,-10723.97
1934-10-17,9.11,0.02,0.22,31.86,-71.41,True,1,1694,-9.11,-26122.45,15432.34,-10690.11
1934-10-18,9.07,-0.04,-0.44,31.86,-71.53,True,1,1695,-9.07,-26131.52,15373.65,-10757.87
1934-10-19,9.03,-0.04,-0.44,31.86,-71.66,True,1,1696,-9.03,-26140.55,15314.88,-10825.67
1934-10-22,9.02,-0.01,-0.11,31.86,-71.69,True,1,1697,-9.02,-26149.57,15306.94,-10842.63
1934-10-23,8.99,-0.03,-0.33,31.86,-71.78,True,1,1698,-8.99,-26158.56,15265.02,-10893.54
1934-10-24,9.14,0.15,1.67,31.86,-71.31,True,1,1699,-9.14,-26167.7,15528.86,-10638.84
1934-10-25,8.93,-0.21,-2.3,31.86,-71.97,True,1,1700,-8.93,-26176.63,15181.0,-10995.63
1934-10-26,8.8,-0.13,-1.46,31.86,-72.38,True,1,1701,-8.8,-26185.43,14968.8,-11216.63
1934-10-29,8.76,-0.04,-0.46,31.86,-72.5,True,1,1702,-8.76,-26194.19,14909.52,-11284.67
1934-10-30,8.79,0.03,0.34,31.86,-72.41,True,1,1703,-8.79,-26202.98,14969.37,-11233.61
1934-10-31,8.81,0.02,0.23,31.86,-72.35,True,1,1704,-8.81,-26211.79,15012.24,-11199.55
1934-11-01,8.77,-0.04,-0.45,31.86,-72.47,True,1,1705,-8.77,-26220.56,14952.85,-11267.71
1934-11-02,8.87,0.1,1.14,31.86,-72.16,True,1,1706,-8.87,-26229.43,15132.22,-11097.21
1934-11-05,9.02,0.15,1.69,31.86,-71.69,True,1,1707,-9.02,-26238.45,15397.14,-10841.31
1934-11-07,9.19,0.17,1.88,31.86,-71.16,True,1,1708,-9.19,-26247.64,15696.52,-10551.12
1934-11-08,9.12,-0.07,-0.76,31.86,-71.38,True,1,1709,-9.12,-26256.76,15586.08,-10670.68
1934-11-09,9.3,0.18,1.97,31.86,-70.81,True,1,1710,-9.3,-26266.06,15903.0,-10363.06
1934-11-13,9.23,-0.07,-0.75,31.86,-71.03,True,1,1711,-9.23,-26275.29,15792.53,-10482.76
1934-11-14,9.2,-0.03,-0.32,31.86,-71.12,True,1,1712,-9.2,-26284.49,15750.4,-10534.09
1934-11-15,9.0,-0.2,-2.17,31.86,-71.75,True,1,1713,-9.0,-26293.49,15417.0,-10876.49
1934-11-16,9.18,0.18,2.0,31.86,-71.19,True,1,1714,-9.18,-26302.67,15734.52,-10568.15
1934-11-19,9.1,-0.08,-0.87,31.86,-71.44,True,1,1715,-9.1,-26311.77,15606.5,-10705.27
1934-11-20,9.14,0.04,0.44,31.86,-71.31,True,1,1716,-9.14,-26320.91,15684.24,-10636.67
1934-11-21,9.1,-0.04,-0.44,31.86,-71.44,True,1,1717,-9.1,-26330.01,15624.7,-10705.31
1934-11-22,9.14,0.04,0.44,31.86,-71.31,True,1,1718,-9.14,-26339.15,15702.52,-10636.63
1934-11-23,9.27,0.13,1.42,31.86,-70.9,True,1,1719,-9.27,-26348.42,15935.13,-10413.29
1934-11-26,9.52,0.25,2.7,31.86,-70.12,True,1,1720,-9.52,-26357.94,16374.4,-9983.54
1934-11-27,9.43,-0.09,-0.94,31.86,-70.4,True,1,1721,-9.43,-26367.37,16229.03,-10138.34
1934-11-28,9.54,0.11,1.17,31.86,-70.06,True,1,1722,-9.54,-26376.91,16427.88,-9949.03
1934-11-30,9.54,0.0,0.0,31.86,-70.06,True,1,1723,-9.54,-26386.45,16437.42,-9949.03
1934-12-03,9.41,-0.13,-1.36,31.86,-70.46,True,1,1724,-9.41,-26395.86,16222.84,-10173.02
1934-12-04,9.48,0.07,0.74,31.86,-70.24,True,1,1725,-9.48,-26405.34,16353.0,-10052.34
1934-12-05,9.56,0.08,0.84,31.86,-69.99,True,1,1726,-9.56,-26414.9,16500.56,-9914.34
1934-12-06,9.54,-0.02,-0.21,31.86,-70.06,True,1,1727,-9.54,-26424.44,16475.58,-9948.86
1934-12-07,9.46,-0.08,-0.84,31.86,-70.31,True,1,1728,-9.46,-26433.9,16346.88,-10087.02
1934-12-10,9.36,-0.1,-1.06,31.86,-70.62,True,1,1729,-9.36,-26443.26,16183.44,-10259.82
1934-12-11,9.17,-0.19,-2.03,31.86,-71.22,True,1,1730,-9.17,-26452.43,15864.1,-10588.33
1934-12-12,9.18,0.01,0.11,31.86,-71.19,True,1,1731,-9.18,-26461.61,15890.58,-10571.03
1934-12-13,9.13,-0.05,-0.55,31.86,-71.34,True,1,1732,-9.13,-26470.74,15813.16,-10657.58
1934-12-14,9.11,-0.02,-0.22,31.86,-71.41,True,1,1733,-9.11,-26479.85,15787.63,-10692.22
1934-12-17,9.17,0.06,0.66,31.86,-71.22,True,1,1734,-9.17,-26489.02,15900.78,-10588.24
1934-12-18,9.16,-0.01,-0.11,31.86,-71.25,True,1,1735,-9.16,-26498.18,15892.6,-10605.58
1934-12-19,9.03,-0.13,-1.42,31.86,-71.66,True,1,1736,-9.03,-26507.21,15676.08,-10831.13
1934-12-20,9.02,-0.01,-0.11,31.86,-71.69,True,1,1737,-9.02,-26516.23,15667.74,-10848.49
1934-12-21,9.04,0.02,0.22,31.86,-71.63,True,1,1738,-9.04,-26525.27,15711.52,-10813.75
1934-12-24,9.11,0.07,0.77,31.86,-71.41,True,1,1739,-9.11,-26534.38,15842.29,-10692.09
1934-12-26,9.06,-0.05,-0.55,31.86,-71.56,True,1,1740,-9.06,-26543.44,15764.4,-10779.04
1934-12-27,9.07,0.01,0.11,31.86,-71.53,True,1,1741,-9.07,-26552.51,15790.87,-10761.64
1934-12-28,9.41,0.34,3.75,31.86,-70.46,True,1,1742,-9.41,-26561.92,16392.22,-10169.7
1934-12-31,9.5,0.09,0.96,31.86,-70.18,True,1,1743,-9.5,-26571.42,16558.5,-10012.92
1935-01-02,9.51,0.01,0.1,31.86,-70.15,True,1,1744,-9.51,-26580.93,16585.44,-9995.49
1935-01-03,9.53,0.02,0.21,31.86,-70.09,True,1,1745,-9.53,-26590.46,16629.85,-9960.61
1935-01-04,9.51,-0.02,-0.21,31.86,-70.15,True,1,1746,-9.51,-26599.97,16604.46,-9995.51
1935-01-07,9.58,0.07,0.74,31.86,-69.93,True,1,1747,-9.58,-26609.55,16736.26,-9873.29
1935-01-08,9.47,-0.11,-1.15,31.86,-70.28,True,1,1748,-9.47,-26619.02,16553.56,-10065.46
1935-01-09,9.46,-0.01,-0.11,31.86,-70.31,True,1,1749,-9.46,-26628.48,16545.54,-10082.94
1935-01-10,9.44,-0.02,-0.21,31.86,-70.37,True,1,1750,-9.44,-26637.92,16520.0,-10117.92
1935-01-11,9.25,-0.19,-2.01,31.86,-70.97,True,1,1751,-9.25,-26647.17,16196.75,-10450.42
1935-01-14,9.17,-0.08,-0.86,31.86,-71.22,True,1,1752,-9.17,-26656.34,16065.84,-10590.5
1935-01-15,8.96,-0.21,-2.29,31.86,-71.88,True,1,1753,-8.96,-26665.3,15706.88,-10958.42
1935-01-16,9.0,0.04,0.45,31.86,-71.75,True,1,1754,-9.0,-26674.3,15786.0,-10888.3
1935-01-17,9.14,0.14,1.56,31.86,-71.31,True,1,1755,-9.14,-26683.44,16040.7,-10642.74
1935-01-18,9.18,0.04,0.44,31.86,-71.19,True,1,1756,-9.18,-26692.62,16120.08,-10572.54
1935-01-21,9.28,0.1,1.09,31.86,-70.87,True,1,1757,-9.28,-26701.9,16304.96,-10396.94
1935-01-22,9.2,-0.08,-0.86,31.86,-71.12,True,1,1758,-9.2,-26711.1,16173.6,-10537.5
1935-01-23,9.2,0.0,0.0,31.86,-71.12,True,1,1759,-9.2,-26720.3,16182.8,-10537.5
1935-01-24,9.18,-0.02,-0.22,31.86,-71.19,True,1,1760,-9.18,-26729.48,16156.8,-10572.68
1935-01-25,9.23,0.05,0.55,31.86,-71.03,True,1,1761,-9.23,-26738.71,16254.03,-10484.68
1935-01-28,9.07,-0.16,-1.73,31.86,-71.53,True,1,1762,-9.07,-26747.78,15981.34,-10766.44
1935-01-29,8.98,-0.09,-0.99,31.86,-71.81,True,1,1763,-8.98,-26756.76,15831.74,-10925.02
1935-01-30,9.03,0.05,0.56,31.86,-71.66,True,1,1764,-9.03,-26765.79,15928.92,-10836.87
1935-01-31,9.1,0.07,0.78,31.86,-71.44,True,1,1765,-9.1,-26774.89,16061.5,-10713.39
1935-02-01,9.05,-0.05,-0.55,31.86,-71.59,True,1,1766,-9.05,-26783.94,15982.3,-10801.64
1935-02-04,8.99,-0.06,-0.66,31.86,-71.78,True,1,1767,-8.99,-26792.93,15885.33,-10907.6
1935-02-05,8.89,-0.1,-1.11,31.86,-72.1,True,1,1768,-8.89,-26801.82,15717.52,-11084.3
1935-02-06,8.81,-0.08,-0.9,31.86,-72.35,True,1,1769,-8.81,-26810.63,15584.89,-11225.74
1935-02-07,8.88,0.07,0.8,31.86,-72.13,True,1,1770,-8.88,-26819.51,15717.6,-11101.91
1935-02-08,9.03,0.15,1.69,31.86,-71.66,True,1,1771,-9.03,-26828.54,15992.13,-10836.41
1935-02-11,9.02,-0.01,-0.11,31.86,-71.69,True,1,1772,-9.02,-26837.56,15983.44,-10854.12
1935-02-13,9.01,-0.01,-0.11,31.86,-71.72,True,1,1773,-9.01,-26846.57,15974.73,-10871.84
1935-02-14,9.01,0.0,0.0,31.86,-71.72,True,1,1774,-9.01,-26855.58,15983.74,-10871.84
1935-02-15,9.06,0.05,0.56,31.86,-71.56,True,1,1775,-9.06,-26864.64,16081.5,-10783.14
1935-02-18,9.34,0.28,3.09,31.86,-70.68,True,1,1776,-9.34,-26873.98,16587.84,-10286.14
1935-02-19,9.19,-0.15,-1.61,31.86,-71.16,True,1,1777,-9.19,-26883.17,16330.63,-10552.54
1935-02-20,9.04,-0.15,-1.63,31.86,-71.63,True,1,1778,-9.04,-26892.21,16073.12,-10819.09
1935-02-21,9.03,-0.01,-0.11,31.86,-71.66,True,1,1779,-9.03,-26901.24,16064.37,-10836.87
1935-02-25,8.85,-0.18,-1.99,31.86,-72.22,True,1,1780,-8.85,-26910.09,15753.0,-11157.09
1935-02-26,8.76,-0.09,-1.02,31.86,-72.5,True,1,1781,-8.76,-26918.85,15601.56,-11317.29
1935-02-27,8.79,0.03,0.34,31.86,-72.41,True,1,1782,-8.79,-26927.64,15663.78,-11263.86
1935-02-28,8.74,-0.05,-0.57,31.86,-72.57,True,1,1783,-8.74,-26936.38,15583.42,-11352.96
1935-03-01,8.79,0.05,0.57,31.86,-72.41,True,1,1784,-8.79,-26945.17,15681.36,-11263.81
1935-03-04,8.72,-0.07,-0.8,31.86,-72.63,True,1,1785,-8.72,-26953.89,15565.2,-11388.69
1935-03-05,8.47,-0.25,-2.87,31.86,-73.42,True,1,1786,-8.47,-26962.36,15127.42,-11834.94
1935-03-06,8.45,-0.02,-0.24,31.86,-73.48,True,1,1787,-8.45,-26970.81,15100.15,-11870.66
1935-03-07,8.56,0.11,1.3,31.86,-73.13,True,1,1788,-8.56,-26979.37,15305.28,-11674.09
1935-03-08,8.54,-0.02,-0.23,31.86,-73.19,True,1,1789,-8.54,-26987.91,15278.06,-11709.85
1935-03-11,8.32,-0.22,-2.58,31.86,-73.89,True,1,1790,-8.32,-26996.23,14892.8,-12103.43
1935-03-12,8.16,-0.16,-1.92,31.86,-74.39,True,1,1791,-8.16,-27004.39,14614.56,-12389.83
1935-03-13,8.19,0.03,0.37,31.86,-74.29,True,1,1792,-8.19,-27012.58,14676.48,-12336.1
1935-03-14,8.06,-0.13,-1.59,31.86,-74.7,True,1,1793,-8.06,-27020.64,14451.58,-12569.06
1935-03-15,8.23,0.17,2.11,31.86,-74.17,True,1,1794,-8.23,-27028.87,14764.62,-12264.25
1935-03-18,8.14,-0.09,-1.09,31.86,-74.45,True,1,1795,-8.14,-27037.01,14611.3,-12425.71
1935-03-19,8.26,0.12,1.47,31.86,-74.07,True,1,1796,-8.26,-27045.27,14834.96,-12210.31
1935-03-20,8.25,-0.01,-0.12,31.86,-74.1,True,1,1797,-8.25,-27053.52,14825.25,-12228.27
1935-03-21,8.42,0.17,2.06,31.86,-73.57,True,1,1798,-8.42,-27061.94,15139.16,-11922.78
1935-03-22,8.55,0.13,1.54,31.86,-73.16,True,1,1799,-8.55,-27070.49,15381.45,-11689.04
1935-03-25,8.42,-0.13,-1.52,31.86,-73.57,True,1,1800,-8.42,-27078.91,15156.0,-11922.91
1935-03-26,8.35,-0.07,-0.83,31.86,-73.79,True,1,1801,-8.35,-27087.26,15038.35,-12048.91
1935-03-27,8.44,0.09,1.08,31.86,-73.51,True,1,1802,-8.44,-27095.7,15208.88,-11886.82
1935-03-28,8.45,0.01,0.12,31.86,-73.48,True,1,1803,-8.45,-27104.15,15235.35,-11868.8
1935-03-29,8.45,0.0,0.0,31.86,-73.48,True,1,1804,-8.45,-27112.6,15243.8,-11868.8
1935-04-01,8.54,0.09,1.06,31.86,-73.19,True,1,1805,-8.54,-27121.14,15414.7,-11706.44
1935-04-02,8.5,-0.04,-0.47,31.86,-73.32,True,1,1806,-8.5,-27129.64,15351.0,-11778.64
1935-04-03,8.48,-0.02,-0.24,31.86,-73.38,True,1,1807,-8.48,-27138.12,15323.36,-11814.76
1935-04-04,8.57,0.09,1.06,31.86,-73.1,True,1,1808,-8.57,-27146.69,15494.56,-11652.13
1935-04-05,8.78,0.21,2.45,31.86,-72.44,True,1,1809,-8.78,-27155.47,15883.02,-11272.45
1935-04-08,8.78,0.0,0.0,31.86,-72.44,True,1,1810,-8.78,-27164.25,15891.8,-11272.45
1935-04-09,8.94,0.16,1.82,31.86,-71.94,True,1,1811,-8.94,-27173.19,16190.34,-10982.85
1935-04-10,8.9,-0.04,-0.45,31.86,-72.06,True,1,1812,-8.9,-27182.09,16126.8,-11055.29
1935-04-11,8.85,-0.05,-0.56,31.86,-72.22,True,1,1813,-8.85,-27190.94,16045.05,-11145.89
1935-04-12,8.95,0.1,1.13,31.86,-71.91,True,1,1814,-8.95,-27199.89,16235.3,-10964.59
1935-04-15,9.13,0.18,2.01,31.86,-71.34,True,1,1815,-9.13,-27209.02,16570.95,-10638.07
1935-04-16,8.22,-0.91,-9.97,31.86,-74.2,True,1,1816,-8.22,-27217.24,14927.52,-12289.72
1935-04-17,9.01,0.79,9.61,31.86,-71.72,True,1,1817,-9.01,-27226.25,16371.17,-10855.08
1935-04-18,9.14,0.13,1.44,31.86,-71.31,True,1,1818,-9.14,-27235.39,16616.52,-10618.87
1935-04-22,9.41,0.27,2.95,31.86,-70.46,True,1,1819,-9.41,-27244.8,17116.79,-10128.01
1935-04-23,9.44,0.03,0.32,31.86,-70.37,True,1,1820,-9.44,-27254.24,17180.8,-10073.44
1935-04-24,9.32,-0.12,-1.27,31.86,-70.75,True,1,1821,-9.32,-27263.56,16971.72,-10291.84
1935-04-25,9.44,0.12,1.29,31.86,-70.37,True,1,1822,-9.44,-27273.0,17199.68,-10073.32
1935-04-26,9.4,-0.04,-0.42,31.86,-70.5,True,1,1823,-9.4,-27282.4,17136.2,-10146.2
1935-04-29,9.39,-0.01,-0.11,31.86,-70.53,True,1,1824,-9.39,-27291.79,17127.36,-10164.43
1935-04-30,9.28,-0.11,-1.17,31.86,-70.87,True,1,1825,-9.28,-27301.07,16936.0,-10365.07
1935-05-01,9.23,-0.05,-0.54,31.86,-71.03,True,1,1826,-9.23,-27310.3,16853.98,-10456.32
1935-05-02,9.27,0.04,0.43,31.86,-70.9,True,1,1827,-9.27,-27319.57,16936.29,-10383.28
1935-05-03,9.42,0.15,1.62,31.86,-70.43,True,1,1828,-9.42,-27328.99,17219.76,-10109.23
1935-05-06,9.42,0.0,0.0,31.86,-70.43,True,1,1829,-9.42,-27338.41,17229.18,-10109.23
1935-05-07,9.38,-0.04,-0.42,31.86,-70.56,True,1,1830,-9.38,-27347.79,17165.4,-10182.39
1935-05-08,9.65,0.27,2.88,31.86,-69.71,True,1,1831,-9.65,-27357.44,17669.15,-9688.29
1935-05-09,9.69,0.04,0.42,31.86,-69.59,True,1,1832,-9.69,-27367.13,17752.08,-9615.05
1935-05-10,9.75,0.06,0.62,31.86,-69.4,True,1,1833,-9.75,-27376.88,17871.75,-9505.13
1935-05-13,9.8,0.05,0.51,31.86,-69.24,True,1,1834,-9.8,-27386.68,17973.2,-9413.48
1935-05-14,9.81,0.01,0.1,31.86,-69.21,True,1,1835,-9.81,-27396.49,18001.35,-9395.14
1935-05-15,9.82,0.01,0.1,31.86,-69.18,True,1,1836,-9.82,-27406.31,18029.52,-9376.79
1935-05-16,9.15,-0.67,-6.82,31.86,-71.28,True,1,1837,-9.15,-27415.46,16808.55,-10606.91
1935-05-17,10.01,0.86,9.4,31.86,-68.58,True,1,1838,-10.01,-27425.47,18398.38,-9027.09
1935-05-20,9.89,-0.12,-1.2,31.86,-68.96,True,1,1839,-9.89,-27435.36,18187.71,-9247.65
1935-05-21,9.98,0.09,0.91,31.86,-68.68,True,1,1840,-9.98,-27445.34,18363.2,-9082.14
1935-05-22,10.06,0.08,0.8,31.86,-68.42,True,1,1841,-10.06,-27455.4,18520.46,-8934.94
1935-05-23,10.07,0.01,0.1,31.86,-68.39,True,1,1842,-10.07,-27465.47,18548.94,-8916.53
1935-05-24,10.02,-0.05,-0.5,31.86,-68.55,True,1,1843,-10.02,-27475.49,18466.86,-9008.63
1935-05-27,10.03,0.01,0.1,31.86,-68.52,True,1,1844,-10.03,-27485.52,18495.32,-8990.2
1935-05-28,9.85,-0.18,-1.8,31.86,-69.08,True,1,1845,-9.85,-27495.37,18173.25,-9322.12
1935-05-29,9.69,-0.16,-1.62,31.86,-69.59,True,1,1846,-9.69,-27505.06,17887.74,-9617.32
1935-05-31,9.58,-0.11,-1.14,31.86,-69.93,True,1,1847,-9.58,-27514.64,17694.26,-9820.38
1935-06-03,9.67,0.09,0.94,31.86,-69.65,True,1,1848,-9.67,-27524.31,17870.16,-9654.15
1935-06-04,9.92,0.25,2.58,31.86,-68.86,True,1,1849,-9.92,-27534.23,18342.08,-9192.15
1935-06-05,9.91,-0.01,-0.1,31.86,-68.9,True,1,1850,-9.91,-27544.14,18333.5,-9210.64
1935-06-06,9.84,-0.07,-0.71,31.86,-69.11,True,1,1851,-9.84,-27553.98,18213.84,-9340.14
1935-06-07,9.9,0.06,0.61,31.86,-68.93,True,1,1852,-9.9,-27563.88,18334.8,-9229.08
1935-06-10,10.03,0.13,1.31,31.86,-68.52,True,1,1853,-10.03,-27573.91,18585.59,-8988.32
1935-06-11,10.13,0.1,1.0,31.86,-68.2,True,1,1854,-10.13,-27584.04,18781.02,-8803.02
1935-06-12,10.06,-0.07,-0.69,31.86,-68.42,True,1,1855,-10.06,-27594.1,18661.3,-8932.8
1935-06-13,10.12,0.06,0.6,31.86,-68.24,True,1,1856,-10.12,-27604.22,18782.72,-8821.5
1935-06-14,10.22,0.1,0.99,31.86,-67.92,True,1,1857,-10.22,-27614.44,18978.54,-8635.9
1935-06-17,10.22,0.0,0.0,31.86,-67.92,True,1,1858,-10.22,-27624.66,18988.76,-8635.9
1935-06-18,10.28,0.06,0.59,31.86,-67.73,True,1,1859,-10.28,-27634.94,19110.52,-8524.42
1935-06-19,10.23,-0.05,-0.49,31.86,-67.89,True,1,1860,-10.23,-27645.17,19027.8,-8617.37
1935-06-20,10.15,-0.08,-0.78,31.86,-68.14,True,1,1861,-10.15,-27655.32,18889.15,-8766.17
1935-06-21,10.38,0.23,2.27,31.86,-67.42,True,1,1862,-10.38,-27665.7,19327.56,-8338.14
1935-06-24,10.47,0.09,0.87,31.86,-67.14,True,1,1863,-10.47,-27676.17,19505.61,-8170.56
1935-06-25,10.32,-0.15,-1.43,31.86,-67.61,True,1,1864,-10.32,-27686.49,19236.48,-8450.01
1935-06-26,10.2,-0.12,-1.16,31.86,-67.98,True,1,1865,-10.2,-27696.69,19023.0,-8673.69
1935-06-27,10.15,-0.05,-0.49,31.86,-68.14,True,1,1866,-10.15,-27706.84,18939.9,-8766.94
1935-06-28,10.24,0.09,0.89,31.86,-67.86,True,1,1867,-10.24,-27717.08,19118.08,-8599.0
1935-07-01,10.28,0.04,0.39,31.86,-67.73,True,1,1868,-10.28,-27727.36,19203.04,-8524.32
1935-07-02,10.29,0.01,0.1,31.86,-67.7,True,1,1869,-10.29,-27737.65,19232.01,-8505.64
1935-07-03,10.35,0.06,0.58,31.86,-67.51,True,1,1870,-10.35,-27748.0,19354.5,-8393.5
1935-07-05,10.47,0.12,1.16,31.86,-67.14,True,1,1871,-10.47,-27758.47,19589.37,-8169.1
1935-07-08,10.6,0.13,1.24,31.86,-66.73,True,1,1872,-10.6,-27769.07,19843.2,-7925.87
1935-07-09,10.55,-0.05,-0.47,31.86,-66.89,True,1,1873,-10.55,-27779.62,19760.15,-8019.47
1935-07-10,10.63,0.08,0.76,31.86,-66.64,True,1,1874,-10.63,-27790.25,19920.62,-7869.63
1935-07-11,10.52,-0.11,-1.03,31.86,-66.98,True,1,1875,-10.52,-27800.77,19725.0,-8075.77
1935-07-12,10.62,0.1,0.95,31.86,-66.67,True,1,1876,-10.62,-27811.39,19923.12,-7888.27
1935-07-15,10.6,-0.02,-0.19,31.86,-66.73,True,1,1877,-10.6,-27821.99,19896.2,-7925.79
1935-07-16,10.61,0.01,0.09,31.86,-66.7,True,1,1878,-10.61,-27832.6,19925.58,-7907.02
1935-07-17,10.67,0.06,0.57,31.86,-66.51,True,1,1879,-10.67,-27843.27,20048.93,-7794.34
1935-07-18,10.66,-0.01,-0.09,31.86,-66.54,True,1,1880,-10.66,-27853.93,20040.8,-7813.13
1935-07-19,10.58,-0.08,-0.75,31.86,-66.79,True,1,1881,-10.58,-27864.51,19900.98,-7963.53
1935-07-22,10.77,0.19,1.8,31.86,-66.2,True,1,1882,-10.77,-27875.28,20269.14,-7606.14
1935-07-23,10.76,-0.01,-0.09,31.86,-66.23,True,1,1883,-10.76,-27886.04,20261.08,-7624.96
1935-07-24,10.84,0.08,0.74,31.86,-65.98,True,1,1884,-10.84,-27896.88,20422.56,-7474.32
1935-07-25,10.73,-0.11,-1.01,31.86,-66.32,True,1,1885,-10.73,-27907.61,20226.05,-7681.56
1935-07-26,10.79,0.06,0.56,31.86,-66.13,True,1,1886,-10.79,-27918.4,20349.94,-7568.46
1935-07-29,11.04,0.25,2.32,31.86,-65.35,True,1,1887,-11.04,-27929.44,20832.48,-7096.96
1935-07-30,10.94,-0.1,-0.91,31.86,-65.66,True,1,1888,-10.94,-27940.38,20654.72,-7285.66
1935-07-31,11.08,0.14,1.28,31.86,-65.22,True,1,1889,-11.08,-27951.46,20930.12,-7021.34
1935-08-01,11.04,-0.04,-0.36,31.86,-65.35,True,1,1890,-11.04,-27962.5,20865.6,-7096.9
1935-08-02,10.95,-0.09,-0.82,31.86,-65.63,True,1,1891,-10.95,-27973.45,20706.45,-7267.0
1935-08-05,11.2,0.25,2.28,31.86,-64.85,True,1,1892,-11.2,-27984.65,21190.4,-6794.25
1935-08-06,11.19,-0.01,-0.09,31.86,-64.88,True,1,1893,-11.19,-27995.84,21182.67,-6813.17
1935-08-07,11.18,-0.01,-0.09,31.86,-64.91,True,1,1894,-11.18,-28007.02,21174.92,-6832.1
1935-08-08,11.22,0.04,0.36,31.86,-64.78,True,1,1895,-11.22,-28018.24,21261.9,-6756.34
1935-08-09,11.49,0.27,2.41,31.86,-63.94,True,1,1896,-11.49,-28029.73,21785.04,-6244.69
1935-08-12,11.6,0.11,0.96,31.86,-63.59,True,1,1897,-11.6,-28041.33,22005.2,-6036.13
1935-08-13,11.67,0.07,0.6,31.86,-63.37,True,1,1898,-11.67,-28053.0,22149.66,-5903.34
1935-08-14,11.67,0.0,0.0,31.86,-63.37,True,1,1899,-11.67,-28064.67,22161.33,-5903.34
1935-08-15,11.54,-0.13,-1.11,31.86,-63.78,True,1,1900,-11.54,-28076.21,21926.0,-6150.21
1935-08-16,10.62,-0.92,-7.97,31.86,-66.67,True,1,1901,-10.62,-28086.83,20188.62,-7898.21
1935-08-19,11.42,0.8,7.53,31.86,-64.16,True,1,1902,-11.42,-28098.25,21720.84,-6377.41
1935-08-20,11.45,0.03,0.26,31.86,-64.06,True,1,1903,-11.45,-28109.7,21789.35,-6320.35
1935-08-21,11.55,0.1,0.87,31.86,-63.75,True,1,1904,-11.55,-28121.25,21991.2,-6130.05
1935-08-22,11.59,0.04,0.35,31.86,-63.62,True,1,1905,-11.59,-28132.84,22078.95,-6053.89
1935-08-23,11.56,-0.03,-0.26,31.86,-63.72,True,1,1906,-11.56,-28144.4,22033.36,-6111.04
1935-08-26,11.46,-0.1,-0.86,31.86,-64.03,True,1,1907,-11.46,-28155.86,21854.22,-6301.64
1935-08-27,11.12,-0.34,-2.97,31.86,-65.1,True,1,1908,-11.12,-28166.98,21216.96,-6950.02
1935-08-28,11.1,-0.02,-0.18,31.86,-65.16,True,1,1909,-11.1,-28178.08,21189.9,-6988.18
1935-08-29,11.17,0.07,0.63,31.86,-64.94,True,1,1910,-11.17,-28189.25,21334.7,-6854.55
1935-08-30,11.24,0.07,0.63,31.86,-64.72,True,1,1911,-11.24,-28200.49,21479.64,-6720.85
1935-09-03,11.21,-0.03,-0.27,31.86,-64.82,True,1,1912,-11.21,-28211.7,21433.52,-6778.18
1935-09-04,11.36,0.15,1.34,31.86,-64.34,True,1,1913,-11.36,-28223.06,21731.68,-6491.38
1935-09-05,11.47,0.11,0.97,31.86,-64.0,True,1,1914,-11.47,-28234.53,21953.58,-6280.95
1935-09-06,11.65,0.18,1.57,31.86,-63.43,True,1,1915,-11.65,-28246.18,22309.75,-5936.43
1935-09-09,11.76,0.11,0.94,31.86,-63.09,True,1,1916,-11.76,-28257.94,22532.16,-5725.78
1935-09-10,11.86,0.1,0.85,31.86,-62.78,True,1,1917,-11.86,-28269.8,22735.62,-5534.18
1935-09-11,11.92,0.06,0.51,31.86,-62.59,True,1,1918,-11.92,-28281.72,22862.56,-5419.16
1935-09-12,11.78,-0.14,-1.17,31.86,-63.03,True,1,1919,-11.78,-28293.5,22605.82,-5687.68
1935-09-13,11.8,0.02,0.17,31.86,-62.96,True,1,1920,-11.8,-28305.3,22656.0,-5649.3
1935-09-16,11.64,-0.16,-1.36,31.86,-63.46,True,1,1921,-11.64,-28316.94,22360.44,-5956.5
1935-09-17,11.72,0.08,0.69,31.86,-63.21,True,1,1922,-11.72,-28328.66,22525.84,-5802.82
1935-09-18,11.82,0.1,0.85,31.86,-62.9,True,1,1923,-11.82,-28340.48,22729.86,-5610.62
1935-09-19,11.58,-0.24,-2.03,31.86,-63.65,True,1,1924,-11.58,-28352.06,22279.92,-6072.14
1935-09-20,11.26,-0.32,-2.76,31.86,-64.66,True,1,1925,-11.26,-28363.32,21675.5,-6687.82
1935-09-23,11.4,0.14,1.24,31.86,-64.22,True,1,1926,-11.4,-28374.72,21956.4,-6418.32
1935-09-24,11.54,0.14,1.23,31.86,-63.78,True,1,1927,-11.54,-28386.26,22237.58,-6148.68
1935-09-25,11.59,0.05,0.43,31.86,-63.62,True,1,1928,-11.59,-28397.85,22345.52,-6052.33
1935-09-26,11.59,0.0,0.0,31.86,-63.62,True,1,1929,-11.59,-28409.44,22357.11,-6052.33
1935-09-27,11.56,-0.03,-0.26,31.86,-63.72,True,1,1930,-11.56,-28421.0,22310.8,-6110.2
1935-09-30,11.59,0.03,0.26,31.86,-63.62,True,1,1931,-11.59,-28432.59,22380.29,-6052.3
1935-10-01,11.48,-0.11,-0.95,31.86,-63.97,True,1,1932,-11.48,-28444.07,22179.36,-6264.71
1935-10-02,11.1,-0.38,-3.31,31.86,-65.16,True,1,1933,-11.1,-28455.17,21456.3,-6998.87
1935-10-03,11.26,0.16,1.44,31.86,-64.66,True,1,1934,-11.26,-28466.43,21776.84,-6689.59
1935-10-04,11.36,0.1,0.89,31.86,-64.34,True,1,1935,-11.36,-28477.79,21981.6,-6496.19
1935-10-07,11.53,0.17,1.5,31.86,-63.81,True,1,1936,-11.53,-28489.32,22322.08,-6167.24
1935-10-08,11.45,-0.08,-0.69,31.86,-64.06,True,1,1937,-11.45,-28500.77,22178.65,-6322.12
1935-10-09,11.51,0.06,0.52,31.86,-63.87,True,1,1938,-11.51,-28512.28,22306.38,-6205.9
1935-10-10,11.74,0.23,2.0,31.86,-63.15,True,1,1939,-11.74,-28524.02,22763.86,-5760.16
1935-10-11,11.75,0.01,0.08,31.86,-63.12,True,1,1940,-11.75,-28535.77,22795.0,-5740.77
1935-10-14,11.88,0.13,1.11,31.86,-62.71,True,1,1941,-11.88,-28547.65,23059.08,-5488.57
1935-10-15,11.96,0.08,0.67,31.86,-62.46,True,1,1942,-11.96,-28559.61,23226.32,-5333.29
1935-10-16,11.72,-0.24,-2.01,31.86,-63.21,True,1,1943,-11.72,-28571.33,22771.96,-5799.37
1935-10-17,11.85,0.13,1.11,31.86,-62.81,True,1,1944,-11.85,-28583.18,23036.4,-5546.78
1935-10-18,11.81,-0.04,-0.34,31.86,-62.93,True,1,1945,-11.81,-28594.99,22970.45,-5624.54
1935-10-21,12.19,0.38,3.22,31.86,-61.74,True,1,1946,-12.19,-28607.18,23721.74,-4885.44
1935-10-22,12.25,0.06,0.49,31.86,-61.55,True,1,1947,-12.25,-28619.43,23850.75,-4768.68
1935-10-23,12.33,0.08,0.65,31.86,-61.3,True,1,1948,-12.33,-28631.76,24018.84,-4612.92
1935-10-24,12.31,-0.02,-0.16,31.86,-61.36,True,1,1949,-12.31,-28644.07,23992.19,-4651.88
1935-10-25,12.43,0.12,0.98,31.86,-60.99,True,1,1950,-12.43,-28656.5,24238.5,-4418.0
1935-10-28,12.46,0.03,0.24,31.86,-60.89,True,1,1951,-12.46,-28668.96,24309.46,-4359.5
1935-10-29,12.45,-0.01,-0.08,31.86,-60.92,True,1,1952,-12.45,-28681.41,24302.4,-4379.01
1935-10-30,12.36,-0.09,-0.72,31.86,-61.2,True,1,1953,-12.36,-28693.77,24139.08,-4554.69
1935-10-31,12.46,0.1,0.81,31.86,-60.89,True,1,1954,-12.46,-28706.23,24346.84,-4359.39
1935-11-01,12.61,0.15,1.2,31.86,-60.42,True,1,1955,-12.61,-28718.84,24652.55,-4066.29
1935-11-04,12.62,0.01,0.08,31.86,-60.39,True,1,1956,-12.62,-28731.46,24684.72,-4046.74
1935-11-06,12.86,0.24,1.9,31.86,-59.64,True,1,1957,-12.86,-28744.32,25167.02,-3577.3
1935-11-07,12.81,-0.05,-0.39,31.86,-59.79,True,1,1958,-12.81,-28757.13,25081.98,-3675.15
1935-11-08,12.92,0.11,0.86,31.86,-59.45,True,1,1959,-12.92,-28770.05,25310.28,-3459.77
1935-11-12,12.81,-0.11,-0.85,31.86,-59.79,True,1,1960,-12.81,-28782.86,25107.6,-3675.26
1935-11-13,12.96,0.15,1.17,31.86,-59.32,True,1,1961,-12.96,-28795.82,25414.56,-3381.26
1935-11-14,13.2,0.24,1.85,31.86,-58.57,True,1,1962,-13.2,-28809.02,25898.4,-2910.62
1935-11-15,13.25,0.05,0.38,31.86,-58.41,True,1,1963,-13.25,-28822.27,26009.75,-2812.52
1935-11-18,13.28,0.03,0.23,31.86,-58.32,True,1,1964,-13.28,-28835.55,26081.92,-2753.63
1935-11-19,13.46,0.18,1.36,31.86,-57.75,True,1,1965,-13.46,-28849.01,26448.9,-2400.11
1935-11-20,13.29,-0.17,-1.26,31.86,-58.29,True,1,1966,-13.29,-28862.3,26128.14,-2734.16
1935-11-21,13.42,0.13,0.98,31.86,-57.88,True,1,1967,-13.42,-28875.72,26397.14,-2478.58
1935-11-22,13.14,-0.28,-2.09,31.86,-58.76,True,1,1968,-13.14,-28888.86,25859.52,-3029.34
1935-11-25,13.18,0.04,0.3,31.86,-58.63,True,1,1969,-13.18,-28902.04,25951.42,-2950.62
1935-11-26,12.99,-0.19,-1.44,31.86,-59.23,True,1,1970,-12.99,-28915.03,25590.3,-3324.73
1935-11-27,13.09,0.1,0.77,31.86,-58.91,True,1,1971,-13.09,-28928.12,25800.39,-3127.73
1935-11-29,12.94,-0.15,-1.15,31.86,-59.38,True,1,1972,-12.94,-28941.06,25517.68,-3423.38
1935-12-02,12.75,-0.19,-1.47,31.86,-59.98,True,1,1973,-12.75,-28953.81,25155.75,-3798.06
1935-12-03,13.1,0.35,2.74,31.86,-58.88,True,1,1974,-13.1,-28966.91,25859.4,-3107.51
1935-12-04,13.21,0.11,0.84,31.86,-58.54,True,1,1975,-13.21,-28980.12,26089.75,-2890.37
1935-12-05,13.18,-0.03,-0.23,31.86,-58.63,True,1,1976,-13.18,-28993.3,26043.68,-2949.62
1935-12-06,13.15,-0.03,-0.23,31.86,-58.73,True,1,1977,-13.15,-29006.45,25997.55,-3008.9
1935-12-09,13.32,0.17,1.29,31.86,-58.19,True,1,1978,-13.32,-29019.77,26346.96,-2672.81
1935-12-10,13.09,-0.23,-1.73,31.86,-58.91,True,1,1979,-13.09,-29032.86,25905.11,-3127.75
1935-12-11,13.14,0.05,0.38,31.86,-58.76,True,1,1980,-13.14,-29046.0,26017.2,-3028.8
1935-12-12,12.96,-0.18,-1.37,31.86,-59.32,True,1,1981,-12.96,-29058.96,25673.76,-3385.2
1935-12-13,12.84,-0.12,-0.93,31.86,-59.7,True,1,1982,-12.84,-29071.8,25448.88,-3622.92
1935-12-16,13.33,0.49,3.82,31.86,-58.16,True,1,1983,-13.33,-29085.13,26433.39,-2651.74
1935-12-17,12.9,-0.43,-3.23,31.86,-59.51,True,1,1984,-12.9,-29098.03,25593.6,-3504.43
1935-12-18,12.86,-0.04,-0.31,31.86,-59.64,True,1,1985,-12.86,-29110.89,25527.1,-3583.79
1935-12-19,12.8,-0.06,-0.47,31.86,-59.82,True,1,1986,-12.8,-29123.69,25420.8,-3702.89
1935-12-20,12.88,0.08,0.62,31.86,-59.57,True,1,1987,-12.88,-29136.57,25592.56,-3544.01
1935-12-23,12.96,0.08,0.62,31.86,-59.32,True,1,1988,-12.96,-29149.53,25764.48,-3385.05
1935-12-24,13.09,0.13,1.0,31.86,-58.91,True,1,1989,-13.09,-29162.62,26036.01,-3126.61
1935-12-26,13.12,0.03,0.23,31.86,-58.82,True,1,1990,-13.12,-29175.74,26108.8,-3066.94
1935-12-27,13.11,-0.01,-0.08,31.86,-58.85,True,1,1991,-13.11,-29188.85,26102.01,-3086.84
1935-12-30,13.3,0.19,1.45,31.86,-58.26,True,1,1992,-13.3,-29202.15,26493.6,-2708.55
1935-12-31,13.43,0.13,0.98,31.86,-57.85,True,1,1993,-13.43,-29215.58,26765.99,-2449.59
1936-01-02,13.4,-0.03,-0.22,31.86,-57.94,True,1,1994,-13.4,-29228.98,26719.6,-2509.38
1936-01-03,13.55,0.15,1.12,31.86,-57.47,True,1,1995,-13.55,-29242.53,27032.25,-2210.28
1936-01-06,13.41,-0.14,-1.03,31.86,-57.91,True,1,1996,-13.41,-29255.94,26766.36,-2489.58
1936-01-07,13.62,0.21,1.57,31.86,-57.25,True,1,1997,-13.62,-29269.56,27199.14,-2070.42
1936-01-08,13.7,0.08,0.59,31.86,-57.0,True,1,1998,-13.7,-29283.26,27372.6,-1910.66
1936-01-09,13.67,-0.03,-0.22,31.86,-57.09,True,1,1999,-13.67,-29296.93,27326.33,-1970.6
1936-01-10,13.78,0.11,0.8,31.86,-56.75,True,1,2000,-13.78,-29310.71,27560.0,-1750.71
1936-01-13,13.72,-0.06,-0.44,31.86,-56.94,True,1,2001,-13.72,-29324.43,27453.72,-1870.71
1936-01-14,13.8,0.08,0.58,31.86,-56.69,True,1,2002,-13.8,-29338.23,27627.6,-1710.63
1936-01-15,13.71,-0.09,-0.65,31.86,-56.97,True,1,2003,-13.71,-29351.94,27461.13,-1890.81
1936-01-16,13.77,0.06,0.44,31.86,-56.78,True,1,2004,-13.77,-29365.71,27595.08,-1770.63
1936-01-17,13.75,-0.02,-0.14,31.86,-56.84,True,1,2005,-13.75,-29379.46,27568.75,-1810.71
1936-01-20,13.52,-0.23,-1.67,31.86,-57.56,True,1,2006,-13.52,-29392.98,27121.12,-2271.86
1936-01-21,13.47,-0.05,-0.37,31.86,-57.72,True,1,2007,-13.47,-29406.45,27034.29,-2372.16
1936-01-22,13.76,0.29,2.15,31.86,-56.81,True,1,2008,-13.76,-29420.21,27630.08,-1790.13
1936-01-23,13.91,0.15,1.09,31.86,-56.34,True,1,2009,-13.91,-29434.12,27945.19,-1488.93
1936-01-24,13.85,-0.06,-0.43,31.86,-56.53,True,1,2010,-13.85,-29447.97,27838.5,-1609.47
1936-01-27,13.99,0.14,1.01,31.86,-56.09,True,1,2011,-13.99,-29461.96,28133.89,-1328.07
1936-01-28,14.01,0.02,0.14,31.86,-56.03,True,1,2012,-14.01,-29475.97,28188.12,-1287.85
1936-01-29,14.15,0.14,1.0,31.86,-55.59,True,1,2013,-14.15,-29490.12,28483.95,-1006.17
1936-01-30,14.08,-0.07,-0.5,31.86,-55.81,True,1,2014,-14.08,-29504.2,28357.12,-1147.08
1936-01-31,14.31,0.23,1.63,31.86,-55.08,True,1,2015,-14.31,-29518.51,28834.65,-683.86
1936-02-03,14.44,0.13,0.91,31.86,-54.68,True,1,2016,-14.44,-29532.95,29111.04,-421.91
1936-02-04,14.42,-0.02,-0.14,31.86,-54.74,True,1,2017,-14.42,-29547.37,29085.14,-462.23
1936-02-05,14.37,-0.05,-0.35,31.86,-54.9,True,1,2018,-14.37,-29561.74,28998.66,-563.08
1936-02-06,14.39,0.02,0.14,31.86,-54.83,True,1,2019,-14.39,-29576.13,29053.41,-522.72
1936-02-07,14.32,-0.07,-0.49,31.86,-55.05,True,1,2020,-14.32,-29590.45,28926.4,-664.05
1936-02-10,14.43,0.11,0.77,31.86,-54.71,True,1,2021,-14.43,-29604.88,29163.03,-441.85
1936-02-11,14.63,0.2,1.39,31.86,-54.08,True,1,2022,-14.63,-29619.51,29581.86,-37.65
1936-02-13,14.72,0.09,0.62,31.86,-53.8,True,1,2023,-14.72,-29634.23,29778.56,144.33
1936-02-14,14.66,-0.06,-0.41,31.86,-53.99,True,1,2024,-14.66,-29648.89,29671.84,22.95
1936-02-17,14.58,-0.08,-0.55,31.86,-54.24,True,1,2025,-14.58,-29663.47,29524.5,-138.97
1936-02-18,14.74,0.16,1.1,31.86,-53.74,True,1,2026,-14.74,-29678.21,29863.24,185.03
1936-02-19,14.64,-0.1,-0.68,31.86,-54.05,True,1,2027,-14.64,-29692.85,29675.28,-17.57
1936-02-20,14.87,0.23,1.57,31.86,-53.33,True,1,2028,-14.87,-29707.72,30156.36,448.64
1936-02-21,14.83,-0.04,-0.27,31.86,-53.45,True,1,2029,-14.83,-29722.55,30090.07,367.52
1936-02-24,14.69,-0.14,-0.94,31.86,-53.89,True,1,2030,-14.69,-29737.24,29820.7,83.46
1936-02-25,14.42,-0.27,-1.84,31.86,-54.74,True,1,2031,-14.42,-29751.66,29287.02,-464.64
1936-02-26,14.35,-0.07,-0.48,31.86,-54.96,True,1,2032,-14.35,-29766.01,29159.2,-606.81
1936-02-27,14.69,0.34,2.37,31.86,-53.89,True,1,2033,-14.69,-29780.7,29864.77,84.07
1936-02-28,14.6,-0.09,-0.61,31.86,-54.18,True,1,2034,-14.6,-29795.3,29696.4,-98.9
1936-03-02,14.77,0.17,1.16,31.86,-53.64,True,1,2035,-14.77,-29810.07,30056.95,246.88
1936-03-03,14.98,0.21,1.42,31.86,-52.98,True,1,2036,-14.98,-29825.05,30499.28,674.23
1936-03-04,15.02,0.04,0.27,31.86,-52.86,True,1,2037,-15.02,-29840.07,30595.74,755.67
1936-03-05,15.04,0.02,0.13,31.86,-52.79,True,1,2038,-15.04,-29855.11,30651.52,796.41
1936-03-06,15.1,0.06,0.4,31.86,-52.6,True,1,2039,-15.1,-29870.21,30788.9,918.69
1936-03-09,14.51,-0.59,-3.91,31.86,-54.46,True,1,2040,-14.51,-29884.72,29600.4,-284.32
1936-03-10,14.73,0.22,1.52,31.86,-53.77,True,1,2041,-14.73,-29899.45,30063.93,164.48
1936-03-11,14.88,0.15,1.02,31.86,-53.3,True,1,2042,-14.88,-29914.33,30384.96,470.63
1936-03-12,14.46,-0.42,-2.82,31.86,-54.61,True,1,2043,-14.46,-29928.79,29541.78,-387.01
1936-03-13,14.24,-0.22,-1.52,31.86,-55.3,True,1,2044,-14.24,-29943.03,29106.56,-836.47
1936-03-16,14.57,0.33,2.32,31.86,-54.27,True,1,2045,-14.57,-29957.6,29795.65,-161.95
1936-03-17,14.92,0.35,2.4,31.86,-53.17,True,1,2046,-14.92,-29972.52,30526.32,553.8
1936-03-18,14.86,-0.06,-0.4,31.86,-53.36,True,1,2047,-14.86,-29987.38,30418.42,431.04
1936-03-19,15.06,0.2,1.35,31.86,-52.73,True,1,2048,-15.06,-30002.44,30842.88,840.44
1936-03-20,15.04,-0.02,-0.13,31.86,-52.79,True,1,2049,-15.04,-30017.48,30816.96,799.48
1936-03-23,15.05,0.01,0.07,31.86,-52.76,True,1,2050,-15.05,-30032.53,30852.5,819.97
1936-03-24,14.97,-0.08,-0.53,31.86,-53.01,True,1,2051,-14.97,-30047.5,30703.47,655.97
1936-03-25,15.1,0.13,0.87,31.86,-52.6,True,1,2052,-15.1,-30062.6,30985.2,922.6
1936-03-26,15.05,-0.05,-0.33,31.86,-52.76,True,1,2053,-15.05,-30077.65,30897.65,820.0
1936-03-27,14.82,-0.23,-1.53,31.86,-53.48,True,1,2054,-14.82,-30092.47,30440.28,347.81
1936-03-30,14.81,-0.01,-0.07,31.86,-53.52,True,1,2055,-14.81,-30107.28,30434.55,327.27
1936-03-31,14.92,0.11,0.74,31.86,-53.17,True,1,2056,-14.92,-30122.2,30675.52,553.32
1936-04-01,15.19,0.27,1.81,31.86,-52.32,True,1,2057,-15.19,-30137.39,31245.83,1108.44
1936-04-02,15.34,0.15,0.99,31.86,-51.85,True,1,2058,-15.34,-30152.73,31569.72,1416.99
1936-04-03,15.27,-0.07,-0.46,31.86,-52.07,True,1,2059,-15.27,-30168.0,31440.93,1272.93
1936-04-06,15.51,0.24,1.57,31.86,-51.32,True,1,2060,-15.51,-30183.51,31950.6,1767.09
1936-04-07,15.43,-0.08,-0.52,31.86,-51.57,True,1,2061,-15.43,-30198.94,31801.23,1602.29
1936-04-08,15.44,0.01,0.06,31.86,-51.54,True,1,2062,-15.44,-30214.38,31837.28,1622.9
1936-04-09,15.39,-0.05,-0.32,31.86,-51.7,True,1,2063,-15.39,-30229.77,31749.57,1519.8
1936-04-13,15.42,0.03,0.2,31.86,-51.6,True,1,2064,-15.42,-30245.19,31826.88,1581.69
1936-04-14,15.11,-0.31,-2.01,31.86,-52.57,True,1,2065,-15.11,-30260.3,31202.15,941.85
1936-04-15,15.26,0.15,0.99,31.86,-52.1,True,1,2066,-15.26,-30275.56,31527.16,1251.6
1936-04-16,15.19,-0.07,-0.46,31.86,-52.32,True,1,2067,-15.19,-30290.75,31397.73,1106.98
1936-04-17,15.1,-0.09,-0.59,31.86,-52.6,True,1,2068,-15.1,-30305.85,31226.8,920.95
1936-04-20,14.62,-0.48,-3.18,31.86,-54.11,True,1,2069,-14.62,-30320.47,30248.78,-71.69
1936-04-21,14.6,-0.02,-0.14,31.86,-54.18,True,1,2070,-14.6,-30335.07,30222.0,-113.07
1936-04-22,14.85,0.25,1.71,31.86,-53.39,True,1,2071,-14.85,-30349.92,30754.35,404.43
1936-04-23,14.4,-0.45,-3.03,31.86,-54.8,True,1,2072,-14.4,-30364.32,29836.8,-527.52
1936-04-24,14.44,0.04,0.28,31.86,-54.68,True,1,2073,-14.44,-30378.76,29934.12,-444.64
1936-04-27,13.96,-0.48,-3.32,31.86,-56.18,True,1,2074,-13.96,-30392.72,28953.04,-1439.68
1936-04-28,13.94,-0.02,-0.14,31.86,-56.25,True,1,2075,-13.94,-30406.66,28925.5,-1481.16
1936-04-29,13.53,-0.41,-2.94,31.86,-57.53,True,1,2076,-13.53,-30420.19,28088.28,-2331.91
1936-04-30,13.77,0.24,1.77,31.86,-56.78,True,1,2077,-13.77,-30433.96,28600.29,-1833.67
1936-05-01,13.87,0.1,0.73,31.86,-56.47,True,1,2078,-13.87,-30447.83,28821.86,-1625.97
1936-05-04,13.82,-0.05,-0.36,31.86,-56.62,True,1,2079,-13.82,-30461.65,28731.78,-1729.87
1936-05-05,14.02,0.2,1.45,31.86,-56.0,True,1,2080,-14.02,-30475.67,29161.6,-1314.07
1936-05-06,14.18,0.16,1.14,31.86,-55.49,True,1,2081,-14.18,-30489.85,29508.58,-981.27
1936-05-07,13.92,-0.26,-1.83,31.86,-56.31,True,1,2082,-13.92,-30503.77,28981.44,-1522.33
1936-05-08,13.9,-0.02,-0.14,31.86,-56.37,True,1,2083,-13.9,-30517.67,28953.7,-1563.97
1936-05-11,13.86,-0.04,-0.29,31.86,-56.5,True,1,2084,-13.86,-30531.53,28884.24,-1647.29
1936-05-12,13.86,0.0,0.0,31.86,-56.5,True,1,2085,-13.86,-30545.39,28898.1,-1647.29
1936-05-13,13.97,0.11,0.79,31.86,-56.15,True,1,2086,-13.97,-30559.36,29141.42,-1417.94
1936-05-14,14.29,0.32,2.29,31.86,-55.15,True,1,2087,-14.29,-30573.65,29823.23,-750.42
1936-05-15,14.29,0.0,0.0,31.86,-55.15,True,1,2088,-14.29,-30587.94,29837.52,-750.42
1936-05-18,14.19,-0.1,-0.7,31.86,-55.46,True,1,2089,-14.19,-30602.13,29642.91,-959.22
1936-05-19,13.85,-0.34,-2.4,31.86,-56.53,True,1,2090,-13.85,-30615.98,28946.5,-1669.48
1936-05-20,13.99,0.14,1.01,31.86,-56.09,True,1,2091,-13.99,-30629.97,29253.09,-1376.88
1936-05-21,13.94,-0.05,-0.36,31.86,-56.25,True,1,2092,-13.94,-30643.91,29162.48,-1481.43
1936-05-22,14.09,0.15,1.08,31.86,-55.78,True,1,2093,-14.09,-30658.0,29490.37,-1167.63
1936-05-25,14.25,0.16,1.14,31.86,-55.27,True,1,2094,-14.25,-30672.25,29839.5,-832.75
1936-05-26,14.45,0.2,1.4,31.86,-54.64,True,1,2095,-14.45,-30686.7,30272.75,-413.95
1936-05-27,14.42,-0.03,-0.21,31.86,-54.74,True,1,2096,-14.42,-30701.12,30224.32,-476.8
1936-05-28,14.3,-0.12,-0.83,31.86,-55.12,True,1,2097,-14.3,-30715.42,29987.1,-728.32
1936-05-29,14.4,0.1,0.7,31.86,-54.8,True,1,2098,-14.4,-30729.82,30211.2,-518.62
1936-06-01,14.39,-0.01,-0.07,31.86,-54.83,True,1,2099,-14.39,-30744.21,30204.61,-539.6
1936-06-02,14.39,0.0,0.0,31.86,-54.83,True,1,2100,-14.39,-30758.6,30219.0,-539.6
1936-06-03,14.34,-0.05,-0.35,31.86,-54.99,True,1,2101,-14.34,-30772.94,30128.34,-644.6
1936-06-04,14.13,-0.21,-1.46,31.86,-55.65,True,1,2102,-14.13,-30787.07,29701.26,-1085.81
1936-06-05,14.12,-0.01,-0.07,31.86,-55.68,True,1,2103,-14.12,-30801.19,29694.36,-1106.83
1936-06-08,14.34,0.22,1.56,31.86,-54.99,True,1,2104,-14.34,-30815.53,30171.36,-644.17
1936-06-09,14.48,0.14,0.98,31.86,-54.55,True,1,2105,-14.48,-30830.01,30480.4,-349.61
1936-06-10,14.55,0.07,0.48,31.86,-54.33,True,1,2106,-14.55,-30844.56,30642.3,-202.26
1936-06-11,14.76,0.21,1.44,31.86,-53.67,True,1,2107,-14.76,-30859.32,31099.32,240.0
1936-06-12,14.59,-0.17,-1.15,31.86,-54.21,True,1,2108,-14.59,-30873.91,30755.72,-118.19
1936-06-15,14.74,0.15,1.03,31.86,-53.74,True,1,2109,-14.74,-30888.65,31086.66,198.01
1936-06-16,14.92,0.18,1.22,31.86,-53.17,True,1,2110,-14.92,-30903.57,31481.2,577.63
1936-06-17,14.85,-0.07,-0.47,31.86,-53.39,True,1,2111,-14.85,-30918.42,31348.35,429.93
1936-06-18,14.92,0.07,0.47,31.86,-53.17,True,1,2112,-14.92,-30933.34,31511.04,577.7
1936-06-19,14.83,-0.09,-0.6,31.86,-53.45,True,1,2113,-14.83,-30948.17,31335.79,387.62
1936-06-22,15.07,0.24,1.62,31.86,-52.7,True,1,2114,-15.07,-30963.24,31857.98,894.74
1936-06-23,15.0,-0.07,-0.46,31.86,-52.92,True,1,2115,-15.0,-30978.24,31725.0,746.76
1936-06-24,15.16,0.16,1.07,31.86,-52.42,True,1,2116,-15.16,-30993.4,32078.56,1085.16
1936-06-25,15.0,-0.16,-1.06,31.86,-52.92,True,1,2117,-15.0,-31008.4,31755.0,746.6
1936-06-26,14.95,-0.05,-0.33,31.86,-53.08,True,1,2118,-14.95,-31023.35,31664.1,640.75
1936-06-29,14.89,-0.06,-0.4,31.86,-53.26,True,1,2119,-14.89,-31038.24,31551.91,513.67
1936-06-30,14.84,-0.05,-0.34,31.86,-53.42,True,1,2120,-14.84,-31053.08,31460.8,407.72
1936-07-01,14.9,0.06,0.4,31.86,-53.23,True,1,2121,-14.9,-31067.98,31602.9,534.92
1936-07-02,14.88,-0.02,-0.13,31.86,-53.3,True,1,2122,-14.88,-31082.86,31575.36,492.5
1936-07-03,15.02,0.14,0.94,31.86,-52.86,True,1,2123,-15.02,-31097.88,31887.46,789.58
1936-07-06,14.94,-0.08,-0.53,31.86,-53.11,True,1,2124,-14.94,-31112.82,31732.56,619.74
1936-07-07,14.81,-0.13,-0.87,31.86,-53.52,True,1,2125,-14.81,-31127.63,31471.25,343.62
1936-07-08,14.89,0.08,0.54,31.86,-53.26,True,1,2126,-14.89,-31142.52,31656.14,513.62
1936-07-09,15.07,0.18,1.21,31.86,-52.7,True,1,2127,-15.07,-31157.59,32053.89,896.3
1936-07-10,15.35,0.28,1.86,31.86,-51.82,True,1,2128,-15.35,-31172.94,32664.8,1491.86
1936-07-13,15.45,0.1,0.65,31.86,-51.51,True,1,2129,-15.45,-31188.39,32893.05,1704.66
1936-07-14,15.63,0.18,1.16,31.86,-50.94,True,1,2130,-15.63,-31204.02,33291.9,2087.88
1936-07-15,15.64,0.01,0.06,31.86,-50.91,True,1,2131,-15.64,-31219.66,33328.84,2109.18
1936-07-16,15.63,-0.01,-0.06,31.86,-50.94,True,1,2132,-15.63,-31235.29,33323.16,2087.87
1936-07-17,15.66,0.03,0.19,31.86,-50.85,True,1,2133,-15.66,-31250.95,33402.78,2151.83
1936-07-20,15.83,0.17,1.09,31.86,-50.31,True,1,2134,-15.83,-31266.78,33781.22,2514.44
1936-07-21,15.93,0.1,0.63,31.86,-50.0,True,1,2135,-15.93,-31282.71,34010.55,2727.84
1936-07-22,15.83,-0.1,-0.63,31.86,-50.31,True,1,2136,-15.83,-31298.54,33812.88,2514.34
1936-07-23,15.89,0.06,0.38,31.86,-50.13,True,1,2137,-15.89,-31314.43,33956.93,2642.5
1936-07-24,15.83,-0.06,-0.38,31.86,-50.31,True,1,2138,-15.83,-31330.26,33844.54,2514.28
1936-07-27,16.15,0.32,2.02,31.86,-49.31,True,1,2139,-16.15,-31346.41,34544.85,3198.44
1936-07-28,16.12,-0.03,-0.19,31.86,-49.4,True,1,2140,-16.12,-31362.53,34496.8,3134.27
1936-07-29,15.96,-0.16,-0.99,31.86,-49.91,True,1,2141,-15.96,-31378.49,34170.36,2791.87
1936-07-30,16.02,0.06,0.38,31.86,-49.72,True,1,2142,-16.02,-31394.51,34314.84,2920.33
1936-07-31,15.85,-0.17,-1.06,31.86,-50.25,True,1,2143,-15.85,-31410.36,33966.55,2556.19
1936-08-03,15.91,0.06,0.38,31.86,-50.06,True,1,2144,-15.91,-31426.27,34111.04,2684.77
1936-08-04,15.87,-0.04,-0.25,31.86,-50.19,True,1,2145,-15.87,-31442.14,34041.15,2599.01
1936-08-05,15.77,-0.1,-0.63,31.86,-50.5,True,1,2146,-15.77,-31457.91,33842.42,2384.51
1936-08-06,15.87,0.1,0.63,31.86,-50.19,True,1,2147,-15.87,-31473.78,34072.89,2599.11
1936-08-07,16.08,0.21,1.32,31.86,-49.53,True,1,2148,-16.08,-31489.86,34539.84,3049.98
1936-08-10,16.2,0.12,0.75,31.86,-49.15,True,1,2149,-16.2,-31506.06,34813.8,3307.74
1936-08-11,16.08,-0.12,-0.74,31.86,-49.53,True,1,2150,-16.08,-31522.14,34572.0,3049.86
1936-08-12,16.16,0.08,0.5,31.86,-49.28,True,1,2151,-16.16,-31538.3,34760.16,3221.86
1936-08-13,16.08,-0.08,-0.5,31.86,-49.53,True,1,2152,-16.08,-31554.38,34604.16,3049.78
1936-08-14,15.87,-0.21,-1.31,31.86,-50.19,True,1,2153,-15.87,-31570.25,34168.11,2597.86
1936-08-17,15.8,-0.07,-0.44,31.86,-50.41,True,1,2154,-15.8,-31586.05,34033.2,2447.15
1936-08-18,15.81,0.01,0.06,31.86,-50.38,True,1,2155,-15.81,-31601.86,34070.55,2468.69
1936-08-19,15.9,0.09,0.57,31.86,-50.09,True,1,2156,-15.9,-31617.76,34280.4,2662.64
1936-08-20,15.81,-0.09,-0.57,31.86,-50.38,True,1,2157,-15.81,-31633.57,34102.17,2468.6
1936-08-21,15.32,-0.49,-3.1,31.86,-51.92,True,1,2158,-15.32,-31648.89,33060.56,1411.67
1936-08-24,15.65,0.33,2.15,31.86,-50.88,True,1,2159,-15.65,-31664.54,33788.35,2123.81
1936-08-25,15.67,0.02,0.13,31.86,-50.82,True,1,2160,-15.67,-31680.21,33847.2,2166.99
1936-08-26,15.55,-0.12,-0.77,31.86,-51.19,True,1,2161,-15.55,-31695.76,33603.55,1907.79
1936-08-27,15.89,0.34,2.19,31.86,-50.13,True,1,2162,-15.89,-31711.65,34354.18,2642.53
1936-08-28,15.92,0.03,0.19,31.86,-50.03,True,1,2163,-15.92,-31727.57,34434.96,2707.39
1936-08-31,15.99,0.07,0.44,31.86,-49.81,True,1,2164,-15.99,-31743.56,34602.36,2858.8
1936-09-01,15.95,-0.04,-0.25,31.86,-49.94,True,1,2165,-15.95,-31759.51,34531.75,2772.24
1936-09-02,16.01,0.06,0.38,31.86,-49.75,True,1,2166,-16.01,-31775.52,34677.66,2902.14
1936-09-03,15.95,-0.06,-0.38,31.86,-49.94,True,1,2167,-15.95,-31791.47,34563.65,2772.18
1936-09-04,16.02,0.07,0.44,31.86,-49.72,True,1,2168,-16.02,-31807.49,34731.36,2923.87
1936-09-08,16.29,0.27,1.68,31.86,-48.87,True,1,2169,-16.29,-31823.78,35333.01,3509.23
1936-09-09,16.17,-0.12,-0.74,31.86,-49.25,True,1,2170,-16.17,-31839.95,35088.9,3248.95
1936-09-10,16.16,-0.01,-0.06,31.86,-49.28,True,1,2171,-16.16,-31856.11,35083.36,3227.25
1936-09-11,16.11,-0.05,-0.31,31.86,-49.44,True,1,2172,-16.11,-31872.22,34990.92,3118.7
1936-09-14,15.96,-0.15,-0.93,31.86,-49.91,True,1,2173,-15.96,-31888.18,34681.08,2792.9
1936-09-15,15.93,-0.03,-0.19,31.86,-50.0,True,1,2174,-15.93,-31904.11,34631.82,2727.71
1936-09-16,15.0,-0.93,-5.84,31.86,-52.92,True,1,2175,-15.0,-31919.11,32625.0,705.89
1936-09-17,15.87,0.87,5.8,31.86,-50.19,True,1,2176,-15.87,-31934.98,34533.12,2598.14
1936-09-18,16.03,0.16,1.01,31.86,-49.69,True,1,2177,-16.03,-31951.01,34897.31,2946.3
1936-09-21,16.16,0.13,0.81,31.86,-49.28,True,1,2178,-16.16,-31967.17,35196.48,3229.31
1936-09-22,16.22,0.06,0.37,31.86,-49.09,True,1,2179,-16.22,-31983.39,35343.38,3359.99
1936-09-23,16.14,-0.08,-0.49,31.86,-49.34,True,1,2180,-16.14,-31999.53,35185.2,3185.67
1936-09-24,16.17,0.03,0.19,31.86,-49.25,True,1,2181,-16.17,-32015.7,35266.77,3251.07
1936-09-25,15.88,-0.29,-1.79,31.86,-50.16,True,1,2182,-15.88,-32031.58,34650.16,2618.58
1936-09-28,16.13,0.25,1.57,31.86,-49.37,True,1,2183,-16.13,-32047.71,35211.79,3164.08
1936-09-29,16.06,-0.07,-0.43,31.86,-49.59,True,1,2184,-16.06,-32063.77,35075.04,3011.27
1936-09-30,16.01,-0.05,-0.31,31.86,-49.75,True,1,2185,-16.01,-32079.78,34981.85,2902.07
1936-10-01,16.04,0.03,0.19,31.86,-49.66,True,1,2186,-16.04,-32095.82,35063.44,2967.62
1936-10-02,16.35,0.31,1.93,31.86,-48.68,True,1,2187,-16.35,-32112.17,35757.45,3645.28
1936-10-05,16.53,0.18,1.1,31.86,-48.12,True,1,2188,-16.53,-32128.7,36167.64,4038.94
1936-10-06,16.68,0.15,0.91,31.86,-47.65,True,1,2189,-16.68,-32145.38,36512.52,4367.14
1936-10-07,16.72,0.04,0.24,31.86,-47.52,True,1,2190,-16.72,-32162.1,36616.8,4454.7
1936-10-08,16.81,0.09,0.54,31.86,-47.24,True,1,2191,-16.81,-32178.91,36830.71,4651.8
1936-10-09,16.87,0.06,0.36,31.86,-47.05,True,1,2192,-16.87,-32195.78,36979.04,4783.26
1936-10-13,16.96,0.09,0.53,31.86,-46.77,True,1,2193,-16.96,-32212.74,37193.28,4980.54
1936-10-14,16.88,-0.08,-0.47,31.86,-47.02,True,1,2194,-16.88,-32229.62,37034.72,4805.1
1936-10-15,16.85,-0.03,-0.18,31.86,-47.11,True,1,2195,-16.85,-32246.47,36985.75,4739.28
1936-10-16,17.04,0.19,1.13,31.86,-46.52,True,1,2196,-17.04,-32263.51,37419.84,5156.33
1936-10-19,17.13,0.09,0.53,31.86,-46.23,True,1,2197,-17.13,-32280.64,37634.61,5353.97
1936-10-20,17.11,-0.02,-0.12,31.86,-46.3,True,1,2198,-17.11,-32297.75,37607.78,5310.03
1936-10-21,17.18,0.07,0.41,31.86,-46.08,True,1,2199,-17.18,-32314.93,37778.82,5463.89
1936-10-22,17.04,-0.14,-0.82,31.86,-46.52,True,1,2200,-17.04,-32331.97,37488.0,5156.03
1936-10-23,17.09,0.05,0.29,31.86,-46.36,True,1,2201,-17.09,-32349.06,37615.09,5266.03
1936-10-26,16.65,-0.44,-2.58,31.86,-47.74,True,1,2202,-16.65,-32365.71,36663.3,4297.59
1936-10-27,16.93,0.28,1.68,31.86,-46.86,True,1,2203,-16.93,-32382.64,37296.79,4914.15
1936-10-28,16.94,0.01,0.06,31.86,-46.83,True,1,2204,-16.94,-32399.58,37335.76,4936.18
1936-10-29,17.2,0.26,1.54,31.86,-46.01,True,1,2205,-17.2,-32416.78,37926.0,5509.22
1936-10-30,17.23,0.03,0.17,31.86,-45.92,True,1,2206,-17.23,-32434.01,38009.38,5575.37
1936-11-02,17.17,-0.06,-0.35,31.86,-46.11,True,1,2207,-17.17,-32451.18,37894.19,5443.01
1936-11-04,17.43,0.26,1.51,31.86,-45.29,True,1,2208,-17.43,-32468.61,38485.44,6016.83
1936-11-05,17.56,0.13,0.75,31.86,-44.88,True,1,2209,-17.56,-32486.17,38790.04,6303.87
1936-11-06,17.43,-0.13,-0.74,31.86,-45.29,True,1,2210,-17.43,-32503.6,38520.3,6016.7
1936-11-09,17.69,0.26,1.49,31.86,-44.48,True,1,2211,-17.69,-32521.29,39112.59,6591.3
1936-11-10,17.63,-0.06,-0.34,31.86,-44.66,True,1,2212,-17.63,-32538.92,38997.56,6458.64
1936-11-12,17.43,-0.2,-1.13,31.86,-45.29,True,1,2213,-17.43,-32556.35,38572.59,6016.24
1936-11-13,17.24,-0.19,-1.09,31.86,-45.89,True,1,2214,-17.24,-32573.59,38169.36,5595.77
1936-11-16,17.4,0.16,0.93,31.86,-45.39,True,1,2215,-17.4,-32590.99,38541.0,5950.01
1936-11-17,17.64,0.24,1.38,31.86,-44.63,True,1,2216,-17.64,-32608.63,39090.24,6481.61
1936-11-18,17.51,-0.13,-0.74,31.86,-45.04,True,1,2217,-17.51,-32626.14,38819.67,6193.53
1936-11-19,17.3,-0.21,-1.2,31.86,-45.7,True,1,2218,-17.3,-32643.44,38371.4,5727.96
1936-11-20,17.13,-0.17,-0.98,31.86,-46.23,True,1,2219,-17.13,-32660.57,38011.47,5350.9
1936-11-23,16.89,-0.24,-1.4,31.86,-46.99,True,1,2220,-16.89,-32677.46,37495.8,4818.34
1936-11-24,17.18,0.29,1.72,31.86,-46.08,True,1,2221,-17.18,-32694.64,38156.78,5462.14
1936-11-25,17.09,-0.09,-0.52,31.86,-46.36,True,1,2222,-17.09,-32711.73,37973.98,5262.25
1936-11-27,17.34,0.25,1.46,31.86,-45.57,True,1,2223,-17.34,-32729.07,38546.82,5817.75
1936-11-30,17.28,-0.06,-0.35,31.86,-45.76,True,1,2224,-17.28,-32746.35,38430.72,5684.37
1936-12-01,17.14,-0.14,-0.81,31.86,-46.2,True,1,2225,-17.14,-32763.49,38136.5,5373.01
1936-12-02,16.95,-0.19,-1.11,31.86,-46.8,True,1,2226,-16.95,-32780.44,37730.7,4950.26
1936-12-03,17.04,0.09,0.53,31.86,-46.52,True,1,2227,-17.04,-32797.48,37948.08,5150.6
1936-12-04,17.01,-0.03,-0.18,31.86,-46.61,True,1,2228,-17.01,-32814.49,37898.28,5083.79
1936-12-07,16.91,-0.1,-0.59,31.86,-46.92,True,1,2229,-16.91,-32831.4,37692.39,4860.99
1936-12-08,16.97,0.06,0.36,31.86,-46.74,True,1,2230,-16.97,-32848.37,37843.1,4994.73
1936-12-09,17.05,0.08,0.47,31.86,-46.48,True,1,2231,-17.05,-32865.42,38038.55,5173.13
1936-12-10,17.22,0.17,1.0,31.86,-45.95,True,1,2232,-17.22,-32882.64,38435.04,5552.4
1936-12-11,17.14,-0.08,-0.46,31.86,-46.2,True,1,2233,-17.14,-32899.78,38273.62,5373.84
1936-12-14,17.32,0.18,1.05,31.86,-45.64,True,1,2234,-17.32,-32917.1,38692.88,5775.78
1936-12-15,17.32,0.0,0.0,31.86,-45.64,True,1,2235,-17.32,-32934.42,38710.2,5775.78
1936-12-16,17.29,-0.03,-0.17,31.86,-45.73,True,1,2236,-17.29,-32951.71,38660.44,5708.73
1936-12-17,17.16,-0.13,-0.75,31.86,-46.14,True,1,2237,-17.16,-32968.87,38386.92,5418.05
1936-12-18,17.0,-0.16,-0.93,31.86,-46.64,True,1,2238,-17.0,-32985.87,38046.0,5060.13
1936-12-21,16.65,-0.35,-2.06,31.86,-47.74,True,1,2239,-16.65,-33002.52,37279.35,4276.83
1936-12-22,16.86,0.21,1.26,31.86,-47.08,True,1,2240,-16.86,-33019.38,37766.4,4747.02
1936-12-23,17.03,0.17,1.01,31.86,-46.55,True,1,2241,-17.03,-33036.41,38164.23,5127.82
1936-12-24,17.06,0.03,0.18,31.86,-46.45,True,1,2242,-17.06,-33053.47,38248.52,5195.05
1936-12-28,16.94,-0.12,-0.7,31.86,-46.83,True,1,2243,-16.94,-33070.41,37996.42,4926.01
1936-12-29,17.01,0.07,0.41,31.86,-46.61,True,1,2244,-17.01,-33087.42,38170.44,5083.02
1936-12-30,17.27,0.26,1.53,31.86,-45.79,True,1,2245,-17.27,-33104.69,38771.15,5666.46
1936-12-31,17.18,-0.09,-0.52,31.86,-46.08,True,1,2246,-17.18,-33121.87,38586.28,5464.41
1937-01-04,16.93,-0.25,-1.46,31.86,-46.86,True,1,2247,-16.93,-33138.8,38041.71,4902.91
1937-01-05,17.08,0.15,0.89,31.86,-46.39,True,1,2248,-17.08,-33155.88,38395.84,5239.96
1937-01-06,17.09,0.01,0.06,31.86,-46.36,True,1,2249,-17.09,-33172.97,38435.41,5262.44
1937-01-07,17.48,0.39,2.28,31.86,-45.14,True,1,2250,-17.48,-33190.45,39330.0,6139.55
1937-01-08,17.48,0.0,0.0,31.86,-45.14,True,1,2251,-17.48,-33207.93,39347.48,6139.55
1937-01-11,17.57,0.09,0.52,31.86,-44.85,True,1,2252,-17.57,-33225.5,39567.64,6342.14
1937-01-12,17.58,0.01,0.06,31.86,-44.82,True,1,2253,-17.58,-33243.08,39607.74,6364.66
1937-01-13,17.61,0.03,0.17,31.86,-44.73,True,1,2254,-17.61,-33260.69,39692.94,6432.25
1937-01-14,17.66,0.05,0.28,31.86,-44.57,True,1,2255,-17.66,-33278.35,39823.3,6544.95
1937-01-15,17.74,0.08,0.45,31.86,-44.32,True,1,2256,-17.74,-33296.09,40021.44,6725.35
1937-01-18,17.74,0.0,0.0,31.86,-44.32,True,1,2257,-17.74,-33313.83,40039.18,6725.35
1937-01-19,17.62,-0.12,-0.68,31.86,-44.7,True,1,2258,-17.62,-33331.45,39785.96,6454.51
1937-01-20,17.84,0.22,1.25,31.86,-44.0,True,1,2259,-17.84,-33349.29,40300.56,6951.27
1937-01-21,17.96,0.12,0.67,31.86,-43.63,True,1,2260,-17.96,-33367.25,40589.6,7222.35
1937-01-22,17.87,-0.09,-0.5,31.86,-43.91,True,1,2261,-17.87,-33385.12,40404.07,7018.95
1937-01-25,17.77,-0.1,-0.56,31.86,-44.22,True,1,2262,-17.77,-33402.89,40195.74,6792.85
1937-01-26,17.51,-0.26,-1.46,31.86,-45.04,True,1,2263,-17.51,-33420.4,39625.13,6204.73
1937-01-27,17.65,0.14,0.8,31.86,-44.6,True,1,2264,-17.65,-33438.05,39959.6,6521.55
1937-01-28,17.63,-0.02,-0.11,31.86,-44.66,True,1,2265,-17.63,-33455.68,39931.95,6476.27
1937-01-29,17.77,0.14,0.79,31.86,-44.22,True,1,2266,-17.77,-33473.45,40266.82,6793.37
1937-02-01,17.88,0.11,0.62,31.86,-43.88,True,1,2267,-17.88,-33491.33,40533.96,7042.63
1937-02-02,18.0,0.12,0.67,31.86,-43.5,True,1,2268,-18.0,-33509.33,40824.0,7314.67
1937-02-03,18.13,0.13,0.72,31.86,-43.1,True,1,2269,-18.13,-33527.46,41136.97,7609.51
1937-02-04,18.15,0.02,0.11,31.86,-43.03,True,1,2270,-18.15,-33545.61,41200.5,7654.89
1937-02-05,17.86,-0.29,-1.6,31.86,-43.94,True,1,2271,-17.86,-33563.47,40560.06,6996.59
1937-02-08,18.07,0.21,1.18,31.86,-43.28,True,1,2272,-18.07,-33581.54,41055.04,7473.5
1937-02-09,17.99,-0.08,-0.44,31.86,-43.53,True,1,2273,-17.99,-33599.53,40891.27,7291.74
1937-02-10,18.17,0.18,1.0,31.86,-42.97,True,1,2274,-18.17,-33617.7,41318.58,7700.88
1937-02-11,18.32,0.15,0.83,31.86,-42.5,True,1,2275,-18.32,-33636.02,41678.0,8041.98
1937-02-15,18.1,-0.22,-1.2,31.86,-43.19,True,1,2276,-18.1,-33654.12,41195.6,7541.48
1937-02-16,18.15,0.05,0.28,31.86,-43.03,True,1,2277,-18.15,-33672.27,41327.55,7655.28
1937-02-17,18.12,-0.03,-0.16,31.86,-43.13,True,1,2278,-18.12,-33690.39,41277.36,7586.97
1937-02-18,18.22,0.1,0.55,31.86,-42.81,True,1,2279,-18.22,-33708.61,41523.38,7814.77
1937-02-19,18.37,0.15,0.82,31.86,-42.34,True,1,2280,-18.37,-33726.98,41883.6,8156.62
1937-02-23,17.97,-0.4,-2.18,31.86,-43.6,True,1,2281,-17.97,-33744.95,40989.57,7244.62
1937-02-24,18.07,0.1,0.56,31.86,-43.28,True,1,2282,-18.07,-33763.02,41235.74,7472.72
1937-02-25,18.0,-0.07,-0.39,31.86,-43.5,True,1,2283,-18.0,-33781.02,41094.0,7312.98
1937-02-26,18.06,0.06,0.33,31.86,-43.32,True,1,2284,-18.06,-33799.08,41249.04,7449.96
1937-03-01,18.09,0.03,0.17,31.86,-43.22,True,1,2285,-18.09,-33817.17,41335.65,7518.48
1937-03-02,18.34,0.25,1.38,31.86,-42.44,True,1,2286,-18.34,-33835.51,41925.24,8089.73
1937-03-03,18.55,0.21,1.14,31.86,-41.78,True,1,2287,-18.55,-33854.06,42423.85,8569.79
1937-03-04,18.38,-0.17,-0.92,31.86,-42.31,True,1,2288,-18.38,-33872.44,42053.44,8181.0
1937-03-05,18.62,0.24,1.31,31.86,-41.56,True,1,2289,-18.62,-33891.06,42621.18,8730.12
1937-03-08,18.56,-0.06,-0.32,31.86,-41.74,True,1,2290,-18.56,-33909.62,42502.4,8592.78
1937-03-09,18.54,-0.02,-0.11,31.86,-41.81,True,1,2291,-18.54,-33928.16,42475.14,8546.98
1937-03-10,18.67,0.13,0.7,31.86,-41.4,True,1,2292,-18.67,-33946.83,42791.64,8844.81
1937-03-11,18.38,-0.29,-1.55,31.86,-42.31,True,1,2293,-18.38,-33965.21,42145.34,8180.13
1937-03-12,18.36,-0.02,-0.11,31.86,-42.37,True,1,2294,-18.36,-33983.57,42117.84,8134.27
1937-03-15,18.14,-0.22,-1.2,31.86,-43.06,True,1,2295,-18.14,-34001.71,41631.3,7629.59
1937-03-16,18.23,0.09,0.5,31.86,-42.78,True,1,2296,-18.23,-34019.94,41856.08,7836.14
1937-03-17,18.11,-0.12,-0.66,31.86,-43.16,True,1,2297,-18.11,-34038.05,41598.67,7560.62
1937-03-18,17.73,-0.38,-2.1,31.86,-44.35,True,1,2298,-17.73,-34055.78,40743.54,6687.76
1937-03-19,17.72,-0.01,-0.06,31.86,-44.38,True,1,2299,-17.72,-34073.5,40738.28,6664.78
1937-03-22,17.22,-0.5,-2.82,31.86,-45.95,True,1,2300,-17.22,-34090.72,39606.0,5515.28
1937-03-23,17.49,0.27,1.57,31.86,-45.1,True,1,2301,-17.49,-34108.21,40244.49,6136.28
1937-03-24,17.7,0.21,1.2,31.86,-44.44,True,1,2302,-17.7,-34125.91,40745.4,6619.49
1937-03-25,17.68,-0.02,-0.11,31.86,-44.51,True,1,2303,-17.68,-34143.59,40717.04,6573.45
1937-03-29,17.63,-0.05,-0.28,31.86,-44.66,True,1,2304,-17.63,-34161.22,40619.52,6458.3
1937-03-30,17.95,0.32,1.82,31.86,-43.66,True,1,2305,-17.95,-34179.17,41374.75,7195.58
1937-03-31,17.92,-0.03,-0.17,31.86,-43.75,True,1,2306,-17.92,-34197.09,41323.52,7126.43
1937-04-01,17.71,-0.21,-1.17,31.86,-44.41,True,1,2307,-17.71,-34214.8,40856.97,6642.17
1937-04-02,17.49,-0.22,-1.24,31.86,-45.1,True,1,2308,-17.49,-34232.29,40366.92,6134.63
1937-04-05,17.62,0.13,0.74,31.86,-44.7,True,1,2309,-17.62,-34249.91,40684.58,6434.67
1937-04-06,17.46,-0.16,-0.91,31.86,-45.2,True,1,2310,-17.46,-34267.37,40332.6,6065.23
1937-04-07,16.91,-0.55,-3.15,31.86,-46.92,True,1,2311,-16.91,-34284.28,39079.01,4794.73
1937-04-08,16.99,0.08,0.47,31.86,-46.67,True,1,2312,-16.99,-34301.27,39280.88,4979.61
1937-04-09,17.03,0.04,0.24,31.86,-46.55,True,1,2313,-17.03,-34318.3,39390.39,5072.09
1937-04-12,17.1,0.07,0.41,31.86,-46.33,True,1,2314,-17.1,-34335.4,39569.4,5234.0
1937-04-13,17.28,0.18,1.05,31.86,-45.76,True,1,2315,-17.28,-34352.68,40003.2,5650.52
1937-04-14,17.3,0.02,0.12,31.86,-45.7,True,1,2316,-17.3,-34369.98,40066.8,5696.82
1937-04-15,17.23,-0.07,-0.4,31.86,-45.92,True,1,2317,-17.23,-34387.21,39921.91,5534.7
1937-04-16,17.16,-0.07,-0.41,31.86,-46.14,True,1,2318,-17.16,-34404.37,39776.88,5372.51
1937-04-19,17.13,-0.03,-0.18,31.86,-46.23,True,1,2319,-17.13,-34421.5,39724.47,5302.97
1937-04-20,17.18,0.05,0.29,31.86,-46.08,True,1,2320,-17.18,-34438.68,39857.6,5418.92
1937-04-21,17.41,0.23,1.34,31.86,-45.36,True,1,2321,-17.41,-34456.09,40408.61,5952.52
1937-04-22,17.19,-0.22,-1.26,31.86,-46.04,True,1,2322,-17.19,-34473.28,39915.18,5441.9
1937-04-23,16.85,-0.34,-1.98,31.86,-47.11,True,1,2323,-16.85,-34490.13,39142.55,4652.42
1937-04-26,16.16,-0.69,-4.1,31.86,-49.28,True,1,2324,-16.16,-34506.29,37555.84,3049.55
1937-04-27,16.43,0.27,1.67,31.86,-48.43,True,1,2325,-16.43,-34522.72,38199.75,3677.03
1937-04-28,15.99,-0.44,-2.68,31.86,-49.81,True,1,2326,-15.99,-34538.71,37192.74,2654.03
1937-04-29,15.99,0.0,0.0,31.86,-49.81,True,1,2327,-15.99,-34554.7,37208.73,2654.03
1937-04-30,16.43,0.44,2.75,31.86,-48.43,True,1,2328,-16.43,-34571.13,38249.04,3677.91
1937-05-03,16.47,0.04,0.24,31.86,-48.3,True,1,2329,-16.47,-34587.6,38358.63,3771.03
1937-05-04,16.73,0.26,1.58,31.86,-47.49,True,1,2330,-16.73,-34604.33,38980.9,4376.57
1937-05-05,16.59,-0.14,-0.84,31.86,-47.93,True,1,2331,-16.59,-34620.92,38671.29,4050.37
1937-05-06,16.71,0.12,0.72,31.86,-47.55,True,1,2332,-16.71,-34637.63,38967.72,4330.09
1937-05-07,16.65,-0.06,-0.36,31.86,-47.74,True,1,2333,-16.65,-34654.28,38844.45,4190.17
1937-05-10,16.28,-0.37,-2.22,31.86,-48.9,True,1,2334,-16.28,-34670.56,37997.52,3326.96
1937-05-11,16.29,0.01,0.06,31.86,-48.87,True,1,2335,-16.29,-34686.85,38037.15,3350.3
1937-05-12,16.19,-0.1,-0.61,31.86,-49.18,True,1,2336,-16.19,-34703.04,37819.84,3116.8
1937-05-13,15.65,-0.54,-3.34,31.86,-50.88,True,1,2337,-15.65,-34718.69,36574.05,1855.36
1937-05-14,15.81,0.16,1.02,31.86,-50.38,True,1,2338,-15.81,-34734.5,36963.78,2229.28
1937-05-17,15.62,-0.19,-1.2,31.86,-50.97,True,1,2339,-15.62,-34750.12,36535.18,1785.06
1937-05-18,15.88,0.26,1.66,31.86,-50.16,True,1,2340,-15.88,-34766.0,37159.2,2393.2
1937-05-19,15.84,-0.04,-0.25,31.86,-50.28,True,1,2341,-15.84,-34781.84,37081.44,2299.6
1937-05-20,16.26,0.42,2.65,31.86,-48.96,True,1,2342,-16.26,-34798.1,38080.92,3282.82
1937-05-21,16.27,0.01,0.06,31.86,-48.93,True,1,2343,-16.27,-34814.37,38120.61,3306.24
1937-05-24,16.46,0.19,1.17,31.86,-48.34,True,1,2344,-16.46,-34830.83,38582.24,3751.41
1937-05-25,16.25,-0.21,-1.28,31.86,-49.0,True,1,2345,-16.25,-34847.08,38106.25,3259.17
1937-05-26,16.23,-0.02,-0.12,31.86,-49.06,True,1,2346,-16.23,-34863.31,38075.58,3212.27
1937-05-27,16.26,0.03,0.18,31.86,-48.96,True,1,2347,-16.26,-34879.57,38162.22,3282.65
1937-05-28,16.26,0.0,0.0,31.86,-48.96,True,1,2348,-16.26,-34895.83,38178.48,3282.65
1937-06-01,15.96,-0.3,-1.84,31.86,-49.91,True,1,2349,-15.96,-34911.79,37490.04,2578.25
1937-06-02,16.07,0.11,0.69,31.86,-49.56,True,1,2350,-16.07,-34927.86,37764.5,2836.64
1937-06-03,16.1,0.03,0.19,31.86,-49.47,True,1,2351,-16.1,-34943.96,37851.1,2907.14
1937-06-04,16.28,0.18,1.12,31.86,-48.9,True,1,2352,-16.28,-34960.24,38290.56,3330.32
1937-06-07,16.13,-0.15,-0.92,31.86,-49.37,True,1,2353,-16.13,-34976.37,37953.89,2977.52
1937-06-08,16.18,0.05,0.31,31.86,-49.22,True,1,2354,-16.18,-34992.55,38087.72,3095.17
1937-06-09,16.04,-0.14,-0.86,31.86,-49.66,True,1,2355,-16.04,-35008.59,37774.2,2765.61
1937-06-10,15.94,-0.1,-0.62,31.86,-49.97,True,1,2356,-15.94,-35024.53,37554.64,2530.11
1937-06-11,15.73,-0.21,-1.32,31.86,-50.63,True,1,2357,-15.73,-35040.26,37075.61,2035.35
1937-06-14,15.2,-0.53,-3.37,31.86,-52.29,True,1,2358,-15.2,-35055.46,35841.6,786.14
1937-06-15,15.34,0.14,0.92,31.86,-51.85,True,1,2359,-15.34,-35070.8,36187.06,1116.26
1937-06-16,15.18,-0.16,-1.04,31.86,-52.35,True,1,2360,-15.18,-35085.98,35824.8,738.82
1937-06-17,15.39,0.21,1.38,31.86,-51.7,True,1,2361,-15.39,-35101.37,36335.79,1234.42
1937-06-18,15.51,0.12,0.78,31.86,-51.32,True,1,2362,-15.51,-35116.88,36634.62,1517.74
1937-06-21,15.35,-0.16,-1.03,31.86,-51.82,True,1,2363,-15.35,-35132.23,36272.05,1139.82
1937-06-22,15.38,0.03,0.2,31.86,-51.73,True,1,2364,-15.38,-35147.61,36358.32,1210.71
1937-06-23,15.51,0.13,0.84,31.86,-51.32,True,1,2365,-15.51,-35163.12,36681.15,1518.03
1937-06-24,15.62,0.11,0.71,31.86,-50.97,True,1,2366,-15.62,-35178.74,36956.92,1778.18
1937-06-25,15.52,-0.1,-0.64,31.86,-51.29,True,1,2367,-15.52,-35194.26,36735.84,1541.58
1937-06-28,15.12,-0.4,-2.58,31.86,-52.54,True,1,2368,-15.12,-35209.38,35804.16,594.78
1937-06-29,15.14,0.02,0.13,31.86,-52.48,True,1,2369,-15.14,-35224.52,35866.66,642.14
1937-06-30,15.4,0.26,1.72,31.86,-51.66,True,1,2370,-15.4,-35239.92,36498.0,1258.08
1937-07-01,15.47,0.07,0.46,31.86,-51.44,True,1,2371,-15.47,-35255.39,36679.37,1423.98
1937-07-02,15.7,0.23,1.49,31.86,-50.72,True,1,2372,-15.7,-35271.09,37240.4,1969.31
1937-07-06,16.25,0.55,3.5,31.86,-49.0,True,1,2373,-16.25,-35287.34,38561.25,3273.91
1937-07-07,16.37,0.12,0.74,31.86,-48.62,True,1,2374,-16.37,-35303.71,38862.38,3558.67
1937-07-08,16.4,0.03,0.18,31.86,-48.52,True,1,2375,-16.4,-35320.11,38950.0,3629.89
1937-07-09,16.32,-0.08,-0.49,31.86,-48.78,True,1,2376,-16.32,-35336.43,38776.32,3439.89
1937-07-12,16.54,0.22,1.35,31.86,-48.08,True,1,2377,-16.54,-35352.97,39315.58,3962.61
1937-07-13,16.4,-0.14,-0.85,31.86,-48.52,True,1,2378,-16.4,-35369.37,38999.2,3629.83
1937-07-14,16.38,-0.02,-0.12,31.86,-48.59,True,1,2379,-16.38,-35385.75,38968.02,3582.27
1937-07-15,16.46,0.08,0.49,31.86,-48.34,True,1,2380,-16.46,-35402.21,39174.8,3772.59
1937-07-16,16.42,-0.04,-0.24,31.86,-48.46,True,1,2381,-16.42,-35418.63,39096.02,3677.39
1937-07-19,16.74,0.32,1.95,31.86,-47.46,True,1,2382,-16.74,-35435.37,39874.68,4439.31
1937-07-20,16.94,0.2,1.2,31.86,-46.83,True,1,2383,-16.94,-35452.31,40368.02,4915.71
1937-07-21,16.82,-0.12,-0.71,31.86,-47.21,True,1,2384,-16.82,-35469.13,40098.88,4629.75
1937-07-22,16.87,0.05,0.3,31.86,-47.05,True,1,2385,-16.87,-35486.0,40234.95,4748.95
1937-07-23,16.94,0.07,0.42,31.86,-46.83,True,1,2386,-16.94,-35502.94,40418.84,4915.9
1937-07-26,17.06,0.12,0.71,31.86,-46.45,True,1,2387,-17.06,-35520.0,40722.22,5202.22
1937-07-27,17.04,-0.02,-0.12,31.86,-46.52,True,1,2388,-17.04,-35537.04,40691.52,5154.48
1937-07-28,16.78,-0.26,-1.53,31.86,-47.33,True,1,2389,-16.78,-35553.82,40087.42,4533.6
1937-07-29,16.72,-0.06,-0.36,31.86,-47.52,True,1,2390,-16.72,-35570.54,39960.8,4390.26
1937-07-30,16.77,0.05,0.3,31.86,-47.36,True,1,2391,-16.77,-35587.31,40097.07,4509.76
1937-08-02,17.07,0.3,1.79,31.86,-46.42,True,1,2392,-17.07,-35604.38,40831.44,5227.06
1937-08-03,16.93,-0.14,-0.82,31.86,-46.86,True,1,2393,-16.93,-35621.31,40513.49,4892.18
1937-08-04,17.02,0.09,0.53,31.86,-46.58,True,1,2394,-17.02,-35638.33,40745.88,5107.55
1937-08-05,16.91,-0.11,-0.65,31.86,-46.92,True,1,2395,-16.91,-35655.24,40499.45,4844.21
1937-08-06,16.85,-0.06,-0.36,31.86,-47.11,True,1,2396,-16.85,-35672.09,40372.6,4700.51
1937-08-09,17.07,0.22,1.31,31.86,-46.42,True,1,2397,-17.07,-35689.16,40916.79,5227.63
1937-08-10,17.04,-0.03,-0.18,31.86,-46.52,True,1,2398,-17.04,-35706.2,40861.92,5155.72
1937-08-11,17.01,-0.03,-0.18,31.86,-46.61,True,1,2399,-17.01,-35723.21,40806.99,5083.78
1937-08-12,17.1,0.09,0.53,31.86,-46.33,True,1,2400,-17.1,-35740.31,41040.0,5299.69
1937-08-13,17.27,0.17,0.99,31.86,-45.79,True,1,2401,-17.27,-35757.58,41465.27,5707.69
1937-08-16,17.17,-0.1,-0.58,31.86,-46.11,True,1,2402,-17.17,-35774.75,41242.34,5467.59
1937-08-17,17.07,-0.1,-0.58,31.86,-46.42,True,1,2403,-17.07,-35791.82,41019.21,5227.39
1937-08-18,16.91,-0.16,-0.94,31.86,-46.92,True,1,2404,-16.91,-35808.73,40651.64,4842.91
1937-08-19,16.66,-0.25,-1.48,31.86,-47.71,True,1,2405,-16.66,-35825.39,40067.3,4241.91
1937-08-20,16.49,-0.17,-1.02,31.86,-48.24,True,1,2406,-16.49,-35841.88,39674.94,3833.06
1937-08-23,16.46,-0.03,-0.18,31.86,-48.34,True,1,2407,-16.46,-35858.34,39619.22,3760.88
1937-08-24,16.59,0.13,0.79,31.86,-47.93,True,1,2408,-16.59,-35874.93,39948.72,4073.79
1937-08-25,16.47,-0.12,-0.72,31.86,-48.3,True,1,2409,-16.47,-35891.4,39676.23,3784.83
1937-08-26,16.15,-0.32,-1.94,31.86,-49.31,True,1,2410,-16.15,-35907.55,38921.5,3013.95
1937-08-27,15.88,-0.27,-1.67,31.86,-50.16,True,1,2411,-15.88,-35923.43,38286.68,2363.25
1937-08-30,16.12,0.24,1.51,31.86,-49.4,True,1,2412,-16.12,-35939.55,38881.44,2941.89
1937-08-31,16.04,-0.08,-0.5,31.86,-49.66,True,1,2413,-16.04,-35955.59,38704.52,2748.93
1937-09-01,15.61,-0.43,-2.68,31.86,-51.0,True,1,2414,-15.61,-35971.2,37682.54,1711.34
1937-09-02,15.36,-0.25,-1.6,31.86,-51.79,True,1,2415,-15.36,-35986.56,37094.4,1107.84
1937-09-03,15.46,0.1,0.65,31.86,-51.48,True,1,2416,-15.46,-36002.02,37351.36,1349.34
1937-09-07,14.69,-0.77,-4.98,31.86,-53.89,True,1,2417,-14.69,-36016.71,35505.73,-510.98
1937-09-08,14.61,-0.08,-0.55,31.86,-54.14,True,1,2418,-14.61,-36031.32,35326.98,-704.34
1937-09-09,14.98,0.37,2.53,31.86,-52.98,True,1,2419,-14.98,-36046.3,36236.62,190.32
1937-09-10,14.19,-0.79,-5.27,31.86,-55.46,True,1,2420,-14.19,-36060.49,34339.8,-1720.69
1937-09-13,14.23,0.04,0.28,31.86,-55.34,True,1,2421,-14.23,-36074.72,34450.83,-1623.89
1937-09-14,14.68,0.45,3.16,31.86,-53.92,True,1,2422,-14.68,-36089.4,35554.96,-534.44
1937-09-15,14.61,-0.07,-0.48,31.86,-54.14,True,1,2423,-14.61,-36104.01,35400.03,-703.98
1937-09-16,14.89,0.28,1.92,31.86,-53.26,True,1,2424,-14.89,-36118.9,36093.36,-25.54
1937-09-17,14.57,-0.32,-2.15,31.86,-54.27,True,1,2425,-14.57,-36133.47,35332.25,-801.22
1937-09-20,13.94,-0.63,-4.32,31.86,-56.25,True,1,2426,-13.94,-36147.41,33818.44,-2328.97
1937-09-21,14.08,0.14,1.0,31.86,-55.81,True,1,2427,-14.08,-36161.49,34172.16,-1989.33
1937-09-22,14.14,0.06,0.43,31.86,-55.62,True,1,2428,-14.14,-36175.63,34331.92,-1843.71
1937-09-23,13.79,-0.35,-2.48,31.86,-56.72,True,1,2429,-13.79,-36189.42,33495.91,-2693.51
1937-09-24,13.2,-0.59,-4.28,31.86,-58.57,True,1,2430,-13.2,-36202.62,32076.0,-4126.62
1937-09-27,13.63,0.43,3.26,31.86,-57.22,True,1,2431,-13.63,-36216.25,33134.53,-3081.72
1937-09-28,13.72,0.09,0.66,31.86,-56.94,True,1,2432,-13.72,-36229.97,33367.04,-2862.93
1937-09-29,13.79,0.07,0.51,31.86,-56.72,True,1,2433,-13.79,-36243.76,33551.07,-2692.69
1937-09-30,13.76,-0.03,-0.22,31.86,-56.81,True,1,2434,-13.76,-36257.52,33491.84,-2765.68
1937-10-01,13.72,-0.04,-0.29,31.86,-56.94,True,1,2435,-13.72,-36271.24,33408.2,-2863.04
1937-10-04,13.59,-0.13,-0.95,31.86,-57.34,True,1,2436,-13.59,-36284.83,33105.24,-3179.59
1937-10-05,12.85,-0.74,-5.44,31.86,-59.67,True,1,2437,-12.85,-36297.68,31315.45,-4982.23
1937-10-06,13.16,0.31,2.41,31.86,-58.69,True,1,2438,-13.16,-36310.84,32084.08,-4226.76
1937-10-07,13.06,-0.1,-0.76,31.86,-59.01,True,1,2439,-13.06,-36323.9,31853.34,-4470.56
1937-10-08,12.75,-0.31,-2.37,31.86,-59.98,True,1,2440,-12.75,-36336.65,31110.0,-5226.65
1937-10-11,12.22,-0.53,-4.16,31.86,-61.64,True,1,2441,-12.22,-36348.87,29829.02,-6519.85
1937-10-13,12.21,-0.01,-0.08,31.86,-61.68,True,1,2442,-12.21,-36361.08,29816.82,-6544.26
1937-10-14,11.97,-0.24,-1.97,31.86,-62.43,True,1,2443,-11.97,-36373.05,29242.71,-7130.34
1937-10-15,11.84,-0.13,-1.09,31.86,-62.84,True,1,2444,-11.84,-36384.89,28936.96,-7447.93
1937-10-18,10.76,-1.08,-9.12,31.86,-66.23,True,1,2445,-10.76,-36395.65,26308.2,-10087.45
1937-10-19,11.1,0.34,3.16,31.86,-65.16,True,1,2446,-11.1,-36406.75,27150.6,-9256.15
1937-10-20,11.93,0.83,7.48,31.86,-62.56,True,1,2447,-11.93,-36418.68,29192.71,-7225.97
1937-10-21,12.17,0.24,2.01,31.86,-61.8,True,1,2448,-12.17,-36430.85,29792.16,-6638.69
1937-10-22,11.84,-0.33,-2.71,31.86,-62.84,True,1,2449,-11.84,-36442.69,28996.16,-7446.53
1937-10-25,12.0,0.16,1.35,31.86,-62.34,True,1,2450,-12.0,-36454.69,29400.0,-7054.69
1937-10-26,11.74,-0.26,-2.17,31.86,-63.15,True,1,2451,-11.74,-36466.43,28774.74,-7691.69
1937-10-27,11.76,0.02,0.17,31.86,-63.09,True,1,2452,-11.76,-36478.19,28835.52,-7642.67
1937-10-28,12.05,0.29,2.47,31.86,-62.18,True,1,2453,-12.05,-36490.24,29558.65,-6931.59
1937-10-29,12.35,0.3,2.49,31.86,-61.24,True,1,2454,-12.35,-36502.59,30306.9,-6195.69
1937-11-01,12.08,-0.27,-2.19,31.86,-62.08,True,1,2455,-12.08,-36514.67,29656.4,-6858.27
1937-11-03,11.52,-0.56,-4.64,31.86,-63.84,True,1,2456,-11.52,-36526.19,28293.12,-8233.07
1937-11-04,11.46,-0.06,-0.52,31.86,-64.03,True,1,2457,-11.46,-36537.65,28157.22,-8380.43
1937-11-05,11.46,0.0,0.0,31.86,-64.03,True,1,2458,-11.46,-36549.11,28168.68,-8380.43
1937-11-08,11.12,-0.34,-2.97,31.86,-65.1,True,1,2459,-11.12,-36560.23,27344.08,-9216.15
1937-11-09,11.35,0.23,2.07,31.86,-64.38,True,1,2460,-11.35,-36571.58,27921.0,-8650.58
1937-11-10,11.96,0.61,5.37,31.86,-62.46,True,1,2461,-11.96,-36583.54,29433.56,-7149.98
1937-11-12,11.91,-0.05,-0.42,31.86,-62.62,True,1,2462,-11.91,-36595.45,29322.42,-7273.03
1937-11-15,11.53,-0.38,-3.19,31.86,-63.81,True,1,2463,-11.53,-36606.98,28398.39,-8208.59
1937-11-16,11.48,-0.05,-0.43,31.86,-63.97,True,1,2464,-11.48,-36618.46,28286.72,-8331.74
1937-11-17,11.39,-0.09,-0.78,31.86,-64.25,True,1,2465,-11.39,-36629.85,28076.35,-8553.5
1937-11-18,11.16,-0.23,-2.02,31.86,-64.97,True,1,2466,-11.16,-36641.01,27520.56,-9120.45
1937-11-19,10.51,-0.65,-5.82,31.86,-67.01,True,1,2467,-10.51,-36651.52,25928.17,-10723.35
1937-11-22,10.25,-0.26,-2.47,31.86,-67.83,True,1,2468,-10.25,-36661.77,25297.0,-11364.77
1937-11-23,10.43,0.18,1.76,31.86,-67.26,True,1,2469,-10.43,-36672.2,25751.67,-10920.53
1937-11-24,10.17,-0.26,-2.49,31.86,-68.08,True,1,2470,-10.17,-36682.37,25119.9,-11562.47
1937-11-26,10.67,0.5,4.92,31.86,-66.51,True,1,2471,-10.67,-36693.04,26365.57,-10327.47
1937-11-29,10.96,0.29,2.72,31.86,-65.6,True,1,2472,-10.96,-36704.0,27093.12,-9610.88
1937-11-30,11.11,0.15,1.37,31.86,-65.13,True,1,2473,-11.11,-36715.11,27475.03,-9240.08
1937-12-01,10.97,-0.14,-1.26,31.86,-65.57,True,1,2474,-10.97,-36726.08,27139.78,-9586.3
1937-12-02,11.19,0.22,2.0,31.86,-64.88,True,1,2475,-11.19,-36737.27,27695.25,-9042.02
1937-12-03,11.34,0.15,1.34,31.86,-64.41,True,1,2476,-11.34,-36748.61,28077.84,-8670.77
1937-12-06,11.13,-0.21,-1.85,31.86,-65.07,True,1,2477,-11.13,-36759.74,27569.01,-9190.73
1937-12-07,11.32,0.19,1.71,31.86,-64.47,True,1,2478,-11.32,-36771.06,28050.96,-8720.1
1937-12-08,11.42,0.1,0.88,31.86,-64.16,True,1,2479,-11.42,-36782.48,28310.18,-8472.3
1937-12-09,11.21,-0.21,-1.84,31.86,-64.82,True,1,2480,-11.21,-36793.69,27800.8,-8992.89
1937-12-10,11.1,-0.11,-0.98,31.86,-65.16,True,1,2481,-11.1,-36804.79,27539.1,-9265.69
1937-12-13,10.74,-0.36,-3.24,31.86,-66.29,True,1,2482,-10.74,-36815.53,26656.68,-10158.85
1937-12-14,10.83,0.09,0.84,31.86,-66.01,True,1,2483,-10.83,-36826.36,26890.89,-9935.47
1937-12-15,10.91,0.08,0.74,31.86,-65.76,True,1,2484,-10.91,-36837.27,27100.44,-9736.83
1937-12-16,11.08,0.17,1.56,31.86,-65.22,True,1,2485,-11.08,-36848.35,27533.8,-9314.55
1937-12-17,11.0,-0.08,-0.72,31.86,-65.47,True,1,2486,-11.0,-36859.35,27346.0,-9513.35
1937-12-20,11.31,0.31,2.82,31.86,-64.5,True,1,2487,-11.31,-36870.66,28127.97,-8742.69
1937-12-21,11.38,0.07,0.62,31.86,-64.28,True,1,2488,-11.38,-36882.04,28313.44,-8568.6
1937-12-22,11.18,-0.2,-1.76,31.86,-64.91,True,1,2489,-11.18,-36893.22,27827.02,-9066.2
1937-12-23,11.12,-0.06,-0.54,31.86,-65.1,True,1,2490,-11.12,-36904.34,27688.8,-9215.54
1937-12-24,11.06,-0.06,-0.54,31.86,-65.29,True,1,2491,-11.06,-36915.4,27550.46,-9364.94
1937-12-27,10.69,-0.37,-3.34,31.86,-66.45,True,1,2492,-10.69,-36926.09,26639.48,-10286.61
1937-12-28,10.31,-0.38,-3.56,31.86,-67.64,True,1,2493,-10.31,-36936.4,25702.83,-11233.57
1937-12-29,10.42,0.11,1.07,31.86,-67.29,True,1,2494,-10.42,-36946.82,25987.48,-10959.34
1937-12-30,10.56,0.14,1.34,31.86,-66.86,True,1,2495,-10.56,-36957.38,26347.2,-10610.18
1937-12-31,10.55,-0.01,-0.1,31.86,-66.89,True,1,2496,-10.55,-36967.93,26332.8,-10635.13
1938-01-03,10.52,-0.03,-0.28,31.86,-66.98,True,1,2497,-10.52,-36978.45,26268.44,-10710.01
1938-01-04,10.99,0.47,4.47,31.86,-65.5,True,1,2498,-10.99,-36989.44,27453.02,-9536.42
1938-01-05,10.92,-0.07,-0.64,31.86,-65.72,True,1,2499,-10.92,-37000.36,27289.08,-9711.28
1938-01-06,11.74,0.82,7.51,31.86,-63.15,True,1,2500,-11.74,-37012.1,29350.0,-7662.1
1938-01-07,11.32,-0.42,-3.58,31.86,-64.47,True,1,2501,-11.32,-37023.42,28311.32,-8712.1
1938-01-10,11.87,0.55,4.86,31.86,-62.74,True,1,2502,-11.87,-37035.29,29698.74,-7336.55
1938-01-11,11.95,0.08,0.67,31.86,-62.49,True,1,2503,-11.95,-37047.24,29910.85,-7136.39
1938-01-12,11.84,-0.11,-0.92,31.86,-62.84,True,1,2504,-11.84,-37059.08,29647.36,-7411.72
1938-01-13,11.67,-0.17,-1.44,31.86,-63.37,True,1,2505,-11.67,-37070.75,29233.35,-7837.4
1938-01-14,11.7,0.03,0.26,31.86,-63.28,True,1,2506,-11.7,-37082.45,29320.2,-7762.25
1938-01-17,11.67,-0.03,-0.26,31.86,-63.37,True,1,2507,-11.67,-37094.12,29256.69,-7837.43
1938-01-18,11.55,-0.12,-1.03,31.86,-63.75,True,1,2508,-11.55,-37105.67,28967.4,-8138.27
1938-01-19,11.45,-0.1,-0.87,31.86,-64.06,True,1,2509,-11.45,-37117.12,28728.05,-8389.07
1938-01-20,11.66,0.21,1.83,31.86,-63.4,True,1,2510,-11.66,-37128.78,29266.6,-7862.18
1938-01-21,11.44,-0.22,-1.89,31.86,-64.09,True,1,2511,-11.44,-37140.22,28725.84,-8414.38
1938-01-24,11.4,-0.04,-0.35,31.86,-64.22,True,1,2512,-11.4,-37151.62,28636.8,-8514.82
1938-01-25,11.22,-0.18,-1.58,31.86,-64.78,True,1,2513,-11.22,-37162.84,28195.86,-8966.98
1938-01-26,10.79,-0.43,-3.83,31.86,-66.13,True,1,2514,-10.79,-37173.63,27126.06,-10047.57
1938-01-27,10.64,-0.15,-1.39,31.86,-66.6,True,1,2515,-10.64,-37184.27,26759.6,-10424.67
1938-01-28,10.55,-0.09,-0.85,31.86,-66.89,True,1,2516,-10.55,-37194.82,26543.8,-10651.02
1938-01-31,10.69,0.14,1.33,31.86,-66.45,True,1,2517,-10.69,-37205.51,26906.73,-10298.78
1938-02-01,10.89,0.2,1.87,31.86,-65.82,True,1,2518,-10.89,-37216.4,27421.02,-9795.38
1938-02-02,10.74,-0.15,-1.38,31.86,-66.29,True,1,2519,-10.74,-37227.14,27054.06,-10173.08
1938-02-03,10.34,-0.4,-3.72,31.86,-67.55,True,1,2520,-10.34,-37237.48,26056.8,-11180.68
1938-02-04,10.54,0.2,1.93,31.86,-66.92,True,1,2521,-10.54,-37248.02,26571.34,-10676.68
1938-02-07,10.56,0.02,0.19,31.86,-66.86,True,1,2522,-10.56,-37258.58,26632.32,-10626.26
1938-02-08,10.98,0.42,3.98,31.86,-65.54,True,1,2523,-10.98,-37269.56,27702.54,-9567.02
1938-02-09,10.9,-0.08,-0.73,31.86,-65.79,True,1,2524,-10.9,-37280.46,27511.6,-9768.86
1938-02-10,10.97,0.07,0.64,31.86,-65.57,True,1,2525,-10.97,-37291.43,27699.25,-9592.18
1938-02-11,10.93,-0.04,-0.36,31.86,-65.69,True,1,2526,-10.93,-37302.36,27609.18,-9693.18
1938-02-14,11.02,0.09,0.82,31.86,-65.41,True,1,2527,-11.02,-37313.38,27847.54,-9465.84
1938-02-15,10.89,-0.13,-1.18,31.86,-65.82,True,1,2528,-10.89,-37324.27,27529.92,-9794.35
1938-02-16,10.87,-0.02,-0.18,31.86,-65.88,True,1,2529,-10.87,-37335.14,27490.23,-9844.91
1938-02-17,11.15,0.28,2.58,31.86,-65.0,True,1,2530,-11.15,-37346.29,28209.5,-9136.79
1938-02-18,11.02,-0.13,-1.17,31.86,-65.41,True,1,2531,-11.02,-37357.31,27891.62,-9465.69
1938-02-21,11.38,0.36,3.27,31.86,-64.28,True,1,2532,-11.38,-37368.69,28814.16,-8554.53
1938-02-23,11.68,0.3,2.64,31.86,-63.34,True,1,2533,-11.68,-37380.37,29585.44,-7794.93
1938-02-24,11.51,-0.17,-1.46,31.86,-63.87,True,1,2534,-11.51,-37391.88,29166.34,-8225.54
1938-02-25,11.57,0.06,0.52,31.86,-63.68,True,1,2535,-11.57,-37403.45,29329.95,-8073.5
1938-02-28,11.34,-0.23,-1.99,31.86,-64.41,True,1,2536,-11.34,-37414.79,28758.24,-8656.55
1938-03-01,11.46,0.12,1.06,31.86,-64.03,True,1,2537,-11.46,-37426.25,29074.02,-8352.23
1938-03-02,11.35,-0.11,-0.96,31.86,-64.38,True,1,2538,-11.35,-37437.6,28806.3,-8631.3
1938-03-03,11.24,-0.11,-0.97,31.86,-64.72,True,1,2539,-11.24,-37448.84,28538.36,-8910.48
1938-03-04,11.13,-0.11,-0.98,31.86,-65.07,True,1,2540,-11.13,-37459.97,28270.2,-9189.77
1938-03-07,10.88,-0.25,-2.25,31.86,-65.85,True,1,2541,-10.88,-37470.85,27646.08,-9824.77
1938-03-08,10.88,0.0,0.0,31.86,-65.85,True,1,2542,-10.88,-37481.73,27656.96,-9824.77
1938-03-09,10.89,0.01,0.09,31.86,-65.82,True,1,2543,-10.89,-37492.62,27693.27,-9799.35
1938-03-10,10.77,-0.12,-1.1,31.86,-66.2,True,1,2544,-10.77,-37503.39,27398.88,-10104.51
1938-03-11,10.58,-0.19,-1.76,31.86,-66.79,True,1,2545,-10.58,-37513.97,26926.1,-10587.87
1938-03-14,10.78,0.2,1.89,31.86,-66.16,True,1,2546,-10.78,-37524.75,27445.88,-10078.87
1938-03-15,11.11,0.33,3.06,31.86,-65.13,True,1,2547,-11.11,-37535.86,28297.17,-9238.69
1938-03-16,10.62,-0.49,-4.41,31.86,-66.67,True,1,2548,-10.62,-37546.48,27059.76,-10486.72
1938-03-17,10.53,-0.09,-0.85,31.86,-66.95,True,1,2549,-10.53,-37557.01,26840.97,-10716.04
1938-03-18,10.19,-0.34,-3.23,31.86,-68.02,True,1,2550,-10.19,-37567.2,25984.5,-11582.7
1938-03-21,10.38,0.19,1.86,31.86,-67.42,True,1,2551,-10.38,-37577.58,26479.38,-11098.2
1938-03-22,10.06,-0.32,-3.08,31.86,-68.42,True,1,2552,-10.06,-37587.64,25673.12,-11914.52
1938-03-23,9.86,-0.2,-1.99,31.86,-69.05,True,1,2553,-9.86,-37597.5,25172.58,-12424.92
1938-03-24,9.89,0.03,0.3,31.86,-68.96,True,1,2554,-9.89,-37607.39,25259.06,-12348.33
1938-03-25,9.35,-0.54,-5.46,31.86,-70.65,True,1,2555,-9.35,-37616.74,23889.25,-13727.49
1938-03-28,9.27,-0.08,-0.86,31.86,-70.9,True,1,2556,-9.27,-37626.01,23694.12,-13931.89
1938-03-29,8.73,-0.54,-5.82,31.86,-72.6,True,1,2557,-8.73,-37634.74,22322.61,-15312.13
1938-03-30,8.62,-0.11,-1.26,31.86,-72.94,True,1,2558,-8.62,-37643.36,22049.96,-15593.4
1938-03-31,8.5,-0.12,-1.39,31.86,-73.32,True,1,2559,-8.5,-37651.86,21751.5,-15900.36
1938-04-01,8.91,0.41,4.82,31.86,-72.03,True,1,2560,-8.91,-37660.77,22809.6,-14851.17
1938-04-04,9.24,0.33,3.7,31.86,-71.0,True,1,2561,-9.24,-37670.01,23663.64,-14006.37
1938-04-05,9.48,0.24,2.6,31.86,-70.24,True,1,2562,-9.48,-37679.49,24287.76,-13391.73
1938-04-06,9.27,-0.21,-2.22,31.86,-70.9,True,1,2563,-9.27,-37688.76,23759.01,-13929.75
1938-04-07,9.2,-0.07,-0.76,31.86,-71.12,True,1,2564,-9.2,-37697.96,23588.8,-14109.16
1938-04-08,9.62,0.42,4.57,31.86,-69.81,True,1,2565,-9.62,-37707.58,24675.3,-13032.28
1938-04-11,9.95,0.33,3.43,31.86,-68.77,True,1,2566,-9.95,-37717.53,25531.7,-12185.83
1938-04-12,10.05,0.1,1.0,31.86,-68.46,True,1,2567,-10.05,-37727.58,25798.35,-11929.23
1938-04-13,10.1,0.05,0.5,31.86,-68.3,True,1,2568,-10.1,-37737.68,25936.8,-11800.88
1938-04-14,10.2,0.1,0.99,31.86,-67.98,True,1,2569,-10.2,-37747.88,26203.8,-11544.08
1938-04-18,10.41,0.21,2.06,31.86,-67.33,True,1,2570,-10.41,-37758.29,26753.7,-11004.59
1938-04-19,10.11,-0.3,-2.88,31.86,-68.27,True,1,2571,-10.11,-37768.4,25992.81,-11775.59
1938-04-20,10.06,-0.05,-0.5,31.86,-68.42,True,1,2572,-10.06,-37778.46,25874.32,-11904.14
1938-04-21,10.16,0.1,0.99,31.86,-68.11,True,1,2573,-10.16,-37788.62,26141.68,-11646.94
1938-04-22,10.45,0.29,2.85,31.86,-67.2,True,1,2574,-10.45,-37799.07,26898.3,-10900.77
1938-04-25,10.21,-0.24,-2.3,31.86,-67.95,True,1,2575,-10.21,-37809.28,26290.75,-11518.53
1938-04-26,9.95,-0.26,-2.55,31.86,-68.77,True,1,2576,-9.95,-37819.23,25631.2,-12188.03
1938-04-27,10.08,0.13,1.31,31.86,-68.36,True,1,2577,-10.08,-37829.31,25976.16,-11853.15
1938-04-28,9.77,-0.31,-3.08,31.86,-69.33,True,1,2578,-9.77,-37839.08,25187.06,-12652.02
1938-04-29,9.78,0.01,0.1,31.86,-69.3,True,1,2579,-9.78,-37848.86,25222.62,-12626.24
1938-05-02,9.59,-0.19,-1.94,31.86,-69.9,True,1,2580,-9.59,-37858.45,24742.2,-13116.25
1938-05-03,9.85,0.26,2.71,31.86,-69.08,True,1,2581,-9.85,-37868.3,25422.85,-12445.45
1938-05-04,10.01,0.16,1.62,31.86,-68.58,True,1,2582,-10.01,-37878.31,25845.82,-12032.49
1938-05-05,9.97,-0.04,-0.4,31.86,-68.71,True,1,2583,-9.97,-37888.28,25752.51,-12135.77
1938-05-06,10.43,0.46,4.61,31.86,-67.26,True,1,2584,-10.43,-37898.71,26951.12,-10947.59
1938-05-09,10.63,0.2,1.92,31.86,-66.64,True,1,2585,-10.63,-37909.34,27478.55,-10430.79
1938-05-10,10.43,-0.2,-1.88,31.86,-67.26,True,1,2586,-10.43,-37919.77,26971.98,-10947.79
1938-05-11,10.49,0.06,0.57,31.86,-67.08,True,1,2587,-10.49,-37930.26,27137.63,-10792.63
1938-05-12,10.43,-0.06,-0.57,31.86,-67.26,True,1,2588,-10.43,-37940.69,26992.84,-10947.85
1938-05-13,10.26,-0.17,-1.63,31.86,-67.8,True,1,2589,-10.26,-37950.95,26563.14,-11387.81
1938-05-16,10.08,-0.18,-1.75,31.86,-68.36,True,1,2590,-10.08,-37961.03,26107.2,-11853.83
1938-05-17,10.14,0.06,0.6,31.86,-68.17,True,1,2591,-10.14,-37971.17,26272.74,-11698.43
1938-05-18,10.0,-0.14,-1.38,31.86,-68.61,True,1,2592,-10.0,-37981.17,25920.0,-12061.17
1938-05-19,10.11,0.11,1.1,31.86,-68.27,True,1,2593,-10.11,-37991.28,26215.23,-11776.05
1938-05-20,9.96,-0.15,-1.48,31.86,-68.74,True,1,2594,-9.96,-38001.24,25836.24,-12165.0
1938-05-23,9.89,-0.07,-0.7,31.86,-68.96,True,1,2595,-9.89,-38011.13,25664.55,-12346.58
1938-05-24,9.71,-0.18,-1.82,31.86,-69.52,True,1,2596,-9.71,-38020.84,25207.16,-12813.68
1938-05-25,9.54,-0.17,-1.75,31.86,-70.06,True,1,2597,-9.54,-38030.38,24775.38,-13255.0
1938-05-26,9.29,-0.25,-2.62,31.86,-70.84,True,1,2598,-9.29,-38039.67,24135.42,-13904.25
1938-05-27,9.28,-0.01,-0.11,31.86,-70.87,True,1,2599,-9.28,-38048.95,24118.72,-13930.23
1938-05-31,9.27,-0.01,-0.11,31.86,-70.9,True,1,2600,-9.27,-38058.22,24102.0,-13956.22
1938-06-01,9.57,0.3,3.24,31.86,-69.96,True,1,2601,-9.57,-38067.79,24891.57,-13176.22
1938-06-02,9.54,-0.03,-0.31,31.86,-70.06,True,1,2602,-9.54,-38077.33,24823.08,-13254.25
1938-06-03,9.42,-0.12,-1.26,31.86,-70.43,True,1,2603,-9.42,-38086.75,24520.26,-13566.49
1938-06-06,9.74,0.32,3.4,31.86,-69.43,True,1,2604,-9.74,-38096.49,25362.96,-12733.53
1938-06-07,9.7,-0.04,-0.41,31.86,-69.55,True,1,2605,-9.7,-38106.19,25268.5,-12837.69
1938-06-08,9.73,0.03,0.31,31.86,-69.46,True,1,2606,-9.73,-38115.92,25356.38,-12759.54
1938-06-09,9.94,0.21,2.16,31.86,-68.8,True,1,2607,-9.94,-38125.86,25913.58,-12212.28
1938-06-10,9.8,-0.14,-1.41,31.86,-69.24,True,1,2608,-9.8,-38135.66,25558.4,-12577.26
1938-06-13,9.52,-0.28,-2.86,31.86,-70.12,True,1,2609,-9.52,-38145.18,24837.68,-13307.5
1938-06-14,9.63,0.11,1.16,31.86,-69.77,True,1,2610,-9.63,-38154.81,25134.3,-13020.51
1938-06-15,9.67,0.04,0.42,31.86,-69.65,True,1,2611,-9.67,-38164.48,25248.37,-12916.11
1938-06-16,9.76,0.09,0.93,31.86,-69.37,True,1,2612,-9.76,-38174.24,25493.12,-12681.12
1938-06-17,9.67,-0.09,-0.92,31.86,-69.65,True,1,2613,-9.67,-38183.91,25267.71,-12916.2
1938-06-20,10.19,0.52,5.38,31.86,-68.02,True,1,2614,-10.19,-38194.1,26636.66,-11557.44
1938-06-21,10.46,0.27,2.65,31.86,-67.17,True,1,2615,-10.46,-38204.56,27352.9,-10851.66
1938-06-22,10.73,0.27,2.58,31.86,-66.32,True,1,2616,-10.73,-38215.29,28069.68,-10145.61
1938-06-23,11.03,0.3,2.8,31.86,-65.38,True,1,2617,-11.03,-38226.32,28865.51,-9360.81
1938-06-24,11.15,0.12,1.09,31.86,-65.0,True,1,2618,-11.15,-38237.47,29190.7,-9046.77
1938-06-27,11.26,0.11,0.99,31.86,-64.66,True,1,2619,-11.26,-38248.73,29489.94,-8758.79
1938-06-28,11.25,-0.01,-0.09,31.86,-64.69,True,1,2620,-11.25,-38259.98,29475.0,-8784.98
1938-06-29,11.72,0.47,4.18,31.86,-63.21,True,1,2621,-11.72,-38271.7,30718.12,-7553.58
1938-06-30,11.56,-0.16,-1.36,31.86,-63.72,True,1,2622,-11.56,-38283.26,30310.32,-7972.94
1938-07-01,11.91,0.35,3.03,31.86,-62.62,True,1,2623,-11.91,-38295.17,31239.93,-7055.24
1938-07-05,11.98,0.07,0.59,31.86,-62.4,True,1,2624,-11.98,-38307.15,31435.52,-6871.63
1938-07-06,12.14,0.16,1.34,31.86,-61.9,True,1,2625,-12.14,-38319.29,31867.5,-6451.79
1938-07-07,12.09,-0.05,-0.41,31.86,-62.05,True,1,2626,-12.09,-38331.38,31748.34,-6583.04
1938-07-08,11.89,-0.2,-1.65,31.86,-62.68,True,1,2627,-11.89,-38343.27,31235.03,-7108.24
1938-07-11,11.73,-0.16,-1.35,31.86,-63.18,True,1,2628,-11.73,-38355.0,30826.44,-7528.56
1938-07-12,12.04,0.31,2.64,31.86,-62.21,True,1,2629,-12.04,-38367.04,31653.16,-6713.88
1938-07-13,11.95,-0.09,-0.75,31.86,-62.49,True,1,2630,-11.95,-38378.99,31428.5,-6950.49
1938-07-14,11.84,-0.11,-0.92,31.86,-62.84,True,1,2631,-11.84,-38390.83,31151.04,-7239.79
1938-07-15,12.0,0.16,1.35,31.86,-62.34,True,1,2632,-12.0,-38402.83,31584.0,-6818.83
1938-07-18,12.35,0.35,2.92,31.86,-61.24,True,1,2633,-12.35,-38415.18,32517.55,-5897.63
1938-07-19,12.67,0.32,2.59,31.86,-60.23,True,1,2634,-12.67,-38427.85,33372.78,-5055.07
1938-07-20,12.53,-0.14,-1.1,31.86,-60.67,True,1,2635,-12.53,-38440.38,33016.55,-5423.83
1938-07-21,12.54,0.01,0.08,31.86,-60.64,True,1,2636,-12.54,-38452.92,33055.44,-5397.48
1938-07-22,12.55,0.01,0.08,31.86,-60.61,True,1,2637,-12.55,-38465.47,33094.35,-5371.12
1938-07-25,12.8,0.25,1.99,31.86,-59.82,True,1,2638,-12.8,-38478.27,33766.4,-4711.87
1938-07-26,12.62,-0.18,-1.41,31.86,-60.39,True,1,2639,-12.62,-38490.89,33304.18,-5186.71
1938-07-27,12.25,-0.37,-2.93,31.86,-61.55,True,1,2640,-12.25,-38503.14,32340.0,-6163.14
1938-07-28,12.48,0.23,1.88,31.86,-60.83,True,1,2641,-12.48,-38515.62,32959.68,-5555.94
1938-07-29,12.33,-0.15,-1.2,31.86,-61.3,True,1,2642,-12.33,-38527.95,32575.86,-5952.09
1938-08-01,12.25,-0.08,-0.65,31.86,-61.55,True,1,2643,-12.25,-38540.2,32376.75,-6163.45
1938-08-02,12.41,0.16,1.31,31.86,-61.05,True,1,2644,-12.41,-38552.61,32812.04,-5740.57
1938-08-03,12.3,-0.11,-0.89,31.86,-61.39,True,1,2645,-12.3,-38564.91,32533.5,-6031.41
1938-08-04,12.38,0.08,0.65,31.86,-61.14,True,1,2646,-12.38,-38577.29,32757.48,-5819.81
1938-08-05,12.66,0.28,2.26,31.86,-60.26,True,1,2647,-12.66,-38589.95,33511.02,-5078.93
1938-08-08,12.73,0.07,0.55,31.86,-60.04,True,1,2648,-12.73,-38602.68,33709.04,-4893.64
1938-08-09,12.65,-0.08,-0.63,31.86,-60.3,True,1,2649,-12.65,-38615.33,33509.85,-5105.48
1938-08-10,12.49,-0.16,-1.26,31.86,-60.8,True,1,2650,-12.49,-38627.82,33098.5,-5529.32
1938-08-11,12.17,-0.32,-2.56,31.86,-61.8,True,1,2651,-12.17,-38639.99,32262.67,-6377.32
1938-08-12,11.92,-0.25,-2.05,31.86,-62.59,True,1,2652,-11.92,-38651.91,31611.84,-7040.07
1938-08-15,11.92,0.0,0.0,31.86,-62.59,True,1,2653,-11.92,-38663.83,31623.76,-7040.07
1938-08-16,12.08,0.16,1.34,31.86,-62.08,True,1,2654,-12.08,-38675.91,32060.32,-6615.59
1938-08-17,12.1,0.02,0.17,31.86,-62.02,True,1,2655,-12.1,-38688.01,32125.5,-6562.51
1938-08-18,12.09,-0.01,-0.08,31.86,-62.05,True,1,2656,-12.09,-38700.1,32111.04,-6589.06
1938-08-19,12.31,0.22,1.82,31.86,-61.36,True,1,2657,-12.31,-38712.41,32707.67,-6004.74
1938-08-22,12.27,-0.04,-0.32,31.86,-61.49,True,1,2658,-12.27,-38724.68,32613.66,-6111.02
1938-08-23,12.55,0.28,2.28,31.86,-60.61,True,1,2659,-12.55,-38737.23,33370.45,-5366.78
1938-08-24,12.52,-0.03,-0.24,31.86,-60.7,True,1,2660,-12.52,-38749.75,33303.2,-5446.55
1938-08-25,12.62,0.1,0.8,31.86,-60.39,True,1,2661,-12.62,-38762.37,33581.82,-5180.55
1938-08-26,12.5,-0.12,-0.95,31.86,-60.77,True,1,2662,-12.5,-38774.87,33275.0,-5499.87
1938-08-29,11.85,-0.65,-5.2,31.86,-62.81,True,1,2663,-11.85,-38786.72,31556.55,-7230.17
1938-08-30,12.04,0.19,1.6,31.86,-62.21,True,1,2664,-12.04,-38798.76,32074.56,-6724.2
1938-08-31,12.06,0.02,0.17,31.86,-62.15,True,1,2665,-12.06,-38810.82,32139.9,-6670.92
1938-09-01,11.92,-0.14,-1.16,31.86,-62.59,True,1,2666,-11.92,-38822.74,31778.72,-7044.02
1938-09-02,12.26,0.34,2.85,31.86,-61.52,True,1,2667,-12.26,-38835.0,32697.42,-6137.58
1938-09-06,12.22,-0.04,-0.33,31.86,-61.64,True,1,2668,-12.22,-38847.22,32602.96,-6244.26
1938-09-07,12.41,0.19,1.56,31.86,-61.05,True,1,2669,-12.41,-38859.63,33122.29,-5737.34
1938-09-08,12.29,-0.12,-0.97,31.86,-61.42,True,1,2670,-12.29,-38871.92,32814.3,-6057.62
1938-09-09,12.02,-0.27,-2.2,31.86,-62.27,True,1,2671,-12.02,-38883.94,32105.42,-6778.52
1938-09-12,12.06,0.04,0.33,31.86,-62.15,True,1,2672,-12.06,-38896.0,32224.32,-6671.68
1938-09-13,11.37,-0.69,-5.72,31.86,-64.31,True,1,2673,-11.37,-38907.37,30392.01,-8515.36
1938-09-14,11.3,-0.07,-0.62,31.86,-64.53,True,1,2674,-11.3,-38918.67,30216.2,-8702.47
1938-09-15,11.67,0.37,3.27,31.86,-63.37,True,1,2675,-11.67,-38930.34,31217.25,-7713.09
1938-09-16,11.43,-0.24,-2.06,31.86,-64.12,True,1,2676,-11.43,-38941.77,30586.68,-8355.09
1938-09-19,11.5,0.07,0.61,31.86,-63.9,True,1,2677,-11.5,-38953.27,30785.5,-8167.77
1938-09-20,11.89,0.39,3.39,31.86,-62.68,True,1,2678,-11.89,-38965.16,31841.42,-7123.74
1938-09-21,11.96,0.07,0.59,31.86,-62.46,True,1,2679,-11.96,-38977.12,32040.84,-6936.28
1938-09-22,11.75,-0.21,-1.76,31.86,-63.12,True,1,2680,-11.75,-38988.87,31490.0,-7498.87
1938-09-23,11.36,-0.39,-3.32,31.86,-64.34,True,1,2681,-11.36,-39000.23,30456.16,-8544.07
1938-09-26,11.02,-0.34,-2.99,31.86,-65.41,True,1,2682,-11.02,-39011.25,29555.64,-9455.61
1938-09-27,10.99,-0.03,-0.27,31.86,-65.5,True,1,2683,-10.99,-39022.24,29486.17,-9536.07
1938-09-28,11.48,0.49,4.46,31.86,-63.97,True,1,2684,-11.48,-39033.72,30812.32,-8221.4
1938-09-29,11.9,0.42,3.66,31.86,-62.65,True,1,2685,-11.9,-39045.62,31951.5,-7094.12
1938-09-30,12.24,0.34,2.86,31.86,-61.58,True,1,2686,-12.24,-39057.86,32876.64,-6181.22
1938-10-03,12.52,0.28,2.29,31.86,-60.7,True,1,2687,-12.52,-39070.38,33641.24,-5429.14
1938-10-04,12.48,-0.04,-0.32,31.86,-60.83,True,1,2688,-12.48,-39082.86,33546.24,-5536.62
1938-10-05,12.86,0.38,3.04,31.86,-59.64,True,1,2689,-12.86,-39095.72,34580.54,-4515.18
1938-10-06,12.82,-0.04,-0.31,31.86,-59.76,True,1,2690,-12.82,-39108.54,34485.8,-4622.74
1938-10-07,12.85,0.03,0.23,31.86,-59.67,True,1,2691,-12.85,-39121.39,34579.35,-4542.04
1938-10-10,13.91,1.06,8.25,31.86,-56.34,True,1,2692,-13.91,-39135.3,37445.72,-1689.58
1938-10-11,12.84,-1.07,-7.69,31.86,-59.7,True,1,2693,-12.84,-39148.14,34578.12,-4570.02
1938-10-13,13.24,0.4,3.12,31.86,-58.44,True,1,2694,-13.24,-39161.38,35668.56,-3492.82
1938-10-14,13.15,-0.09,-0.68,31.86,-58.73,True,1,2695,-13.15,-39174.53,35439.25,-3735.28
1938-10-17,13.07,-0.08,-0.61,31.86,-58.98,True,1,2696,-13.07,-39187.6,35236.72,-3950.88
1938-10-18,13.25,0.18,1.38,31.86,-58.41,True,1,2697,-13.25,-39200.85,35735.25,-3465.6
1938-10-19,13.01,-0.24,-1.81,31.86,-59.16,True,1,2698,-13.01,-39213.86,35100.98,-4112.88
1938-10-20,13.21,0.2,1.54,31.86,-58.54,True,1,2699,-13.21,-39227.07,35653.79,-3573.28
1938-10-21,13.25,0.04,0.3,31.86,-58.41,True,1,2700,-13.25,-39240.32,35775.0,-3465.32
1938-10-24,13.4,0.15,1.13,31.86,-57.94,True,1,2701,-13.4,-39253.72,36193.4,-3060.32
1938-10-25,13.43,0.03,0.22,31.86,-57.85,True,1,2702,-13.43,-39267.15,36287.86,-2979.29
1938-10-26,13.26,-0.17,-1.27,31.86,-58.38,True,1,2703,-13.26,-39280.41,35841.78,-3438.63
1938-10-27,13.33,0.07,0.53,31.86,-58.16,True,1,2704,-13.33,-39293.74,36044.32,-3249.42
1938-10-28,13.14,-0.19,-1.42,31.86,-58.76,True,1,2705,-13.14,-39306.88,35543.7,-3763.18
1938-10-31,13.17,0.03,0.23,31.86,-58.66,True,1,2706,-13.17,-39320.05,35638.02,-3682.03
1938-11-01,13.1,-0.07,-0.53,31.86,-58.88,True,1,2707,-13.1,-39333.15,35461.7,-3871.45
1938-11-02,13.15,0.05,0.38,31.86,-58.73,True,1,2708,-13.15,-39346.3,35610.2,-3736.1
1938-11-03,13.19,0.04,0.3,31.86,-58.6,True,1,2709,-13.19,-39359.49,35731.71,-3627.78
1938-11-04,13.17,-0.02,-0.15,31.86,-58.66,True,1,2710,-13.17,-39372.66,35690.7,-3681.96
1938-11-07,13.43,0.26,1.97,31.86,-57.85,True,1,2711,-13.43,-39386.09,36408.73,-2977.36
1938-11-09,13.79,0.36,2.68,31.86,-56.72,True,1,2712,-13.79,-39399.88,37398.48,-2001.4
1938-11-10,13.7,-0.09,-0.65,31.86,-57.0,True,1,2713,-13.7,-39413.58,37168.1,-2245.48
1938-11-14,13.43,-0.27,-1.97,31.86,-57.85,True,1,2714,-13.43,-39427.01,36449.02,-2977.99
1938-11-15,13.35,-0.08,-0.6,31.86,-58.1,True,1,2715,-13.35,-39440.36,36245.25,-3195.11
1938-11-16,12.97,-0.38,-2.85,31.86,-59.29,True,1,2716,-12.97,-39453.33,35226.52,-4226.81
1938-11-17,13.12,0.15,1.16,31.86,-58.82,True,1,2717,-13.12,-39466.45,35647.04,-3819.41
1938-11-18,12.84,-0.28,-2.13,31.86,-59.7,True,1,2718,-12.84,-39479.29,34899.12,-4580.17
1938-11-21,12.88,0.04,0.31,31.86,-59.57,True,1,2719,-12.88,-39492.17,35020.72,-4471.45
1938-11-22,12.77,-0.11,-0.85,31.86,-59.92,True,1,2720,-12.77,-39504.94,34734.4,-4770.54
1938-11-23,12.8,0.03,0.24,31.86,-59.82,True,1,2721,-12.8,-39517.74,34828.8,-4688.94
1938-11-25,12.82,0.02,0.16,31.86,-59.76,True,1,2722,-12.82,-39530.56,34896.04,-4634.52
1938-11-28,12.37,-0.45,-3.51,31.86,-61.17,True,1,2723,-12.37,-39542.93,33683.51,-5859.42
1938-11-29,12.43,0.06,0.48,31.86,-60.99,True,1,2724,-12.43,-39555.36,33859.32,-5696.04
1938-11-30,12.73,0.3,2.41,31.86,-60.04,True,1,2725,-12.73,-39568.09,34689.25,-4878.84
1938-12-01,12.61,-0.12,-0.94,31.86,-60.42,True,1,2726,-12.61,-39580.7,34374.86,-5205.84
1938-12-02,12.48,-0.13,-1.03,31.86,-60.83,True,1,2727,-12.48,-39593.18,34032.96,-5560.22
1938-12-05,12.4,-0.08,-0.64,31.86,-61.08,True,1,2728,-12.4,-39605.58,33827.2,-5778.38
1938-12-06,12.5,0.1,0.81,31.86,-60.77,True,1,2729,-12.5,-39618.08,34112.5,-5505.58
1938-12-07,12.54,0.04,0.32,31.86,-60.64,True,1,2730,-12.54,-39630.62,34234.2,-5396.42
1938-12-08,12.39,-0.15,-1.2,31.86,-61.11,True,1,2731,-12.39,-39643.01,33837.09,-5805.92
1938-12-09,12.32,-0.07,-0.56,31.86,-61.33,True,1,2732,-12.32,-39655.33,33658.24,-5997.09
1938-12-12,12.46,0.14,1.14,31.86,-60.89,True,1,2733,-12.46,-39667.79,34053.18,-5614.61
1938-12-13,12.59,0.13,1.04,31.86,-60.48,True,1,2734,-12.59,-39680.38,34421.06,-5259.32
1938-12-14,12.86,0.27,2.14,31.86,-59.64,True,1,2735,-12.86,-39693.24,35172.1,-4521.14
1938-12-15,12.89,0.03,0.23,31.86,-59.54,True,1,2736,-12.89,-39706.13,35267.04,-4439.09
1938-12-16,12.9,0.01,0.08,31.86,-59.51,True,1,2737,-12.9,-39719.03,35307.3,-4411.73
1938-12-19,12.68,-0.22,-1.7,31.86,-60.2,True,1,2738,-12.68,-39731.71,34717.84,-5013.87
1938-12-20,12.66,-0.02,-0.16,31.86,-60.26,True,1,2739,-12.66,-39744.37,34675.74,-5068.63
1938-12-21,12.58,-0.08,-0.63,31.86,-60.52,True,1,2740,-12.58,-39756.95,34469.2,-5287.75
1938-12-22,12.67,0.09,0.72,31.86,-60.23,True,1,2741,-12.67,-39769.62,34728.47,-5041.15
1938-12-23,12.81,0.14,1.1,31.86,-59.79,True,1,2742,-12.81,-39782.43,35125.02,-4657.41
1938-12-27,12.73,-0.08,-0.62,31.86,-60.04,True,1,2743,-12.73,-39795.16,34918.39,-4876.77
1938-12-28,12.85,0.12,0.94,31.86,-59.67,True,1,2744,-12.85,-39808.01,35260.4,-4547.61
1938-12-29,13.13,0.28,2.18,31.86,-58.79,True,1,2745,-13.13,-39821.14,36041.85,-3779.29
1938-12-30,13.14,0.01,0.08,31.86,-58.76,True,1,2746,-13.14,-39834.28,36082.44,-3751.84
1939-01-03,13.08,-0.06,-0.46,31.86,-58.94,True,1,2747,-13.08,-39847.36,35930.76,-3916.6
1939-01-04,13.23,0.15,1.15,31.86,-58.48,True,1,2748,-13.23,-39860.59,36356.04,-3504.55
1939-01-05,13.06,-0.17,-1.28,31.86,-59.01,True,1,2749,-13.06,-39873.65,35901.94,-3971.71
1939-01-06,13.07,0.01,0.08,31.86,-58.98,True,1,2750,-13.07,-39886.72,35942.5,-3944.22
1939-01-09,12.79,-0.28,-2.14,31.86,-59.86,True,1,2751,-12.79,-39899.51,35185.29,-4714.22
1939-01-10,12.81,0.02,0.16,31.86,-59.79,True,1,2752,-12.81,-39912.32,35253.12,-4659.2
1939-01-11,12.57,-0.24,-1.87,31.86,-60.55,True,1,2753,-12.57,-39924.89,34605.21,-5319.68
1939-01-12,12.47,-0.1,-0.8,31.86,-60.86,True,1,2754,-12.47,-39937.36,34342.38,-5594.98
1939-01-13,12.33,-0.14,-1.12,31.86,-61.3,True,1,2755,-12.33,-39949.69,33969.15,-5980.54
1939-01-16,12.63,0.3,2.43,31.86,-60.36,True,1,2756,-12.63,-39962.32,34808.28,-5154.04
1939-01-17,12.73,0.1,0.79,31.86,-60.04,True,1,2757,-12.73,-39975.05,35096.61,-4878.44
1939-01-18,12.71,-0.02,-0.16,31.86,-60.11,True,1,2758,-12.71,-39987.76,35054.18,-4933.58
1939-01-19,12.8,0.09,0.71,31.86,-59.82,True,1,2759,-12.8,-40000.56,35315.2,-4685.36
1939-01-20,12.75,-0.05,-0.39,31.86,-59.98,True,1,2760,-12.75,-40013.31,35190.0,-4823.31
1939-01-23,11.93,-0.82,-6.43,31.86,-62.56,True,1,2761,-11.93,-40025.24,32938.73,-7086.51
1939-01-24,11.98,0.05,0.42,31.86,-62.4,True,1,2762,-11.98,-40037.22,33088.76,-6948.46
1939-01-25,11.91,-0.07,-0.58,31.86,-62.62,True,1,2763,-11.91,-40049.13,32907.33,-7141.8
1939-01-26,11.53,-0.38,-3.19,31.86,-63.81,True,1,2764,-11.53,-40060.66,31868.92,-8191.74
1939-01-27,11.86,0.33,2.86,31.86,-62.78,True,1,2765,-11.86,-40072.52,32792.9,-7279.62
1939-01-30,12.16,0.3,2.53,31.86,-61.83,True,1,2766,-12.16,-40084.68,33634.56,-6450.12
1939-01-31,12.3,0.14,1.15,31.86,-61.39,True,1,2767,-12.3,-40096.98,34034.1,-6062.88
1939-02-01,12.12,-0.18,-1.46,31.86,-61.96,True,1,2768,-12.12,-40109.1,33548.16,-6560.94
1939-02-02,12.38,0.26,2.14,31.86,-61.14,True,1,2769,-12.38,-40121.48,34280.22,-5841.26
1939-02-03,12.3,-0.08,-0.65,31.86,-61.39,True,1,2770,-12.3,-40133.78,34071.0,-6062.78
1939-02-06,12.47,0.17,1.38,31.86,-60.86,True,1,2771,-12.47,-40146.25,34554.37,-5591.88
1939-02-07,12.32,-0.15,-1.2,31.86,-61.33,True,1,2772,-12.32,-40158.57,34151.04,-6007.53
1939-02-08,12.48,0.16,1.3,31.86,-60.83,True,1,2773,-12.48,-40171.05,34607.04,-5564.01
1939-02-09,12.3,-0.18,-1.44,31.86,-61.39,True,1,2774,-12.3,-40183.35,34120.2,-6063.15
1939-02-10,12.33,0.03,0.24,31.86,-61.3,True,1,2775,-12.33,-40195.68,34215.75,-5979.93
1939-02-14,12.36,0.03,0.24,31.86,-61.2,True,1,2776,-12.36,-40208.04,34311.36,-5896.68
1939-02-15,12.38,0.02,0.16,31.86,-61.14,True,1,2777,-12.38,-40220.42,34379.26,-5841.16
1939-02-16,12.48,0.1,0.81,31.86,-60.83,True,1,2778,-12.48,-40232.9,34669.44,-5563.46
1939-02-17,12.4,-0.08,-0.64,31.86,-61.08,True,1,2779,-12.4,-40245.3,34459.6,-5785.7
1939-02-20,12.16,-0.24,-1.94,31.86,-61.83,True,1,2780,-12.16,-40257.46,33804.8,-6452.66
1939-02-21,12.23,0.07,0.58,31.86,-61.61,True,1,2781,-12.23,-40269.69,34011.63,-6258.06
1939-02-23,12.24,0.01,0.08,31.86,-61.58,True,1,2782,-12.24,-40281.93,34051.68,-6230.25
1939-02-24,12.54,0.3,2.45,31.86,-60.64,True,1,2783,-12.54,-40294.47,34898.82,-5395.65
1939-02-27,12.63,0.09,0.72,31.86,-60.36,True,1,2784,-12.63,-40307.1,35161.92,-5145.18
1939-02-28,12.7,0.07,0.55,31.86,-60.14,True,1,2785,-12.7,-40319.8,35369.5,-4950.3
1939-03-01,12.7,0.0,0.0,31.86,-60.14,True,1,2786,-12.7,-40332.5,35382.2,-4950.3
1939-03-02,12.68,-0.02,-0.16,31.86,-60.2,True,1,2787,-12.68,-40345.18,35339.16,-5006.02
1939-03-03,12.86,0.18,1.42,31.86,-59.64,True,1,2788,-12.86,-40358.04,35853.68,-4504.36
1939-03-06,12.79,-0.07,-0.54,31.86,-59.86,True,1,2789,-12.79,-40370.83,35671.31,-4699.52
1939-03-07,12.85,0.06,0.47,31.86,-59.67,True,1,2790,-12.85,-40383.68,35851.5,-4532.18
1939-03-08,13.07,0.22,1.71,31.86,-58.98,True,1,2791,-13.07,-40396.75,36478.37,-3918.38
1939-03-09,13.01,-0.06,-0.46,31.86,-59.16,True,1,2792,-13.01,-40409.76,36323.92,-4085.84
1939-03-10,13.1,0.09,0.69,31.86,-58.88,True,1,2793,-13.1,-40422.86,36588.3,-3834.56
1939-03-13,12.92,-0.18,-1.37,31.86,-59.45,True,1,2794,-12.92,-40435.78,36098.48,-4337.3
1939-03-14,12.97,0.05,0.39,31.86,-59.29,True,1,2795,-12.97,-40448.75,36251.15,-4197.6
1939-03-15,12.61,-0.36,-2.78,31.86,-60.42,True,1,2796,-12.61,-40461.36,35257.56,-5203.8
1939-03-16,12.58,-0.03,-0.24,31.86,-60.52,True,1,2797,-12.58,-40473.94,35186.26,-5287.68
1939-03-17,12.21,-0.37,-2.94,31.86,-61.68,True,1,2798,-12.21,-40486.15,34163.58,-6322.57
1939-03-20,11.95,-0.26,-2.13,31.86,-62.49,True,1,2799,-11.95,-40498.1,33448.05,-7050.05
1939-03-21,12.16,0.21,1.76,31.86,-61.83,True,1,2800,-12.16,-40510.26,34048.0,-6462.26
1939-03-22,11.75,-0.41,-3.37,31.86,-63.12,True,1,2801,-11.75,-40522.01,32911.75,-7610.26
1939-03-23,11.92,0.17,1.45,31.86,-62.59,True,1,2802,-11.92,-40533.93,33399.84,-7134.09
1939-03-24,12.07,0.15,1.26,31.86,-62.12,True,1,2803,-12.07,-40546.0,33832.21,-6713.79
1939-03-27,11.99,-0.08,-0.66,31.86,-62.37,True,1,2804,-11.99,-40557.99,33619.96,-6938.03
1939-03-28,11.83,-0.16,-1.33,31.86,-62.87,True,1,2805,-11.83,-40569.82,33183.15,-7386.67
1939-03-29,11.92,0.09,0.76,31.86,-62.59,True,1,2806,-11.92,-40581.74,33447.52,-7134.22
1939-03-30,11.51,-0.41,-3.44,31.86,-63.87,True,1,2807,-11.51,-40593.25,32308.57,-8284.68
1939-03-31,10.98,-0.53,-4.61,31.86,-65.54,True,1,2808,-10.98,-40604.23,30831.84,-9772.39
1939-04-03,11.26,0.28,2.55,31.86,-64.66,True,1,2809,-11.26,-40615.49,31629.34,-8986.15
1939-04-04,11.02,-0.24,-2.13,31.86,-65.41,True,1,2810,-11.02,-40626.51,30966.2,-9660.31
1939-04-05,11.06,0.04,0.36,31.86,-65.29,True,1,2811,-11.06,-40637.57,31089.66,-9547.91
1939-04-06,10.66,-0.4,-3.62,31.86,-66.54,True,1,2812,-10.66,-40648.23,29975.92,-10672.31
1939-04-10,10.44,-0.22,-2.06,31.86,-67.23,True,1,2813,-10.44,-40658.67,29367.72,-11290.95
1939-04-11,10.42,-0.02,-0.19,31.86,-67.29,True,1,2814,-10.42,-40669.09,29321.88,-11347.21
1939-04-12,10.7,0.28,2.69,31.86,-66.42,True,1,2815,-10.7,-40679.79,30120.5,-10559.29
1939-04-13,10.79,0.09,0.84,31.86,-66.13,True,1,2816,-10.79,-40690.58,30384.64,-10305.94
1939-04-14,10.63,-0.16,-1.48,31.86,-66.64,True,1,2817,-10.63,-40701.21,29944.71,-10756.5
1939-04-17,10.83,0.2,1.88,31.86,-66.01,True,1,2818,-10.83,-40712.04,30518.94,-10193.1
1939-04-18,10.66,-0.17,-1.57,31.86,-66.54,True,1,2819,-10.66,-40722.7,30050.54,-10672.16
1939-04-19,10.79,0.13,1.22,31.86,-66.13,True,1,2820,-10.79,-40733.49,30427.8,-10305.69
1939-04-20,10.92,0.13,1.2,31.86,-65.72,True,1,2821,-10.92,-40744.41,30805.32,-9939.09
1939-04-21,10.96,0.04,0.37,31.86,-65.6,True,1,2822,-10.96,-40755.37,30929.12,-9826.25
1939-04-24,10.78,-0.18,-1.64,31.86,-66.16,True,1,2823,-10.78,-40766.15,30431.94,-10334.21
1939-04-25,10.8,0.02,0.19,31.86,-66.1,True,1,2824,-10.8,-40776.95,30499.2,-10277.75
1939-04-26,10.91,0.11,1.02,31.86,-65.76,True,1,2825,-10.91,-40787.86,30820.75,-9967.11
1939-04-27,11.03,0.12,1.1,31.86,-65.38,True,1,2826,-11.03,-40798.89,31170.78,-9628.11
1939-04-28,10.93,-0.1,-0.91,31.86,-65.69,True,1,2827,-10.93,-40809.82,30899.11,-9910.71
1939-05-01,10.86,-0.07,-0.64,31.86,-65.91,True,1,2828,-10.86,-40820.68,30712.08,-10108.6
1939-05-02,11.0,0.14,1.29,31.86,-65.47,True,1,2829,-11.0,-40831.68,31119.0,-9712.68
1939-05-03,11.29,0.29,2.64,31.86,-64.56,True,1,2830,-11.29,-40842.97,31950.7,-8892.27
1939-05-04,11.25,-0.04,-0.35,31.86,-64.69,True,1,2831,-11.25,-40854.22,31848.75,-9005.47
1939-05-05,11.21,-0.04,-0.36,31.86,-64.82,True,1,2832,-11.21,-40865.43,31746.72,-9118.71
1939-05-08,11.23,0.02,0.18,31.86,-64.75,True,1,2833,-11.23,-40876.66,31814.59,-9062.07
1939-05-09,11.43,0.2,1.78,31.86,-64.12,True,1,2834,-11.43,-40888.09,32392.62,-8495.47
1939-05-10,11.29,-0.14,-1.23,31.86,-64.56,True,1,2835,-11.29,-40899.38,32007.15,-8892.23
1939-05-11,11.29,0.0,0.0,31.86,-64.56,True,1,2836,-11.29,-40910.67,32018.44,-8892.23
1939-05-12,11.21,-0.08,-0.71,31.86,-64.82,True,1,2837,-11.21,-40921.88,31802.77,-9119.11
1939-05-15,11.25,0.04,0.36,31.86,-64.69,True,1,2838,-11.25,-40933.13,31927.5,-9005.63
1939-05-16,10.94,-0.31,-2.76,31.86,-65.66,True,1,2839,-10.94,-40944.07,31058.66,-9885.41
1939-05-17,10.87,-0.07,-0.64,31.86,-65.88,True,1,2840,-10.87,-40954.94,30870.8,-10084.14
1939-05-18,10.89,0.02,0.18,31.86,-65.82,True,1,2841,-10.89,-40965.83,30938.49,-10027.34
1939-05-19,10.99,0.1,0.92,31.86,-65.5,True,1,2842,-10.99,-40976.82,31233.58,-9743.24
1939-05-22,11.17,0.18,1.64,31.86,-64.94,True,1,2843,-11.17,-40987.99,31756.31,-9231.68
1939-05-23,11.11,-0.06,-0.54,31.86,-65.13,True,1,2844,-11.11,-40999.1,31596.84,-9402.26
1939-05-24,11.43,0.32,2.88,31.86,-64.12,True,1,2845,-11.43,-41010.53,32518.35,-8492.18
1939-05-25,11.45,0.02,0.18,31.86,-64.06,True,1,2846,-11.45,-41021.98,32586.7,-8435.28
1939-05-26,11.49,0.04,0.35,31.86,-63.94,True,1,2847,-11.49,-41033.47,32712.03,-8321.44
1939-05-29,11.65,0.16,1.39,31.86,-63.43,True,1,2848,-11.65,-41045.12,33179.2,-7865.92
1939-05-31,11.6,-0.05,-0.43,31.86,-63.59,True,1,2849,-11.6,-41056.72,33048.4,-8008.32
1939-06-01,11.42,-0.18,-1.55,31.86,-64.16,True,1,2850,-11.42,-41068.14,32547.0,-8521.14
1939-06-02,11.48,0.06,0.52,31.86,-63.97,True,1,2851,-11.48,-41079.62,32729.48,-8350.14
1939-06-05,11.51,0.03,0.26,31.86,-63.87,True,1,2852,-11.51,-41091.13,32826.52,-8264.61
1939-06-06,11.66,0.15,1.3,31.86,-63.4,True,1,2853,-11.66,-41102.79,33265.98,-7836.81
1939-06-07,11.67,0.01,0.09,31.86,-63.37,True,1,2854,-11.67,-41114.46,33306.18,-7808.28
1939-06-08,11.64,-0.03,-0.26,31.86,-63.46,True,1,2855,-11.64,-41126.1,33232.2,-7893.9
1939-06-09,11.8,0.16,1.38,31.86,-62.96,True,1,2856,-11.8,-41137.9,33700.8,-7437.1
1939-06-12,11.66,-0.14,-1.19,31.86,-63.4,True,1,2857,-11.66,-41149.56,33312.62,-7836.94
1939-06-13,11.58,-0.08,-0.69,31.86,-63.65,True,1,2858,-11.58,-41161.14,33095.64,-8065.5
1939-06-14,11.53,-0.05,-0.43,31.86,-63.81,True,1,2859,-11.53,-41172.67,32964.27,-8208.4
1939-06-15,11.25,-0.28,-2.43,31.86,-64.69,True,1,2860,-11.25,-41183.92,32175.0,-9008.92
1939-06-16,11.28,0.03,0.27,31.86,-64.6,True,1,2861,-11.28,-41195.2,32272.08,-8923.12
1939-06-19,11.42,0.14,1.24,31.86,-64.16,True,1,2862,-11.42,-41206.62,32684.04,-8522.58
1939-06-20,11.52,0.1,0.88,31.86,-63.84,True,1,2863,-11.52,-41218.14,32981.76,-8236.38
1939-06-21,11.52,0.0,0.0,31.86,-63.84,True,1,2864,-11.52,-41229.66,32993.28,-8236.38
1939-06-22,11.45,-0.07,-0.61,31.86,-64.06,True,1,2865,-11.45,-41241.11,32804.25,-8436.86
1939-06-23,11.5,0.05,0.44,31.86,-63.9,True,1,2866,-11.5,-41252.61,32959.0,-8293.61
1939-06-26,11.24,-0.26,-2.26,31.86,-64.72,True,1,2867,-11.24,-41263.85,32225.08,-9038.77
1939-06-27,11.29,0.05,0.44,31.86,-64.56,True,1,2868,-11.29,-41275.14,32379.72,-8895.42
1939-06-28,11.06,-0.23,-2.04,31.86,-65.29,True,1,2869,-11.06,-41286.2,31731.14,-9555.06
1939-06-29,10.79,-0.27,-2.44,31.86,-66.13,True,1,2870,-10.79,-41296.99,30967.3,-10329.69
1939-06-30,10.86,0.07,0.65,31.86,-65.91,True,1,2871,-10.86,-41307.85,31179.06,-10128.79
1939-07-03,11.0,0.14,1.29,31.86,-65.47,True,1,2872,-11.0,-41318.85,31592.0,-9726.85
1939-07-05,11.2,0.2,1.82,31.86,-64.85,True,1,2873,-11.2,-41330.05,32177.6,-9152.45
1939-07-06,11.19,-0.01,-0.09,31.86,-64.88,True,1,2874,-11.19,-41341.24,32160.06,-9181.18
1939-07-07,11.13,-0.06,-0.54,31.86,-65.07,True,1,2875,-11.13,-41352.37,31998.75,-9353.62
1939-07-10,11.17,0.04,0.36,31.86,-64.94,True,1,2876,-11.17,-41363.54,32124.92,-9238.62
1939-07-11,11.31,0.14,1.25,31.86,-64.5,True,1,2877,-11.31,-41374.85,32538.87,-8835.98
1939-07-12,11.55,0.24,2.12,31.86,-63.75,True,1,2878,-11.55,-41386.4,33240.9,-8145.5
1939-07-13,11.64,0.09,0.78,31.86,-63.46,True,1,2879,-11.64,-41398.04,33511.56,-7886.48
1939-07-14,11.55,-0.09,-0.77,31.86,-63.75,True,1,2880,-11.55,-41409.59,33264.0,-8145.59
1939-07-17,12.07,0.52,4.5,31.86,-62.12,True,1,2881,-12.07,-41421.66,34773.67,-6647.99
1939-07-18,12.16,0.09,0.75,31.86,-61.83,True,1,2882,-12.16,-41433.82,35045.12,-6388.7
1939-07-19,12.0,-0.16,-1.32,31.86,-62.34,True,1,2883,-12.0,-41445.82,34596.0,-6849.82
1939-07-20,11.85,-0.15,-1.25,31.86,-62.81,True,1,2884,-11.85,-41457.67,34175.4,-7282.27
1939-07-21,12.09,0.24,2.02,31.86,-62.05,True,1,2885,-12.09,-41469.76,34879.65,-6590.11
1939-07-24,12.13,0.04,0.33,31.86,-61.93,True,1,2886,-12.13,-41481.89,35007.18,-6474.71
1939-07-25,12.05,-0.08,-0.66,31.86,-62.18,True,1,2887,-12.05,-41493.94,34788.35,-6705.59
1939-07-26,12.17,0.12,1.0,31.86,-61.8,True,1,2888,-12.17,-41506.11,35146.96,-6359.15
1939-07-27,12.18,0.01,0.08,31.86,-61.77,True,1,2889,-12.18,-41518.29,35188.02,-6330.27
1939-07-28,12.14,-0.04,-0.33,31.86,-61.9,True,1,2890,-12.14,-41530.43,35084.6,-6445.83
1939-07-31,12.04,-0.1,-0.82,31.86,-62.21,True,1,2891,-12.04,-41542.47,34807.64,-6734.83
1939-08-01,12.04,0.0,0.0,31.86,-62.21,True,1,2892,-12.04,-41554.51,34819.68,-6734.83
1939-08-02,12.16,0.12,1.0,31.86,-61.83,True,1,2893,-12.16,-41566.67,35178.88,-6387.79
1939-08-03,12.12,-0.04,-0.33,31.86,-61.96,True,1,2894,-12.12,-41578.79,35075.28,-6503.51
1939-08-04,11.9,-0.22,-1.82,31.86,-62.65,True,1,2895,-11.9,-41590.69,34450.5,-7140.19
1939-08-07,11.84,-0.06,-0.5,31.86,-62.84,True,1,2896,-11.84,-41602.53,34288.64,-7313.89
1939-08-08,11.87,0.03,0.25,31.86,-62.74,True,1,2897,-11.87,-41614.4,34387.39,-7227.01
1939-08-09,11.78,-0.09,-0.76,31.86,-63.03,True,1,2898,-11.78,-41626.18,34138.44,-7487.74
1939-08-10,11.54,-0.24,-2.04,31.86,-63.78,True,1,2899,-11.54,-41637.72,33454.46,-8183.26
1939-08-11,11.56,0.02,0.17,31.86,-63.72,True,1,2900,-11.56,-41649.28,33524.0,-8125.28
1939-08-14,11.78,0.22,1.9,31.86,-63.03,True,1,2901,-11.78,-41661.06,34173.78,-7487.28
1939-08-15,11.89,0.11,0.93,31.86,-62.68,True,1,2902,-11.89,-41672.95,34504.78,-7168.17
1939-08-16,11.58,-0.31,-2.61,31.86,-63.65,True,1,2903,-11.58,-41684.53,33616.74,-8067.79
1939-08-17,11.57,-0.01,-0.09,31.86,-63.68,True,1,2904,-11.57,-41696.1,33599.28,-8096.82
1939-08-18,11.33,-0.24,-2.07,31.86,-64.44,True,1,2905,-11.33,-41707.43,32913.65,-8793.78
1939-08-21,11.03,-0.3,-2.65,31.86,-65.38,True,1,2906,-11.03,-41718.46,32053.18,-9665.28
1939-08-22,11.24,0.21,1.9,31.86,-64.72,True,1,2907,-11.24,-41729.7,32674.68,-9055.02
1939-08-23,10.89,-0.35,-3.11,31.86,-65.82,True,1,2908,-10.89,-41740.59,31668.12,-10072.47
1939-08-24,10.86,-0.03,-0.28,31.86,-65.91,True,1,2909,-10.86,-41751.45,31591.74,-10159.71
1939-08-25,11.09,0.23,2.12,31.86,-65.19,True,1,2910,-11.09,-41762.54,32271.9,-9490.64
1939-08-28,11.17,0.08,0.72,31.86,-64.94,True,1,2911,-11.17,-41773.71,32515.87,-9257.84
1939-08-29,11.48,0.31,2.78,31.86,-63.97,True,1,2912,-11.48,-41785.19,33429.76,-8355.43
1939-08-30,11.36,-0.12,-1.04,31.86,-64.34,True,1,2913,-11.36,-41796.55,33091.68,-8704.87
1939-08-31,11.18,-0.18,-1.58,31.86,-64.91,True,1,2914,-11.18,-41807.73,32578.52,-9229.21
1939-09-01,11.3,0.12,1.07,31.86,-64.53,True,1,2915,-11.3,-41819.03,32939.5,-8879.53
1939-09-05,12.64,1.34,11.86,31.86,-60.33,True,1,2916,-12.64,-41831.67,36858.24,-4973.43
1939-09-06,12.53,-0.11,-0.87,31.86,-60.67,True,1,2917,-12.53,-41844.2,36550.01,-5294.19
1939-09-07,12.5,-0.03,-0.24,31.86,-60.77,True,1,2918,-12.5,-41856.7,36475.0,-5381.7
1939-09-08,12.69,0.19,1.52,31.86,-60.17,True,1,2919,-12.69,-41869.39,37042.11,-4827.28
1939-09-11,13.02,0.33,2.6,31.86,-59.13,True,1,2920,-13.02,-41882.41,38018.4,-3864.01
1939-09-12,13.17,0.15,1.15,31.86,-58.66,True,1,2921,-13.17,-41895.58,38469.57,-3426.01
1939-09-13,13.03,-0.14,-1.06,31.86,-59.1,True,1,2922,-13.03,-41908.61,38073.66,-3834.95
1939-09-14,13.08,0.05,0.38,31.86,-58.94,True,1,2923,-13.08,-41921.69,38232.84,-3688.85
1939-09-15,13.07,-0.01,-0.08,31.86,-58.98,True,1,2924,-13.07,-41934.76,38216.68,-3718.08
1939-09-18,12.47,-0.6,-4.59,31.86,-60.86,True,1,2925,-12.47,-41947.23,36474.75,-5472.48
1939-09-19,12.95,0.48,3.85,31.86,-59.35,True,1,2926,-12.95,-41960.18,37891.7,-4068.48
1939-09-20,12.94,-0.01,-0.08,31.86,-59.38,True,1,2927,-12.94,-41973.12,37875.38,-4097.74
1939-09-21,13.02,0.08,0.62,31.86,-59.13,True,1,2928,-13.02,-41986.14,38122.56,-3863.58
1939-09-22,12.92,-0.1,-0.77,31.86,-59.45,True,1,2929,-12.92,-41999.06,37842.68,-4156.38
1939-09-25,12.95,0.03,0.23,31.86,-59.35,True,1,2930,-12.95,-42012.01,37943.5,-4068.51
1939-09-26,13.11,0.16,1.24,31.86,-58.85,True,1,2931,-13.11,-42025.12,38425.41,-3599.71
1939-09-27,13.11,0.0,0.0,31.86,-58.85,True,1,2932,-13.11,-42038.23,38438.52,-3599.71
1939-09-28,12.86,-0.25,-1.91,31.86,-59.64,True,1,2933,-12.86,-42051.09,37718.38,-4332.71
1939-09-29,12.79,-0.07,-0.54,31.86,-59.86,True,1,2934,-12.79,-42063.88,37525.86,-4538.02
1939-10-02,12.88,0.09,0.7,31.86,-59.57,True,1,2935,-12.88,-42076.76,37802.8,-4273.96
1939-10-03,12.77,-0.11,-0.85,31.86,-59.92,True,1,2936,-12.77,-42089.53,37492.72,-4596.81
1939-10-04,12.79,0.02,0.16,31.86,-59.86,True,1,2937,-12.79,-42102.32,37564.23,-4538.09
1939-10-05,12.82,0.03,0.24,31.86,-59.76,True,1,2938,-12.82,-42115.14,37665.16,-4449.98
1939-10-06,12.8,-0.02,-0.16,31.86,-59.82,True,1,2939,-12.8,-42127.94,37619.2,-4508.74
1939-10-09,12.73,-0.07,-0.55,31.86,-60.04,True,1,2940,-12.73,-42140.67,37426.2,-4714.47
1939-10-10,12.76,0.03,0.24,31.86,-59.95,True,1,2941,-12.76,-42153.43,37527.16,-4626.27
1939-10-11,12.84,0.08,0.63,31.86,-59.7,True,1,2942,-12.84,-42166.27,37775.28,-4390.99
1939-10-13,12.74,-0.1,-0.78,31.86,-60.01,True,1,2943,-12.74,-42179.01,37493.82,-4685.19
1939-10-16,12.74,0.0,0.0,31.86,-60.01,True,1,2944,-12.74,-42191.75,37506.56,-4685.19
1939-10-17,13.09,0.35,2.75,31.86,-58.91,True,1,2945,-13.09,-42204.84,38550.05,-3654.79
1939-10-18,13.0,-0.09,-0.69,31.86,-59.2,True,1,2946,-13.0,-42217.84,38298.0,-3919.84
1939-10-19,12.98,-0.02,-0.15,31.86,-59.26,True,1,2947,-12.98,-42230.82,38252.06,-3978.76
1939-10-20,12.94,-0.04,-0.31,31.86,-59.38,True,1,2948,-12.94,-42243.76,38147.12,-4096.64
1939-10-23,12.99,0.05,0.39,31.86,-59.23,True,1,2949,-12.99,-42256.75,38307.51,-3949.24
1939-10-24,13.02,0.03,0.23,31.86,-59.13,True,1,2950,-13.02,-42269.77,38409.0,-3860.77
1939-10-25,13.21,0.19,1.46,31.86,-58.54,True,1,2951,-13.21,-42282.98,38982.71,-3300.27
1939-10-26,13.08,-0.13,-0.98,31.86,-58.94,True,1,2952,-13.08,-42296.06,38612.16,-3683.9
1939-10-27,13.02,-0.06,-0.46,31.86,-59.13,True,1,2953,-13.02,-42309.08,38448.06,-3861.02
1939-10-30,12.96,-0.06,-0.46,31.86,-59.32,True,1,2954,-12.96,-42322.04,38283.84,-4038.2
1939-10-31,12.83,-0.13,-1.0,31.86,-59.73,True,1,2955,-12.83,-42334.87,37912.65,-4422.22
1939-11-01,12.82,-0.01,-0.08,31.86,-59.76,True,1,2956,-12.82,-42347.69,37895.92,-4451.77
1939-11-02,12.84,0.02,0.16,31.86,-59.7,True,1,2957,-12.84,-42360.53,37967.88,-4392.65
1939-11-03,12.95,0.11,0.86,31.86,-59.35,True,1,2958,-12.95,-42373.48,38306.1,-4067.38
1939-11-06,12.82,-0.13,-1.0,31.86,-59.76,True,1,2959,-12.82,-42386.3,37934.38,-4451.92
1939-11-08,12.75,-0.07,-0.55,31.86,-59.98,True,1,2960,-12.75,-42399.05,37740.0,-4659.05
1939-11-09,12.58,-0.17,-1.33,31.86,-60.52,True,1,2961,-12.58,-42411.63,37249.38,-5162.25
1939-11-10,12.64,0.06,0.48,31.86,-60.33,True,1,2962,-12.64,-42424.27,37439.68,-4984.59
1939-11-13,12.65,0.01,0.08,31.86,-60.3,True,1,2963,-12.65,-42436.92,37481.95,-4954.97
1939-11-14,12.74,0.09,0.71,31.86,-60.01,True,1,2964,-12.74,-42449.66,37761.36,-4688.3
1939-11-15,12.63,-0.11,-0.86,31.86,-60.36,True,1,2965,-12.63,-42462.29,37447.95,-5014.34
1939-11-16,12.79,0.16,1.27,31.86,-59.86,True,1,2966,-12.79,-42475.08,37935.14,-4539.94
1939-11-17,12.75,-0.04,-0.31,31.86,-59.98,True,1,2967,-12.75,-42487.83,37829.25,-4658.58
1939-11-20,12.79,0.04,0.31,31.86,-59.86,True,1,2968,-12.79,-42500.62,37960.72,-4539.9
1939-11-21,12.7,-0.09,-0.7,31.86,-60.14,True,1,2969,-12.7,-42513.32,37706.3,-4807.02
1939-11-22,12.68,-0.02,-0.16,31.86,-60.2,True,1,2970,-12.68,-42526.0,37659.6,-4866.4
1939-11-24,12.49,-0.19,-1.5,31.86,-60.8,True,1,2971,-12.49,-42538.49,37107.79,-5430.7
1939-11-27,12.52,0.03,0.24,31.86,-60.7,True,1,2972,-12.52,-42551.01,37209.44,-5341.57
1939-11-28,12.47,-0.05,-0.4,31.86,-60.86,True,1,2973,-12.47,-42563.48,37073.31,-5490.17
1939-11-29,12.33,-0.14,-1.12,31.86,-61.3,True,1,2974,-12.33,-42575.81,36669.42,-5906.39
1939-11-30,12.2,-0.13,-1.05,31.86,-61.71,True,1,2975,-12.2,-42588.01,36295.0,-6293.01
1939-12-01,12.29,0.09,0.74,31.86,-61.42,True,1,2976,-12.29,-42600.3,36575.04,-6025.26
1939-12-04,12.28,-0.01,-0.08,31.86,-61.46,True,1,2977,-12.28,-42612.58,36557.56,-6055.02
1939-12-05,12.26,-0.02,-0.16,31.86,-61.52,True,1,2978,-12.26,-42624.84,36510.28,-6114.56
1939-12-06,12.45,0.19,1.55,31.86,-60.92,True,1,2979,-12.45,-42637.29,37088.55,-5548.74
1939-12-07,12.46,0.01,0.08,31.86,-60.89,True,1,2980,-12.46,-42649.75,37130.8,-5518.95
1939-12-08,12.36,-0.1,-0.8,31.86,-61.2,True,1,2981,-12.36,-42662.11,36845.16,-5816.95
1939-12-11,12.23,-0.13,-1.05,31.86,-61.61,True,1,2982,-12.23,-42674.34,36469.86,-6204.48
1939-12-12,12.19,-0.04,-0.33,31.86,-61.74,True,1,2983,-12.19,-42686.53,36362.77,-6323.76
1939-12-13,12.38,0.19,1.56,31.86,-61.14,True,1,2984,-12.38,-42698.91,36941.92,-5756.99
1939-12-14,12.36,-0.02,-0.16,31.86,-61.2,True,1,2985,-12.36,-42711.27,36894.6,-5816.67
1939-12-15,12.4,0.04,0.32,31.86,-61.08,True,1,2986,-12.4,-42723.67,37026.4,-5697.27
1939-12-18,12.37,-0.03,-0.24,31.86,-61.17,True,1,2987,-12.37,-42736.04,36949.19,-5786.85
1939-12-19,12.34,-0.03,-0.24,31.86,-61.27,True,1,2988,-12.34,-42748.38,36871.92,-5876.46
1939-12-20,12.39,0.05,0.4,31.86,-61.11,True,1,2989,-12.39,-42760.77,37033.71,-5727.06
1939-12-21,12.38,-0.01,-0.08,31.86,-61.14,True,1,2990,-12.38,-42773.15,37016.2,-5756.95
1939-12-22,12.44,0.06,0.48,31.86,-60.95,True,1,2991,-12.44,-42785.59,37208.04,-5577.55
1939-12-26,12.38,-0.06,-0.48,31.86,-61.14,True,1,2992,-12.38,-42797.97,37040.96,-5757.01
1939-12-27,12.31,-0.07,-0.56,31.86,-61.36,True,1,2993,-12.31,-42810.28,36843.83,-5966.45
1939-12-28,12.42,0.11,0.89,31.86,-61.02,True,1,2994,-12.42,-42822.7,37185.48,-5637.22
1939-12-29,12.46,0.04,0.32,31.86,-60.89,True,1,2995,-12.46,-42835.16,37317.7,-5517.46
1940-01-02,12.63,0.17,1.36,31.86,-60.36,True,1,2996,-12.63,-42847.79,37839.48,-5008.31
1940-01-03,12.77,0.14,1.11,31.86,-59.92,True,1,2997,-12.77,-42860.56,38271.69,-4588.87
1940-01-04,12.73,-0.04,-0.31,31.86,-60.04,True,1,2998,-12.73,-42873.29,38164.54,-4708.75
1940-01-05,12.66,-0.07,-0.55,31.86,-60.26,True,1,2999,-12.66,-42885.95,37967.34,-4918.61
1940-01-08,12.67,0.01,0.08,31.86,-60.23,True,1,3000,-12.67,-42898.62,38010.0,-4888.62
1940-01-09,12.55,-0.12,-0.95,31.86,-60.61,True,1,3001,-12.55,-42911.17,37662.55,-5248.62
1940-01-10,12.57,0.02,0.16,31.86,-60.55,True,1,3002,-12.57,-42923.74,37735.14,-5188.6
1940-01-11,12.37,-0.2,-1.59,31.86,-61.17,True,1,3003,-12.37,-42936.11,37147.11,-5789.0
1940-01-12,12.13,-0.24,-1.94,31.86,-61.93,True,1,3004,-12.13,-42948.24,36438.52,-6509.72
1940-01-15,12.07,-0.06,-0.5,31.86,-62.12,True,1,3005,-12.07,-42960.31,36270.35,-6689.96
1940-01-16,12.14,0.07,0.58,31.86,-61.9,True,1,3006,-12.14,-42972.45,36492.84,-6479.61
1940-01-17,12.15,0.01,0.08,31.86,-61.86,True,1,3007,-12.15,-42984.6,36535.05,-6449.55
1940-01-18,12.13,-0.02,-0.16,31.86,-61.93,True,1,3008,-12.13,-42996.73,36487.04,-6509.69
1940-01-19,12.15,0.02,0.16,31.86,-61.86,True,1,3009,-12.15,-43008.88,36559.35,-6449.53
1940-01-22,12.06,-0.09,-0.74,31.86,-62.15,True,1,3010,-12.06,-43020.94,36300.6,-6720.34
1940-01-23,12.11,0.05,0.42,31.86,-61.99,True,1,3011,-12.11,-43033.05,36463.21,-6569.84
1940-01-24,12.27,0.16,1.32,31.86,-61.49,True,1,3012,-12.27,-43045.32,36957.24,-6088.08
1940-01-25,12.16,-0.11,-0.9,31.86,-61.83,True,1,3013,-12.16,-43057.48,36638.08,-6419.4
1940-01-26,12.15,-0.01,-0.08,31.86,-61.86,True,1,3014,-12.15,-43069.63,36620.1,-6449.53
1940-01-29,12.16,0.01,0.08,31.86,-61.83,True,1,3015,-12.16,-43081.79,36662.4,-6419.39
1940-01-30,12.09,-0.07,-0.58,31.86,-62.05,True,1,3016,-12.09,-43093.88,36463.44,-6630.44
1940-01-31,12.05,-0.04,-0.33,31.86,-62.18,True,1,3017,-12.05,-43105.93,36354.85,-6751.08
1940-02-01,12.05,0.0,0.0,31.86,-62.18,True,1,3018,-12.05,-43117.98,36366.9,-6751.08
1940-02-02,12.06,0.01,0.08,31.86,-62.15,True,1,3019,-12.06,-43130.04,36409.14,-6720.9
1940-02-05,12.04,-0.02,-0.17,31.86,-62.21,True,1,3020,-12.04,-43142.08,36360.8,-6781.28
1940-02-06,12.14,0.1,0.83,31.86,-61.9,True,1,3021,-12.14,-43154.22,36674.94,-6479.28
1940-02-07,12.22,0.08,0.66,31.86,-61.64,True,1,3022,-12.22,-43166.44,36928.84,-6237.6
1940-02-08,12.37,0.15,1.23,31.86,-61.17,True,1,3023,-12.37,-43178.81,37394.51,-5784.3
1940-02-09,12.37,0.0,0.0,31.86,-61.17,True,1,3024,-12.37,-43191.18,37406.88,-5784.3
1940-02-13,12.33,-0.04,-0.32,31.86,-61.3,True,1,3025,-12.33,-43203.51,37298.25,-5905.26
1940-02-14,12.28,-0.05,-0.41,31.86,-61.46,True,1,3026,-12.28,-43215.79,37159.28,-6056.51
1940-02-15,12.28,0.0,0.0,31.86,-61.46,True,1,3027,-12.28,-43228.07,37171.56,-6056.51
1940-02-16,12.29,0.01,0.08,31.86,-61.42,True,1,3028,-12.29,-43240.36,37214.12,-6026.24
1940-02-19,12.29,0.0,0.0,31.86,-61.42,True,1,3029,-12.29,-43252.65,37226.41,-6026.24
1940-02-20,12.35,0.06,0.49,31.86,-61.24,True,1,3030,-12.35,-43265.0,37420.5,-5844.5
1940-02-21,12.32,-0.03,-0.24,31.86,-61.33,True,1,3031,-12.32,-43277.32,37341.92,-5935.4
1940-02-23,12.23,-0.09,-0.73,31.86,-61.61,True,1,3032,-12.23,-43289.55,37081.36,-6208.19
1940-02-26,12.16,-0.07,-0.57,31.86,-61.83,True,1,3033,-12.16,-43301.71,36881.28,-6420.43
1940-02-27,12.14,-0.02,-0.16,31.86,-61.9,True,1,3034,-12.14,-43313.85,36832.76,-6481.09
1940-02-28,12.15,0.01,0.08,31.86,-61.86,True,1,3035,-12.15,-43326.0,36875.25,-6450.75
1940-02-29,12.13,-0.02,-0.16,31.86,-61.93,True,1,3036,-12.13,-43338.13,36826.68,-6511.45
1940-03-01,12.06,-0.07,-0.58,31.86,-62.15,True,1,3037,-12.06,-43350.19,36626.22,-6723.97
1940-03-04,12.09,0.03,0.25,31.86,-62.05,True,1,3038,-12.09,-43362.28,36729.42,-6632.86
1940-03-05,12.15,0.06,0.5,31.86,-61.86,True,1,3039,-12.15,-43374.43,36923.85,-6450.58
1940-03-06,12.24,0.09,0.74,31.86,-61.58,True,1,3040,-12.24,-43386.67,37209.6,-6177.07
1940-03-07,12.25,0.01,0.08,31.86,-61.55,True,1,3041,-12.25,-43398.92,37252.25,-6146.67
1940-03-08,12.2,-0.05,-0.41,31.86,-61.71,True,1,3042,-12.2,-43411.12,37112.4,-6298.72
1940-03-11,12.24,0.04,0.33,31.86,-61.58,True,1,3043,-12.24,-43423.36,37246.32,-6177.04
1940-03-12,12.27,0.03,0.24,31.86,-61.49,True,1,3044,-12.27,-43435.63,37349.88,-6085.75
1940-03-13,12.25,-0.02,-0.16,31.86,-61.55,True,1,3045,-12.25,-43447.88,37301.25,-6146.63
1940-03-14,12.22,-0.03,-0.24,31.86,-61.64,True,1,3046,-12.22,-43460.1,37222.12,-6237.98
1940-03-15,12.07,-0.15,-1.23,31.86,-62.12,True,1,3047,-12.07,-43472.17,36777.29,-6694.88
1940-03-18,12.0,-0.07,-0.58,31.86,-62.34,True,1,3048,-12.0,-43484.17,36576.0,-6908.17
1940-03-19,12.09,0.09,0.75,31.86,-62.05,True,1,3049,-12.09,-43496.26,36862.41,-6633.85
1940-03-20,12.14,0.05,0.41,31.86,-61.9,True,1,3050,-12.14,-43508.4,37027.0,-6481.4
1940-03-21,12.14,0.0,0.0,31.86,-61.9,True,1,3051,-12.14,-43520.54,37039.14,-6481.4
1940-03-25,12.07,-0.07,-0.58,31.86,-62.12,True,1,3052,-12.07,-43532.61,36837.64,-6694.97
1940-03-26,12.01,-0.06,-0.5,31.86,-62.3,True,1,3053,-12.01,-43544.62,36666.53,-6878.09
1940-03-27,12.17,0.16,1.33,31.86,-61.8,True,1,3054,-12.17,-43556.79,37167.18,-6389.61
1940-03-28,12.14,-0.03,-0.25,31.86,-61.9,True,1,3055,-12.14,-43568.93,37087.7,-6481.23
1940-03-29,12.18,0.04,0.33,31.86,-61.77,True,1,3056,-12.18,-43581.11,37222.08,-6359.03
1940-04-01,12.21,0.03,0.25,31.86,-61.68,True,1,3057,-12.21,-43593.32,37325.97,-6267.35
1940-04-02,12.25,0.04,0.33,31.86,-61.55,True,1,3058,-12.25,-43605.57,37460.5,-6145.07
1940-04-03,12.44,0.19,1.55,31.86,-60.95,True,1,3059,-12.44,-43618.01,38053.96,-5564.05
1940-04-04,12.52,0.08,0.64,31.86,-60.7,True,1,3060,-12.52,-43630.53,38311.2,-5319.33
1940-04-05,12.48,-0.04,-0.32,31.86,-60.83,True,1,3061,-12.48,-43643.01,38201.28,-5441.73
1940-04-08,12.59,0.11,0.88,31.86,-60.48,True,1,3062,-12.59,-43655.6,38550.58,-5105.02
1940-04-09,12.46,-0.13,-1.03,31.86,-60.89,True,1,3063,-12.46,-43668.06,38164.98,-5503.08
1940-04-10,12.35,-0.11,-0.88,31.86,-61.24,True,1,3064,-12.35,-43680.41,37840.4,-5840.01
1940-04-11,12.39,0.04,0.32,31.86,-61.11,True,1,3065,-12.39,-43692.8,37975.35,-5717.45
1940-04-12,12.32,-0.07,-0.56,31.86,-61.33,True,1,3066,-12.32,-43705.12,37773.12,-5932.0
1940-04-15,12.32,0.0,0.0,31.86,-61.33,True,1,3067,-12.32,-43717.44,37785.44,-5932.0
1940-04-16,12.15,-0.17,-1.38,31.86,-61.86,True,1,3068,-12.15,-43729.59,37276.2,-6453.39
1940-04-17,12.16,0.01,0.08,31.86,-61.83,True,1,3069,-12.16,-43741.75,37319.04,-6422.71
1940-04-18,12.04,-0.12,-0.99,31.86,-62.21,True,1,3070,-12.04,-43753.79,36962.8,-6790.99
1940-04-19,12.04,0.0,0.0,31.86,-62.21,True,1,3071,-12.04,-43765.83,36974.84,-6790.99
1940-04-22,12.14,0.1,0.83,31.86,-61.9,True,1,3072,-12.14,-43777.97,37294.08,-6483.89
1940-04-23,12.23,0.09,0.74,31.86,-61.61,True,1,3073,-12.23,-43790.2,37582.79,-6207.41
1940-04-24,12.18,-0.05,-0.41,31.86,-61.77,True,1,3074,-12.18,-43802.38,37441.32,-6361.06
1940-04-25,12.19,0.01,0.08,31.86,-61.74,True,1,3075,-12.19,-43814.57,37484.25,-6330.32
1940-04-26,12.08,-0.11,-0.9,31.86,-62.08,True,1,3076,-12.08,-43826.65,37158.08,-6668.57
1940-04-29,12.12,0.04,0.33,31.86,-61.96,True,1,3077,-12.12,-43838.77,37293.24,-6545.53
1940-04-30,12.19,0.07,0.58,31.86,-61.74,True,1,3078,-12.19,-43850.96,37520.82,-6330.14
1940-05-01,12.03,-0.16,-1.31,31.86,-62.24,True,1,3079,-12.03,-43862.99,37040.37,-6822.62
1940-05-02,12.1,0.07,0.58,31.86,-62.02,True,1,3080,-12.1,-43875.09,37268.0,-6607.09
1940-05-03,12.12,0.02,0.16,31.86,-61.96,True,1,3081,-12.12,-43887.21,37341.72,-6545.49
1940-05-06,12.06,-0.06,-0.5,31.86,-62.15,True,1,3082,-12.06,-43899.27,37168.92,-6730.35
1940-05-07,12.09,0.03,0.25,31.86,-62.05,True,1,3083,-12.09,-43911.36,37273.47,-6637.89
1940-05-08,12.11,0.02,0.16,31.86,-61.99,True,1,3084,-12.11,-43923.47,37347.24,-6576.23
1940-05-09,12.12,0.01,0.08,31.86,-61.96,True,1,3085,-12.12,-43935.59,37390.2,-6545.39
1940-05-10,11.76,-0.36,-2.97,31.86,-63.09,True,1,3086,-11.76,-43947.35,36291.36,-7655.99
1940-05-13,11.11,-0.65,-5.53,31.86,-65.13,True,1,3087,-11.11,-43958.46,34296.57,-9661.89
1940-05-14,10.28,-0.83,-7.47,31.86,-67.73,True,1,3088,-10.28,-43968.74,31744.64,-12224.1
1940-05-15,10.38,0.1,0.97,31.86,-67.42,True,1,3089,-10.38,-43979.12,32063.82,-11915.3
1940-05-16,10.48,0.1,0.96,31.86,-67.11,True,1,3090,-10.48,-43989.6,32383.2,-11606.4
1940-05-17,9.95,-0.53,-5.06,31.86,-68.77,True,1,3091,-9.95,-43999.55,30755.45,-13244.1
1940-05-20,9.79,-0.16,-1.61,31.86,-69.27,True,1,3092,-9.79,-44009.34,30270.68,-13738.66
1940-05-21,9.14,-0.65,-6.64,31.86,-71.31,True,1,3093,-9.14,-44018.48,28270.02,-15748.46
1940-05-22,9.18,0.04,0.44,31.86,-71.19,True,1,3094,-9.18,-44027.66,28402.92,-15624.74
1940-05-23,9.2,0.02,0.22,31.86,-71.12,True,1,3095,-9.2,-44036.86,28474.0,-15562.86
1940-05-24,9.16,-0.04,-0.44,31.86,-71.25,True,1,3096,-9.16,-44046.02,28359.36,-15686.66
1940-05-27,9.38,0.22,2.4,31.86,-70.56,True,1,3097,-9.38,-44055.4,29049.86,-15005.54
1940-05-28,9.19,-0.19,-2.03,31.86,-71.16,True,1,3098,-9.19,-44064.59,28470.62,-15593.97
1940-05-29,9.25,0.06,0.65,31.86,-70.97,True,1,3099,-9.25,-44073.84,28665.75,-15408.09
1940-05-31,9.27,0.02,0.22,31.86,-70.9,True,1,3100,-9.27,-44083.11,28737.0,-15346.11
1940-06-03,9.11,-0.16,-1.73,31.86,-71.41,True,1,3101,-9.11,-44092.22,28250.11,-15842.11
1940-06-04,9.23,0.12,1.32,31.86,-71.03,True,1,3102,-9.23,-44101.45,28631.46,-15469.99
1940-06-05,9.09,-0.14,-1.52,31.86,-71.47,True,1,3103,-9.09,-44110.54,28206.27,-15904.27
1940-06-06,9.22,0.13,1.43,31.86,-71.06,True,1,3104,-9.22,-44119.76,28618.88,-15500.88
1940-06-07,9.34,0.12,1.3,31.86,-70.68,True,1,3105,-9.34,-44129.1,29000.7,-15128.4
1940-06-10,8.99,-0.35,-3.75,31.86,-71.78,True,1,3106,-8.99,-44138.09,27922.94,-16215.15
1940-06-11,9.42,0.43,4.78,31.86,-70.43,True,1,3107,-9.42,-44147.51,29267.94,-14879.57
1940-06-12,9.89,0.47,4.99,31.86,-68.96,True,1,3108,-9.89,-44157.4,30738.12,-13419.28
1940-06-13,9.7,-0.19,-1.92,31.86,-69.55,True,1,3109,-9.7,-44167.1,30157.3,-14009.8
1940-06-14,9.94,0.24,2.47,31.86,-68.8,True,1,3110,-9.94,-44177.04,30913.4,-13263.64
1940-06-17,9.98,0.04,0.4,31.86,-68.68,True,1,3111,-9.98,-44187.02,31047.78,-13139.24
1940-06-18,10.01,0.03,0.3,31.86,-68.58,True,1,3112,-10.01,-44197.03,31151.12,-13045.91
1940-06-19,10.03,0.02,0.2,31.86,-68.52,True,1,3113,-10.03,-44207.06,31223.39,-12983.67
1940-06-20,9.91,-0.12,-1.2,31.86,-68.9,True,1,3114,-9.91,-44216.97,30859.74,-13357.23
1940-06-21,9.91,0.0,0.0,31.86,-68.9,True,1,3115,-9.91,-44226.88,30869.65,-13357.23
1940-06-24,10.1,0.19,1.92,31.86,-68.3,True,1,3116,-10.1,-44236.98,31471.6,-12765.38
1940-06-25,9.81,-0.29,-2.87,31.86,-69.21,True,1,3117,-9.81,-44246.79,30577.77,-13669.02
1940-06-26,9.75,-0.06,-0.61,31.86,-69.4,True,1,3118,-9.75,-44256.54,30400.5,-13856.04
1940-06-27,9.85,0.1,1.03,31.86,-69.08,True,1,3119,-9.85,-44266.39,30722.15,-13544.24
1940-06-28,9.98,0.13,1.32,31.86,-68.68,True,1,3120,-9.98,-44276.37,31137.6,-13138.77
1940-07-01,9.87,-0.11,-1.1,31.86,-69.02,True,1,3121,-9.87,-44286.24,30804.27,-13481.97
1940-07-02,9.85,-0.02,-0.2,31.86,-69.08,True,1,3122,-9.85,-44296.09,30751.7,-13544.39
1940-07-03,9.88,0.03,0.3,31.86,-68.99,True,1,3123,-9.88,-44305.97,30855.24,-13450.73
1940-07-05,9.94,0.06,0.61,31.86,-68.8,True,1,3124,-9.94,-44315.91,31052.56,-13263.35
1940-07-08,9.94,0.0,0.0,31.86,-68.8,True,1,3125,-9.94,-44325.85,31062.5,-13263.35
1940-07-09,9.94,0.0,0.0,31.86,-68.8,True,1,3126,-9.94,-44335.79,31072.44,-13263.35
1940-07-10,9.97,0.03,0.3,31.86,-68.71,True,1,3127,-9.97,-44345.76,31176.19,-13169.57
1940-07-11,9.97,0.0,0.0,31.86,-68.71,True,1,3128,-9.97,-44355.73,31186.16,-13169.57
1940-07-12,9.95,-0.02,-0.2,31.86,-68.77,True,1,3129,-9.95,-44365.68,31133.55,-13232.13
1940-07-15,9.98,0.03,0.3,31.86,-68.68,True,1,3130,-9.98,-44375.66,31237.4,-13138.26
1940-07-16,10.09,0.11,1.1,31.86,-68.33,True,1,3131,-10.09,-44385.75,31591.79,-12793.96
1940-07-17,10.06,-0.03,-0.3,31.86,-68.42,True,1,3132,-10.06,-44395.81,31507.92,-12887.89
1940-07-18,10.07,0.01,0.1,31.86,-68.39,True,1,3133,-10.07,-44405.88,31549.31,-12856.57
1940-07-19,9.97,-0.1,-0.99,31.86,-68.71,True,1,3134,-9.97,-44415.85,31245.98,-13169.87
1940-07-22,9.97,0.0,0.0,31.86,-68.71,True,1,3135,-9.97,-44425.82,31255.95,-13169.87
1940-07-23,9.98,0.01,0.1,31.86,-68.68,True,1,3136,-9.98,-44435.8,31297.28,-13138.52
1940-07-24,9.89,-0.09,-0.9,31.86,-68.96,True,1,3137,-9.89,-44445.69,31024.93,-13420.76
1940-07-25,9.92,0.03,0.3,31.86,-68.86,True,1,3138,-9.92,-44455.61,31128.96,-13326.65
1940-07-26,9.97,0.05,0.5,31.86,-68.71,True,1,3139,-9.97,-44465.58,31295.83,-13169.75
1940-07-29,10.08,0.11,1.1,31.86,-68.36,True,1,3140,-10.08,-44475.66,31651.2,-12824.46
1940-07-30,10.33,0.25,2.48,31.86,-67.58,True,1,3141,-10.33,-44485.99,32446.53,-12039.46
1940-07-31,10.29,-0.04,-0.39,31.86,-67.7,True,1,3142,-10.29,-44496.28,32331.18,-12165.1
1940-08-01,10.26,-0.03,-0.29,31.86,-67.8,True,1,3143,-10.26,-44506.54,32247.18,-12259.36
1940-08-02,10.25,-0.01,-0.1,31.86,-67.83,True,1,3144,-10.25,-44516.79,32226.0,-12290.79
1940-08-05,10.28,0.03,0.29,31.86,-67.73,True,1,3145,-10.28,-44527.07,32330.6,-12196.47
1940-08-06,10.17,-0.11,-1.07,31.86,-68.08,True,1,3146,-10.17,-44537.24,31994.82,-12542.42
1940-08-07,10.17,0.0,0.0,31.86,-68.08,True,1,3147,-10.17,-44547.41,32004.99,-12542.42
1940-08-08,10.17,0.0,0.0,31.86,-68.08,True,1,3148,-10.17,-44557.58,32015.16,-12542.42
1940-08-09,10.27,0.1,0.98,31.86,-67.76,True,1,3149,-10.27,-44567.85,32340.23,-12227.62
1940-08-12,10.38,0.11,1.07,31.86,-67.42,True,1,3150,-10.38,-44578.23,32697.0,-11881.23
1940-08-13,10.0,-0.38,-3.66,31.86,-68.61,True,1,3151,-10.0,-44588.23,31510.0,-13078.23
1940-08-14,9.91,-0.09,-0.9,31.86,-68.9,True,1,3152,-9.91,-44598.14,31236.32,-13361.82
1940-08-15,10.0,0.09,0.91,31.86,-68.61,True,1,3153,-10.0,-44608.14,31530.0,-13078.14
1940-08-16,9.84,-0.16,-1.6,31.86,-69.11,True,1,3154,-9.84,-44617.98,31035.36,-13582.62
1940-08-19,9.91,0.07,0.71,31.86,-68.9,True,1,3155,-9.91,-44627.89,31266.05,-13361.84
1940-08-20,10.03,0.12,1.21,31.86,-68.52,True,1,3156,-10.03,-44637.92,31654.68,-12983.24
1940-08-21,10.21,0.18,1.8,31.86,-67.95,True,1,3157,-10.21,-44648.13,32232.97,-12415.16
1940-08-22,10.32,0.11,1.08,31.86,-67.61,True,1,3158,-10.32,-44658.45,32590.56,-12067.89
1940-08-23,10.19,-0.13,-1.26,31.86,-68.02,True,1,3159,-10.19,-44668.64,32190.21,-12478.43
1940-08-26,10.23,0.04,0.39,31.86,-67.89,True,1,3160,-10.23,-44678.87,32326.8,-12352.07
1940-08-27,10.23,0.0,0.0,31.86,-67.89,True,1,3161,-10.23,-44689.1,32337.03,-12352.07
1940-08-28,10.37,0.14,1.37,31.86,-67.45,True,1,3162,-10.37,-44699.47,32789.94,-11909.53
1940-08-29,10.32,-0.05,-0.48,31.86,-67.61,True,1,3163,-10.32,-44709.79,32642.16,-12067.63
1940-08-30,10.5,0.18,1.74,31.86,-67.04,True,1,3164,-10.5,-44720.29,33222.0,-11498.29
1940-09-03,10.56,0.06,0.57,31.86,-66.86,True,1,3165,-10.56,-44730.85,33422.4,-11308.45
1940-09-04,10.78,0.22,2.08,31.86,-66.16,True,1,3166,-10.78,-44741.63,34129.48,-10612.15
1940-09-05,10.93,0.15,1.39,31.86,-65.69,True,1,3167,-10.93,-44752.56,34615.31,-10137.25
1940-09-06,10.85,-0.08,-0.73,31.86,-65.94,True,1,3168,-10.85,-44763.41,34372.8,-10390.61
1940-09-09,10.52,-0.33,-3.04,31.86,-66.98,True,1,3169,-10.52,-44773.93,33337.88,-11436.05
1940-09-10,10.53,0.01,0.1,31.86,-66.95,True,1,3170,-10.53,-44784.46,33380.1,-11404.36
1940-09-11,10.45,-0.08,-0.76,31.86,-67.2,True,1,3171,-10.45,-44794.91,33136.95,-11657.96
1940-09-12,10.3,-0.15,-1.44,31.86,-67.67,True,1,3172,-10.3,-44805.21,32671.6,-12133.61
1940-09-13,10.31,0.01,0.1,31.86,-67.64,True,1,3173,-10.31,-44815.52,32713.63,-12101.89
1940-09-16,10.46,0.15,1.46,31.86,-67.17,True,1,3174,-10.46,-44825.98,33200.04,-11625.94
1940-09-17,10.54,0.08,0.76,31.86,-66.92,True,1,3175,-10.54,-44836.52,33464.5,-11372.02
1940-09-18,10.62,0.08,0.76,31.86,-66.67,True,1,3176,-10.62,-44847.14,33729.12,-11118.02
1940-09-19,10.59,-0.03,-0.28,31.86,-66.76,True,1,3177,-10.59,-44857.73,33644.43,-11213.3
1940-09-20,10.59,0.0,0.0,31.86,-66.76,True,1,3178,-10.59,-44868.32,33655.02,-11213.3
1940-09-23,10.9,0.31,2.93,31.86,-65.79,True,1,3179,-10.9,-44879.22,34651.1,-10228.12
1940-09-24,10.86,-0.04,-0.37,31.86,-65.91,True,1,3180,-10.86,-44890.08,34534.8,-10355.28
1940-09-25,10.84,-0.02,-0.18,31.86,-65.98,True,1,3181,-10.84,-44900.92,34482.04,-10418.88
1940-09-26,10.77,-0.07,-0.65,31.86,-66.2,True,1,3182,-10.77,-44911.69,34270.14,-10641.55
1940-09-27,10.58,-0.19,-1.76,31.86,-66.79,True,1,3183,-10.58,-44922.27,33676.14,-11246.13
1940-09-30,10.66,0.08,0.76,31.86,-66.54,True,1,3184,-10.66,-44932.93,33941.44,-10991.49
1940-10-01,10.81,0.15,1.41,31.86,-66.07,True,1,3185,-10.81,-44943.74,34429.85,-10513.89
1940-10-02,10.86,0.05,0.46,31.86,-65.91,True,1,3186,-10.86,-44954.6,34599.96,-10354.64
1940-10-03,10.87,0.01,0.09,31.86,-65.88,True,1,3187,-10.87,-44965.47,34642.69,-10322.78
1940-10-04,10.78,-0.09,-0.83,31.86,-66.16,True,1,3188,-10.78,-44976.25,34366.64,-10609.61
1940-10-07,10.72,-0.06,-0.56,31.86,-66.35,True,1,3189,-10.72,-44986.97,34186.08,-10800.89
1940-10-08,10.54,-0.18,-1.68,31.86,-66.92,True,1,3190,-10.54,-44997.51,33622.6,-11374.91
1940-10-09,10.48,-0.06,-0.57,31.86,-67.11,True,1,3191,-10.48,-45007.99,33441.68,-11566.31
1940-10-10,10.47,-0.01,-0.1,31.86,-67.14,True,1,3192,-10.47,-45018.46,33420.24,-11598.22
1940-10-11,10.58,0.11,1.05,31.86,-66.79,True,1,3193,-10.58,-45029.04,33781.94,-11247.1
1940-10-14,10.53,-0.05,-0.47,31.86,-66.95,True,1,3194,-10.53,-45039.57,33632.82,-11406.75
1940-10-15,10.64,0.11,1.04,31.86,-66.6,True,1,3195,-10.64,-45050.21,33994.8,-11055.41
1940-10-16,10.68,0.04,0.38,31.86,-66.48,True,1,3196,-10.68,-45060.89,34133.28,-10927.61
1940-10-17,10.73,0.05,0.47,31.86,-66.32,True,1,3197,-10.73,-45071.62,34303.81,-10767.81
1940-10-18,10.72,-0.01,-0.09,31.86,-66.35,True,1,3198,-10.72,-45082.34,34282.56,-10799.78
1940-10-21,10.65,-0.07,-0.65,31.86,-66.57,True,1,3199,-10.65,-45092.99,34069.35,-11023.64
1940-10-22,10.7,0.05,0.47,31.86,-66.42,True,1,3200,-10.7,-45103.69,34240.0,-10863.69
1940-10-23,10.8,0.1,0.94,31.86,-66.1,True,1,3201,-10.8,-45114.49,34570.8,-10543.69
1940-10-24,10.73,-0.07,-0.65,31.86,-66.32,True,1,3202,-10.73,-45125.22,34357.46,-10767.76
1940-10-25,10.73,0.0,0.0,31.86,-66.32,True,1,3203,-10.73,-45135.95,34368.19,-10767.76
1940-10-28,10.81,0.08,0.75,31.86,-66.07,True,1,3204,-10.81,-45146.76,34635.24,-10511.52
1940-10-29,10.83,0.02,0.18,31.86,-66.01,True,1,3205,-10.83,-45157.59,34710.15,-10447.44
1940-10-30,10.92,0.09,0.83,31.86,-65.72,True,1,3206,-10.92,-45168.51,35009.52,-10158.99
1940-10-31,11.08,0.16,1.46,31.86,-65.22,True,1,3207,-11.08,-45179.59,35533.56,-9646.03
1940-11-01,11.08,0.0,0.0,31.86,-65.22,True,1,3208,-11.08,-45190.67,35544.64,-9646.03
1940-11-04,11.16,0.08,0.72,31.86,-64.97,True,1,3209,-11.16,-45201.83,35812.44,-9389.39
1940-11-06,10.79,-0.37,-3.32,31.86,-66.13,True,1,3210,-10.79,-45212.62,34635.9,-10576.72
1940-11-07,11.39,0.6,5.56,31.86,-64.25,True,1,3211,-11.39,-45224.01,36573.29,-8650.72
1940-11-08,11.23,-0.16,-1.4,31.86,-64.75,True,1,3212,-11.23,-45235.24,36070.76,-9164.48
1940-11-12,11.36,0.13,1.16,31.86,-64.34,True,1,3213,-11.36,-45246.6,36499.68,-8746.92
1940-11-13,11.26,-0.1,-0.88,31.86,-64.66,True,1,3214,-11.26,-45257.86,36189.64,-9068.22
1940-11-14,11.29,0.03,0.27,31.86,-64.56,True,1,3215,-11.29,-45269.15,36297.35,-8971.8
1940-11-15,11.17,-0.12,-1.06,31.86,-64.94,True,1,3216,-11.17,-45280.32,35922.72,-9357.6
1940-11-18,11.04,-0.13,-1.16,31.86,-65.35,True,1,3217,-11.04,-45291.36,35515.68,-9775.68
1940-11-19,11.05,0.01,0.09,31.86,-65.32,True,1,3218,-11.05,-45302.41,35558.9,-9743.51
1940-11-20,10.79,-0.26,-2.35,31.86,-66.13,True,1,3219,-10.79,-45313.2,34733.01,-10580.19
1940-11-22,10.79,0.0,0.0,31.86,-66.13,True,1,3220,-10.79,-45323.99,34743.8,-10580.19
1940-11-25,10.79,0.0,0.0,31.86,-66.13,True,1,3221,-10.79,-45334.78,34754.59,-10580.19
1940-11-26,10.76,-0.03,-0.28,31.86,-66.23,True,1,3222,-10.76,-45345.54,34668.72,-10676.82
1940-11-27,10.56,-0.2,-1.86,31.86,-66.86,True,1,3223,-10.56,-45356.1,34034.88,-11321.22
1940-11-28,10.56,0.0,0.0,31.86,-66.86,True,1,3224,-10.56,-45366.66,34045.44,-11321.22
1940-11-29,10.57,0.01,0.1,31.86,-66.82,True,1,3225,-10.57,-45377.23,34088.25,-11288.98
1940-12-02,10.62,0.05,0.47,31.86,-66.67,True,1,3226,-10.62,-45387.85,34260.12,-11127.73
1940-12-03,10.58,-0.04,-0.38,31.86,-66.79,True,1,3227,-10.58,-45398.43,34141.66,-11256.77
1940-12-04,10.58,0.0,0.0,31.86,-66.79,True,1,3228,-10.58,-45409.01,34152.24,-11256.77
1940-12-05,10.51,-0.07,-0.66,31.86,-67.01,True,1,3229,-10.51,-45419.52,33936.79,-11482.73
1940-12-06,10.53,0.02,0.19,31.86,-66.95,True,1,3230,-10.53,-45430.05,34011.9,-11418.15
1940-12-09,10.61,0.08,0.76,31.86,-66.7,True,1,3231,-10.61,-45440.66,34280.91,-11159.75
1940-12-10,10.61,0.0,0.0,31.86,-66.7,True,1,3232,-10.61,-45451.27,34291.52,-11159.75
1940-12-11,10.63,0.02,0.19,31.86,-66.64,True,1,3233,-10.63,-45461.9,34366.79,-11095.11
1940-12-12,10.67,0.04,0.38,31.86,-66.51,True,1,3234,-10.67,-45472.57,34506.78,-10965.79
1940-12-13,10.69,0.02,0.19,31.86,-66.45,True,1,3235,-10.69,-45483.26,34582.15,-10901.11
1940-12-16,10.58,-0.11,-1.03,31.86,-66.79,True,1,3236,-10.58,-45493.84,34236.88,-11256.96
1940-12-17,10.54,-0.04,-0.38,31.86,-66.92,True,1,3237,-10.54,-45504.38,34117.98,-11386.4
1940-12-18,10.44,-0.1,-0.95,31.86,-67.23,True,1,3238,-10.44,-45514.82,33804.72,-11710.1
1940-12-19,10.4,-0.04,-0.38,31.86,-67.36,True,1,3239,-10.4,-45525.22,33685.6,-11839.62
1940-12-20,10.41,0.01,0.1,31.86,-67.33,True,1,3240,-10.41,-45535.63,33728.4,-11807.23
1940-12-23,10.38,-0.03,-0.29,31.86,-67.42,True,1,3241,-10.38,-45546.01,33641.58,-11904.43
1940-12-24,10.4,0.02,0.19,31.86,-67.36,True,1,3242,-10.4,-45556.41,33716.8,-11839.61
1940-12-26,10.39,-0.01,-0.1,31.86,-67.39,True,1,3243,-10.39,-45566.8,33694.77,-11872.03
1940-12-27,10.44,0.05,0.48,31.86,-67.23,True,1,3244,-10.44,-45577.24,33867.36,-11709.88
1940-12-30,10.57,0.13,1.25,31.86,-66.82,True,1,3245,-10.57,-45587.81,34299.65,-11288.16
1940-12-31,10.58,0.01,0.1,31.86,-66.79,True,1,3246,-10.58,-45598.39,34342.68,-11255.71
1941-01-02,10.48,-0.1,-0.94,31.86,-67.11,True,1,3247,-10.48,-45608.87,34028.56,-11580.31
1941-01-03,10.72,0.24,2.29,31.86,-66.35,True,1,3248,-10.72,-45619.59,34818.56,-10801.03
1941-01-06,10.74,0.02,0.19,31.86,-66.29,True,1,3249,-10.74,-45630.33,34894.26,-10736.07
1941-01-07,10.75,0.01,0.09,31.86,-66.26,True,1,3250,-10.75,-45641.08,34937.5,-10703.58
1941-01-08,10.77,0.02,0.19,31.86,-66.2,True,1,3251,-10.77,-45651.85,35013.27,-10638.58
1941-01-09,10.83,0.06,0.56,31.86,-66.01,True,1,3252,-10.83,-45662.68,35219.16,-10443.52
1941-01-10,10.86,0.03,0.28,31.86,-65.91,True,1,3253,-10.86,-45673.54,35327.58,-10345.96
1941-01-13,10.82,-0.04,-0.37,31.86,-66.04,True,1,3254,-10.82,-45684.36,35208.28,-10476.08
1941-01-14,10.76,-0.06,-0.56,31.86,-66.23,True,1,3255,-10.76,-45695.12,35023.8,-10671.32
1941-01-15,10.67,-0.09,-0.84,31.86,-66.51,True,1,3256,-10.67,-45705.79,34741.52,-10964.27
1941-01-16,10.54,-0.13,-1.22,31.86,-66.92,True,1,3257,-10.54,-45716.33,34328.78,-11387.55
1941-01-17,10.52,-0.02,-0.19,31.86,-66.98,True,1,3258,-10.52,-45726.85,34274.16,-11452.69
1941-01-20,10.47,-0.05,-0.48,31.86,-67.14,True,1,3259,-10.47,-45737.32,34121.73,-11615.59
1941-01-21,10.37,-0.1,-0.96,31.86,-67.45,True,1,3260,-10.37,-45747.69,33806.2,-11941.49
1941-01-22,10.43,0.06,0.58,31.86,-67.26,True,1,3261,-10.43,-45758.12,34012.23,-11745.89
1941-01-23,10.42,-0.01,-0.1,31.86,-67.29,True,1,3262,-10.42,-45768.54,33990.04,-11778.5
1941-01-24,10.45,0.03,0.29,31.86,-67.2,True,1,3263,-10.45,-45778.99,34098.35,-11680.64
1941-01-27,10.49,0.04,0.38,31.86,-67.08,True,1,3264,-10.49,-45789.48,34239.36,-11550.12
1941-01-28,10.43,-0.06,-0.57,31.86,-67.26,True,1,3265,-10.43,-45799.91,34053.95,-11745.96
1941-01-29,10.22,-0.21,-2.01,31.86,-67.92,True,1,3266,-10.22,-45810.13,33378.52,-12431.61
1941-01-30,10.04,-0.18,-1.76,31.86,-68.49,True,1,3267,-10.04,-45820.17,32800.68,-13019.49
1941-01-31,10.07,0.03,0.3,31.86,-68.39,True,1,3268,-10.07,-45830.24,32908.76,-12921.48
1941-02-03,9.96,-0.11,-1.09,31.86,-68.74,True,1,3269,-9.96,-45840.2,32559.24,-13280.96
1941-02-04,9.97,0.01,0.1,31.86,-68.71,True,1,3270,-9.97,-45850.17,32601.9,-13248.27
1941-02-05,10.15,0.18,1.8,31.86,-68.14,True,1,3271,-10.15,-45860.32,33200.65,-12659.67
1941-02-06,10.19,0.04,0.39,31.86,-68.02,True,1,3272,-10.19,-45870.51,33341.68,-12528.83
1941-02-07,10.16,-0.03,-0.29,31.86,-68.11,True,1,3273,-10.16,-45880.67,33253.68,-12626.99
1941-02-10,10.15,-0.01,-0.1,31.86,-68.14,True,1,3274,-10.15,-45890.82,33231.1,-12659.72
1941-02-11,9.98,-0.17,-1.68,31.86,-68.68,True,1,3275,-9.98,-45900.8,32684.5,-13216.3
1941-02-13,9.84,-0.14,-1.4,31.86,-69.11,True,1,3276,-9.84,-45910.64,32235.84,-13674.8
1941-02-14,9.53,-0.31,-3.15,31.86,-70.09,True,1,3277,-9.53,-45920.17,31229.81,-14690.36
1941-02-17,9.65,0.12,1.26,31.86,-69.71,True,1,3278,-9.65,-45929.82,31632.7,-14297.12
1941-02-18,9.63,-0.02,-0.21,31.86,-69.77,True,1,3279,-9.63,-45939.45,31576.77,-14362.68
1941-02-19,9.55,-0.08,-0.83,31.86,-70.03,True,1,3280,-9.55,-45949.0,31324.0,-14625.0
1941-02-20,9.72,0.17,1.78,31.86,-69.49,True,1,3281,-9.72,-45958.72,31891.32,-14067.4
1941-02-21,9.76,0.04,0.41,31.86,-69.37,True,1,3282,-9.76,-45968.48,32032.32,-13936.16
1941-02-24,9.84,0.08,0.82,31.86,-69.11,True,1,3283,-9.84,-45978.32,32304.72,-13673.6
1941-02-25,9.93,0.09,0.92,31.86,-68.83,True,1,3284,-9.93,-45988.25,32610.12,-13378.13
1941-02-26,9.95,0.02,0.2,31.86,-68.77,True,1,3285,-9.95,-45998.2,32685.75,-13312.45
1941-02-27,9.88,-0.07,-0.7,31.86,-68.99,True,1,3286,-9.88,-46008.08,32465.68,-13542.4
1941-02-28,9.92,0.04,0.4,31.86,-68.86,True,1,3287,-9.92,-46018.0,32607.04,-13410.96
1941-03-03,9.77,-0.15,-1.51,31.86,-69.33,True,1,3288,-9.77,-46027.77,32123.76,-13904.01
1941-03-04,9.82,0.05,0.51,31.86,-69.18,True,1,3289,-9.82,-46037.59,32297.98,-13739.61
1941-03-05,9.76,-0.06,-0.61,31.86,-69.37,True,1,3290,-9.76,-46047.35,32110.4,-13936.95
1941-03-06,9.95,0.19,1.95,31.86,-68.77,True,1,3291,-9.95,-46057.3,32745.45,-13311.85
1941-03-07,9.9,-0.05,-0.5,31.86,-68.93,True,1,3292,-9.9,-46067.2,32590.8,-13476.4
1941-03-10,10.1,0.2,2.02,31.86,-68.3,True,1,3293,-10.1,-46077.3,33259.3,-12818.0
1941-03-11,10.02,-0.08,-0.79,31.86,-68.55,True,1,3294,-10.02,-46087.32,33005.88,-13081.44
1941-03-12,10.02,0.0,0.0,31.86,-68.55,True,1,3295,-10.02,-46097.34,33015.9,-13081.44
1941-03-13,9.97,-0.05,-0.5,31.86,-68.71,True,1,3296,-9.97,-46107.31,32861.12,-13246.19
1941-03-14,9.98,0.01,0.1,31.86,-68.68,True,1,3297,-9.98,-46117.29,32904.06,-13213.23
1941-03-17,10.03,0.05,0.5,31.86,-68.52,True,1,3298,-10.03,-46127.32,33078.94,-13048.38
1941-03-18,10.07,0.04,0.4,31.86,-68.39,True,1,3299,-10.07,-46137.39,33220.93,-12916.46
1941-03-19,10.01,-0.06,-0.6,31.86,-68.58,True,1,3300,-10.01,-46147.4,33033.0,-13114.4
1941-03-20,10.02,0.01,0.1,31.86,-68.55,True,1,3301,-10.02,-46157.42,33076.02,-13081.4
1941-03-21,9.93,-0.09,-0.9,31.86,-68.83,True,1,3302,-9.93,-46167.35,32788.86,-13378.49
1941-03-24,9.92,-0.01,-0.1,31.86,-68.86,True,1,3303,-9.92,-46177.27,32765.76,-13411.51
1941-03-25,9.96,0.04,0.4,31.86,-68.74,True,1,3304,-9.96,-46187.23,32907.84,-13279.39
1941-03-26,9.93,-0.03,-0.3,31.86,-68.83,True,1,3305,-9.93,-46197.16,32818.65,-13378.51
1941-03-27,10.01,0.08,0.81,31.86,-68.58,True,1,3306,-10.01,-46207.17,33093.06,-13114.11
1941-03-28,9.94,-0.07,-0.7,31.86,-68.8,True,1,3307,-9.94,-46217.11,32871.58,-13345.53
1941-03-31,9.96,0.02,0.2,31.86,-68.74,True,1,3308,-9.96,-46227.07,32947.68,-13279.39
1941-04-01,9.97,0.01,0.1,31.86,-68.71,True,1,3309,-9.97,-46237.04,32990.73,-13246.31
1941-04-02,10.01,0.04,0.4,31.86,-68.58,True,1,3310,-10.01,-46247.05,33133.1,-13113.95
1941-04-03,10.16,0.15,1.5,31.86,-68.11,True,1,3311,-10.16,-46257.21,33639.76,-12617.45
1941-04-04,10.14,-0.02,-0.2,31.86,-68.17,True,1,3312,-10.14,-46267.35,33583.68,-12683.67
1941-04-07,10.05,-0.09,-0.89,31.86,-68.46,True,1,3313,-10.05,-46277.4,33295.65,-12981.75
1941-04-08,9.84,-0.21,-2.09,31.86,-69.11,True,1,3314,-9.84,-46287.24,32609.76,-13677.48
1941-04-09,9.7,-0.14,-1.42,31.86,-69.55,True,1,3315,-9.7,-46296.94,32155.5,-14141.44
1941-04-10,9.69,-0.01,-0.1,31.86,-69.59,True,1,3316,-9.69,-46306.63,32132.04,-14174.59
1941-04-14,9.62,-0.07,-0.72,31.86,-69.81,True,1,3317,-9.62,-46316.25,31909.54,-14406.71
1941-04-15,9.59,-0.03,-0.31,31.86,-69.9,True,1,3318,-9.59,-46325.84,31819.62,-14506.22
1941-04-16,9.59,0.0,0.0,31.86,-69.9,True,1,3319,-9.59,-46335.43,31829.21,-14506.22
1941-04-17,9.54,-0.05,-0.52,31.86,-70.06,True,1,3320,-9.54,-46344.97,31672.8,-14672.17
1941-04-18,9.4,-0.14,-1.47,31.86,-70.5,True,1,3321,-9.4,-46354.37,31217.4,-15136.97
1941-04-21,9.37,-0.03,-0.32,31.86,-70.59,True,1,3322,-9.37,-46363.74,31127.14,-15236.6
1941-04-22,9.32,-0.05,-0.53,31.86,-70.75,True,1,3323,-9.32,-46373.06,30970.36,-15402.7
1941-04-23,9.43,0.11,1.18,31.86,-70.4,True,1,3324,-9.43,-46382.49,31345.32,-15037.17
1941-04-24,9.47,0.04,0.42,31.86,-70.28,True,1,3325,-9.47,-46391.96,31487.75,-14904.21
1941-04-25,9.4,-0.07,-0.74,31.86,-70.5,True,1,3326,-9.4,-46401.36,31264.4,-15136.96
1941-04-28,9.42,0.02,0.21,31.86,-70.43,True,1,3327,-9.42,-46410.78,31340.34,-15070.44
1941-04-29,9.44,0.02,0.21,31.86,-70.37,True,1,3328,-9.44,-46420.22,31416.32,-15003.9
1941-04-30,9.31,-0.13,-1.38,31.86,-70.78,True,1,3329,-9.31,-46429.53,30992.99,-15436.54
1941-05-01,9.3,-0.01,-0.11,31.86,-70.81,True,1,3330,-9.3,-46438.83,30969.0,-15469.83
1941-05-02,9.33,0.03,0.32,31.86,-70.72,True,1,3331,-9.33,-46448.16,31078.23,-15369.93
1941-05-05,9.34,0.01,0.11,31.86,-70.68,True,1,3332,-9.34,-46457.5,31120.88,-15336.62
1941-05-06,9.5,0.16,1.71,31.86,-70.18,True,1,3333,-9.5,-46467.0,31663.5,-14803.5
1941-05-07,9.47,-0.03,-0.32,31.86,-70.28,True,1,3334,-9.47,-46476.47,31572.98,-14903.49
1941-05-08,9.45,-0.02,-0.21,31.86,-70.34,True,1,3335,-9.45,-46485.92,31515.75,-14970.17
1941-05-09,9.45,0.0,0.0,31.86,-70.34,True,1,3336,-9.45,-46495.37,31525.2,-14970.17
1941-05-12,9.56,0.11,1.16,31.86,-69.99,True,1,3337,-9.56,-46504.93,31901.72,-14603.21
1941-05-13,9.56,0.0,0.0,31.86,-69.99,True,1,3338,-9.56,-46514.49,31911.28,-14603.21
1941-05-14,9.49,-0.07,-0.73,31.86,-70.21,True,1,3339,-9.49,-46523.98,31687.11,-14836.87
1941-05-15,9.33,-0.16,-1.69,31.86,-70.72,True,1,3340,-9.33,-46533.31,31162.2,-15371.11
1941-05-16,9.35,0.02,0.21,31.86,-70.65,True,1,3341,-9.35,-46542.66,31238.35,-15304.31
1941-05-19,9.4,0.05,0.54,31.86,-70.5,True,1,3342,-9.4,-46552.06,31414.8,-15137.26
1941-05-20,9.56,0.16,1.7,31.86,-69.99,True,1,3343,-9.56,-46561.62,31959.08,-14602.54
1941-05-21,9.55,-0.01,-0.1,31.86,-70.03,True,1,3344,-9.55,-46571.17,31935.2,-14635.97
1941-05-22,9.44,-0.11,-1.15,31.86,-70.37,True,1,3345,-9.44,-46580.61,31576.8,-15003.81
1941-05-23,9.44,0.0,0.0,31.86,-70.37,True,1,3346,-9.44,-46590.05,31586.24,-15003.81
1941-05-26,9.33,-0.11,-1.16,31.86,-70.72,True,1,3347,-9.33,-46599.38,31227.51,-15371.87
1941-05-27,9.39,0.06,0.64,31.86,-70.53,True,1,3348,-9.39,-46608.77,31437.72,-15171.05
1941-05-28,9.39,0.0,0.0,31.86,-70.53,True,1,3349,-9.39,-46618.16,31447.11,-15171.05
1941-05-29,9.38,-0.01,-0.11,31.86,-70.56,True,1,3350,-9.38,-46627.54,31423.0,-15204.54
1941-06-02,9.36,-0.02,-0.21,31.86,-70.62,True,1,3351,-9.36,-46636.9,31365.36,-15271.54
1941-06-03,9.47,0.11,1.18,31.86,-70.28,True,1,3352,-9.47,-46646.37,31743.44,-14902.93
1941-06-04,9.46,-0.01,-0.11,31.86,-70.31,True,1,3353,-9.46,-46655.83,31719.38,-14936.45
1941-06-05,9.5,0.04,0.42,31.86,-70.18,True,1,3354,-9.5,-46665.33,31863.0,-14802.33
1941-06-06,9.49,-0.01,-0.1,31.86,-70.21,True,1,3355,-9.49,-46674.82,31838.95,-14835.87
1941-06-09,9.66,0.17,1.79,31.86,-69.68,True,1,3356,-9.66,-46684.48,32418.96,-14265.52
1941-06-10,9.82,0.16,1.66,31.86,-69.18,True,1,3357,-9.82,-46694.3,32965.74,-13728.56
1941-06-11,9.82,0.0,0.0,31.86,-69.18,True,1,3358,-9.82,-46704.12,32975.56,-13728.56
1941-06-12,9.87,0.05,0.51,31.86,-69.02,True,1,3359,-9.87,-46713.99,33153.33,-13560.66
1941-06-13,9.85,-0.02,-0.2,31.86,-69.08,True,1,3360,-9.85,-46723.84,33096.0,-13627.84
1941-06-16,9.81,-0.04,-0.41,31.86,-69.21,True,1,3361,-9.81,-46733.65,32971.41,-13762.24
1941-06-17,9.89,0.08,0.82,31.86,-68.96,True,1,3362,-9.89,-46743.54,33250.18,-13493.36
1941-06-18,9.9,0.01,0.1,31.86,-68.93,True,1,3363,-9.9,-46753.44,33293.7,-13459.74
1941-06-19,9.88,-0.02,-0.2,31.86,-68.99,True,1,3364,-9.88,-46763.32,33236.32,-13527.0
1941-06-20,9.76,-0.12,-1.22,31.86,-69.37,True,1,3365,-9.76,-46773.08,32842.4,-13930.68
1941-06-23,9.95,0.19,1.95,31.86,-68.77,True,1,3366,-9.95,-46783.03,33491.7,-13291.33
1941-06-24,9.88,-0.07,-0.7,31.86,-68.99,True,1,3367,-9.88,-46792.91,33265.96,-13526.95
1941-06-25,9.9,0.02,0.2,31.86,-68.93,True,1,3368,-9.9,-46802.81,33343.2,-13459.61
1941-06-26,9.94,0.04,0.4,31.86,-68.8,True,1,3369,-9.94,-46812.75,33487.86,-13324.89
1941-06-27,9.89,-0.05,-0.5,31.86,-68.96,True,1,3370,-9.89,-46822.64,33329.3,-13493.34
1941-06-30,9.85,-0.04,-0.4,31.86,-69.08,True,1,3371,-9.85,-46832.49,33204.35,-13628.14
1941-07-01,9.82,-0.03,-0.3,31.86,-69.18,True,1,3372,-9.82,-46842.31,33113.04,-13729.27
1941-07-02,9.89,0.07,0.71,31.86,-68.96,True,1,3373,-9.89,-46852.2,33358.97,-13493.23
1941-07-03,9.91,0.02,0.2,31.86,-68.9,True,1,3374,-9.91,-46862.11,33436.34,-13425.77
1941-07-07,10.09,0.18,1.82,31.86,-68.33,True,1,3375,-10.09,-46872.2,34053.75,-12818.45
1941-07-08,10.28,0.19,1.88,31.86,-67.73,True,1,3376,-10.28,-46882.48,34705.28,-12177.2
1941-07-09,10.28,0.0,0.0,31.86,-67.73,True,1,3377,-10.28,-46892.76,34715.56,-12177.2
1941-07-10,10.31,0.03,0.29,31.86,-67.64,True,1,3378,-10.31,-46903.07,34827.18,-12075.89
1941-07-11,10.28,-0.03,-0.29,31.86,-67.73,True,1,3379,-10.28,-46913.35,34736.12,-12177.23
1941-07-14,10.3,0.02,0.2,31.86,-67.67,True,1,3380,-10.3,-46923.65,34814.0,-12109.65
1941-07-15,10.33,0.03,0.29,31.86,-67.58,True,1,3381,-10.33,-46933.98,34925.73,-12008.25
1941-07-16,10.28,-0.05,-0.48,31.86,-67.73,True,1,3382,-10.28,-46944.26,34766.96,-12177.3
1941-07-17,10.21,-0.07,-0.68,31.86,-67.95,True,1,3383,-10.21,-46954.47,34540.43,-12414.04
1941-07-18,10.25,0.04,0.39,31.86,-67.83,True,1,3384,-10.25,-46964.72,34686.0,-12278.72
1941-07-21,10.46,0.21,2.05,31.86,-67.17,True,1,3385,-10.46,-46975.18,35407.1,-11568.08
1941-07-22,10.45,-0.01,-0.1,31.86,-67.2,True,1,3386,-10.45,-46985.63,35383.7,-11601.93
1941-07-23,10.42,-0.03,-0.29,31.86,-67.29,True,1,3387,-10.42,-46996.05,35292.54,-11703.51
1941-07-24,10.36,-0.06,-0.58,31.86,-67.48,True,1,3388,-10.36,-47006.41,35099.68,-11906.73
1941-07-25,10.34,-0.02,-0.19,31.86,-67.55,True,1,3389,-10.34,-47016.75,35042.26,-11974.49
1941-07-28,10.47,0.13,1.26,31.86,-67.14,True,1,3390,-10.47,-47027.22,35493.3,-11533.92
1941-07-29,10.45,-0.02,-0.19,31.86,-67.2,True,1,3391,-10.45,-47037.67,35435.95,-11601.72
1941-07-30,10.4,-0.05,-0.48,31.86,-67.36,True,1,3392,-10.4,-47048.07,35276.8,-11771.27
1941-07-31,10.39,-0.01,-0.1,31.86,-67.39,True,1,3393,-10.39,-47058.46,35253.27,-11805.19
1941-08-01,10.34,-0.05,-0.48,31.86,-67.55,True,1,3394,-10.34,-47068.8,35093.96,-11974.84
1941-08-04,10.36,0.02,0.19,31.86,-67.48,True,1,3395,-10.36,-47079.16,35172.2,-11906.96
1941-08-05,10.36,0.0,0.0,31.86,-67.48,True,1,3396,-10.36,-47089.52,35182.56,-11906.96
1941-08-06,10.36,0.0,0.0,31.86,-67.48,True,1,3397,-10.36,-47099.88,35192.92,-11906.96
1941-08-07,10.34,-0.02,-0.19,31.86,-67.55,True,1,3398,-10.34,-47110.22,35135.32,-11974.9
1941-08-08,10.23,-0.11,-1.06,31.86,-67.89,True,1,3399,-10.23,-47120.45,34771.77,-12348.68
1941-08-11,10.14,-0.09,-0.88,31.86,-68.17,True,1,3400,-10.14,-47130.59,34476.0,-12654.59
1941-08-12,10.14,0.0,0.0,31.86,-68.17,True,1,3401,-10.14,-47140.73,34486.14,-12654.59
1941-08-13,10.09,-0.05,-0.49,31.86,-68.33,True,1,3402,-10.09,-47150.82,34326.18,-12824.64
1941-08-14,10.13,0.04,0.4,31.86,-68.2,True,1,3403,-10.13,-47160.95,34472.39,-12688.56
1941-08-15,10.03,-0.1,-0.99,31.86,-68.52,True,1,3404,-10.03,-47170.98,34142.12,-13028.86
1941-08-18,10.13,0.1,1.0,31.86,-68.2,True,1,3405,-10.13,-47181.11,34492.65,-12688.46
1941-08-19,10.14,0.01,0.1,31.86,-68.17,True,1,3406,-10.14,-47191.25,34536.84,-12654.41
1941-08-20,10.18,0.04,0.39,31.86,-68.05,True,1,3407,-10.18,-47201.43,34683.26,-12518.17
1941-08-21,10.17,-0.01,-0.1,31.86,-68.08,True,1,3408,-10.17,-47211.6,34659.36,-12552.24
1941-08-22,10.15,-0.02,-0.2,31.86,-68.14,True,1,3409,-10.15,-47221.75,34601.35,-12620.4
1941-08-25,10.17,0.02,0.2,31.86,-68.08,True,1,3410,-10.17,-47231.92,34679.7,-12552.22
1941-08-26,10.25,0.08,0.79,31.86,-67.83,True,1,3411,-10.25,-47242.17,34962.75,-12279.42
1941-08-27,10.26,0.01,0.1,31.86,-67.8,True,1,3412,-10.26,-47252.43,35007.12,-12245.31
1941-08-28,10.29,0.03,0.29,31.86,-67.7,True,1,3413,-10.29,-47262.72,35119.77,-12142.95
1941-08-29,10.28,-0.01,-0.1,31.86,-67.73,True,1,3414,-10.28,-47273.0,35095.92,-12177.08
1941-09-02,10.34,0.06,0.58,31.86,-67.55,True,1,3415,-10.34,-47283.34,35311.1,-11972.24
1941-09-03,10.27,-0.07,-0.68,31.86,-67.76,True,1,3416,-10.27,-47293.61,35082.32,-12211.29
1941-09-04,10.24,-0.03,-0.29,31.86,-67.86,True,1,3417,-10.24,-47303.85,34990.08,-12313.77
1941-09-05,10.21,-0.03,-0.29,31.86,-67.95,True,1,3418,-10.21,-47314.06,34897.78,-12416.28
1941-09-08,10.23,0.02,0.2,31.86,-67.89,True,1,3419,-10.23,-47324.29,34976.37,-12347.92
1941-09-09,10.2,-0.03,-0.29,31.86,-67.98,True,1,3420,-10.2,-47334.49,34884.0,-12450.49
1941-09-10,10.12,-0.08,-0.78,31.86,-68.24,True,1,3421,-10.12,-47344.61,34620.52,-12724.09
1941-09-11,10.23,0.11,1.09,31.86,-67.89,True,1,3422,-10.23,-47354.84,35007.06,-12347.78
1941-09-12,10.23,0.0,0.0,31.86,-67.89,True,1,3423,-10.23,-47365.07,35017.29,-12347.78
1941-09-15,10.24,0.01,0.1,31.86,-67.86,True,1,3424,-10.24,-47375.31,35061.76,-12313.55
1941-09-16,10.29,0.05,0.49,31.86,-67.7,True,1,3425,-10.29,-47385.6,35243.25,-12142.35
1941-09-17,10.47,0.18,1.75,31.86,-67.14,True,1,3426,-10.47,-47396.07,35870.22,-11525.85
1941-09-18,10.39,-0.08,-0.76,31.86,-67.39,True,1,3427,-10.39,-47406.46,35606.53,-11799.93
1941-09-19,10.29,-0.1,-0.96,31.86,-67.7,True,1,3428,-10.29,-47416.75,35274.12,-12142.63
1941-09-22,10.28,-0.01,-0.1,31.86,-67.73,True,1,3429,-10.28,-47427.03,35250.12,-12176.91
1941-09-23,10.32,0.04,0.39,31.86,-67.61,True,1,3430,-10.32,-47437.35,35397.6,-12039.75
1941-09-24,10.25,-0.07,-0.68,31.86,-67.83,True,1,3431,-10.25,-47447.6,35167.75,-12279.85
1941-09-25,10.12,-0.13,-1.27,31.86,-68.24,True,1,3432,-10.12,-47457.72,34731.84,-12725.88
1941-09-26,10.09,-0.03,-0.3,31.86,-68.33,True,1,3433,-10.09,-47467.81,34638.97,-12828.84
1941-09-29,10.13,0.04,0.4,31.86,-68.2,True,1,3434,-10.13,-47477.94,34786.42,-12691.52
1941-09-30,10.2,0.07,0.69,31.86,-67.98,True,1,3435,-10.2,-47488.14,35037.0,-12451.14
1941-10-01,10.17,-0.03,-0.29,31.86,-68.08,True,1,3436,-10.17,-47498.31,34944.12,-12554.19
1941-10-02,10.14,-0.03,-0.3,31.86,-68.17,True,1,3437,-10.14,-47508.45,34851.18,-12657.27
1941-10-03,10.13,-0.01,-0.1,31.86,-68.2,True,1,3438,-10.13,-47518.58,34826.94,-12691.64
1941-10-06,10.12,-0.01,-0.1,31.86,-68.24,True,1,3439,-10.12,-47528.7,34802.68,-12726.02
1941-10-07,10.0,-0.12,-1.19,31.86,-68.61,True,1,3440,-10.0,-47538.7,34400.0,-13138.7
1941-10-08,9.98,-0.02,-0.2,31.86,-68.68,True,1,3441,-9.98,-47548.68,34341.18,-13207.5
1941-10-09,9.84,-0.14,-1.4,31.86,-69.11,True,1,3442,-9.84,-47558.52,33869.28,-13689.24
1941-10-10,9.84,0.0,0.0,31.86,-69.11,True,1,3443,-9.84,-47568.36,33879.12,-13689.24
1941-10-14,9.78,-0.06,-0.61,31.86,-69.3,True,1,3444,-9.78,-47578.14,33682.32,-13895.82
1941-10-15,9.72,-0.06,-0.61,31.86,-69.49,True,1,3445,-9.72,-47587.86,33485.4,-14102.46
1941-10-16,9.58,-0.14,-1.44,31.86,-69.93,True,1,3446,-9.58,-47597.44,33012.68,-14584.76
1941-10-17,9.62,0.04,0.42,31.86,-69.81,True,1,3447,-9.62,-47607.06,33160.14,-14446.92
1941-10-20,9.71,0.09,0.94,31.86,-69.52,True,1,3448,-9.71,-47616.77,33480.08,-14136.69
1941-10-21,9.8,0.09,0.93,31.86,-69.24,True,1,3449,-9.8,-47626.57,33800.2,-13826.37
1941-10-22,9.76,-0.04,-0.41,31.86,-69.37,True,1,3450,-9.76,-47636.33,33672.0,-13964.33
1941-10-23,9.77,0.01,0.1,31.86,-69.33,True,1,3451,-9.77,-47646.1,33716.27,-13929.83
1941-10-24,9.82,0.05,0.51,31.86,-69.18,True,1,3452,-9.82,-47655.92,33898.64,-13757.28
1941-10-27,9.66,-0.16,-1.63,31.86,-69.68,True,1,3453,-9.66,-47665.58,33355.98,-14309.6
1941-10-28,9.65,-0.01,-0.1,31.86,-69.71,True,1,3454,-9.65,-47675.23,33331.1,-14344.13
1941-10-29,9.62,-0.03,-0.31,31.86,-69.81,True,1,3455,-9.62,-47684.85,33237.1,-14447.75
1941-10-30,9.62,0.0,0.0,31.86,-69.81,True,1,3456,-9.62,-47694.47,33246.72,-14447.75
1941-10-31,9.5,-0.12,-1.25,31.86,-70.18,True,1,3457,-9.5,-47703.97,32841.5,-14862.47
1941-11-03,9.59,0.09,0.95,31.86,-69.9,True,1,3458,-9.59,-47713.56,33162.22,-14551.34
1941-11-05,9.66,0.07,0.73,31.86,-69.68,True,1,3459,-9.66,-47723.22,33413.94,-14309.28
1941-11-06,9.58,-0.08,-0.83,31.86,-69.93,True,1,3460,-9.58,-47732.8,33146.8,-14586.0
1941-11-07,9.55,-0.03,-0.31,31.86,-70.03,True,1,3461,-9.55,-47742.35,33052.55,-14689.8
1941-11-10,9.48,-0.07,-0.73,31.86,-70.24,True,1,3462,-9.48,-47751.83,32819.76,-14932.07
1941-11-12,9.26,-0.22,-2.32,31.86,-70.94,True,1,3463,-9.26,-47761.09,32067.38,-15693.71
1941-11-13,9.21,-0.05,-0.54,31.86,-71.09,True,1,3464,-9.21,-47770.3,31903.44,-15866.86
1941-11-14,9.3,0.09,0.98,31.86,-70.81,True,1,3465,-9.3,-47779.6,32224.5,-15555.1
1941-11-17,9.28,-0.02,-0.22,31.86,-70.87,True,1,3466,-9.28,-47788.88,32164.48,-15624.4
1941-11-18,9.26,-0.02,-0.22,31.86,-70.94,True,1,3467,-9.26,-47798.14,32104.42,-15693.72
1941-11-19,9.34,0.08,0.86,31.86,-70.68,True,1,3468,-9.34,-47807.48,32391.12,-15416.36
1941-11-21,9.38,0.04,0.43,31.86,-70.56,True,1,3469,-9.38,-47816.86,32539.22,-15277.64
1941-11-24,9.4,0.02,0.21,31.86,-70.5,True,1,3470,-9.4,-47826.26,32618.0,-15208.26
1941-11-25,9.35,-0.05,-0.53,31.86,-70.65,True,1,3471,-9.35,-47835.61,32453.85,-15381.76
1941-11-26,9.27,-0.08,-0.86,31.86,-70.9,True,1,3472,-9.27,-47844.88,32185.44,-15659.44
1941-11-27,9.21,-0.06,-0.65,31.86,-71.09,True,1,3473,-9.21,-47854.09,31986.33,-15867.76
1941-11-28,9.12,-0.09,-0.98,31.86,-71.38,True,1,3474,-9.12,-47863.21,31682.88,-16180.33
1941-12-01,9.07,-0.05,-0.55,31.86,-71.53,True,1,3475,-9.07,-47872.28,31518.25,-16354.03
1941-12-02,9.26,0.19,2.1,31.86,-70.94,True,1,3476,-9.26,-47881.54,32187.76,-15693.78
1941-12-03,9.36,0.1,1.08,31.86,-70.62,True,1,3477,-9.36,-47890.9,32544.72,-15346.18
1941-12-04,9.38,0.02,0.21,31.86,-70.56,True,1,3478,-9.38,-47900.28,32623.64,-15276.64
1941-12-05,9.32,-0.06,-0.64,31.86,-70.75,True,1,3479,-9.32,-47909.6,32424.28,-15485.32
1941-12-08,8.97,-0.35,-3.76,31.86,-71.85,True,1,3480,-8.97,-47918.57,31215.6,-16702.97
1941-12-09,8.68,-0.29,-3.23,31.86,-72.76,True,1,3481,-8.68,-47927.25,30215.08,-17712.17
1941-12-10,8.68,0.0,0.0,31.86,-72.76,True,1,3482,-8.68,-47935.93,30223.76,-17712.17
1941-12-11,8.82,0.14,1.61,31.86,-72.32,True,1,3483,-8.82,-47944.75,30720.06,-17224.69
1941-12-12,8.73,-0.09,-1.02,31.86,-72.6,True,1,3484,-8.73,-47953.48,30415.32,-17538.16
1941-12-15,8.73,0.0,0.0,31.86,-72.6,True,1,3485,-8.73,-47962.21,30424.05,-17538.16
1941-12-16,8.71,-0.02,-0.23,31.86,-72.66,True,1,3486,-8.71,-47970.92,30363.06,-17607.86
1941-12-17,8.57,-0.14,-1.61,31.86,-73.1,True,1,3487,-8.57,-47979.49,29883.59,-18095.9
1941-12-18,8.49,-0.08,-0.93,31.86,-73.35,True,1,3488,-8.49,-47987.98,29613.12,-18374.86
1941-12-19,8.49,0.0,0.0,31.86,-73.35,True,1,3489,-8.49,-47996.47,29621.61,-18374.86
1941-12-22,8.4,-0.09,-1.06,31.86,-73.64,True,1,3490,-8.4,-48004.87,29316.0,-18688.87
1941-12-23,8.38,-0.02,-0.24,31.86,-73.7,True,1,3491,-8.38,-48013.25,29254.58,-18758.67
1941-12-24,8.39,0.01,0.12,31.86,-73.67,True,1,3492,-8.39,-48021.64,29297.88,-18723.76
1941-12-26,8.42,0.03,0.36,31.86,-73.57,True,1,3493,-8.42,-48030.06,29411.06,-18619.0
1941-12-29,8.37,-0.05,-0.59,31.86,-73.73,True,1,3494,-8.37,-48038.43,29244.78,-18793.65
1941-12-30,8.74,0.37,4.42,31.86,-72.57,True,1,3495,-8.74,-48047.17,30546.3,-17500.87
1941-12-31,8.69,-0.05,-0.57,31.86,-72.72,True,1,3496,-8.69,-48055.86,30380.24,-17675.62
1942-01-02,8.89,0.2,2.3,31.86,-72.1,True,1,3497,-8.89,-48064.75,31088.33,-16976.42
1942-01-05,9.09,0.2,2.25,31.86,-71.47,True,1,3498,-9.09,-48073.84,31796.82,-16277.02
1942-01-06,9.05,-0.04,-0.44,31.86,-71.59,True,1,3499,-9.05,-48082.89,31665.95,-16416.94
1942-01-07,9.0,-0.05,-0.55,31.86,-71.75,True,1,3500,-9.0,-48091.89,31500.0,-16591.89
1942-01-08,8.88,-0.12,-1.33,31.86,-72.13,True,1,3501,-8.88,-48100.77,31088.88,-17011.89
1942-01-09,8.85,-0.03,-0.34,31.86,-72.22,True,1,3502,-8.85,-48109.62,30992.7,-17116.92
1942-01-12,8.84,-0.01,-0.11,31.86,-72.25,True,1,3503,-8.84,-48118.46,30966.52,-17151.94
1942-01-13,9.02,0.18,2.04,31.86,-71.69,True,1,3504,-9.02,-48127.48,31606.08,-16521.4
1942-01-14,9.02,0.0,0.0,31.86,-71.69,True,1,3505,-9.02,-48136.5,31615.1,-16521.4
1942-01-15,9.04,0.02,0.22,31.86,-71.63,True,1,3506,-9.04,-48145.54,31694.24,-16451.3
1942-01-16,8.96,-0.08,-0.88,31.86,-71.88,True,1,3507,-8.96,-48154.5,31422.72,-16731.78
1942-01-19,8.96,0.0,0.0,31.86,-71.88,True,1,3508,-8.96,-48163.46,31431.68,-16731.78
1942-01-20,8.94,-0.02,-0.22,31.86,-71.94,True,1,3509,-8.94,-48172.4,31370.46,-16801.94
1942-01-21,8.81,-0.13,-1.45,31.86,-72.35,True,1,3510,-8.81,-48181.21,30923.1,-17258.11
1942-01-22,8.81,0.0,0.0,31.86,-72.35,True,1,3511,-8.81,-48190.02,30931.91,-17258.11
1942-01-23,8.84,0.03,0.34,31.86,-72.25,True,1,3512,-8.84,-48198.86,31046.08,-17152.78
1942-01-26,8.97,0.13,1.47,31.86,-71.85,True,1,3513,-8.97,-48207.83,31511.61,-16696.22
1942-01-27,8.99,0.02,0.22,31.86,-71.78,True,1,3514,-8.99,-48216.82,31590.86,-16625.96
1942-01-28,8.93,-0.06,-0.67,31.86,-71.97,True,1,3515,-8.93,-48225.75,31388.95,-16836.8
1942-01-29,8.91,-0.02,-0.22,31.86,-72.03,True,1,3516,-8.91,-48234.66,31327.56,-16907.1
1942-01-30,8.85,-0.06,-0.67,31.86,-72.22,True,1,3517,-8.85,-48243.51,31125.45,-17118.06
1942-02-02,8.84,-0.01,-0.11,31.86,-72.25,True,1,3518,-8.84,-48252.35,31099.12,-17153.23
1942-02-03,8.9,0.06,0.68,31.86,-72.06,True,1,3519,-8.9,-48261.25,31319.1,-16942.15
1942-02-04,8.97,0.07,0.79,31.86,-71.85,True,1,3520,-8.97,-48270.22,31574.4,-16695.82
1942-02-05,8.95,-0.02,-0.22,31.86,-71.91,True,1,3521,-8.95,-48279.17,31512.95,-16766.22
1942-02-06,8.85,-0.1,-1.12,31.86,-72.22,True,1,3522,-8.85,-48288.02,31169.7,-17118.32
1942-02-09,8.74,-0.11,-1.24,31.86,-72.57,True,1,3523,-8.74,-48296.76,30791.02,-17505.74
1942-02-10,8.62,-0.12,-1.37,31.86,-72.94,True,1,3524,-8.62,-48305.38,30376.88,-17928.5
1942-02-11,8.6,-0.02,-0.23,31.86,-73.01,True,1,3525,-8.6,-48313.98,30315.0,-17998.98
1942-02-13,8.62,0.02,0.23,31.86,-72.94,True,1,3526,-8.62,-48322.6,30394.12,-17928.48
1942-02-16,8.65,0.03,0.35,31.86,-72.85,True,1,3527,-8.65,-48331.25,30508.55,-17822.7
1942-02-17,8.49,-0.16,-1.85,31.86,-73.35,True,1,3528,-8.49,-48339.74,29952.72,-18387.02
1942-02-18,8.48,-0.01,-0.12,31.86,-73.38,True,1,3529,-8.48,-48348.22,29925.92,-18422.3
1942-02-19,8.5,0.02,0.24,31.86,-73.32,True,1,3530,-8.5,-48356.72,30005.0,-18351.72
1942-02-20,8.47,-0.03,-0.35,31.86,-73.42,True,1,3531,-8.47,-48365.19,29907.57,-18457.62
1942-02-24,8.52,0.05,0.59,31.86,-73.26,True,1,3532,-8.52,-48373.71,30092.64,-18281.07
1942-02-25,8.46,-0.06,-0.7,31.86,-73.45,True,1,3533,-8.46,-48382.17,29889.18,-18492.99
1942-02-26,8.52,0.06,0.71,31.86,-73.26,True,1,3534,-8.52,-48390.69,30109.68,-18281.01
1942-02-27,8.59,0.07,0.82,31.86,-73.04,True,1,3535,-8.59,-48399.28,30365.65,-18033.63
1942-03-02,8.47,-0.12,-1.4,31.86,-73.42,True,1,3536,-8.47,-48407.75,29949.92,-18457.83
1942-03-03,8.6,0.13,1.54,31.86,-73.01,True,1,3537,-8.6,-48416.35,30418.2,-17998.15
1942-03-04,8.51,-0.09,-1.05,31.86,-73.29,True,1,3538,-8.51,-48424.86,30108.38,-18316.48
1942-03-05,8.38,-0.13,-1.53,31.86,-73.7,True,1,3539,-8.38,-48433.24,29656.82,-18776.42
1942-03-06,8.16,-0.22,-2.62,31.86,-74.39,True,1,3540,-8.16,-48441.4,28886.4,-19555.0
1942-03-09,8.2,0.04,0.49,31.86,-74.26,True,1,3541,-8.2,-48449.6,29036.2,-19413.4
1942-03-10,8.14,-0.06,-0.73,31.86,-74.45,True,1,3542,-8.14,-48457.74,28831.88,-19625.86
1942-03-11,7.98,-0.16,-1.97,31.86,-74.95,True,1,3543,-7.98,-48465.72,28273.14,-20192.58
1942-03-12,7.98,0.0,0.0,31.86,-74.95,True,1,3544,-7.98,-48473.7,28281.12,-20192.58
1942-03-13,8.03,0.05,0.63,31.86,-74.8,True,1,3545,-8.03,-48481.73,28466.35,-20015.38
1942-03-16,8.12,0.09,1.12,31.86,-74.51,True,1,3546,-8.12,-48489.85,28793.52,-19696.33
1942-03-17,8.29,0.17,2.09,31.86,-73.98,True,1,3547,-8.29,-48498.14,29404.63,-19093.51
1942-03-18,8.21,-0.08,-0.96,31.86,-74.23,True,1,3548,-8.21,-48506.35,29129.08,-19377.27
1942-03-19,8.2,-0.01,-0.12,31.86,-74.26,True,1,3549,-8.2,-48514.55,29101.8,-19412.75
1942-03-20,8.11,-0.09,-1.1,31.86,-74.54,True,1,3550,-8.11,-48522.66,28790.5,-19732.16
1942-03-23,8.15,0.04,0.49,31.86,-74.42,True,1,3551,-8.15,-48530.81,28940.65,-19590.16
1942-03-24,8.22,0.07,0.86,31.86,-74.2,True,1,3552,-8.22,-48539.03,29197.44,-19341.59
1942-03-25,8.16,-0.06,-0.73,31.86,-74.39,True,1,3553,-8.16,-48547.19,28992.48,-19554.71
1942-03-26,8.13,-0.03,-0.37,31.86,-74.48,True,1,3554,-8.13,-48555.32,28894.02,-19661.3
1942-03-27,8.05,-0.08,-0.98,31.86,-74.73,True,1,3555,-8.05,-48563.37,28617.75,-19945.62
1942-03-30,8.06,0.01,0.12,31.86,-74.7,True,1,3556,-8.06,-48571.43,28661.36,-19910.07
1942-03-31,8.01,-0.05,-0.62,31.86,-74.86,True,1,3557,-8.01,-48579.44,28491.57,-20087.87
1942-04-01,8.05,0.04,0.5,31.86,-74.73,True,1,3558,-8.05,-48587.49,28641.9,-19945.59
1942-04-02,8.11,0.06,0.74,31.86,-74.54,True,1,3559,-8.11,-48595.6,28863.49,-19732.11
1942-04-06,8.2,0.09,1.11,31.86,-74.26,True,1,3560,-8.2,-48603.8,29192.0,-19411.8
1942-04-07,8.16,-0.04,-0.49,31.86,-74.39,True,1,3561,-8.16,-48611.96,29057.76,-19554.2
1942-04-08,8.12,-0.04,-0.49,31.86,-74.51,True,1,3562,-8.12,-48620.08,28923.44,-19696.64
1942-04-09,7.99,-0.13,-1.6,31.86,-74.92,True,1,3563,-7.99,-48628.07,28468.37,-20159.7
1942-04-10,7.98,-0.01,-0.12,31.86,-74.95,True,1,3564,-7.98,-48636.05,28440.72,-20195.33
1942-04-13,7.96,-0.02,-0.25,31.86,-75.02,True,1,3565,-7.96,-48644.01,28377.4,-20266.61
1942-04-14,7.83,-0.13,-1.63,31.86,-75.42,True,1,3566,-7.83,-48651.84,27921.78,-20730.06
1942-04-15,7.81,-0.02,-0.26,31.86,-75.49,True,1,3567,-7.81,-48659.65,27858.27,-20801.38
1942-04-16,7.82,0.01,0.13,31.86,-75.46,True,1,3568,-7.82,-48667.47,27901.76,-20765.71
1942-04-17,7.7,-0.12,-1.54,31.86,-75.83,True,1,3569,-7.7,-48675.17,27481.3,-21193.87
1942-04-20,7.79,0.09,1.17,31.86,-75.55,True,1,3570,-7.79,-48682.96,27810.3,-20872.66
1942-04-21,7.81,0.02,0.26,31.86,-75.49,True,1,3571,-7.81,-48690.77,27889.51,-20801.26
1942-04-22,7.79,-0.02,-0.26,31.86,-75.55,True,1,3572,-7.79,-48698.56,27825.88,-20872.68
1942-04-23,7.59,-0.2,-2.57,31.86,-76.18,True,1,3573,-7.59,-48706.15,27119.07,-21587.08
1942-04-24,7.55,-0.04,-0.53,31.86,-76.3,True,1,3574,-7.55,-48713.7,26983.7,-21730.0
1942-04-27,7.54,-0.01,-0.13,31.86,-76.33,True,1,3575,-7.54,-48721.24,26955.5,-21765.74
1942-04-28,7.47,-0.07,-0.93,31.86,-76.55,True,1,3576,-7.47,-48728.71,26712.72,-22015.99
1942-04-29,7.61,0.14,1.87,31.86,-76.11,True,1,3577,-7.61,-48736.32,27220.97,-21515.35
1942-04-30,7.66,0.05,0.66,31.86,-75.96,True,1,3578,-7.66,-48743.98,27407.48,-21336.5
1942-05-01,7.71,0.05,0.65,31.86,-75.8,True,1,3579,-7.71,-48751.69,27594.09,-21157.6
1942-05-04,7.77,0.06,0.78,31.86,-75.61,True,1,3580,-7.77,-48759.46,27816.6,-20942.86
1942-05-05,7.8,0.03,0.39,31.86,-75.52,True,1,3581,-7.8,-48767.26,27931.8,-20835.46
1942-05-06,7.79,-0.01,-0.13,31.86,-75.55,True,1,3582,-7.79,-48775.05,27903.78,-20871.27
1942-05-07,7.89,0.1,1.28,31.86,-75.24,True,1,3583,-7.89,-48782.94,28269.87,-20513.07
1942-05-08,7.89,0.0,0.0,31.86,-75.24,True,1,3584,-7.89,-48790.83,28277.76,-20513.07
1942-05-11,8.0,0.11,1.39,31.86,-74.89,True,1,3585,-8.0,-48798.83,28680.0,-20118.83
1942-05-12,7.94,-0.06,-0.75,31.86,-75.08,True,1,3586,-7.94,-48806.77,28472.84,-20333.93
1942-05-13,7.81,-0.13,-1.64,31.86,-75.49,True,1,3587,-7.81,-48814.58,28014.47,-20800.11
1942-05-14,7.79,-0.02,-0.26,31.86,-75.55,True,1,3588,-7.79,-48822.37,27950.52,-20871.85
1942-05-15,7.88,0.09,1.16,31.86,-75.27,True,1,3589,-7.88,-48830.25,28281.32,-20548.93
1942-05-18,7.94,0.06,0.76,31.86,-75.08,True,1,3590,-7.94,-48838.19,28504.6,-20333.59
1942-05-19,7.91,-0.03,-0.38,31.86,-75.17,True,1,3591,-7.91,-48846.1,28404.81,-20441.29
1942-05-20,7.89,-0.02,-0.25,31.86,-75.24,True,1,3592,-7.89,-48853.99,28340.88,-20513.11
1942-05-21,8.02,0.13,1.65,31.86,-74.83,True,1,3593,-8.02,-48862.01,28815.86,-20046.15
1942-05-22,8.01,-0.01,-0.12,31.86,-74.86,True,1,3594,-8.01,-48870.02,28787.94,-20082.08
1942-05-25,7.98,-0.03,-0.38,31.86,-74.95,True,1,3595,-7.98,-48878.0,28688.1,-20189.9
1942-05-26,8.0,0.02,0.25,31.86,-74.89,True,1,3596,-8.0,-48886.0,28768.0,-20118.0
1942-05-27,8.16,0.16,2.0,31.86,-74.39,True,1,3597,-8.16,-48894.16,29351.52,-19542.64
1942-05-28,8.18,0.02,0.24,31.86,-74.32,True,1,3598,-8.18,-48902.34,29431.64,-19470.7
1942-05-29,8.15,-0.03,-0.37,31.86,-74.42,True,1,3599,-8.15,-48910.49,29331.85,-19578.64
1942-06-01,8.19,0.04,0.49,31.86,-74.29,True,1,3600,-8.19,-48918.68,29484.0,-19434.68
1942-06-02,8.18,-0.01,-0.12,31.86,-74.32,True,1,3601,-8.18,-48926.86,29456.18,-19470.68
1942-06-03,8.24,0.06,0.73,31.86,-74.14,True,1,3602,-8.24,-48935.1,29680.48,-19254.62
1942-06-04,8.35,0.11,1.34,31.86,-73.79,True,1,3603,-8.35,-48943.45,30085.05,-18858.4
1942-06-05,8.37,0.02,0.24,31.86,-73.73,True,1,3604,-8.37,-48951.82,30165.48,-18786.34
1942-06-08,8.47,0.1,1.2,31.86,-73.42,True,1,3605,-8.47,-48960.29,30534.35,-18425.94
1942-06-09,8.39,-0.08,-0.94,31.86,-73.67,True,1,3606,-8.39,-48968.68,30254.34,-18714.34
1942-06-10,8.34,-0.05,-0.6,31.86,-73.82,True,1,3607,-8.34,-48977.02,30082.38,-18894.64
1942-06-11,8.37,0.03,0.36,31.86,-73.73,True,1,3608,-8.37,-48985.39,30198.96,-18786.43
1942-06-12,8.32,-0.05,-0.6,31.86,-73.89,True,1,3609,-8.32,-48993.71,30026.88,-18966.83
1942-06-15,8.38,0.06,0.72,31.86,-73.7,True,1,3610,-8.38,-49002.09,30251.8,-18750.29
1942-06-16,8.39,0.01,0.12,31.86,-73.67,True,1,3611,-8.39,-49010.48,30296.29,-18714.19
1942-06-17,8.53,0.14,1.67,31.86,-73.23,True,1,3612,-8.53,-49019.01,30810.36,-18208.65
1942-06-18,8.49,-0.04,-0.47,31.86,-73.35,True,1,3613,-8.49,-49027.5,30674.37,-18353.13
1942-06-19,8.4,-0.09,-1.06,31.86,-73.64,True,1,3614,-8.4,-49035.9,30357.6,-18678.3
1942-06-22,8.25,-0.15,-1.79,31.86,-74.1,True,1,3615,-8.25,-49044.15,29823.75,-19220.4
1942-06-23,8.25,0.0,0.0,31.86,-74.1,True,1,3616,-8.25,-49052.4,29832.0,-19220.4
1942-06-24,8.21,-0.04,-0.48,31.86,-74.23,True,1,3617,-8.21,-49060.61,29695.57,-19365.04
1942-06-25,8.22,0.01,0.12,31.86,-74.2,True,1,3618,-8.22,-49068.83,29739.96,-19328.87
1942-06-26,8.23,0.01,0.12,31.86,-74.17,True,1,3619,-8.23,-49077.06,29784.37,-19292.69
1942-06-29,8.28,0.05,0.61,31.86,-74.01,True,1,3620,-8.28,-49085.34,29973.6,-19111.74
1942-06-30,8.3,0.02,0.24,31.86,-73.95,True,1,3621,-8.3,-49093.64,30054.3,-19039.34
1942-07-01,8.23,-0.07,-0.84,31.86,-74.17,True,1,3622,-8.23,-49101.87,29809.06,-19292.81
1942-07-02,8.36,0.13,1.58,31.86,-73.76,True,1,3623,-8.36,-49110.23,30288.28,-18821.95
1942-07-03,8.44,0.08,0.96,31.86,-73.51,True,1,3624,-8.44,-49118.67,30586.56,-18532.11
1942-07-06,8.53,0.09,1.07,31.86,-73.23,True,1,3625,-8.53,-49127.2,30921.25,-18205.95
1942-07-07,8.51,-0.02,-0.23,31.86,-73.29,True,1,3626,-8.51,-49135.71,30857.26,-18278.45
1942-07-08,8.72,0.21,2.47,31.86,-72.63,True,1,3627,-8.72,-49144.43,31627.44,-17516.99
1942-07-09,8.81,0.09,1.03,31.86,-72.35,True,1,3628,-8.81,-49153.24,31962.68,-17190.56
1942-07-10,8.8,-0.01,-0.11,31.86,-72.38,True,1,3629,-8.8,-49162.04,31935.2,-17226.84
1942-07-13,8.73,-0.07,-0.8,31.86,-72.6,True,1,3630,-8.73,-49170.77,31689.9,-17480.87
1942-07-14,8.82,0.09,1.03,31.86,-72.32,True,1,3631,-8.82,-49179.59,32025.42,-17154.17
1942-07-15,8.83,0.01,0.11,31.86,-72.28,True,1,3632,-8.83,-49188.42,32070.56,-17117.86
1942-07-16,8.82,-0.01,-0.11,31.86,-72.32,True,1,3633,-8.82,-49197.24,32043.06,-17154.18
1942-07-17,8.72,-0.1,-1.13,31.86,-72.63,True,1,3634,-8.72,-49205.96,31688.48,-17517.48
1942-07-20,8.75,0.03,0.34,31.86,-72.54,True,1,3635,-8.75,-49214.71,31806.25,-17408.46
1942-07-21,8.77,0.02,0.23,31.86,-72.47,True,1,3636,-8.77,-49223.48,31887.72,-17335.76
1942-07-22,8.74,-0.03,-0.34,31.86,-72.57,True,1,3637,-8.74,-49232.22,31787.38,-17444.84
1942-07-23,8.62,-0.12,-1.37,31.86,-72.94,True,1,3638,-8.62,-49240.84,31359.56,-17881.28
1942-07-24,8.63,0.01,0.12,31.86,-72.91,True,1,3639,-8.63,-49249.47,31404.57,-17844.9
1942-07-27,8.63,0.0,0.0,31.86,-72.91,True,1,3640,-8.63,-49258.1,31413.2,-17844.9
1942-07-28,8.62,-0.01,-0.12,31.86,-72.94,True,1,3641,-8.62,-49266.72,31385.42,-17881.3
1942-07-29,8.48,-0.14,-1.62,31.86,-73.38,True,1,3642,-8.48,-49275.2,30884.16,-18391.04
1942-07-30,8.5,0.02,0.24,31.86,-73.32,True,1,3643,-8.5,-49283.7,30965.5,-18318.2
1942-07-31,8.56,0.06,0.71,31.86,-73.13,True,1,3644,-8.56,-49292.26,31192.64,-18099.62
1942-08-03,8.57,0.01,0.12,31.86,-73.1,True,1,3645,-8.57,-49300.83,31237.65,-18063.18
1942-08-04,8.55,-0.02,-0.23,31.86,-73.16,True,1,3646,-8.55,-49309.38,31173.3,-18136.08
1942-08-05,8.47,-0.08,-0.94,31.86,-73.42,True,1,3647,-8.47,-49317.85,30890.09,-18427.76
1942-08-06,8.46,-0.01,-0.12,31.86,-73.45,True,1,3648,-8.46,-49326.31,30862.08,-18464.23
1942-08-07,8.49,0.03,0.36,31.86,-73.35,True,1,3649,-8.49,-49334.8,30980.01,-18354.79
1942-08-10,8.48,-0.01,-0.12,31.86,-73.38,True,1,3650,-8.48,-49343.28,30952.0,-18391.28
1942-08-11,8.51,0.03,0.35,31.86,-73.29,True,1,3651,-8.51,-49351.79,31070.01,-18281.78
1942-08-12,8.51,0.0,0.0,31.86,-73.29,True,1,3652,-8.51,-49360.3,31078.52,-18281.78
1942-08-13,8.54,0.03,0.35,31.86,-73.19,True,1,3653,-8.54,-49368.84,31196.62,-18172.22
1942-08-14,8.58,0.04,0.47,31.86,-73.07,True,1,3654,-8.58,-49377.42,31351.32,-18026.1
1942-08-17,8.65,0.07,0.82,31.86,-72.85,True,1,3655,-8.65,-49386.07,31615.75,-17770.32
1942-08-18,8.73,0.08,0.92,31.86,-72.6,True,1,3656,-8.73,-49394.8,31916.88,-17477.92
1942-08-19,8.72,-0.01,-0.12,31.86,-72.63,True,1,3657,-8.72,-49403.52,31889.04,-17514.48
1942-08-20,8.69,-0.03,-0.34,31.86,-72.72,True,1,3658,-8.69,-49412.21,31788.02,-17624.19
1942-08-21,8.71,0.02,0.23,31.86,-72.66,True,1,3659,-8.71,-49420.92,31869.89,-17551.03
1942-08-24,8.73,0.02,0.23,31.86,-72.6,True,1,3660,-8.73,-49429.65,31951.8,-17477.85
1942-08-25,8.65,-0.08,-0.92,31.86,-72.85,True,1,3661,-8.65,-49438.3,31667.65,-17770.65
1942-08-26,8.54,-0.11,-1.27,31.86,-73.19,True,1,3662,-8.54,-49446.84,31273.48,-18173.36
1942-08-27,8.59,0.05,0.58,31.86,-73.04,True,1,3663,-8.59,-49455.43,31465.17,-17990.26
1942-08-28,8.61,0.02,0.23,31.86,-72.98,True,1,3664,-8.61,-49464.04,31547.04,-17917.0
1942-08-31,8.62,0.01,0.12,31.86,-72.94,True,1,3665,-8.62,-49472.66,31592.3,-17880.36
1942-09-01,8.62,0.0,0.0,31.86,-72.94,True,1,3666,-8.62,-49481.28,31600.92,-17880.36
1942-09-02,8.63,0.01,0.12,31.86,-72.91,True,1,3667,-8.63,-49489.91,31646.21,-17843.7
1942-09-03,8.62,-0.01,-0.12,31.86,-72.94,True,1,3668,-8.62,-49498.53,31618.16,-17880.37
1942-09-04,8.61,-0.01,-0.12,31.86,-72.98,True,1,3669,-8.61,-49507.14,31590.09,-17917.05
1942-09-08,8.68,0.07,0.81,31.86,-72.76,True,1,3670,-8.68,-49515.82,31855.6,-17660.22
1942-09-09,8.64,-0.04,-0.46,31.86,-72.88,True,1,3671,-8.64,-49524.46,31717.44,-17807.02
1942-09-10,8.58,-0.06,-0.69,31.86,-73.07,True,1,3672,-8.58,-49533.04,31505.76,-18027.28
1942-09-11,8.54,-0.04,-0.47,31.86,-73.19,True,1,3673,-8.54,-49541.58,31367.42,-18174.16
1942-09-14,8.55,0.01,0.12,31.86,-73.16,True,1,3674,-8.55,-49550.13,31412.7,-18137.43
1942-09-15,8.59,0.04,0.47,31.86,-73.04,True,1,3675,-8.59,-49558.72,31568.25,-17990.47
1942-09-16,8.6,0.01,0.12,31.86,-73.01,True,1,3676,-8.6,-49567.32,31613.6,-17953.72
1942-09-17,8.59,-0.01,-0.12,31.86,-73.04,True,1,3677,-8.59,-49575.91,31585.43,-17990.48
1942-09-18,8.66,0.07,0.82,31.86,-72.82,True,1,3678,-8.66,-49584.57,31851.48,-17733.09
1942-09-21,8.65,-0.01,-0.12,31.86,-72.85,True,1,3679,-8.65,-49593.22,31823.35,-17769.87
1942-09-22,8.68,0.03,0.35,31.86,-72.76,True,1,3680,-8.68,-49601.9,31942.4,-17659.5
1942-09-23,8.75,0.07,0.81,31.86,-72.54,True,1,3681,-8.75,-49610.65,32208.75,-17401.9
1942-09-24,8.86,0.11,1.26,31.86,-72.19,True,1,3682,-8.86,-49619.51,32622.52,-16996.99
1942-09-25,8.9,0.04,0.45,31.86,-72.06,True,1,3683,-8.9,-49628.41,32778.7,-16849.71
1942-09-28,8.89,-0.01,-0.11,31.86,-72.1,True,1,3684,-8.89,-49637.3,32750.76,-16886.54
1942-09-29,8.85,-0.04,-0.45,31.86,-72.22,True,1,3685,-8.85,-49646.15,32612.25,-17033.9
1942-09-30,8.85,0.0,0.0,31.86,-72.22,True,1,3686,-8.85,-49655.0,32621.1,-17033.9
1942-10-01,8.92,0.07,0.79,31.86,-72.0,True,1,3687,-8.92,-49663.92,32888.04,-16775.88
1942-10-02,9.05,0.13,1.46,31.86,-71.59,True,1,3688,-9.05,-49672.97,33376.4,-16296.57
1942-10-05,9.13,0.08,0.88,31.86,-71.34,True,1,3689,-9.13,-49682.1,33680.57,-16001.53
1942-10-06,9.13,0.0,0.0,31.86,-71.34,True,1,3690,-9.13,-49691.23,33689.7,-16001.53
1942-10-07,9.17,0.04,0.44,31.86,-71.22,True,1,3691,-9.17,-49700.4,33846.47,-15853.93
1942-10-08,9.3,0.13,1.42,31.86,-70.81,True,1,3692,-9.3,-49709.7,34335.6,-15374.1
1942-10-09,9.34,0.04,0.43,31.86,-70.68,True,1,3693,-9.34,-49719.04,34492.62,-15226.42
1942-10-13,9.45,0.11,1.18,31.86,-70.34,True,1,3694,-9.45,-49728.49,34908.3,-14820.19
1942-10-14,9.43,-0.02,-0.21,31.86,-70.4,True,1,3695,-9.43,-49737.92,34843.85,-14894.07
1942-10-15,9.31,-0.12,-1.27,31.86,-70.78,True,1,3696,-9.31,-49747.23,34409.76,-15337.47
1942-10-16,9.35,0.04,0.43,31.86,-70.65,True,1,3697,-9.35,-49756.58,34566.95,-15189.63
1942-10-19,9.35,0.0,0.0,31.86,-70.65,True,1,3698,-9.35,-49765.93,34576.3,-15189.63
1942-10-20,9.47,0.12,1.28,31.86,-70.28,True,1,3699,-9.47,-49775.4,35029.53,-14745.87
1942-10-21,9.46,-0.01,-0.11,31.86,-70.31,True,1,3700,-9.46,-49784.86,35002.0,-14782.86
1942-10-22,9.46,0.0,0.0,31.86,-70.31,True,1,3701,-9.46,-49794.32,35011.46,-14782.86
1942-10-23,9.43,-0.03,-0.32,31.86,-70.4,True,1,3702,-9.43,-49803.75,34909.86,-14893.89
1942-10-26,9.48,0.05,0.53,31.86,-70.24,True,1,3703,-9.48,-49813.23,35104.44,-14708.79
1942-10-27,9.39,-0.09,-0.95,31.86,-70.53,True,1,3704,-9.39,-49822.62,34780.56,-15042.06
1942-10-28,9.31,-0.08,-0.85,31.86,-70.78,True,1,3705,-9.31,-49831.93,34493.55,-15338.38
1942-10-29,9.3,-0.01,-0.11,31.86,-70.81,True,1,3706,-9.3,-49841.23,34465.8,-15375.43
1942-10-30,9.36,0.06,0.64,31.86,-70.62,True,1,3707,-9.36,-49850.59,34697.52,-15153.07
1942-11-02,9.48,0.12,1.28,31.86,-70.24,True,1,3708,-9.48,-49860.07,35151.84,-14708.23
1942-11-04,9.44,-0.04,-0.42,31.86,-70.37,True,1,3709,-9.44,-49869.51,35012.96,-14856.55
1942-11-05,9.46,0.02,0.21,31.86,-70.31,True,1,3710,-9.46,-49878.97,35096.6,-14782.37
1942-11-06,9.58,0.12,1.27,31.86,-69.93,True,1,3711,-9.58,-49888.55,35551.38,-14337.17
1942-11-09,9.69,0.11,1.15,31.86,-69.59,True,1,3712,-9.69,-49898.24,35969.28,-13928.96
1942-11-10,9.61,-0.08,-0.83,31.86,-69.84,True,1,3713,-9.61,-49907.85,35681.93,-14225.92
1942-11-12,9.63,0.02,0.21,31.86,-69.77,True,1,3714,-9.63,-49917.48,35765.82,-14151.66
1942-11-13,9.57,-0.06,-0.62,31.86,-69.96,True,1,3715,-9.57,-49927.05,35552.55,-14374.5
1942-11-16,9.48,-0.09,-0.94,31.86,-70.24,True,1,3716,-9.48,-49936.53,35227.68,-14708.85
1942-11-17,9.36,-0.12,-1.27,31.86,-70.62,True,1,3717,-9.36,-49945.89,34791.12,-15154.77
1942-11-18,9.4,0.04,0.43,31.86,-70.5,True,1,3718,-9.4,-49955.29,34949.2,-15006.09
1942-11-19,9.39,-0.01,-0.11,31.86,-70.53,True,1,3719,-9.39,-49964.68,34921.41,-15043.27
1942-11-20,9.48,0.09,0.96,31.86,-70.24,True,1,3720,-9.48,-49974.16,35265.6,-14708.56
1942-11-23,9.37,-0.11,-1.16,31.86,-70.59,True,1,3721,-9.37,-49983.53,34865.77,-15117.76
1942-11-24,9.35,-0.02,-0.21,31.86,-70.65,True,1,3722,-9.35,-49992.88,34800.7,-15192.18
1942-11-25,9.31,-0.04,-0.43,31.86,-70.78,True,1,3723,-9.31,-50002.19,34661.13,-15341.06
1942-11-27,9.34,0.03,0.32,31.86,-70.68,True,1,3724,-9.34,-50011.53,34782.16,-15229.37
1942-11-30,9.29,-0.05,-0.54,31.86,-70.84,True,1,3725,-9.29,-50020.82,34605.25,-15415.57
1942-12-01,9.28,-0.01,-0.11,31.86,-70.87,True,1,3726,-9.28,-50030.1,34577.28,-15452.82
1942-12-02,9.31,0.03,0.32,31.86,-70.78,True,1,3727,-9.31,-50039.41,34698.37,-15341.04
1942-12-03,9.34,0.03,0.32,31.86,-70.68,True,1,3728,-9.34,-50048.75,34819.52,-15229.23
1942-12-04,9.34,0.0,0.0,31.86,-70.68,True,1,3729,-9.34,-50058.09,34828.86,-15229.23
1942-12-07,9.3,-0.04,-0.43,31.86,-70.81,True,1,3730,-9.3,-50067.39,34689.0,-15378.39
1942-12-08,9.36,0.06,0.64,31.86,-70.62,True,1,3731,-9.36,-50076.75,34922.16,-15154.59
1942-12-09,9.36,0.0,0.0,31.86,-70.62,True,1,3732,-9.36,-50086.11,34931.52,-15154.59
1942-12-10,9.37,0.01,0.11,31.86,-70.59,True,1,3733,-9.37,-50095.48,34978.21,-15117.27
1942-12-11,9.37,0.0,0.0,31.86,-70.59,True,1,3734,-9.37,-50104.85,34987.58,-15117.27
1942-12-14,9.42,0.05,0.53,31.86,-70.43,True,1,3735,-9.42,-50114.27,35183.7,-14930.57
1942-12-15,9.44,0.02,0.21,31.86,-70.37,True,1,3736,-9.44,-50123.71,35267.84,-14855.87
1942-12-16,9.52,0.08,0.85,31.86,-70.12,True,1,3737,-9.52,-50133.23,35576.24,-14556.99
1942-12-17,9.69,0.17,1.79,31.86,-69.59,True,1,3738,-9.69,-50142.92,36221.22,-13921.7
1942-12-18,9.68,-0.01,-0.1,31.86,-69.62,True,1,3739,-9.68,-50152.6,36193.52,-13959.08
1942-12-21,9.68,0.0,0.0,31.86,-69.62,True,1,3740,-9.68,-50162.28,36203.2,-13959.08
1942-12-22,9.67,-0.01,-0.1,31.86,-69.65,True,1,3741,-9.67,-50171.95,36175.47,-13996.48
1942-12-23,9.7,0.03,0.31,31.86,-69.55,True,1,3742,-9.7,-50181.65,36297.4,-13884.25
1942-12-24,9.74,0.04,0.41,31.86,-69.43,True,1,3743,-9.74,-50191.39,36456.82,-13734.57
1942-12-28,9.65,-0.09,-0.92,31.86,-69.71,True,1,3744,-9.65,-50201.04,36129.6,-14071.44
1942-12-29,9.65,0.0,0.0,31.86,-69.71,True,1,3745,-9.65,-50210.69,36139.25,-14071.44
1942-12-30,9.76,0.11,1.14,31.86,-69.37,True,1,3746,-9.76,-50220.45,36560.96,-13659.49
1942-12-31,9.77,0.01,0.1,31.86,-69.33,True,1,3747,-9.77,-50230.22,36608.19,-13622.03
1943-01-04,9.92,0.15,1.54,31.86,-68.86,True,1,3748,-9.92,-50240.14,37180.16,-13059.98
1943-01-05,9.9,-0.02,-0.2,31.86,-68.93,True,1,3749,-9.9,-50250.04,37115.1,-13134.94
1943-01-06,9.89,-0.01,-0.1,31.86,-68.96,True,1,3750,-9.89,-50259.93,37087.5,-13172.43
1943-01-07,9.91,0.02,0.2,31.86,-68.9,True,1,3751,-9.91,-50269.84,37172.41,-13097.43
1943-01-08,9.92,0.01,0.1,31.86,-68.86,True,1,3752,-9.92,-50279.76,37219.84,-13059.92
1943-01-11,9.96,0.04,0.4,31.86,-68.74,True,1,3753,-9.96,-50289.72,37379.88,-12909.84
1943-01-12,9.93,-0.03,-0.3,31.86,-68.83,True,1,3754,-9.93,-50299.65,37277.22,-13022.43
1943-01-13,9.95,0.02,0.2,31.86,-68.77,True,1,3755,-9.95,-50309.6,37362.25,-12947.35
1943-01-14,10.01,0.06,0.6,31.86,-68.58,True,1,3756,-10.01,-50319.61,37597.56,-12722.05
1943-01-15,10.09,0.08,0.8,31.86,-68.33,True,1,3757,-10.09,-50329.7,37908.13,-12421.57
1943-01-18,10.12,0.03,0.3,31.86,-68.24,True,1,3758,-10.12,-50339.82,38030.96,-12308.86
1943-01-19,10.02,-0.1,-0.99,31.86,-68.55,True,1,3759,-10.02,-50349.84,37665.18,-12684.66
1943-01-20,10.03,0.01,0.1,31.86,-68.52,True,1,3760,-10.03,-50359.87,37712.8,-12647.07
1943-01-21,10.18,0.15,1.5,31.86,-68.05,True,1,3761,-10.18,-50370.05,38286.98,-12083.07
1943-01-22,10.17,-0.01,-0.1,31.86,-68.08,True,1,3762,-10.17,-50380.22,38259.54,-12120.68
1943-01-25,10.3,0.13,1.28,31.86,-67.67,True,1,3763,-10.3,-50390.52,38758.9,-11631.62
1943-01-26,10.35,0.05,0.48,31.86,-67.51,True,1,3764,-10.35,-50400.87,38957.4,-11443.47
1943-01-27,10.34,-0.01,-0.1,31.86,-67.55,True,1,3765,-10.34,-50411.21,38930.1,-11481.11
1943-01-28,10.35,0.01,0.1,31.86,-67.51,True,1,3766,-10.35,-50421.56,38978.1,-11443.46
1943-01-29,10.44,0.09,0.87,31.86,-67.23,True,1,3767,-10.44,-50432.0,39327.48,-11104.52
1943-02-01,10.52,0.08,0.77,31.86,-66.98,True,1,3768,-10.52,-50442.52,39639.36,-10803.16
1943-02-02,10.52,0.0,0.0,31.86,-66.98,True,1,3769,-10.52,-50453.04,39649.88,-10803.16
1943-02-03,10.44,-0.08,-0.76,31.86,-67.23,True,1,3770,-10.44,-50463.48,39358.8,-11104.68
1943-02-04,10.43,-0.01,-0.1,31.86,-67.26,True,1,3771,-10.43,-50473.91,39331.53,-11142.38
1943-02-05,10.51,0.08,0.77,31.86,-67.01,True,1,3772,-10.51,-50484.42,39643.72,-10840.7
1943-02-08,10.5,-0.01,-0.1,31.86,-67.04,True,1,3773,-10.5,-50494.92,39616.5,-10878.42
1943-02-09,10.58,0.08,0.76,31.86,-66.79,True,1,3774,-10.58,-50505.5,39928.92,-10576.58
1943-02-10,10.65,0.07,0.66,31.86,-66.57,True,1,3775,-10.65,-50516.15,40203.75,-10312.4
1943-02-11,10.67,0.02,0.19,31.86,-66.51,True,1,3776,-10.67,-50526.82,40289.92,-10236.9
1943-02-15,10.81,0.14,1.31,31.86,-66.07,True,1,3777,-10.81,-50537.63,40829.37,-9708.26
1943-02-16,10.79,-0.02,-0.18,31.86,-66.13,True,1,3778,-10.79,-50548.42,40764.62,-9783.8
1943-02-17,10.81,0.02,0.18,31.86,-66.07,True,1,3779,-10.81,-50559.23,40850.99,-9708.24
1943-02-18,10.66,-0.15,-1.39,31.86,-66.54,True,1,3780,-10.66,-50569.89,40294.8,-10275.09
1943-02-19,10.64,-0.02,-0.19,31.86,-66.6,True,1,3781,-10.64,-50580.53,40229.84,-10350.69
1943-02-23,10.84,0.2,1.88,31.86,-65.98,True,1,3782,-10.84,-50591.37,40996.88,-9594.49
1943-02-24,10.9,0.06,0.55,31.86,-65.79,True,1,3783,-10.9,-50602.27,41234.7,-9367.57
1943-02-25,10.97,0.07,0.64,31.86,-65.57,True,1,3784,-10.97,-50613.24,41510.48,-9102.76
1943-02-26,10.97,0.0,0.0,31.86,-65.57,True,1,3785,-10.97,-50624.21,41521.45,-9102.76
1943-03-01,10.92,-0.05,-0.46,31.86,-65.72,True,1,3786,-10.92,-50635.13,41343.12,-9292.01
1943-03-02,10.84,-0.08,-0.73,31.86,-65.98,True,1,3787,-10.84,-50645.97,41051.08,-9594.89
1943-03-03,10.98,0.14,1.29,31.86,-65.54,True,1,3788,-10.98,-50656.95,41592.24,-9064.71
1943-03-04,11.0,0.02,0.18,31.86,-65.47,True,1,3789,-11.0,-50667.95,41679.0,-8988.95
1943-03-05,11.05,0.05,0.46,31.86,-65.32,True,1,3790,-11.05,-50679.0,41879.5,-8799.5
1943-03-08,11.01,-0.04,-0.36,31.86,-65.44,True,1,3791,-11.01,-50690.01,41738.91,-8951.1
1943-03-09,10.95,-0.06,-0.55,31.86,-65.63,True,1,3792,-10.95,-50700.96,41522.4,-9178.56
1943-03-10,10.9,-0.05,-0.46,31.86,-65.79,True,1,3793,-10.9,-50711.86,41343.7,-9368.16
1943-03-11,11.01,0.11,1.01,31.86,-65.44,True,1,3794,-11.01,-50722.87,41771.94,-8950.93
1943-03-12,11.05,0.04,0.36,31.86,-65.32,True,1,3795,-11.05,-50733.92,41934.75,-8799.17
1943-03-15,11.04,-0.01,-0.09,31.86,-65.35,True,1,3796,-11.04,-50744.96,41907.84,-8837.12
1943-03-16,11.01,-0.03,-0.27,31.86,-65.44,True,1,3797,-11.01,-50755.97,41804.97,-8951.0
1943-03-17,10.93,-0.08,-0.73,31.86,-65.69,True,1,3798,-10.93,-50766.9,41512.14,-9254.76
1943-03-18,10.91,-0.02,-0.18,31.86,-65.76,True,1,3799,-10.91,-50777.81,41447.09,-9330.72
1943-03-19,10.88,-0.03,-0.28,31.86,-65.85,True,1,3800,-10.88,-50788.69,41344.0,-9444.69
1943-03-22,10.92,0.04,0.37,31.86,-65.72,True,1,3801,-10.92,-50799.61,41506.92,-9292.69
1943-03-23,10.95,0.03,0.28,31.86,-65.63,True,1,3802,-10.95,-50810.56,41631.9,-9178.66
1943-03-24,10.98,0.03,0.27,31.86,-65.54,True,1,3803,-10.98,-50821.54,41756.94,-9064.6
1943-03-25,11.21,0.23,2.1,31.86,-64.82,True,1,3804,-11.21,-50832.75,42642.84,-8189.91
1943-03-26,11.3,0.09,0.8,31.86,-64.53,True,1,3805,-11.3,-50844.05,42996.5,-7847.55
1943-03-29,11.49,0.19,1.68,31.86,-63.94,True,1,3806,-11.49,-50855.54,43730.94,-7124.6
1943-03-30,11.59,0.1,0.87,31.86,-63.62,True,1,3807,-11.59,-50867.13,44123.13,-6744.0
1943-03-31,11.58,-0.01,-0.09,31.86,-63.65,True,1,3808,-11.58,-50878.71,44096.64,-6782.07
1943-04-01,11.59,0.01,0.09,31.86,-63.62,True,1,3809,-11.59,-50890.3,44146.31,-6743.99
1943-04-02,11.56,-0.03,-0.26,31.86,-63.72,True,1,3810,-11.56,-50901.86,44043.6,-6858.26
1943-04-05,11.59,0.03,0.26,31.86,-63.62,True,1,3811,-11.59,-50913.45,44169.49,-6743.96
1943-04-06,11.76,0.17,1.47,31.86,-63.09,True,1,3812,-11.76,-50925.21,44829.12,-6096.09
1943-04-07,11.7,-0.06,-0.51,31.86,-63.28,True,1,3813,-11.7,-50936.91,44612.1,-6324.81
1943-04-08,11.6,-0.1,-0.86,31.86,-63.59,True,1,3814,-11.6,-50948.51,44242.4,-6706.11
1943-04-09,11.14,-0.46,-3.97,31.86,-65.04,True,1,3815,-11.14,-50959.65,42499.1,-8460.55
1943-04-12,11.15,0.01,0.09,31.86,-65.0,True,1,3816,-11.15,-50970.8,42548.4,-8422.4
1943-04-13,11.14,-0.01,-0.09,31.86,-65.04,True,1,3817,-11.14,-50981.94,42521.38,-8460.56
1943-04-14,11.28,0.14,1.26,31.86,-64.6,True,1,3818,-11.28,-50993.22,43067.04,-7926.18
1943-04-15,11.36,0.08,0.71,31.86,-64.34,True,1,3819,-11.36,-51004.58,43383.84,-7620.74
1943-04-16,11.33,-0.03,-0.26,31.86,-64.44,True,1,3820,-11.33,-51015.91,43280.6,-7735.31
1943-04-19,11.38,0.05,0.44,31.86,-64.28,True,1,3821,-11.38,-51027.29,43482.98,-7544.31
1943-04-20,11.34,-0.04,-0.35,31.86,-64.41,True,1,3822,-11.34,-51038.63,43341.48,-7697.15
1943-04-21,11.45,0.11,0.97,31.86,-64.06,True,1,3823,-11.45,-51050.08,43773.35,-7276.73
1943-04-22,11.48,0.03,0.26,31.86,-63.97,True,1,3824,-11.48,-51061.56,43899.52,-7162.04
1943-04-26,11.48,0.0,0.0,31.86,-63.97,True,1,3825,-11.48,-51073.04,43911.0,-7162.04
1943-04-27,11.48,0.0,0.0,31.86,-63.97,True,1,3826,-11.48,-51084.52,43922.48,-7162.04
1943-04-28,11.48,0.0,0.0,31.86,-63.97,True,1,3827,-11.48,-51096.0,43933.96,-7162.04
1943-04-29,11.59,0.11,0.96,31.86,-63.62,True,1,3828,-11.59,-51107.59,44366.52,-6741.07
1943-04-30,11.59,0.0,0.0,31.86,-63.62,True,1,3829,-11.59,-51119.18,44378.11,-6741.07
1943-05-03,11.82,0.23,1.98,31.86,-62.9,True,1,3830,-11.82,-51131.0,45270.6,-5860.4
1943-05-04,11.86,0.04,0.34,31.86,-62.78,True,1,3831,-11.86,-51142.86,45435.66,-5707.2
1943-05-05,11.93,0.07,0.59,31.86,-62.56,True,1,3832,-11.93,-51154.79,45715.76,-5439.03
1943-05-06,11.97,0.04,0.34,31.86,-62.43,True,1,3833,-11.97,-51166.76,45881.01,-5285.75
1943-05-07,11.81,-0.16,-1.34,31.86,-62.93,True,1,3834,-11.81,-51178.57,45279.54,-5899.03
1943-05-10,11.97,0.16,1.36,31.86,-62.43,True,1,3835,-11.97,-51190.54,45904.95,-5285.59
1943-05-11,11.93,-0.04,-0.33,31.86,-62.56,True,1,3836,-11.93,-51202.47,45763.48,-5438.99
1943-05-12,11.88,-0.05,-0.42,31.86,-62.71,True,1,3837,-11.88,-51214.35,45583.56,-5630.79
1943-05-13,11.92,0.04,0.34,31.86,-62.59,True,1,3838,-11.92,-51226.27,45748.96,-5477.31
1943-05-14,11.7,-0.22,-1.85,31.86,-63.28,True,1,3839,-11.7,-51237.97,44916.3,-6321.67
1943-05-17,11.72,0.02,0.17,31.86,-63.21,True,1,3840,-11.72,-51249.69,45004.8,-6244.89
1943-05-18,11.81,0.09,0.77,31.86,-62.93,True,1,3841,-11.81,-51261.5,45362.21,-5899.29
1943-05-19,11.93,0.12,1.02,31.86,-62.56,True,1,3842,-11.93,-51273.43,45835.06,-5438.37
1943-05-20,11.9,-0.03,-0.25,31.86,-62.65,True,1,3843,-11.9,-51285.33,45731.7,-5553.63
1943-05-21,11.9,0.0,0.0,31.86,-62.65,True,1,3844,-11.9,-51297.23,45743.6,-5553.63
1943-05-24,11.87,-0.03,-0.25,31.86,-62.74,True,1,3845,-11.87,-51309.1,45640.15,-5668.95
1943-05-25,11.9,0.03,0.25,31.86,-62.65,True,1,3846,-11.9,-51321.0,45767.4,-5553.6
1943-05-26,11.99,0.09,0.76,31.86,-62.37,True,1,3847,-11.99,-51332.99,46125.53,-5207.46
1943-05-27,12.02,0.03,0.25,31.86,-62.27,True,1,3848,-12.02,-51345.01,46252.96,-5092.05
1943-05-28,12.05,0.03,0.25,31.86,-62.18,True,1,3849,-12.05,-51357.06,46380.45,-4976.61
1943-06-01,12.18,0.13,1.08,31.86,-61.77,True,1,3850,-12.18,-51369.24,46893.0,-4476.24
1943-06-02,12.19,0.01,0.08,31.86,-61.74,True,1,3851,-12.19,-51381.43,46943.69,-4437.74
1943-06-03,12.24,0.05,0.41,31.86,-61.58,True,1,3852,-12.24,-51393.67,47148.48,-4245.19
1943-06-04,12.18,-0.06,-0.49,31.86,-61.77,True,1,3853,-12.18,-51405.85,46929.54,-4476.31
1943-06-07,12.15,-0.03,-0.25,31.86,-61.86,True,1,3854,-12.15,-51418.0,46826.1,-4591.9
1943-06-08,12.08,-0.07,-0.58,31.86,-62.08,True,1,3855,-12.08,-51430.08,46568.4,-4861.68
1943-06-09,12.12,0.04,0.33,31.86,-61.96,True,1,3856,-12.12,-51442.2,46734.72,-4707.48
1943-06-10,12.14,0.02,0.16,31.86,-61.9,True,1,3857,-12.14,-51454.34,46823.98,-4630.36
1943-06-11,12.08,-0.06,-0.49,31.86,-62.08,True,1,3858,-12.08,-51466.42,46604.64,-4861.78
1943-06-14,11.88,-0.2,-1.66,31.86,-62.71,True,1,3859,-11.88,-51478.3,45844.92,-5633.38
1943-06-15,11.93,0.05,0.42,31.86,-62.56,True,1,3860,-11.93,-51490.23,46049.8,-5440.43
1943-06-16,11.95,0.02,0.17,31.86,-62.49,True,1,3861,-11.95,-51502.18,46138.95,-5363.23
1943-06-17,11.97,0.02,0.17,31.86,-62.43,True,1,3862,-11.97,-51514.15,46228.14,-5286.01
1943-06-18,11.96,-0.01,-0.08,31.86,-62.46,True,1,3863,-11.96,-51526.11,46201.48,-5324.63
1943-06-21,11.9,-0.06,-0.5,31.86,-62.65,True,1,3864,-11.9,-51538.01,45981.6,-5556.41
1943-06-22,11.92,0.02,0.17,31.86,-62.59,True,1,3865,-11.92,-51549.93,46070.8,-5479.13
1943-06-23,11.89,-0.03,-0.25,31.86,-62.68,True,1,3866,-11.89,-51561.82,45966.74,-5595.08
1943-06-24,11.95,0.06,0.5,31.86,-62.49,True,1,3867,-11.95,-51573.77,46210.65,-5363.12
1943-06-25,12.21,0.26,2.18,31.86,-61.68,True,1,3868,-12.21,-51585.98,47228.28,-4357.7
1943-06-28,12.32,0.11,0.9,31.86,-61.33,True,1,3869,-12.32,-51598.3,47666.08,-3932.22
1943-06-29,12.28,-0.04,-0.32,31.86,-61.46,True,1,3870,-12.28,-51610.58,47523.6,-4086.98
1943-06-30,12.35,0.07,0.57,31.86,-61.24,True,1,3871,-12.35,-51622.93,47806.85,-3816.08
1943-07-01,12.36,0.01,0.08,31.86,-61.2,True,1,3872,-12.36,-51635.29,47857.92,-3777.37
1943-07-02,12.35,-0.01,-0.08,31.86,-61.24,True,1,3873,-12.35,-51647.64,47831.55,-3816.09
1943-07-06,12.37,0.02,0.16,31.86,-61.17,True,1,3874,-12.37,-51660.01,47921.38,-3738.63
1943-07-07,12.35,-0.02,-0.16,31.86,-61.24,True,1,3875,-12.35,-51672.36,47856.25,-3816.11
1943-07-08,12.36,0.01,0.08,31.86,-61.2,True,1,3876,-12.36,-51684.72,47907.36,-3777.36
1943-07-09,12.41,0.05,0.4,31.86,-61.05,True,1,3877,-12.41,-51697.13,48113.57,-3583.56
1943-07-12,12.49,0.08,0.64,31.86,-60.8,True,1,3878,-12.49,-51709.62,48436.22,-3273.4
1943-07-13,12.57,0.08,0.64,31.86,-60.55,True,1,3879,-12.57,-51722.19,48759.03,-2963.16
1943-07-14,12.64,0.07,0.56,31.86,-60.33,True,1,3880,-12.64,-51734.83,49043.2,-2691.63
1943-07-15,12.57,-0.07,-0.55,31.86,-60.55,True,1,3881,-12.57,-51747.4,48784.17,-2963.23
1943-07-16,12.54,-0.03,-0.24,31.86,-60.64,True,1,3882,-12.54,-51759.94,48680.28,-3079.66
1943-07-19,12.55,0.01,0.08,31.86,-60.61,True,1,3883,-12.55,-51772.49,48731.65,-3040.84
1943-07-20,12.47,-0.08,-0.64,31.86,-60.86,True,1,3884,-12.47,-51784.96,48433.48,-3351.48
1943-07-21,12.5,0.03,0.24,31.86,-60.77,True,1,3885,-12.5,-51797.46,48562.5,-3234.96
1943-07-22,12.5,0.0,0.0,31.86,-60.77,True,1,3886,-12.5,-51809.96,48575.0,-3234.96
1943-07-23,12.51,0.01,0.08,31.86,-60.73,True,1,3887,-12.51,-51822.47,48626.37,-3196.1
1943-07-26,12.31,-0.2,-1.6,31.86,-61.36,True,1,3888,-12.31,-51834.78,47861.28,-3973.5
1943-07-27,11.92,-0.39,-3.17,31.86,-62.59,True,1,3889,-11.92,-51846.7,46356.88,-5489.82
1943-07-28,11.88,-0.04,-0.34,31.86,-62.71,True,1,3890,-11.88,-51858.58,46213.2,-5645.38
1943-07-29,12.08,0.2,1.68,31.86,-62.08,True,1,3891,-12.08,-51870.66,47003.28,-4867.38
1943-07-30,11.85,-0.23,-1.9,31.86,-62.81,True,1,3892,-11.85,-51882.51,46120.2,-5762.31
1943-08-02,11.47,-0.38,-3.21,31.86,-64.0,True,1,3893,-11.47,-51893.98,44652.71,-7241.27
1943-08-03,11.72,0.25,2.18,31.86,-63.21,True,1,3894,-11.72,-51905.7,45637.68,-6268.02
1943-08-04,11.79,0.07,0.6,31.86,-62.99,True,1,3895,-11.79,-51917.49,45922.05,-5995.44
1943-08-05,11.75,-0.04,-0.34,31.86,-63.12,True,1,3896,-11.75,-51929.24,45778.0,-6151.24
1943-08-06,11.63,-0.12,-1.02,31.86,-63.5,True,1,3897,-11.63,-51940.87,45322.11,-6618.76
1943-08-09,11.6,-0.03,-0.26,31.86,-63.59,True,1,3898,-11.6,-51952.47,45216.8,-6735.67
1943-08-10,11.71,0.11,0.95,31.86,-63.24,True,1,3899,-11.71,-51964.18,45657.29,-6306.89
1943-08-11,11.8,0.09,0.77,31.86,-62.96,True,1,3900,-11.8,-51975.98,46020.0,-5955.98
1943-08-12,11.73,-0.07,-0.59,31.86,-63.18,True,1,3901,-11.73,-51987.71,45758.73,-6228.98
1943-08-13,11.84,0.11,0.94,31.86,-62.84,True,1,3902,-11.84,-51999.55,46199.68,-5799.87
1943-08-16,11.81,-0.03,-0.25,31.86,-62.93,True,1,3903,-11.81,-52011.36,46094.43,-5916.93
1943-08-17,11.88,0.07,0.59,31.86,-62.71,True,1,3904,-11.88,-52023.24,46379.52,-5643.72
1943-08-18,11.92,0.04,0.34,31.86,-62.59,True,1,3905,-11.92,-52035.16,46547.6,-5487.56
1943-08-19,11.91,-0.01,-0.08,31.86,-62.62,True,1,3906,-11.91,-52047.07,46520.46,-5526.61
1943-08-20,11.81,-0.1,-0.84,31.86,-62.93,True,1,3907,-11.81,-52058.88,46141.67,-5917.21
1943-08-23,11.6,-0.21,-1.78,31.86,-63.59,True,1,3908,-11.6,-52070.48,45332.8,-6737.68
1943-08-24,11.69,0.09,0.78,31.86,-63.31,True,1,3909,-11.69,-52082.17,45696.21,-6385.96
1943-08-25,11.71,0.02,0.17,31.86,-63.24,True,1,3910,-11.71,-52093.88,45786.1,-6307.78
1943-08-26,11.75,0.04,0.34,31.86,-63.12,True,1,3911,-11.75,-52105.63,45954.25,-6151.38
1943-08-27,11.67,-0.08,-0.68,31.86,-63.37,True,1,3912,-11.67,-52117.3,45653.04,-6464.26
1943-08-30,11.67,0.0,0.0,31.86,-63.37,True,1,3913,-11.67,-52128.97,45664.71,-6464.26
1943-08-31,11.8,0.13,1.11,31.86,-62.96,True,1,3914,-11.8,-52140.77,46185.2,-5955.57
1943-09-01,11.84,0.04,0.34,31.86,-62.84,True,1,3915,-11.84,-52152.61,46353.6,-5799.01
1943-09-02,11.84,0.0,0.0,31.86,-62.84,True,1,3916,-11.84,-52164.45,46365.44,-5799.01
1943-09-03,11.82,-0.02,-0.17,31.86,-62.9,True,1,3917,-11.82,-52176.27,46298.94,-5877.33
1943-09-07,11.85,0.03,0.25,31.86,-62.81,True,1,3918,-11.85,-52188.12,46428.3,-5759.82
1943-09-08,11.78,-0.07,-0.59,31.86,-63.03,True,1,3919,-11.78,-52199.9,46165.82,-6034.08
1943-09-09,11.91,0.13,1.1,31.86,-62.62,True,1,3920,-11.91,-52211.81,46687.2,-5524.61
1943-09-10,11.93,0.02,0.17,31.86,-62.56,True,1,3921,-11.93,-52223.74,46777.53,-5446.21
1943-09-13,11.91,-0.02,-0.17,31.86,-62.62,True,1,3922,-11.91,-52235.65,46711.02,-5524.63
1943-09-14,11.89,-0.02,-0.17,31.86,-62.68,True,1,3923,-11.89,-52247.54,46644.47,-5603.07
1943-09-15,11.91,0.02,0.17,31.86,-62.62,True,1,3924,-11.91,-52259.45,46734.84,-5524.61
1943-09-16,11.98,0.07,0.59,31.86,-62.4,True,1,3925,-11.98,-52271.43,47021.5,-5249.93
1943-09-17,12.1,0.12,1.0,31.86,-62.02,True,1,3926,-12.1,-52283.53,47504.6,-4778.93
1943-09-20,12.23,0.13,1.07,31.86,-61.61,True,1,3927,-12.23,-52295.76,48027.21,-4268.55
1943-09-21,12.24,0.01,0.08,31.86,-61.58,True,1,3928,-12.24,-52308.0,48078.72,-4229.28
1943-09-22,12.21,-0.03,-0.24,31.86,-61.68,True,1,3929,-12.21,-52320.21,47973.09,-4347.12
1943-09-23,12.1,-0.11,-0.9,31.86,-62.02,True,1,3930,-12.1,-52332.31,47553.0,-4779.31
1943-09-24,12.1,0.0,0.0,31.86,-62.02,True,1,3931,-12.1,-52344.41,47565.1,-4779.31
1943-09-27,12.0,-0.1,-0.83,31.86,-62.34,True,1,3932,-12.0,-52356.41,47184.0,-5172.41
1943-09-28,11.98,-0.02,-0.17,31.86,-62.4,True,1,3933,-11.98,-52368.39,47117.34,-5251.05
1943-09-29,12.01,0.03,0.25,31.86,-62.3,True,1,3934,-12.01,-52380.4,47247.34,-5133.06
1943-09-30,12.08,0.07,0.58,31.86,-62.08,True,1,3935,-12.08,-52392.48,47534.8,-4857.68
1943-10-01,12.09,0.01,0.08,31.86,-62.05,True,1,3936,-12.09,-52404.57,47586.24,-4818.33
1943-10-04,12.02,-0.07,-0.58,31.86,-62.27,True,1,3937,-12.02,-52416.59,47322.74,-5093.85
1943-10-05,11.97,-0.05,-0.42,31.86,-62.43,True,1,3938,-11.97,-52428.56,47137.86,-5290.7
1943-10-06,11.83,-0.14,-1.17,31.86,-62.87,True,1,3939,-11.83,-52440.39,46598.37,-5842.02
1943-10-07,11.67,-0.16,-1.35,31.86,-63.37,True,1,3940,-11.67,-52452.06,45979.8,-6472.26
1943-10-08,11.72,0.05,0.43,31.86,-63.21,True,1,3941,-11.72,-52463.78,46188.52,-6275.26
1943-10-11,11.7,-0.02,-0.17,31.86,-63.28,True,1,3942,-11.7,-52475.48,46121.4,-6354.08
1943-10-13,11.7,0.0,0.0,31.86,-63.28,True,1,3943,-11.7,-52487.18,46133.1,-6354.08
1943-10-14,11.75,0.05,0.43,31.86,-63.12,True,1,3944,-11.75,-52498.93,46342.0,-6156.93
1943-10-15,11.83,0.08,0.68,31.86,-62.87,True,1,3945,-11.83,-52510.76,46669.35,-5841.41
1943-10-18,11.85,0.02,0.17,31.86,-62.81,True,1,3946,-11.85,-52522.61,46760.1,-5762.51
1943-10-19,11.91,0.06,0.51,31.86,-62.62,True,1,3947,-11.91,-52534.52,47008.77,-5525.75
1943-10-20,11.95,0.04,0.34,31.86,-62.49,True,1,3948,-11.95,-52546.47,47178.6,-5367.87
1943-10-21,11.84,-0.11,-0.92,31.86,-62.84,True,1,3949,-11.84,-52558.31,46756.16,-5802.15
1943-10-22,11.89,0.05,0.42,31.86,-62.68,True,1,3950,-11.89,-52570.2,46965.5,-5604.7
1943-10-25,11.88,-0.01,-0.08,31.86,-62.71,True,1,3951,-11.88,-52582.08,46937.88,-5644.2
1943-10-26,11.92,0.04,0.34,31.86,-62.59,True,1,3952,-11.92,-52594.0,47107.84,-5486.16
1943-10-27,11.99,0.07,0.59,31.86,-62.37,True,1,3953,-11.99,-52605.99,47396.47,-5209.52
1943-10-28,11.96,-0.03,-0.25,31.86,-62.46,True,1,3954,-11.96,-52617.95,47289.84,-5328.11
1943-10-29,11.91,-0.05,-0.42,31.86,-62.62,True,1,3955,-11.91,-52629.86,47104.05,-5525.81
1943-11-01,11.92,0.01,0.08,31.86,-62.59,True,1,3956,-11.92,-52641.78,47155.52,-5486.26
1943-11-03,11.78,-0.14,-1.17,31.86,-63.03,True,1,3957,-11.78,-52653.56,46613.46,-6040.1
1943-11-04,11.68,-0.1,-0.85,31.86,-63.34,True,1,3958,-11.68,-52665.24,46229.44,-6435.8
1943-11-05,11.59,-0.09,-0.77,31.86,-63.62,True,1,3959,-11.59,-52676.83,45884.81,-6792.02
1943-11-08,11.26,-0.33,-2.85,31.86,-64.66,True,1,3960,-11.26,-52688.09,44589.6,-8098.49
1943-11-09,11.3,0.04,0.36,31.86,-64.53,True,1,3961,-11.3,-52699.39,44759.3,-7940.09
1943-11-10,11.41,0.11,0.97,31.86,-64.19,True,1,3962,-11.41,-52710.8,45206.42,-7504.38
1943-11-12,11.29,-0.12,-1.05,31.86,-64.56,True,1,3963,-11.29,-52722.09,44742.27,-7979.82
1943-11-15,11.25,-0.04,-0.35,31.86,-64.69,True,1,3964,-11.25,-52733.34,44595.0,-8138.34
1943-11-16,11.2,-0.05,-0.44,31.86,-64.85,True,1,3965,-11.2,-52744.54,44408.0,-8336.54
1943-11-17,11.13,-0.07,-0.62,31.86,-65.07,True,1,3966,-11.13,-52755.67,44141.58,-8614.09
1943-11-18,11.16,0.03,0.27,31.86,-64.97,True,1,3967,-11.16,-52766.83,44271.72,-8495.11
1943-11-19,11.3,0.14,1.25,31.86,-64.53,True,1,3968,-11.3,-52778.13,44838.4,-7939.73
1943-11-22,11.34,0.04,0.35,31.86,-64.41,True,1,3969,-11.34,-52789.47,45008.46,-7781.01
1943-11-23,11.3,-0.04,-0.35,31.86,-64.53,True,1,3970,-11.3,-52800.77,44861.0,-7939.77
1943-11-24,11.24,-0.06,-0.53,31.86,-64.72,True,1,3971,-11.24,-52812.01,44634.04,-8177.97
1943-11-26,11.15,-0.09,-0.8,31.86,-65.0,True,1,3972,-11.15,-52823.16,44287.8,-8535.36
1943-11-29,10.99,-0.16,-1.44,31.86,-65.5,True,1,3973,-10.99,-52834.15,43663.27,-9170.88
1943-11-30,11.02,0.03,0.27,31.86,-65.41,True,1,3974,-11.02,-52845.17,43793.48,-9051.69
1943-12-01,11.13,0.11,1.0,31.86,-65.07,True,1,3975,-11.13,-52856.3,44241.75,-8614.55
1943-12-02,11.22,0.09,0.81,31.86,-64.78,True,1,3976,-11.22,-52867.52,44610.72,-8256.8
1943-12-03,11.23,0.01,0.09,31.86,-64.75,True,1,3977,-11.23,-52878.75,44661.71,-8217.04
1943-12-06,11.28,0.05,0.44,31.86,-64.6,True,1,3978,-11.28,-52890.03,44871.84,-8018.19
1943-12-07,11.38,0.1,0.89,31.86,-64.28,True,1,3979,-11.38,-52901.41,45281.02,-7620.39
1943-12-08,11.5,0.12,1.05,31.86,-63.9,True,1,3980,-11.5,-52912.91,45770.0,-7142.91
1943-12-09,11.43,-0.07,-0.61,31.86,-64.12,True,1,3981,-11.43,-52924.34,45502.83,-7421.51
1943-12-10,11.49,0.06,0.52,31.86,-63.94,True,1,3982,-11.49,-52935.83,45753.18,-7182.65
1943-12-13,11.48,-0.01,-0.09,31.86,-63.97,True,1,3983,-11.48,-52947.31,45724.84,-7222.47
1943-12-14,11.45,-0.03,-0.26,31.86,-64.06,True,1,3984,-11.45,-52958.76,45616.8,-7341.96
1943-12-15,11.44,-0.01,-0.09,31.86,-64.09,True,1,3985,-11.44,-52970.2,45588.4,-7381.8
1943-12-16,11.5,0.06,0.52,31.86,-63.9,True,1,3986,-11.5,-52981.7,45839.0,-7142.7
1943-12-17,11.56,0.06,0.52,31.86,-63.72,True,1,3987,-11.56,-52993.26,46089.72,-6903.54
1943-12-20,11.64,0.08,0.69,31.86,-63.46,True,1,3988,-11.64,-53004.9,46420.32,-6584.58
1943-12-21,11.61,-0.03,-0.26,31.86,-63.56,True,1,3989,-11.61,-53016.51,46312.29,-6704.22
1943-12-22,11.6,-0.01,-0.09,31.86,-63.59,True,1,3990,-11.6,-53028.11,46284.0,-6744.11
1943-12-23,11.59,-0.01,-0.09,31.86,-63.62,True,1,3991,-11.59,-53039.7,46255.69,-6784.01
1943-12-24,11.61,0.02,0.17,31.86,-63.56,True,1,3992,-11.61,-53051.31,46347.12,-6704.19
1943-12-27,11.59,-0.02,-0.17,31.86,-63.62,True,1,3993,-11.59,-53062.9,46278.87,-6784.03
1943-12-28,11.48,-0.11,-0.95,31.86,-63.97,True,1,3994,-11.48,-53074.38,45851.12,-7223.26
1943-12-29,11.48,0.0,0.0,31.86,-63.97,True,1,3995,-11.48,-53085.86,45862.6,-7223.26
1943-12-30,11.69,0.21,1.83,31.86,-63.31,True,1,3996,-11.69,-53097.55,46713.24,-6384.31
1943-12-31,11.67,-0.02,-0.17,31.86,-63.37,True,1,3997,-11.67,-53109.22,46644.99,-6464.23
1944-01-03,11.66,-0.01,-0.09,31.86,-63.4,True,1,3998,-11.66,-53120.88,46616.68,-6504.2
1944-01-04,11.81,0.15,1.29,31.86,-62.93,True,1,3999,-11.81,-53132.69,47228.19,-5904.5
1944-01-05,11.94,0.13,1.1,31.86,-62.52,True,1,4000,-11.94,-53144.63,47760.0,-5384.63
1944-01-06,11.89,-0.05,-0.42,31.86,-62.68,True,1,4001,-11.89,-53156.52,47571.89,-5584.63
1944-01-07,11.87,-0.02,-0.17,31.86,-62.74,True,1,4002,-11.87,-53168.39,47503.74,-5664.65
1944-01-10,11.85,-0.02,-0.17,31.86,-62.81,True,1,4003,-11.85,-53180.24,47435.55,-5744.69
1944-01-11,11.92,0.07,0.59,31.86,-62.59,True,1,4004,-11.92,-53192.16,47727.68,-5464.48
1944-01-12,11.84,-0.08,-0.67,31.86,-62.84,True,1,4005,-11.84,-53204.0,47419.2,-5784.8
1944-01-13,11.81,-0.03,-0.25,31.86,-62.93,True,1,4006,-11.81,-53215.81,47310.86,-5904.95
1944-01-14,11.86,0.05,0.42,31.86,-62.78,True,1,4007,-11.86,-53227.67,47523.02,-5704.65
1944-01-17,11.9,0.04,0.34,31.86,-62.65,True,1,4008,-11.9,-53239.57,47695.2,-5544.37
1944-01-18,11.87,-0.03,-0.25,31.86,-62.74,True,1,4009,-11.87,-53251.44,47586.83,-5664.61
1944-01-19,11.88,0.01,0.08,31.86,-62.71,True,1,4010,-11.88,-53263.32,47638.8,-5624.52
1944-01-20,11.88,0.0,0.0,31.86,-62.71,True,1,4011,-11.88,-53275.2,47650.68,-5624.52
1944-01-21,11.9,0.02,0.17,31.86,-62.65,True,1,4012,-11.9,-53287.1,47742.8,-5544.3
1944-01-24,11.89,-0.01,-0.08,31.86,-62.68,True,1,4013,-11.89,-53298.99,47714.57,-5584.42
1944-01-25,11.88,-0.01,-0.08,31.86,-62.71,True,1,4014,-11.88,-53310.87,47686.32,-5624.55
1944-01-26,11.76,-0.12,-1.01,31.86,-63.09,True,1,4015,-11.76,-53322.63,47216.4,-6106.23
1944-01-27,11.74,-0.02,-0.17,31.86,-63.15,True,1,4016,-11.74,-53334.37,47147.84,-6186.53
1944-01-28,11.81,0.07,0.6,31.86,-62.93,True,1,4017,-11.81,-53346.18,47440.77,-5905.41
1944-01-31,11.85,0.04,0.34,31.86,-62.81,True,1,4018,-11.85,-53358.03,47613.3,-5744.73
1944-02-01,11.83,-0.02,-0.17,31.86,-62.87,True,1,4019,-11.83,-53369.86,47544.77,-5825.09
1944-02-02,11.8,-0.03,-0.25,31.86,-62.96,True,1,4020,-11.8,-53381.66,47436.0,-5945.66
1944-02-03,11.7,-0.1,-0.85,31.86,-63.28,True,1,4021,-11.7,-53393.36,47045.7,-6347.66
1944-02-04,11.6,-0.1,-0.86,31.86,-63.59,True,1,4022,-11.6,-53404.96,46655.2,-6749.76
1944-02-07,11.56,-0.04,-0.34,31.86,-63.72,True,1,4023,-11.56,-53416.52,46505.88,-6910.64
1944-02-08,11.67,0.11,0.95,31.86,-63.37,True,1,4024,-11.67,-53428.19,46960.08,-6468.11
1944-02-09,11.67,0.0,0.0,31.86,-63.37,True,1,4025,-11.67,-53439.86,46971.75,-6468.11
1944-02-10,11.75,0.08,0.69,31.86,-63.12,True,1,4026,-11.75,-53451.61,47305.5,-6146.11
1944-02-11,11.74,-0.01,-0.08,31.86,-63.15,True,1,4027,-11.74,-53463.35,47276.98,-6186.37
1944-02-14,11.74,0.0,0.0,31.86,-63.15,True,1,4028,-11.74,-53475.09,47288.72,-6186.37
1944-02-15,11.82,0.08,0.68,31.86,-62.9,True,1,4029,-11.82,-53486.91,47622.78,-5864.13
1944-02-16,11.79,-0.03,-0.25,31.86,-62.99,True,1,4030,-11.79,-53498.7,47513.7,-5985.0
1944-02-17,11.87,0.08,0.68,31.86,-62.74,True,1,4031,-11.87,-53510.57,47847.97,-5662.6
1944-02-18,11.78,-0.09,-0.76,31.86,-63.03,True,1,4032,-11.78,-53522.35,47496.96,-6025.39
1944-02-21,11.76,-0.02,-0.17,31.86,-63.09,True,1,4033,-11.76,-53534.11,47428.08,-6106.03
1944-02-23,11.86,0.1,0.85,31.86,-62.78,True,1,4034,-11.86,-53545.97,47843.24,-5702.73
1944-02-24,11.88,0.02,0.17,31.86,-62.71,True,1,4035,-11.88,-53557.85,47935.8,-5622.05
1944-02-25,11.8,-0.08,-0.67,31.86,-62.96,True,1,4036,-11.8,-53569.65,47624.8,-5944.85
1944-02-28,11.89,0.09,0.76,31.86,-62.68,True,1,4037,-11.89,-53581.54,47999.93,-5581.61
1944-02-29,11.82,-0.07,-0.59,31.86,-62.9,True,1,4038,-11.82,-53593.36,47729.16,-5864.2
1944-03-01,11.87,0.05,0.42,31.86,-62.74,True,1,4039,-11.87,-53605.23,47942.93,-5662.3
1944-03-02,11.88,0.01,0.08,31.86,-62.71,True,1,4040,-11.88,-53617.11,47995.2,-5621.91
1944-03-03,11.9,0.02,0.17,31.86,-62.65,True,1,4041,-11.9,-53629.01,48087.9,-5541.11
1944-03-06,11.93,0.03,0.25,31.86,-62.56,True,1,4042,-11.93,-53640.94,48221.06,-5419.88
1944-03-07,12.01,0.08,0.67,31.86,-62.3,True,1,4043,-12.01,-53652.95,48556.43,-5096.52
1944-03-08,12.11,0.1,0.83,31.86,-61.99,True,1,4044,-12.11,-53665.06,48972.84,-4692.22
1944-03-09,12.08,-0.03,-0.25,31.86,-62.08,True,1,4045,-12.08,-53677.14,48863.6,-4813.54
1944-03-10,12.1,0.02,0.17,31.86,-62.02,True,1,4046,-12.1,-53689.24,48956.6,-4732.64
1944-03-13,12.24,0.14,1.16,31.86,-61.58,True,1,4047,-12.24,-53701.48,49535.28,-4166.2
1944-03-14,12.22,-0.02,-0.16,31.86,-61.64,True,1,4048,-12.22,-53713.7,49466.56,-4247.14
1944-03-15,12.28,0.06,0.49,31.86,-61.46,True,1,4049,-12.28,-53725.98,49721.72,-4004.26
1944-03-16,12.29,0.01,0.08,31.86,-61.42,True,1,4050,-12.29,-53738.27,49774.5,-3963.77
1944-03-17,12.31,0.02,0.16,31.86,-61.36,True,1,4051,-12.31,-53750.58,49867.81,-3882.77
1944-03-20,12.2,-0.11,-0.89,31.86,-61.71,True,1,4052,-12.2,-53762.78,49434.4,-4328.38
1944-03-21,12.25,0.05,0.41,31.86,-61.55,True,1,4053,-12.25,-53775.03,49649.25,-4125.78
1944-03-22,12.23,-0.02,-0.16,31.86,-61.61,True,1,4054,-12.23,-53787.26,49580.42,-4206.84
1944-03-23,12.1,-0.13,-1.06,31.86,-62.02,True,1,4055,-12.1,-53799.36,49065.5,-4733.86
1944-03-24,12.13,0.03,0.25,31.86,-61.93,True,1,4056,-12.13,-53811.49,49199.28,-4612.21
1944-03-27,12.1,-0.03,-0.25,31.86,-62.02,True,1,4057,-12.1,-53823.59,49089.7,-4733.89
1944-03-28,11.98,-0.12,-0.99,31.86,-62.4,True,1,4058,-11.98,-53835.57,48614.84,-5220.73
1944-03-29,11.95,-0.03,-0.25,31.86,-62.49,True,1,4059,-11.95,-53847.52,48505.05,-5342.47
1944-03-30,12.03,0.08,0.67,31.86,-62.24,True,1,4060,-12.03,-53859.55,48841.8,-5017.75
1944-03-31,12.02,-0.01,-0.08,31.86,-62.27,True,1,4061,-12.02,-53871.57,48813.22,-5058.35
1944-04-03,11.96,-0.06,-0.5,31.86,-62.46,True,1,4062,-11.96,-53883.53,48581.52,-5302.01
1944-04-04,11.97,0.01,0.08,31.86,-62.43,True,1,4063,-11.97,-53895.5,48634.11,-5261.39
1944-04-05,11.98,0.01,0.08,31.86,-62.4,True,1,4064,-11.98,-53907.48,48686.72,-5220.76
1944-04-06,12.04,0.06,0.5,31.86,-62.21,True,1,4065,-12.04,-53919.52,48942.6,-4976.92
1944-04-10,12.06,0.02,0.17,31.86,-62.15,True,1,4066,-12.06,-53931.58,49035.96,-4895.62
1944-04-11,12.06,0.0,0.0,31.86,-62.15,True,1,4067,-12.06,-53943.64,49048.02,-4895.62
1944-04-12,11.98,-0.08,-0.66,31.86,-62.4,True,1,4068,-11.98,-53955.62,48734.64,-5220.98
1944-04-13,11.95,-0.03,-0.25,31.86,-62.49,True,1,4069,-11.95,-53967.57,48624.55,-5343.02
1944-04-14,11.95,0.0,0.0,31.86,-62.49,True,1,4070,-11.95,-53979.52,48636.5,-5343.02
1944-04-17,11.94,-0.01,-0.08,31.86,-62.52,True,1,4071,-11.94,-53991.46,48607.74,-5383.72
1944-04-18,11.73,-0.21,-1.76,31.86,-63.18,True,1,4072,-11.73,-54003.19,47764.56,-6238.63
1944-04-19,11.69,-0.04,-0.34,31.86,-63.31,True,1,4073,-11.69,-54014.88,47613.37,-6401.51
1944-04-20,11.78,0.09,0.77,31.86,-63.03,True,1,4074,-11.78,-54026.66,47991.72,-6034.94
1944-04-21,11.8,0.02,0.17,31.86,-62.96,True,1,4075,-11.8,-54038.46,48085.0,-5953.46
1944-04-24,11.67,-0.13,-1.1,31.86,-63.37,True,1,4076,-11.67,-54050.13,47566.92,-6483.21
1944-04-25,11.69,0.02,0.17,31.86,-63.31,True,1,4077,-11.69,-54061.82,47660.13,-6401.69
1944-04-26,11.76,0.07,0.6,31.86,-63.09,True,1,4078,-11.76,-54073.58,47957.28,-6116.3
1944-04-27,11.81,0.05,0.42,31.86,-62.93,True,1,4079,-11.81,-54085.39,48172.99,-5912.4
1944-04-28,11.87,0.06,0.51,31.86,-62.74,True,1,4080,-11.87,-54097.26,48429.6,-5667.66
1944-05-01,11.96,0.09,0.76,31.86,-62.46,True,1,4081,-11.96,-54109.22,48808.76,-5300.46
1944-05-02,11.95,-0.01,-0.08,31.86,-62.49,True,1,4082,-11.95,-54121.17,48779.9,-5341.27
1944-05-03,12.03,0.08,0.67,31.86,-62.24,True,1,4083,-12.03,-54133.2,49118.49,-5014.71
1944-05-04,12.01,-0.02,-0.17,31.86,-62.3,True,1,4084,-12.01,-54145.21,49048.84,-5096.37
1944-05-05,12.08,0.07,0.58,31.86,-62.08,True,1,4085,-12.08,-54157.29,49346.8,-4810.49
1944-05-08,12.09,0.01,0.08,31.86,-62.05,True,1,4086,-12.09,-54169.38,49399.74,-4769.64
1944-05-09,12.08,-0.01,-0.08,31.86,-62.08,True,1,4087,-12.08,-54181.46,49370.96,-4810.5
1944-05-10,12.08,0.0,0.0,31.86,-62.08,True,1,4088,-12.08,-54193.54,49383.04,-4810.5
1944-05-11,12.09,0.01,0.08,31.86,-62.05,True,1,4089,-12.09,-54205.63,49436.01,-4769.62
1944-05-12,12.0,-0.09,-0.74,31.86,-62.34,True,1,4090,-12.0,-54217.63,49080.0,-5137.63
1944-05-15,11.99,-0.01,-0.08,31.86,-62.37,True,1,4091,-11.99,-54229.62,49051.09,-5178.53
1944-05-16,12.0,0.01,0.08,31.86,-62.34,True,1,4092,-12.0,-54241.62,49104.0,-5137.62
1944-05-17,12.08,0.08,0.67,31.86,-62.08,True,1,4093,-12.08,-54253.7,49443.44,-4810.26
1944-05-18,12.1,0.02,0.17,31.86,-62.02,True,1,4094,-12.1,-54265.8,49537.4,-4728.4
1944-05-19,12.12,0.02,0.16,31.86,-61.96,True,1,4095,-12.12,-54277.92,49631.4,-4646.52
1944-05-22,12.13,0.01,0.08,31.86,-61.93,True,1,4096,-12.13,-54290.05,49684.48,-4605.57
1944-05-23,12.17,0.04,0.33,31.86,-61.8,True,1,4097,-12.17,-54302.22,49860.49,-4441.73
1944-05-24,12.22,0.05,0.41,31.86,-61.64,True,1,4098,-12.22,-54314.44,50077.56,-4236.88
1944-05-25,12.2,-0.02,-0.16,31.86,-61.71,True,1,4099,-12.2,-54326.64,50007.8,-4318.84
1944-05-26,12.22,0.02,0.16,31.86,-61.64,True,1,4100,-12.22,-54338.86,50102.0,-4236.86
1944-05-29,12.27,0.05,0.41,31.86,-61.49,True,1,4101,-12.27,-54351.13,50319.27,-4031.86
1944-05-31,12.35,0.08,0.65,31.86,-61.24,True,1,4102,-12.35,-54363.48,50659.7,-3703.78
1944-06-01,12.31,-0.04,-0.32,31.86,-61.36,True,1,4103,-12.31,-54375.79,50507.93,-3867.86
1944-06-02,12.3,-0.01,-0.08,31.86,-61.39,True,1,4104,-12.3,-54388.09,50479.2,-3908.89
1944-06-05,12.23,-0.07,-0.57,31.86,-61.61,True,1,4105,-12.23,-54400.32,50204.15,-4196.17
1944-06-06,12.31,0.08,0.65,31.86,-61.36,True,1,4106,-12.31,-54412.63,50544.86,-3867.77
1944-06-07,12.3,-0.01,-0.08,31.86,-61.39,True,1,4107,-12.3,-54424.93,50516.1,-3908.83
1944-06-08,12.25,-0.05,-0.41,31.86,-61.55,True,1,4108,-12.25,-54437.18,50323.0,-4114.18
1944-06-09,12.27,0.02,0.16,31.86,-61.49,True,1,4109,-12.27,-54449.45,50417.43,-4032.02
1944-06-12,12.55,0.28,2.28,31.86,-60.61,True,1,4110,-12.55,-54462.0,51580.5,-2881.5
1944-06-13,12.64,0.09,0.72,31.86,-60.33,True,1,4111,-12.64,-54474.64,51963.04,-2511.6
1944-06-14,12.66,0.02,0.16,31.86,-60.26,True,1,4112,-12.66,-54487.3,52057.92,-2429.38
1944-06-15,12.73,0.07,0.55,31.86,-60.04,True,1,4113,-12.73,-54500.03,52358.49,-2141.54
1944-06-16,12.82,0.09,0.71,31.86,-59.76,True,1,4114,-12.82,-54512.85,52741.48,-1771.37
1944-06-19,12.95,0.13,1.01,31.86,-59.35,True,1,4115,-12.95,-54525.8,53289.25,-1236.55
1944-06-20,12.97,0.02,0.15,31.86,-59.29,True,1,4116,-12.97,-54538.77,53384.52,-1154.25
1944-06-21,12.94,-0.03,-0.23,31.86,-59.38,True,1,4117,-12.94,-54551.71,53273.98,-1277.73
1944-06-22,12.92,-0.02,-0.16,31.86,-59.45,True,1,4118,-12.92,-54564.63,53204.56,-1360.07
1944-06-23,12.9,-0.02,-0.16,31.86,-59.51,True,1,4119,-12.9,-54577.53,53135.1,-1442.43
1944-06-26,12.98,0.08,0.62,31.86,-59.26,True,1,4120,-12.98,-54590.51,53477.6,-1112.91
1944-06-27,13.02,0.04,0.31,31.86,-59.13,True,1,4121,-13.02,-54603.53,53655.42,-948.11
1944-06-28,12.95,-0.07,-0.54,31.86,-59.35,True,1,4122,-12.95,-54616.48,53379.9,-1236.58
1944-06-29,12.94,-0.01,-0.08,31.86,-59.38,True,1,4123,-12.94,-54629.42,53351.62,-1277.8
1944-06-30,12.98,0.04,0.31,31.86,-59.26,True,1,4124,-12.98,-54642.4,53529.52,-1112.88
1944-07-03,13.11,0.13,1.0,31.86,-58.85,True,1,4125,-13.11,-54655.51,54078.75,-576.76
1944-07-05,13.18,0.07,0.53,31.86,-58.63,True,1,4126,-13.18,-54668.69,54380.68,-288.01
1944-07-06,13.13,-0.05,-0.38,31.86,-58.79,True,1,4127,-13.13,-54681.82,54187.51,-494.31
1944-07-07,13.16,0.03,0.23,31.86,-58.69,True,1,4128,-13.16,-54694.98,54324.48,-370.5
1944-07-10,13.27,0.11,0.84,31.86,-58.35,True,1,4129,-13.27,-54708.25,54791.83,83.58
1944-07-11,13.25,-0.02,-0.15,31.86,-58.41,True,1,4130,-13.25,-54721.5,54722.5,1.0
1944-07-12,13.27,0.02,0.15,31.86,-58.35,True,1,4131,-13.27,-54734.77,54818.37,83.6
1944-07-13,13.22,-0.05,-0.38,31.86,-58.51,True,1,4132,-13.22,-54747.99,54625.04,-122.95
1944-07-14,13.23,0.01,0.08,31.86,-58.48,True,1,4133,-13.23,-54761.22,54679.59,-81.63
1944-07-17,13.1,-0.13,-0.98,31.86,-58.88,True,1,4134,-13.1,-54774.32,54155.4,-618.92
1944-07-18,12.98,-0.12,-0.92,31.86,-59.26,True,1,4135,-12.98,-54787.3,53672.3,-1115.0
1944-07-19,13.07,0.09,0.69,31.86,-58.98,True,1,4136,-13.07,-54800.37,54057.52,-742.85
1944-07-20,12.96,-0.11,-0.84,31.86,-59.32,True,1,4137,-12.96,-54813.33,53615.52,-1197.81
1944-07-21,12.78,-0.18,-1.39,31.86,-59.89,True,1,4138,-12.78,-54826.11,52883.64,-1942.47
1944-07-24,12.7,-0.08,-0.63,31.86,-60.14,True,1,4139,-12.7,-54838.81,52565.3,-2273.51
1944-07-25,12.8,0.1,0.79,31.86,-59.82,True,1,4140,-12.8,-54851.61,52992.0,-1859.61
1944-07-26,12.77,-0.03,-0.23,31.86,-59.92,True,1,4141,-12.77,-54864.38,52880.57,-1983.81
1944-07-27,12.77,0.0,0.0,31.86,-59.92,True,1,4142,-12.77,-54877.15,52893.34,-1983.81
1944-07-28,12.7,-0.07,-0.55,31.86,-60.14,True,1,4143,-12.7,-54889.85,52616.1,-2273.75
1944-07-31,12.71,0.01,0.08,31.86,-60.11,True,1,4144,-12.71,-54902.56,52670.24,-2232.32
1944-08-01,12.78,0.07,0.55,31.86,-59.89,True,1,4145,-12.78,-54915.34,52973.1,-1942.24
1944-08-02,12.81,0.03,0.24,31.86,-59.79,True,1,4146,-12.81,-54928.15,53110.26,-1817.89
1944-08-03,12.73,-0.08,-0.62,31.86,-60.04,True,1,4147,-12.73,-54940.88,52791.31,-2149.57
1944-08-04,12.61,-0.12,-0.94,31.86,-60.42,True,1,4148,-12.61,-54953.49,52306.28,-2647.21
1944-08-07,12.67,0.06,0.48,31.86,-60.23,True,1,4149,-12.67,-54966.16,52567.83,-2398.33
1944-08-08,12.62,-0.05,-0.4,31.86,-60.39,True,1,4150,-12.62,-54978.78,52373.0,-2605.78
1944-08-09,12.68,0.06,0.48,31.86,-60.2,True,1,4151,-12.68,-54991.46,52634.68,-2356.78
1944-08-10,12.78,0.1,0.79,31.86,-59.89,True,1,4152,-12.78,-55004.24,53062.56,-1941.68
1944-08-11,12.83,0.05,0.39,31.86,-59.73,True,1,4153,-12.83,-55017.07,53282.99,-1734.08
1944-08-14,12.85,0.02,0.16,31.86,-59.67,True,1,4154,-12.85,-55029.92,53378.9,-1651.02
1944-08-15,12.84,-0.01,-0.08,31.86,-59.7,True,1,4155,-12.84,-55042.76,53350.2,-1692.56
1944-08-16,12.9,0.06,0.47,31.86,-59.51,True,1,4156,-12.9,-55055.66,53612.4,-1443.26
1944-08-17,12.98,0.08,0.62,31.86,-59.26,True,1,4157,-12.98,-55068.64,53957.86,-1110.78
1944-08-18,13.04,0.06,0.46,31.86,-59.07,True,1,4158,-13.04,-55081.68,54220.32,-861.36
1944-08-21,12.98,-0.06,-0.46,31.86,-59.26,True,1,4159,-12.98,-55094.66,53983.82,-1110.84
1944-08-22,12.89,-0.09,-0.69,31.86,-59.54,True,1,4160,-12.89,-55107.55,53622.4,-1485.15
1944-08-23,12.91,0.02,0.16,31.86,-59.48,True,1,4161,-12.91,-55120.46,53718.51,-1401.95
1944-08-24,12.83,-0.08,-0.62,31.86,-59.73,True,1,4162,-12.83,-55133.29,53398.46,-1734.83
1944-08-25,12.8,-0.03,-0.23,31.86,-59.82,True,1,4163,-12.8,-55146.09,53286.4,-1859.69
1944-08-28,12.8,0.0,0.0,31.86,-59.82,True,1,4164,-12.8,-55158.89,53299.2,-1859.69
1944-08-29,12.84,0.04,0.31,31.86,-59.7,True,1,4165,-12.84,-55171.73,53478.6,-1693.13
1944-08-30,12.87,0.03,0.23,31.86,-59.6,True,1,4166,-12.87,-55184.6,53616.42,-1568.18
1944-08-31,12.82,-0.05,-0.39,31.86,-59.76,True,1,4167,-12.82,-55197.42,53420.94,-1776.48
1944-09-01,12.86,0.04,0.31,31.86,-59.64,True,1,4168,-12.86,-55210.28,53600.48,-1609.8
1944-09-05,12.78,-0.08,-0.62,31.86,-59.89,True,1,4169,-12.78,-55223.06,53279.82,-1943.24
1944-09-06,12.47,-0.31,-2.43,31.86,-60.86,True,1,4170,-12.47,-55235.53,51999.9,-3235.63
1944-09-07,12.43,-0.04,-0.32,31.86,-60.99,True,1,4171,-12.43,-55247.96,51845.53,-3402.43
1944-09-08,12.41,-0.02,-0.16,31.86,-61.05,True,1,4172,-12.41,-55260.37,51774.52,-3485.85
1944-09-11,12.48,0.07,0.56,31.86,-60.83,True,1,4173,-12.48,-55272.85,52079.04,-3193.81
1944-09-12,12.54,0.06,0.48,31.86,-60.64,True,1,4174,-12.54,-55285.39,52341.96,-2943.43
1944-09-13,12.42,-0.12,-0.96,31.86,-61.02,True,1,4175,-12.42,-55297.81,51853.5,-3444.31
1944-09-14,12.35,-0.07,-0.56,31.86,-61.24,True,1,4176,-12.35,-55310.16,51573.6,-3736.56
1944-09-15,12.45,0.1,0.81,31.86,-60.92,True,1,4177,-12.45,-55322.61,52003.65,-3318.96
1944-09-18,12.53,0.08,0.64,31.86,-60.67,True,1,4178,-12.53,-55335.14,52350.34,-2984.8
1944-09-19,12.64,0.11,0.88,31.86,-60.33,True,1,4179,-12.64,-55347.78,52822.56,-2525.22
1944-09-20,12.66,0.02,0.16,31.86,-60.26,True,1,4180,-12.66,-55360.44,52918.8,-2441.64
1944-09-21,12.62,-0.04,-0.32,31.86,-60.39,True,1,4181,-12.62,-55373.06,52764.22,-2608.84
1944-09-22,12.65,0.03,0.24,31.86,-60.3,True,1,4182,-12.65,-55385.71,52902.3,-2483.41
1944-09-25,12.76,0.11,0.87,31.86,-59.95,True,1,4183,-12.76,-55398.47,53375.08,-2023.39
1944-09-26,12.73,-0.03,-0.24,31.86,-60.04,True,1,4184,-12.73,-55411.2,53262.32,-2148.88
1944-09-27,12.73,0.0,0.0,31.86,-60.04,True,1,4185,-12.73,-55423.93,53275.05,-2148.88
1944-09-28,12.69,-0.04,-0.31,31.86,-60.17,True,1,4186,-12.69,-55436.62,53120.34,-2316.28
1944-09-29,12.74,0.05,0.39,31.86,-60.01,True,1,4187,-12.74,-55449.36,53342.38,-2106.98
1944-10-02,12.8,0.06,0.47,31.86,-59.82,True,1,4188,-12.8,-55462.16,53606.4,-1855.76
1944-10-03,12.8,0.0,0.0,31.86,-59.82,True,1,4189,-12.8,-55474.96,53619.2,-1855.76
1944-10-04,12.87,0.07,0.55,31.86,-59.6,True,1,4190,-12.87,-55487.83,53925.3,-1562.53
1944-10-05,12.95,0.08,0.62,31.86,-59.35,True,1,4191,-12.95,-55500.78,54273.45,-1227.33
1944-10-06,12.97,0.02,0.15,31.86,-59.29,True,1,4192,-12.97,-55513.75,54370.24,-1143.51
1944-10-09,12.89,-0.08,-0.62,31.86,-59.54,True,1,4193,-12.89,-55526.64,54047.77,-1478.87
1944-10-10,12.93,0.04,0.31,31.86,-59.42,True,1,4194,-12.93,-55539.57,54228.42,-1311.15
1944-10-11,13.01,0.08,0.62,31.86,-59.16,True,1,4195,-13.01,-55552.58,54576.95,-975.63
1944-10-13,13.02,0.01,0.08,31.86,-59.13,True,1,4196,-13.02,-55565.6,54631.92,-933.68
1944-10-16,12.95,-0.07,-0.54,31.86,-59.35,True,1,4197,-12.95,-55578.55,54351.15,-1227.4
1944-10-17,13.0,0.05,0.39,31.86,-59.2,True,1,4198,-13.0,-55591.55,54574.0,-1017.55
1944-10-18,13.07,0.07,0.54,31.86,-58.98,True,1,4199,-13.07,-55604.62,54880.93,-723.69
1944-10-19,13.04,-0.03,-0.23,31.86,-59.07,True,1,4200,-13.04,-55617.66,54768.0,-849.66
1944-10-20,13.02,-0.02,-0.15,31.86,-59.13,True,1,4201,-13.02,-55630.68,54697.02,-933.66
1944-10-23,12.8,-0.22,-1.69,31.86,-59.82,True,1,4202,-12.8,-55643.48,53785.6,-1857.88
1944-10-24,12.83,0.03,0.23,31.86,-59.73,True,1,4203,-12.83,-55656.31,53924.49,-1731.82
1944-10-25,12.83,0.0,0.0,31.86,-59.73,True,1,4204,-12.83,-55669.14,53937.32,-1731.82
1944-10-26,12.73,-0.1,-0.78,31.86,-60.04,True,1,4205,-12.73,-55681.87,53529.65,-2152.22
1944-10-27,12.75,0.02,0.16,31.86,-59.98,True,1,4206,-12.75,-55694.62,53626.5,-2068.12
1944-10-30,12.76,0.01,0.08,31.86,-59.95,True,1,4207,-12.76,-55707.38,53681.32,-2026.06
1944-10-31,12.78,0.02,0.16,31.86,-59.89,True,1,4208,-12.78,-55720.16,53778.24,-1941.92
1944-11-01,12.83,0.05,0.39,31.86,-59.73,True,1,4209,-12.83,-55732.99,54001.47,-1731.52
1944-11-02,12.9,0.07,0.55,31.86,-59.51,True,1,4210,-12.9,-55745.89,54309.0,-1436.89
1944-11-03,12.89,-0.01,-0.08,31.86,-59.54,True,1,4211,-12.89,-55758.78,54279.79,-1478.99
1944-11-06,12.96,0.07,0.54,31.86,-59.32,True,1,4212,-12.96,-55771.74,54587.52,-1184.22
1944-11-08,12.94,-0.02,-0.15,31.86,-59.38,True,1,4213,-12.94,-55784.68,54516.22,-1268.46
1944-11-09,12.97,0.03,0.23,31.86,-59.29,True,1,4214,-12.97,-55797.65,54655.58,-1142.07
1944-11-10,12.98,0.01,0.08,31.86,-59.26,True,1,4215,-12.98,-55810.63,54710.7,-1099.93
1944-11-13,12.87,-0.11,-0.85,31.86,-59.6,True,1,4216,-12.87,-55823.5,54259.92,-1563.58
1944-11-14,12.71,-0.16,-1.24,31.86,-60.11,True,1,4217,-12.71,-55836.21,53598.07,-2238.14
1944-11-15,12.68,-0.03,-0.24,31.86,-60.2,True,1,4218,-12.68,-55848.89,53484.24,-2364.65
1944-11-16,12.69,0.01,0.08,31.86,-60.17,True,1,4219,-12.69,-55861.58,53539.11,-2322.47
1944-11-17,12.67,-0.02,-0.16,31.86,-60.23,True,1,4220,-12.67,-55874.25,53467.4,-2406.85
1944-11-20,12.72,0.05,0.4,31.86,-60.08,True,1,4221,-12.72,-55886.97,53691.12,-2195.85
1944-11-21,12.81,0.09,0.71,31.86,-59.79,True,1,4222,-12.81,-55899.78,54083.82,-1815.96
1944-11-22,12.82,0.01,0.08,31.86,-59.76,True,1,4223,-12.82,-55912.6,54138.86,-1773.74
1944-11-24,12.75,-0.07,-0.55,31.86,-59.98,True,1,4224,-12.75,-55925.35,53856.0,-2069.35
1944-11-27,12.79,0.04,0.31,31.86,-59.86,True,1,4225,-12.79,-55938.14,54037.75,-1900.39
1944-11-28,12.78,-0.01,-0.08,31.86,-59.89,True,1,4226,-12.78,-55950.92,54008.28,-1942.64
1944-11-29,12.85,0.07,0.55,31.86,-59.67,True,1,4227,-12.85,-55963.77,54316.95,-1646.82
1944-11-30,12.83,-0.02,-0.16,31.86,-59.73,True,1,4228,-12.83,-55976.6,54245.24,-1731.36
1944-12-01,12.8,-0.03,-0.23,31.86,-59.82,True,1,4229,-12.8,-55989.4,54131.2,-1858.2
1944-12-04,12.91,0.11,0.86,31.86,-59.48,True,1,4230,-12.91,-56002.31,54609.3,-1393.01
1944-12-05,12.96,0.05,0.39,31.86,-59.32,True,1,4231,-12.96,-56015.27,54833.76,-1181.51
1944-12-06,12.96,0.0,0.0,31.86,-59.32,True,1,4232,-12.96,-56028.23,54846.72,-1181.51
1944-12-07,12.99,0.03,0.23,31.86,-59.23,True,1,4233,-12.99,-56041.22,54986.67,-1054.55
1944-12-08,13.09,0.1,0.77,31.86,-58.91,True,1,4234,-13.09,-56054.31,55423.06,-631.25
1944-12-11,13.17,0.08,0.61,31.86,-58.66,True,1,4235,-13.17,-56067.48,55774.95,-292.53
1944-12-12,13.14,-0.03,-0.23,31.86,-58.76,True,1,4236,-13.14,-56080.62,55661.04,-419.58
1944-12-13,13.1,-0.04,-0.3,31.86,-58.88,True,1,4237,-13.1,-56093.72,55504.7,-589.02
1944-12-14,13.14,0.04,0.3,31.86,-58.76,True,1,4238,-13.14,-56106.86,55687.32,-419.54
1944-12-15,13.27,0.13,0.99,31.86,-58.35,True,1,4239,-13.27,-56120.13,56251.53,131.4
1944-12-18,13.19,-0.08,-0.6,31.86,-58.6,True,1,4240,-13.19,-56133.32,55925.6,-207.72
1944-12-19,13.23,0.04,0.3,31.86,-58.48,True,1,4241,-13.23,-56146.55,56108.43,-38.12
1944-12-20,13.14,-0.09,-0.68,31.86,-58.76,True,1,4242,-13.14,-56159.69,55739.88,-419.81
1944-12-21,13.11,-0.03,-0.23,31.86,-58.85,True,1,4243,-13.11,-56172.8,55625.73,-547.07
1944-12-22,13.12,0.01,0.08,31.86,-58.82,True,1,4244,-13.12,-56185.92,55681.28,-504.64
1944-12-26,13.03,-0.09,-0.69,31.86,-59.1,True,1,4245,-13.03,-56198.95,55312.35,-886.6
1944-12-27,12.97,-0.06,-0.46,31.86,-59.29,True,1,4246,-12.97,-56211.92,55070.62,-1141.3
1944-12-28,13.1,0.13,1.0,31.86,-58.88,True,1,4247,-13.1,-56225.02,55635.7,-589.32
1944-12-29,13.28,0.18,1.37,31.86,-58.32,True,1,4248,-13.28,-56238.3,56413.44,175.14
1945-01-02,13.33,0.05,0.38,31.86,-58.16,True,1,4249,-13.33,-56251.63,56639.17,387.54
1945-01-03,13.47,0.14,1.05,31.86,-57.72,True,1,4250,-13.47,-56265.1,57247.5,982.4
1945-01-04,13.49,0.02,0.15,31.86,-57.66,True,1,4251,-13.49,-56278.59,57345.99,1067.4
1945-01-05,13.46,-0.03,-0.22,31.86,-57.75,True,1,4252,-13.46,-56292.05,57231.92,939.87
1945-01-08,13.58,0.12,0.89,31.86,-57.38,True,1,4253,-13.58,-56305.63,57755.74,1450.11
1945-01-09,13.59,0.01,0.07,31.86,-57.34,True,1,4254,-13.59,-56319.22,57811.86,1492.64
1945-01-10,13.69,0.1,0.74,31.86,-57.03,True,1,4255,-13.69,-56332.91,58250.95,1918.04
1945-01-11,13.68,-0.01,-0.07,31.86,-57.06,True,1,4256,-13.68,-56346.59,58222.08,1875.49
1945-01-12,13.64,-0.04,-0.29,31.86,-57.19,True,1,4257,-13.64,-56360.23,58065.48,1705.25
1945-01-15,13.55,-0.09,-0.66,31.86,-57.47,True,1,4258,-13.55,-56373.78,57695.9,1322.12
1945-01-16,13.54,-0.01,-0.07,31.86,-57.5,True,1,4259,-13.54,-56387.32,57666.86,1279.54
1945-01-17,13.63,0.09,0.66,31.86,-57.22,True,1,4260,-13.63,-56400.95,58063.8,1662.85
1945-01-18,13.57,-0.06,-0.44,31.86,-57.41,True,1,4261,-13.57,-56414.52,57821.77,1407.25
1945-01-19,13.44,-0.13,-0.96,31.86,-57.82,True,1,4262,-13.44,-56427.96,57281.28,853.32
1945-01-22,13.3,-0.14,-1.04,31.86,-58.26,True,1,4263,-13.3,-56441.26,56697.9,256.64
1945-01-23,13.21,-0.09,-0.68,31.86,-58.54,True,1,4264,-13.21,-56454.47,56327.44,-127.03
1945-01-24,13.25,0.04,0.3,31.86,-58.41,True,1,4265,-13.25,-56467.72,56511.25,43.53
1945-01-25,13.33,0.08,0.6,31.86,-58.16,True,1,4266,-13.33,-56481.05,56865.78,384.73
1945-01-26,13.46,0.13,0.98,31.86,-57.75,True,1,4267,-13.46,-56494.51,57433.82,939.31
1945-01-29,13.54,0.08,0.59,31.86,-57.5,True,1,4268,-13.54,-56508.05,57788.72,1280.67
1945-01-30,13.46,-0.08,-0.59,31.86,-57.75,True,1,4269,-13.46,-56521.51,57460.74,939.23
1945-01-31,13.47,0.01,0.07,31.86,-57.72,True,1,4270,-13.47,-56534.98,57516.9,981.92
1945-02-01,13.5,0.03,0.22,31.86,-57.63,True,1,4271,-13.5,-56548.48,57658.5,1110.02
1945-02-02,13.6,0.1,0.74,31.86,-57.31,True,1,4272,-13.6,-56562.08,58099.2,1537.12
1945-02-05,13.7,0.1,0.74,31.86,-57.0,True,1,4273,-13.7,-56575.78,58540.1,1964.32
1945-02-06,13.73,0.03,0.22,31.86,-56.9,True,1,4274,-13.73,-56589.51,58682.02,2092.51
1945-02-07,13.76,0.03,0.22,31.86,-56.81,True,1,4275,-13.76,-56603.27,58824.0,2220.73
1945-02-08,13.76,0.0,0.0,31.86,-56.81,True,1,4276,-13.76,-56617.03,58837.76,2220.73
1945-02-09,13.68,-0.08,-0.58,31.86,-57.06,True,1,4277,-13.68,-56630.71,58509.36,1878.65
1945-02-13,13.9,0.22,1.61,31.86,-56.37,True,1,4278,-13.9,-56644.61,59464.2,2819.59
1945-02-14,13.97,0.07,0.5,31.86,-56.15,True,1,4279,-13.97,-56658.58,59777.63,3119.05
1945-02-15,14.07,0.1,0.72,31.86,-55.84,True,1,4280,-14.07,-56672.65,60219.6,3546.95
1945-02-16,14.05,-0.02,-0.14,31.86,-55.9,True,1,4281,-14.05,-56686.7,60148.05,3461.35
1945-02-19,14.16,0.11,0.78,31.86,-55.56,True,1,4282,-14.16,-56700.86,60633.12,3932.26
1945-02-20,14.21,0.05,0.35,31.86,-55.4,True,1,4283,-14.21,-56715.07,60861.43,4146.36
1945-02-21,14.19,-0.02,-0.14,31.86,-55.46,True,1,4284,-14.19,-56729.26,60789.96,4060.7
1945-02-23,14.16,-0.03,-0.21,31.86,-55.56,True,1,4285,-14.16,-56743.42,60675.6,3932.18
1945-02-26,14.09,-0.07,-0.49,31.86,-55.78,True,1,4286,-14.09,-56757.51,60389.74,3632.23
1945-02-27,14.2,0.11,0.78,31.86,-55.43,True,1,4287,-14.2,-56771.71,60875.4,4103.69
1945-02-28,14.3,0.1,0.7,31.86,-55.12,True,1,4288,-14.3,-56786.01,61318.4,4532.39
1945-03-01,14.32,0.02,0.14,31.86,-55.05,True,1,4289,-14.32,-56800.33,61418.48,4618.15
1945-03-02,14.23,-0.09,-0.63,31.86,-55.34,True,1,4290,-14.23,-56814.56,61046.7,4232.14
1945-03-05,14.3,0.07,0.49,31.86,-55.12,True,1,4291,-14.3,-56828.86,61361.3,4532.44
1945-03-06,14.37,0.07,0.49,31.86,-54.9,True,1,4292,-14.37,-56843.23,61676.04,4832.81
1945-03-07,14.38,0.01,0.07,31.86,-54.86,True,1,4293,-14.38,-56857.61,61733.34,4875.73
1945-03-08,14.12,-0.26,-1.81,31.86,-55.68,True,1,4294,-14.12,-56871.73,60631.28,3759.55
1945-03-09,13.82,-0.3,-2.12,31.86,-56.62,True,1,4295,-13.82,-56885.55,59356.9,2471.35
1945-03-12,13.99,0.17,1.23,31.86,-56.09,True,1,4296,-13.99,-56899.54,60101.04,3201.5
1945-03-13,13.99,0.0,0.0,31.86,-56.09,True,1,4297,-13.99,-56913.53,60115.03,3201.5
1945-03-14,14.01,0.02,0.14,31.86,-56.03,True,1,4298,-14.01,-56927.54,60214.98,3287.44
1945-03-15,14.07,0.06,0.43,31.86,-55.84,True,1,4299,-14.07,-56941.61,60486.93,3545.32
1945-03-16,14.09,0.02,0.14,31.86,-55.78,True,1,4300,-14.09,-56955.7,60587.0,3631.3
1945-03-19,14.01,-0.08,-0.57,31.86,-56.03,True,1,4301,-14.01,-56969.71,60257.01,3287.3
1945-03-20,13.82,-0.19,-1.36,31.86,-56.62,True,1,4302,-13.82,-56983.53,59453.64,2470.11
1945-03-21,13.69,-0.13,-0.94,31.86,-57.03,True,1,4303,-13.69,-56997.22,58908.07,1910.85
1945-03-22,13.68,-0.01,-0.07,31.86,-57.06,True,1,4304,-13.68,-57010.9,58878.72,1867.82
1945-03-23,13.74,0.06,0.44,31.86,-56.87,True,1,4305,-13.74,-57024.64,59150.7,2126.06
1945-03-26,13.39,-0.35,-2.55,31.86,-57.97,True,1,4306,-13.39,-57038.03,57657.34,619.31
1945-03-27,13.47,0.08,0.6,31.86,-57.72,True,1,4307,-13.47,-57051.5,58015.29,963.79
1945-03-28,13.58,0.11,0.82,31.86,-57.38,True,1,4308,-13.58,-57065.08,58502.64,1437.56
1945-03-29,13.61,0.03,0.22,31.86,-57.28,True,1,4309,-13.61,-57078.69,58645.49,1566.8
1945-04-02,13.77,0.16,1.18,31.86,-56.78,True,1,4310,-13.77,-57092.46,59348.7,2256.24
1945-04-03,13.79,0.02,0.14,31.86,-56.72,True,1,4311,-13.79,-57106.25,59448.69,2342.44
1945-04-04,13.77,-0.02,-0.14,31.86,-56.78,True,1,4312,-13.77,-57120.02,59376.24,2256.22
1945-04-05,13.67,-0.1,-0.73,31.86,-57.09,True,1,4313,-13.67,-57133.69,58958.71,1825.02
1945-04-06,13.77,0.1,0.73,31.86,-56.78,True,1,4314,-13.77,-57147.46,59403.78,2256.32
1945-04-09,13.81,0.04,0.29,31.86,-56.65,True,1,4315,-13.81,-57161.27,59590.15,2428.88
1945-04-10,13.86,0.05,0.36,31.86,-56.5,True,1,4316,-13.86,-57175.13,59819.76,2644.63
1945-04-11,14.06,0.2,1.44,31.86,-55.87,True,1,4317,-14.06,-57189.19,60697.02,3507.83
1945-04-12,14.05,-0.01,-0.07,31.86,-55.9,True,1,4318,-14.05,-57203.24,60667.9,3464.66
1945-04-13,14.2,0.15,1.07,31.86,-55.43,True,1,4319,-14.2,-57217.44,61329.8,4112.36
1945-04-16,14.49,0.29,2.04,31.86,-54.52,True,1,4320,-14.49,-57231.93,62596.8,5364.87
1945-04-17,14.51,0.02,0.14,31.86,-54.46,True,1,4321,-14.51,-57246.44,62697.71,5451.27
1945-04-18,14.65,0.14,0.96,31.86,-54.02,True,1,4322,-14.65,-57261.09,63317.3,6056.21
1945-04-19,14.51,-0.14,-0.96,31.86,-54.46,True,1,4323,-14.51,-57275.6,62726.73,5451.13
1945-04-20,14.49,-0.02,-0.14,31.86,-54.52,True,1,4324,-14.49,-57290.09,62654.76,5364.67
1945-04-23,14.63,0.14,0.97,31.86,-54.08,True,1,4325,-14.63,-57304.72,63274.75,5970.03
1945-04-24,14.7,0.07,0.48,31.86,-53.86,True,1,4326,-14.7,-57319.42,63592.2,6272.78
1945-04-25,14.67,-0.03,-0.2,31.86,-53.96,True,1,4327,-14.67,-57334.09,63477.09,6143.0
1945-04-26,14.64,-0.03,-0.2,31.86,-54.05,True,1,4328,-14.64,-57348.73,63361.92,6013.19
1945-04-27,14.7,0.06,0.41,31.86,-53.86,True,1,4329,-14.7,-57363.43,63636.3,6272.87
1945-04-30,14.84,0.14,0.95,31.86,-53.42,True,1,4330,-14.84,-57378.27,64257.2,6878.93
1945-05-01,14.79,-0.05,-0.34,31.86,-53.58,True,1,4331,-14.79,-57393.06,64055.49,6662.43
1945-05-02,14.77,-0.02,-0.14,31.86,-53.64,True,1,4332,-14.77,-57407.83,63983.64,6575.81
1945-05-03,14.87,0.1,0.68,31.86,-53.33,True,1,4333,-14.87,-57422.7,64431.71,7009.01
1945-05-04,14.92,0.05,0.34,31.86,-53.17,True,1,4334,-14.92,-57437.62,64663.28,7225.66
1945-05-07,14.93,0.01,0.07,31.86,-53.14,True,1,4335,-14.93,-57452.55,64721.55,7269.0
1945-05-08,14.96,0.03,0.2,31.86,-53.04,True,1,4336,-14.96,-57467.51,64866.56,7399.05
1945-05-09,14.81,-0.15,-1.0,31.86,-53.52,True,1,4337,-14.81,-57482.32,64230.97,6748.65
1945-05-10,14.62,-0.19,-1.28,31.86,-54.11,True,1,4338,-14.62,-57496.94,63421.56,5924.62
1945-05-11,14.62,0.0,0.0,31.86,-54.11,True,1,4339,-14.62,-57511.56,63436.18,5924.62
1945-05-14,14.63,0.01,0.07,31.86,-54.08,True,1,4340,-14.63,-57526.19,63494.2,5968.01
1945-05-15,14.68,0.05,0.34,31.86,-53.92,True,1,4341,-14.68,-57540.87,63725.88,6185.01
1945-05-16,14.69,0.01,0.07,31.86,-53.89,True,1,4342,-14.69,-57555.56,63783.98,6228.42
1945-05-17,14.77,0.08,0.55,31.86,-53.64,True,1,4343,-14.77,-57570.33,64146.11,6575.78
1945-05-18,14.87,0.1,0.68,31.86,-53.33,True,1,4344,-14.87,-57585.2,64595.28,7010.08
1945-05-21,14.82,-0.05,-0.34,31.86,-53.48,True,1,4345,-14.82,-57600.02,64392.9,6792.88
1945-05-22,14.81,-0.01,-0.07,31.86,-53.52,True,1,4346,-14.81,-57614.83,64364.26,6749.43
1945-05-23,14.7,-0.11,-0.74,31.86,-53.86,True,1,4347,-14.7,-57629.53,63900.9,6271.37
1945-05-24,14.7,0.0,0.0,31.86,-53.86,True,1,4348,-14.7,-57644.23,63915.6,6271.37
1945-05-25,14.79,0.09,0.61,31.86,-53.58,True,1,4349,-14.79,-57659.02,64321.71,6662.69
1945-05-28,15.03,0.24,1.62,31.86,-52.82,True,1,4350,-15.03,-57674.05,65380.5,7706.45
1945-05-29,15.11,0.08,0.53,31.86,-52.57,True,1,4351,-15.11,-57689.16,65743.61,8054.45
1945-05-31,15.01,-0.1,-0.66,31.86,-52.89,True,1,4352,-15.01,-57704.17,65323.52,7619.35
1945-06-01,15.03,0.02,0.13,31.86,-52.82,True,1,4353,-15.03,-57719.2,65425.59,7706.39
1945-06-04,15.05,0.02,0.13,31.86,-52.76,True,1,4354,-15.05,-57734.25,65527.7,7793.45
1945-06-05,15.03,-0.02,-0.13,31.86,-52.82,True,1,4355,-15.03,-57749.28,65455.65,7706.37
1945-06-06,14.96,-0.07,-0.47,31.86,-53.04,True,1,4356,-14.96,-57764.24,65165.76,7401.52
1945-06-07,14.97,0.01,0.07,31.86,-53.01,True,1,4357,-14.97,-57779.21,65224.29,7445.08
1945-06-08,14.93,-0.04,-0.27,31.86,-53.14,True,1,4358,-14.93,-57794.14,65064.94,7270.8
1945-06-11,14.89,-0.04,-0.27,31.86,-53.26,True,1,4359,-14.89,-57809.03,64905.51,7096.48
1945-06-12,14.92,0.03,0.2,31.86,-53.17,True,1,4360,-14.92,-57823.95,65051.2,7227.25
1945-06-13,14.99,0.07,0.47,31.86,-52.95,True,1,4361,-14.99,-57838.94,65371.39,7532.45
1945-06-14,15.05,0.06,0.4,31.86,-52.76,True,1,4362,-15.05,-57853.99,65648.1,7794.11
1945-06-15,15.1,0.05,0.33,31.86,-52.6,True,1,4363,-15.1,-57869.09,65881.3,8012.21
1945-06-18,15.09,-0.01,-0.07,31.86,-52.64,True,1,4364,-15.09,-57884.18,65852.76,7968.58
1945-06-19,15.11,0.02,0.13,31.86,-52.57,True,1,4365,-15.11,-57899.29,65955.15,8055.86
1945-06-20,15.18,0.07,0.46,31.86,-52.35,True,1,4366,-15.18,-57914.47,66275.88,8361.41
1945-06-21,15.26,0.08,0.53,31.86,-52.1,True,1,4367,-15.26,-57929.73,66640.42,8710.69
1945-06-22,15.28,0.02,0.13,31.86,-52.04,True,1,4368,-15.28,-57945.01,66743.04,8798.03
1945-06-25,15.35,0.07,0.46,31.86,-51.82,True,1,4369,-15.35,-57960.36,67064.15,9103.79
1945-06-26,15.37,0.02,0.13,31.86,-51.76,True,1,4370,-15.37,-57975.73,67166.9,9191.17
1945-06-27,15.35,-0.02,-0.13,31.86,-51.82,True,1,4371,-15.35,-57991.08,67094.85,9103.77
1945-06-28,15.04,-0.31,-2.02,31.86,-52.79,True,1,4372,-15.04,-58006.12,65754.88,7748.76
1945-06-29,14.87,-0.17,-1.13,31.86,-53.33,True,1,4373,-14.87,-58020.99,65026.51,7005.52
1945-07-02,15.03,0.16,1.08,31.86,-52.82,True,1,4374,-15.03,-58036.02,65741.22,7705.2
1945-07-03,15.03,0.0,0.0,31.86,-52.82,True,1,4375,-15.03,-58051.05,65756.25,7705.2
1945-07-05,14.86,-0.17,-1.13,31.86,-53.36,True,1,4376,-14.86,-58065.91,65027.36,6961.45
1945-07-06,14.91,0.05,0.34,31.86,-53.2,True,1,4377,-14.91,-58080.82,65261.07,7180.25
1945-07-09,15.04,0.13,0.87,31.86,-52.79,True,1,4378,-15.04,-58095.86,65845.12,7749.26
1945-07-10,15.1,0.06,0.4,31.86,-52.6,True,1,4379,-15.1,-58110.96,66122.9,8011.94
1945-07-11,15.05,-0.05,-0.33,31.86,-52.76,True,1,4380,-15.05,-58126.01,65919.0,7792.99
1945-07-12,15.09,0.04,0.27,31.86,-52.64,True,1,4381,-15.09,-58141.1,66109.29,7968.19
1945-07-13,15.05,-0.04,-0.26,31.86,-52.76,True,1,4382,-15.05,-58156.15,65949.1,7792.95
1945-07-16,14.94,-0.11,-0.73,31.86,-53.11,True,1,4383,-14.94,-58171.09,65482.02,7310.93
1945-07-17,14.61,-0.33,-2.21,31.86,-54.14,True,1,4384,-14.61,-58185.7,64050.24,5864.54
1945-07-18,14.56,-0.05,-0.34,31.86,-54.3,True,1,4385,-14.56,-58200.26,63845.6,5645.34
1945-07-19,14.66,0.1,0.69,31.86,-53.99,True,1,4386,-14.66,-58214.92,64298.76,6083.84
1945-07-20,14.66,0.0,0.0,31.86,-53.99,True,1,4387,-14.66,-58229.58,64313.42,6083.84
1945-07-23,14.51,-0.15,-1.02,31.86,-54.46,True,1,4388,-14.51,-58244.09,63669.88,5425.79
1945-07-24,14.54,0.03,0.21,31.86,-54.36,True,1,4389,-14.54,-58258.63,63816.06,5557.43
1945-07-25,14.68,0.14,0.96,31.86,-53.92,True,1,4390,-14.68,-58273.31,64445.2,6171.89
1945-07-26,14.38,-0.3,-2.04,31.86,-54.86,True,1,4391,-14.38,-58287.69,63142.58,4854.89
1945-07-27,14.45,0.07,0.49,31.86,-54.64,True,1,4392,-14.45,-58302.14,63464.4,5162.26
1945-07-30,14.6,0.15,1.04,31.86,-54.18,True,1,4393,-14.6,-58316.74,64137.8,5821.06
1945-07-31,14.66,0.06,0.41,31.86,-53.99,True,1,4394,-14.66,-58331.4,64416.04,6084.64
1945-08-01,14.68,0.02,0.14,31.86,-53.92,True,1,4395,-14.68,-58346.08,64518.6,6172.52
1945-08-02,14.62,-0.06,-0.41,31.86,-54.11,True,1,4396,-14.62,-58360.7,64269.52,5908.82
1945-08-03,14.68,0.06,0.41,31.86,-53.92,True,1,4397,-14.68,-58375.38,64547.96,6172.58
1945-08-06,14.72,0.04,0.27,31.86,-53.8,True,1,4398,-14.72,-58390.1,64738.56,6348.46
1945-08-07,14.52,-0.2,-1.36,31.86,-54.43,True,1,4399,-14.52,-58404.62,63873.48,5468.86
1945-08-08,14.55,0.03,0.21,31.86,-54.33,True,1,4400,-14.55,-58419.17,64020.0,5600.83
1945-08-09,14.79,0.24,1.65,31.86,-53.58,True,1,4401,-14.79,-58433.96,65090.79,6656.83
1945-08-10,14.78,-0.01,-0.07,31.86,-53.61,True,1,4402,-14.78,-58448.74,65061.56,6612.82
1945-08-13,14.61,-0.17,-1.15,31.86,-54.14,True,1,4403,-14.61,-58463.35,64327.83,5864.48
1945-08-14,14.7,0.09,0.62,31.86,-53.86,True,1,4404,-14.7,-58478.05,64738.8,6260.75
1945-08-17,14.62,-0.08,-0.54,31.86,-54.11,True,1,4405,-14.62,-58492.67,64401.1,5908.43
1945-08-20,14.4,-0.22,-1.5,31.86,-54.8,True,1,4406,-14.4,-58507.07,63446.4,4939.33
1945-08-21,14.46,0.06,0.42,31.86,-54.61,True,1,4407,-14.46,-58521.53,63725.22,5203.69
1945-08-22,14.56,0.1,0.69,31.86,-54.3,True,1,4408,-14.56,-58536.09,64180.48,5644.39
1945-08-23,14.85,0.29,1.99,31.86,-53.39,True,1,4409,-14.85,-58550.94,65473.65,6922.71
1945-08-24,15.05,0.2,1.35,31.86,-52.76,True,1,4410,-15.05,-58565.99,66370.5,7804.51
1945-08-27,15.27,0.22,1.46,31.86,-52.07,True,1,4411,-15.27,-58581.26,67355.97,8774.71
1945-08-28,15.32,0.05,0.33,31.86,-51.92,True,1,4412,-15.32,-58596.58,67591.84,8995.26
1945-08-29,15.3,-0.02,-0.13,31.86,-51.98,True,1,4413,-15.3,-58611.88,67518.9,8907.02
1945-08-30,15.35,0.05,0.33,31.86,-51.82,True,1,4414,-15.35,-58627.23,67754.9,9127.67
1945-08-31,15.51,0.16,1.04,31.86,-51.32,True,1,4415,-15.51,-58642.74,68476.65,9833.91
1945-09-04,15.51,0.0,0.0,31.86,-51.32,True,1,4416,-15.51,-58658.25,68492.16,9833.91
1945-09-05,15.53,0.02,0.13,31.86,-51.26,True,1,4417,-15.53,-58673.78,68596.01,9922.23
1945-09-06,15.74,0.21,1.35,31.86,-50.6,True,1,4418,-15.74,-58689.52,69539.32,10849.8
1945-09-07,15.73,-0.01,-0.06,31.86,-50.63,True,1,4419,-15.73,-58705.25,69510.87,10805.62
1945-09-10,15.78,0.05,0.32,31.86,-50.47,True,1,4420,-15.78,-58721.03,69747.6,11026.57
1945-09-11,15.88,0.1,0.63,31.86,-50.16,True,1,4421,-15.88,-58736.91,70205.48,11468.57
1945-09-12,15.95,0.07,0.44,31.86,-49.94,True,1,4422,-15.95,-58752.86,70530.9,11778.04
1945-09-13,15.95,0.0,0.0,31.86,-49.94,True,1,4423,-15.95,-58768.81,70546.85,11778.04
1945-09-14,15.86,-0.09,-0.56,31.86,-50.22,True,1,4424,-15.86,-58784.67,70164.64,11379.97
1945-09-17,15.51,-0.35,-2.21,31.86,-51.32,True,1,4425,-15.51,-58800.18,68631.75,9831.57
1945-09-18,15.82,0.31,2.0,31.86,-50.34,True,1,4426,-15.82,-58816.0,70019.32,11203.32
1945-09-19,15.97,0.15,0.95,31.86,-49.87,True,1,4427,-15.97,-58831.97,70699.19,11867.22
1945-09-20,16.03,0.06,0.38,31.86,-49.69,True,1,4428,-16.03,-58848.0,70980.84,12132.84
1945-09-21,15.95,-0.08,-0.5,31.86,-49.94,True,1,4429,-15.95,-58863.95,70642.55,11778.6
1945-09-24,15.91,-0.04,-0.25,31.86,-50.06,True,1,4430,-15.91,-58879.86,70481.3,11601.44
1945-09-25,15.93,0.02,0.13,31.86,-50.0,True,1,4431,-15.93,-58895.79,70585.83,11690.04
1945-09-26,15.92,-0.01,-0.06,31.86,-50.03,True,1,4432,-15.92,-58911.71,70557.44,11645.73
1945-09-27,15.86,-0.06,-0.38,31.86,-50.22,True,1,4433,-15.86,-58927.57,70307.38,11379.81
1945-09-28,16.05,0.19,1.2,31.86,-49.62,True,1,4434,-16.05,-58943.62,71165.7,12222.08
1945-10-01,16.33,0.28,1.74,31.86,-48.74,True,1,4435,-16.33,-58959.95,72423.55,13463.6
1945-10-02,16.33,0.0,0.0,31.86,-48.74,True,1,4436,-16.33,-58976.28,72439.88,13463.6
1945-10-03,16.3,-0.03,-0.18,31.86,-48.84,True,1,4437,-16.3,-58992.58,72323.1,13330.52
1945-10-04,16.3,0.0,0.0,31.86,-48.84,True,1,4438,-16.3,-59008.88,72339.4,13330.52
1945-10-05,16.38,0.08,0.49,31.86,-48.59,True,1,4439,-16.38,-59025.26,72710.82,13685.56
1945-10-08,16.5,0.12,0.73,31.86,-48.21,True,1,4440,-16.5,-59041.76,73260.0,14218.24
1945-10-09,16.54,0.04,0.24,31.86,-48.08,True,1,4441,-16.54,-59058.3,73454.14,14395.84
1945-10-10,16.6,0.06,0.36,31.86,-47.9,True,1,4442,-16.6,-59074.9,73737.2,14662.3
1945-10-11,16.58,-0.02,-0.12,31.86,-47.96,True,1,4443,-16.58,-59091.48,73664.94,14573.46
1945-10-15,16.59,0.01,0.06,31.86,-47.93,True,1,4444,-16.59,-59108.07,73725.96,14617.89
1945-10-16,16.59,0.0,0.0,31.86,-47.93,True,1,4445,-16.59,-59124.66,73742.55,14617.89
1945-10-17,16.66,0.07,0.42,31.86,-47.71,True,1,4446,-16.66,-59141.32,74070.36,14929.04
1945-10-18,16.72,0.06,0.36,31.86,-47.52,True,1,4447,-16.72,-59158.04,74353.84,15195.8
1945-10-19,16.59,-0.13,-0.78,31.86,-47.93,True,1,4448,-16.59,-59174.63,73792.32,14617.69
1945-10-22,16.71,0.12,0.72,31.86,-47.55,True,1,4449,-16.71,-59191.34,74342.79,15151.45
1945-10-23,16.58,-0.13,-0.78,31.86,-47.96,True,1,4450,-16.58,-59207.92,73781.0,14573.08
1945-10-24,16.33,-0.25,-1.51,31.86,-48.74,True,1,4451,-16.33,-59224.25,72684.83,13460.58
1945-10-25,16.41,0.08,0.49,31.86,-48.49,True,1,4452,-16.41,-59240.66,73057.32,13816.66
1945-10-26,16.49,0.08,0.49,31.86,-48.24,True,1,4453,-16.49,-59257.15,73429.97,14172.82
1945-10-29,16.3,-0.19,-1.15,31.86,-48.84,True,1,4454,-16.3,-59273.45,72600.2,13326.75
1945-10-30,16.38,0.08,0.49,31.86,-48.59,True,1,4455,-16.38,-59289.83,72972.9,13683.07
1945-10-31,16.65,0.27,1.65,31.86,-47.74,True,1,4456,-16.65,-59306.48,74192.4,14885.92
1945-11-01,16.87,0.22,1.32,31.86,-47.05,True,1,4457,-16.87,-59323.35,75189.59,15866.24
1945-11-02,16.86,-0.01,-0.06,31.86,-47.08,True,1,4458,-16.86,-59340.21,75161.88,15821.67
1945-11-05,16.94,0.08,0.47,31.86,-46.83,True,1,4459,-16.94,-59357.15,75535.46,16178.31
1945-11-07,17.14,0.2,1.18,31.86,-46.2,True,1,4460,-17.14,-59374.29,76444.4,17070.11
1945-11-08,17.08,-0.06,-0.35,31.86,-46.39,True,1,4461,-17.08,-59391.37,76193.88,16802.51
1945-11-09,17.1,0.02,0.12,31.86,-46.33,True,1,4462,-17.1,-59408.47,76300.2,16891.73
1945-11-13,17.04,-0.06,-0.35,31.86,-46.52,True,1,4463,-17.04,-59425.51,76049.52,16624.01
1945-11-14,16.95,-0.09,-0.53,31.86,-46.8,True,1,4464,-16.95,-59442.46,75664.8,16222.34
1945-11-15,17.08,0.13,0.77,31.86,-46.39,True,1,4465,-17.08,-59459.54,76262.2,16802.66
1945-11-16,17.0,-0.08,-0.47,31.86,-46.64,True,1,4466,-17.0,-59476.54,75922.0,16445.46
1945-11-19,17.19,0.19,1.12,31.86,-46.04,True,1,4467,-17.19,-59493.73,76787.73,17294.0
1945-11-20,17.27,0.08,0.46,31.86,-45.79,True,1,4468,-17.27,-59511.0,77162.36,17651.36
1945-11-21,17.02,-0.25,-1.45,31.86,-46.58,True,1,4469,-17.02,-59528.02,76062.38,16534.36
1945-11-23,16.85,-0.17,-1.0,31.86,-47.11,True,1,4470,-16.85,-59544.87,75319.5,15774.63
1945-11-26,16.94,0.09,0.53,31.86,-46.83,True,1,4471,-16.94,-59561.81,75738.74,16176.93
1945-11-27,17.15,0.21,1.24,31.86,-46.17,True,1,4472,-17.15,-59578.96,76694.8,17115.84
1945-11-28,17.06,-0.09,-0.52,31.86,-46.45,True,1,4473,-17.06,-59596.02,76309.38,16713.36
1945-11-29,17.03,-0.03,-0.18,31.86,-46.55,True,1,4474,-17.03,-59613.05,76192.22,16579.17
1945-11-30,17.19,0.16,0.94,31.86,-46.04,True,1,4475,-17.19,-59630.24,76925.25,17295.01
1945-12-03,17.44,0.25,1.45,31.86,-45.26,True,1,4476,-17.44,-59647.68,78061.44,18413.76
1945-12-04,17.42,-0.02,-0.12,31.86,-45.32,True,1,4477,-17.42,-59665.1,77989.34,18324.24
1945-12-05,17.41,-0.01,-0.06,31.86,-45.36,True,1,4478,-17.41,-59682.51,77961.98,18279.47
1945-12-06,17.5,0.09,0.52,31.86,-45.07,True,1,4479,-17.5,-59700.01,78382.5,18682.49
1945-12-07,17.54,0.04,0.23,31.86,-44.95,True,1,4480,-17.54,-59717.55,78579.2,18861.65
1945-12-10,17.68,0.14,0.8,31.86,-44.51,True,1,4481,-17.68,-59735.23,79224.08,19488.85
1945-12-11,17.64,-0.04,-0.23,31.86,-44.63,True,1,4482,-17.64,-59752.87,79062.48,19309.61
1945-12-12,17.37,-0.27,-1.53,31.86,-45.48,True,1,4483,-17.37,-59770.24,77869.71,18099.47
1945-12-13,17.29,-0.08,-0.46,31.86,-45.73,True,1,4484,-17.29,-59787.53,77528.36,17740.83
1945-12-14,17.31,0.02,0.12,31.86,-45.67,True,1,4485,-17.31,-59804.84,77635.35,17830.51
1945-12-17,16.94,-0.37,-2.14,31.86,-46.83,True,1,4486,-16.94,-59821.78,75992.84,16171.06
1945-12-18,17.1,0.16,0.94,31.86,-46.33,True,1,4487,-17.1,-59838.88,76727.7,16888.82
1945-12-19,17.1,0.0,0.0,31.86,-46.33,True,1,4488,-17.1,-59855.98,76744.8,16888.82
1945-12-20,16.99,-0.11,-0.64,31.86,-46.67,True,1,4489,-16.99,-59872.97,76268.11,16395.14
1945-12-21,16.98,-0.01,-0.06,31.86,-46.7,True,1,4490,-16.98,-59889.95,76240.2,16350.25
1945-12-26,17.41,0.43,2.53,31.86,-45.36,True,1,4491,-17.41,-59907.36,78188.31,18280.95
1945-12-27,17.28,-0.13,-0.75,31.86,-45.76,True,1,4492,-17.28,-59924.64,77621.76,17697.12
1945-12-28,17.31,0.03,0.17,31.86,-45.67,True,1,4493,-17.31,-59941.95,77773.83,17831.88
1945-12-31,17.36,0.05,0.29,31.86,-45.51,True,1,4494,-17.36,-59959.31,78015.84,18056.53
1946-01-02,17.25,-0.11,-0.63,31.86,-45.86,True,1,4495,-17.25,-59976.56,77538.75,17562.19
1946-01-03,17.27,0.02,0.12,31.86,-45.79,True,1,4496,-17.27,-59993.83,77645.92,17652.09
1946-01-04,17.23,-0.04,-0.23,31.86,-45.92,True,1,4497,-17.23,-60011.06,77483.31,17472.25
1946-01-07,17.31,0.08,0.46,31.86,-45.67,True,1,4498,-17.31,-60028.37,77860.38,17832.01
1946-01-08,17.69,0.38,2.19,31.86,-44.48,True,1,4499,-17.69,-60046.06,79587.31,19541.25
1946-01-09,17.95,0.26,1.47,31.86,-43.66,True,1,4500,-17.95,-60064.01,80775.0,20710.99
1946-01-10,18.07,0.12,0.67,31.86,-43.28,True,1,4501,-18.07,-60082.08,81333.07,21250.99
1946-01-11,18.13,0.06,0.33,31.86,-43.1,True,1,4502,-18.13,-60100.21,81621.26,21521.05
1946-01-14,18.33,0.2,1.1,31.86,-42.47,True,1,4503,-18.33,-60118.54,82539.99,22421.45
1946-01-15,18.36,0.03,0.16,31.86,-42.37,True,1,4504,-18.36,-60136.9,82693.44,22556.54
1946-01-16,18.38,0.02,0.11,31.86,-42.31,True,1,4505,-18.38,-60155.28,82801.9,22646.62
1946-01-17,18.34,-0.04,-0.22,31.86,-42.44,True,1,4506,-18.34,-60173.62,82640.04,22466.42
1946-01-18,18.3,-0.04,-0.22,31.86,-42.56,True,1,4507,-18.3,-60191.92,82478.1,22286.18
1946-01-21,17.74,-0.56,-3.06,31.86,-44.32,True,1,4508,-17.74,-60209.66,79971.92,19762.26
1946-01-22,17.86,0.12,0.68,31.86,-43.94,True,1,4509,-17.86,-60227.52,80530.74,20303.22
1946-01-23,18.07,0.21,1.18,31.86,-43.28,True,1,4510,-18.07,-60245.59,81495.7,21250.11
1946-01-24,18.12,0.05,0.28,31.86,-43.13,True,1,4511,-18.12,-60263.71,81739.32,21475.61
1946-01-25,18.09,-0.03,-0.17,31.86,-43.22,True,1,4512,-18.09,-60281.8,81622.08,21340.28
1946-01-28,18.62,0.53,2.93,31.86,-41.56,True,1,4513,-18.62,-60300.42,84032.06,23731.64
1946-01-29,18.67,0.05,0.27,31.86,-41.4,True,1,4514,-18.67,-60319.09,84276.38,23957.29
1946-01-30,18.56,-0.11,-0.59,31.86,-41.74,True,1,4515,-18.56,-60337.65,83798.4,23460.75
1946-01-31,18.57,0.01,0.05,31.86,-41.71,True,1,4516,-18.57,-60356.22,83862.12,23505.9
1946-02-01,18.64,0.07,0.38,31.86,-41.49,True,1,4517,-18.64,-60374.86,84196.88,23822.02
1946-02-04,18.62,-0.02,-0.11,31.86,-41.56,True,1,4518,-18.62,-60393.48,84125.16,23731.68
1946-02-05,18.7,0.08,0.43,31.86,-41.31,True,1,4519,-18.7,-60412.18,84505.3,24093.12
1946-02-06,18.57,-0.13,-0.7,31.86,-41.71,True,1,4520,-18.57,-60430.75,83936.4,23505.65
1946-02-07,18.57,0.0,0.0,31.86,-41.71,True,1,4521,-18.57,-60449.32,83954.97,23505.65
1946-02-08,18.55,-0.02,-0.11,31.86,-41.78,True,1,4522,-18.55,-60467.87,83883.1,23415.23
1946-02-11,18.24,-0.31,-1.67,31.86,-42.75,True,1,4523,-18.24,-60486.11,82499.52,22013.41
1946-02-13,17.98,-0.26,-1.42,31.86,-43.57,True,1,4524,-17.98,-60504.09,81341.52,20837.43
1946-02-14,18.09,0.11,0.61,31.86,-43.22,True,1,4525,-18.09,-60522.18,81857.25,21335.07
1946-02-15,18.44,0.35,1.94,31.86,-42.12,True,1,4526,-18.44,-60540.62,83459.44,22918.82
1946-02-18,18.38,-0.06,-0.32,31.86,-42.31,True,1,4527,-18.38,-60559.0,83206.26,22647.26
1946-02-19,17.7,-0.68,-3.7,31.86,-44.44,True,1,4528,-17.7,-60576.7,80145.6,19568.9
1946-02-20,17.37,-0.33,-1.86,31.86,-45.48,True,1,4529,-17.37,-60594.07,78668.73,18074.66
1946-02-21,17.72,0.35,2.02,31.86,-44.38,True,1,4530,-17.72,-60611.79,80271.6,19659.81
1946-02-25,16.91,-0.81,-4.57,31.86,-46.92,True,1,4531,-16.91,-60628.7,76619.21,15990.51
1946-02-26,16.81,-0.1,-0.59,31.86,-47.24,True,1,4532,-16.81,-60645.51,76182.92,15537.41
1946-02-27,17.15,0.34,2.02,31.86,-46.17,True,1,4533,-17.15,-60662.66,77740.95,17078.29
1946-02-28,17.28,0.13,0.76,31.86,-45.76,True,1,4534,-17.28,-60679.94,78347.52,17667.58
1946-03-01,17.21,-0.07,-0.4,31.86,-45.98,True,1,4535,-17.21,-60697.15,78047.35,17350.2
1946-03-04,17.09,-0.12,-0.7,31.86,-46.36,True,1,4536,-17.09,-60714.24,77520.24,16806.0
1946-03-05,17.27,0.18,1.05,31.86,-45.79,True,1,4537,-17.27,-60731.51,78353.99,17622.48
1946-03-06,17.19,-0.08,-0.46,31.86,-46.04,True,1,4538,-17.19,-60748.7,78008.22,17259.52
1946-03-07,17.34,0.15,0.87,31.86,-45.57,True,1,4539,-17.34,-60766.04,78706.26,17940.22
1946-03-08,17.49,0.15,0.86,31.86,-45.1,True,1,4540,-17.49,-60783.53,79404.6,18621.07
1946-03-11,17.38,-0.11,-0.63,31.86,-45.45,True,1,4541,-17.38,-60800.91,78922.58,18121.67
1946-03-12,17.42,0.04,0.23,31.86,-45.32,True,1,4542,-17.42,-60818.33,79121.64,18303.31
1946-03-13,17.15,-0.27,-1.55,31.86,-46.17,True,1,4543,-17.15,-60835.48,77912.45,17076.97
1946-03-14,17.09,-0.06,-0.35,31.86,-46.36,True,1,4544,-17.09,-60852.57,77656.96,16804.39
1946-03-15,17.28,0.19,1.11,31.86,-45.76,True,1,4545,-17.28,-60869.85,78537.6,17667.75
1946-03-18,17.57,0.29,1.68,31.86,-44.85,True,1,4546,-17.57,-60887.42,79873.22,18985.8
1946-03-19,17.45,-0.12,-0.68,31.86,-45.23,True,1,4547,-17.45,-60904.87,79345.15,18440.28
1946-03-20,17.58,0.13,0.74,31.86,-44.82,True,1,4548,-17.58,-60922.45,79953.84,19031.39
1946-03-21,17.7,0.12,0.68,31.86,-44.44,True,1,4549,-17.7,-60940.15,80517.3,19577.15
1946-03-22,17.7,0.0,0.0,31.86,-44.44,True,1,4550,-17.7,-60957.85,80535.0,19577.15
1946-03-25,18.07,0.37,2.09,31.86,-43.28,True,1,4551,-18.07,-60975.92,82236.57,21260.65
1946-03-26,18.06,-0.01,-0.06,31.86,-43.32,True,1,4552,-18.06,-60993.98,82209.12,21215.14
1946-03-27,17.95,-0.11,-0.61,31.86,-43.66,True,1,4553,-17.95,-61011.93,81726.35,20714.42
1946-03-28,17.93,-0.02,-0.11,31.86,-43.72,True,1,4554,-17.93,-61029.86,81653.22,20623.36
1946-03-29,18.04,0.11,0.61,31.86,-43.38,True,1,4555,-18.04,-61047.9,82172.2,21124.3
1946-04-01,18.06,0.02,0.11,31.86,-43.32,True,1,4556,-18.06,-61065.96,82281.36,21215.4
1946-04-02,18.07,0.01,0.06,31.86,-43.28,True,1,4557,-18.07,-61084.03,82344.99,21260.96
1946-04-03,18.38,0.31,1.72,31.86,-42.31,True,1,4558,-18.38,-61102.41,83776.04,22673.63
1946-04-04,18.58,0.2,1.09,31.86,-41.68,True,1,4559,-18.58,-61120.99,84706.22,23585.23
1946-04-05,18.54,-0.04,-0.22,31.86,-41.81,True,1,4560,-18.54,-61139.53,84542.4,23402.87
1946-04-08,18.62,0.08,0.43,31.86,-41.56,True,1,4561,-18.62,-61158.15,84925.82,23767.67
1946-04-09,18.88,0.26,1.4,31.86,-40.74,True,1,4562,-18.88,-61177.03,86130.56,24953.53
1946-04-10,18.81,-0.07,-0.37,31.86,-40.96,True,1,4563,-18.81,-61195.84,85830.03,24634.19
1946-04-11,18.77,-0.04,-0.21,31.86,-41.09,True,1,4564,-18.77,-61214.61,85666.28,24451.67
1946-04-12,18.77,0.0,0.0,31.86,-41.09,True,1,4565,-18.77,-61233.38,85685.05,24451.67
1946-04-15,18.62,-0.15,-0.8,31.86,-41.56,True,1,4566,-18.62,-61252.0,85018.92,23766.92
1946-04-16,18.87,0.25,1.34,31.86,-40.77,True,1,4567,-18.87,-61270.87,86179.29,24908.42
1946-04-17,18.84,-0.03,-0.16,31.86,-40.87,True,1,4568,-18.84,-61289.71,86061.12,24771.41
1946-04-18,18.9,0.06,0.32,31.86,-40.68,True,1,4569,-18.9,-61308.61,86354.1,25045.49
1946-04-22,18.88,-0.02,-0.11,31.86,-40.74,True,1,4570,-18.88,-61327.49,86281.6,24954.11
1946-04-23,18.84,-0.04,-0.21,31.86,-40.87,True,1,4571,-18.84,-61346.33,86117.64,24771.31
1946-04-24,18.65,-0.19,-1.01,31.86,-41.46,True,1,4572,-18.65,-61364.98,85267.8,23902.82
1946-04-25,18.54,-0.11,-0.59,31.86,-41.81,True,1,4573,-18.54,-61383.52,84783.42,23399.9
1946-04-26,18.58,0.04,0.22,31.86,-41.68,True,1,4574,-18.58,-61402.1,84984.92,23582.82
1946-04-29,18.72,0.14,0.75,31.86,-41.24,True,1,4575,-18.72,-61420.82,85644.0,24223.18
1946-04-30,18.76,0.04,0.21,31.86,-41.12,True,1,4576,-18.76,-61439.58,85845.76,24406.18
1946-05-01,18.71,-0.05,-0.27,31.86,-41.27,True,1,4577,-18.71,-61458.29,85635.67,24177.38
1946-05-02,18.62,-0.09,-0.48,31.86,-41.56,True,1,4578,-18.62,-61476.91,85242.36,23765.45
1946-05-03,18.46,-0.16,-0.86,31.86,-42.06,True,1,4579,-18.46,-61495.37,84528.34,23032.97
1946-05-06,18.26,-0.2,-1.08,31.86,-42.69,True,1,4580,-18.26,-61513.63,83630.8,22117.17
1946-05-07,18.51,0.25,1.37,31.86,-41.9,True,1,4581,-18.51,-61532.14,84794.31,23262.17
1946-05-08,18.47,-0.04,-0.22,31.86,-42.03,True,1,4582,-18.47,-61550.61,84629.54,23078.93
1946-05-09,18.44,-0.03,-0.16,31.86,-42.12,True,1,4583,-18.44,-61569.05,84510.52,22941.47
1946-05-10,18.74,0.3,1.63,31.86,-41.18,True,1,4584,-18.74,-61587.79,85904.16,24316.37
1946-05-13,18.79,0.05,0.27,31.86,-41.02,True,1,4585,-18.79,-61606.58,86152.15,24545.57
1946-05-14,18.67,-0.12,-0.64,31.86,-41.4,True,1,4586,-18.67,-61625.25,85620.62,23995.37
1946-05-15,18.53,-0.14,-0.75,31.86,-41.84,True,1,4587,-18.53,-61643.78,84997.11,23353.33
1946-05-16,18.64,0.11,0.59,31.86,-41.49,True,1,4588,-18.64,-61662.42,85520.32,23857.9
1946-05-17,18.6,-0.04,-0.22,31.86,-41.62,True,1,4589,-18.6,-61681.02,85355.4,23674.38
1946-05-20,18.64,0.04,0.22,31.86,-41.49,True,1,4590,-18.64,-61699.66,85557.6,23857.94
1946-05-21,18.68,0.04,0.22,31.86,-41.37,True,1,4591,-18.68,-61718.34,85759.88,24041.54
1946-05-22,18.8,0.12,0.64,31.86,-40.99,True,1,4592,-18.8,-61737.14,86329.6,24592.46
1946-05-23,18.78,-0.02,-0.11,31.86,-41.06,True,1,4593,-18.78,-61755.92,86256.54,24500.62
1946-05-24,18.78,0.0,0.0,31.86,-41.06,True,1,4594,-18.78,-61774.7,86275.32,24500.62
1946-05-27,18.92,0.14,0.74,31.86,-40.62,True,1,4595,-18.92,-61793.62,86937.4,25143.78
1946-05-28,19.2,0.28,1.48,31.86,-39.74,True,1,4596,-19.2,-61812.82,88243.2,26430.38
1946-05-29,19.25,0.05,0.26,31.86,-39.58,True,1,4597,-19.25,-61832.07,88492.25,26660.18
1946-05-31,19.18,-0.07,-0.36,31.86,-39.8,True,1,4598,-19.18,-61851.25,88189.64,26338.39
1946-06-03,19.05,-0.13,-0.68,31.86,-40.21,True,1,4599,-19.05,-61870.3,87610.95,25740.65
1946-06-04,18.93,-0.12,-0.63,31.86,-40.58,True,1,4600,-18.93,-61889.23,87078.0,25188.77
1946-06-05,18.82,-0.11,-0.58,31.86,-40.93,True,1,4601,-18.82,-61908.05,86590.82,24682.77
1946-06-06,18.81,-0.01,-0.05,31.86,-40.96,True,1,4602,-18.81,-61926.86,86563.62,24636.76
1946-06-07,18.82,0.01,0.05,31.86,-40.93,True,1,4603,-18.82,-61945.68,86628.46,24682.78
1946-06-10,18.85,0.03,0.16,31.86,-40.84,True,1,4604,-18.85,-61964.53,86785.4,24820.87
1946-06-11,18.65,-0.2,-1.06,31.86,-41.46,True,1,4605,-18.65,-61983.18,85883.25,23900.07
1946-06-12,18.69,0.04,0.21,31.86,-41.34,True,1,4606,-18.69,-62001.87,86086.14,24084.27
1946-06-13,18.8,0.11,0.59,31.86,-40.99,True,1,4607,-18.8,-62020.67,86611.6,24590.93
1946-06-14,18.79,-0.01,-0.05,31.86,-41.02,True,1,4608,-18.79,-62039.46,86584.32,24544.86
1946-06-17,18.81,0.02,0.11,31.86,-40.96,True,1,4609,-18.81,-62058.27,86695.29,24637.02
1946-06-18,18.55,-0.26,-1.38,31.86,-41.78,True,1,4610,-18.55,-62076.82,85515.5,23438.68
1946-06-19,18.44,-0.11,-0.59,31.86,-42.12,True,1,4611,-18.44,-62095.26,85026.84,22931.58
1946-06-20,18.03,-0.41,-2.22,31.86,-43.41,True,1,4612,-18.03,-62113.29,83154.36,21041.07
1946-06-21,18.23,0.2,1.11,31.86,-42.78,True,1,4613,-18.23,-62131.52,84094.99,21963.47
1946-06-24,18.27,0.04,0.22,31.86,-42.66,True,1,4614,-18.27,-62149.79,84297.78,22147.99
1946-06-25,18.14,-0.13,-0.71,31.86,-43.06,True,1,4615,-18.14,-62167.93,83716.1,21548.17
1946-06-26,18.11,-0.03,-0.16,31.86,-43.16,True,1,4616,-18.11,-62186.04,83595.76,21409.72
1946-06-27,18.39,0.28,1.55,31.86,-42.28,True,1,4617,-18.39,-62204.43,84906.63,22702.2
1946-06-28,18.43,0.04,0.22,31.86,-42.15,True,1,4618,-18.43,-62222.86,85109.74,22886.88
1946-07-01,18.54,0.11,0.6,31.86,-41.81,True,1,4619,-18.54,-62241.4,85636.26,23394.86
1946-07-02,18.53,-0.01,-0.05,31.86,-41.84,True,1,4620,-18.53,-62259.93,85608.6,23348.67
1946-07-03,18.49,-0.04,-0.22,31.86,-41.96,True,1,4621,-18.49,-62278.42,85442.29,23163.87
1946-07-05,18.43,-0.06,-0.32,31.86,-42.15,True,1,4622,-18.43,-62296.85,85183.46,22886.61
1946-07-08,18.36,-0.07,-0.38,31.86,-42.37,True,1,4623,-18.36,-62315.21,84878.28,22563.07
1946-07-09,18.46,0.1,0.55,31.86,-42.06,True,1,4624,-18.46,-62333.67,85359.04,23025.37
1946-07-10,18.49,0.03,0.16,31.86,-41.96,True,1,4625,-18.49,-62352.16,85516.25,23164.09
1946-07-11,18.39,-0.1,-0.54,31.86,-42.28,True,1,4626,-18.39,-62370.55,85072.14,22701.59
1946-07-12,18.27,-0.12,-0.65,31.86,-42.66,True,1,4627,-18.27,-62388.82,84535.29,22146.47
1946-07-15,17.95,-0.32,-1.75,31.86,-43.66,True,1,4628,-17.95,-62406.77,83072.6,20665.83
1946-07-16,17.97,0.02,0.11,31.86,-43.6,True,1,4629,-17.97,-62424.74,83183.13,20758.39
1946-07-17,18.07,0.1,0.56,31.86,-43.28,True,1,4630,-18.07,-62442.81,83664.1,21221.29
1946-07-18,18.04,-0.03,-0.17,31.86,-43.38,True,1,4631,-18.04,-62460.85,83543.24,21082.39
1946-07-19,17.98,-0.06,-0.33,31.86,-43.57,True,1,4632,-17.98,-62478.83,83283.36,20804.53
1946-07-22,17.93,-0.05,-0.28,31.86,-43.72,True,1,4633,-17.93,-62496.76,83069.69,20572.93
1946-07-23,17.39,-0.54,-3.01,31.86,-45.42,True,1,4634,-17.39,-62514.15,80585.26,18071.11
1946-07-24,17.41,0.02,0.12,31.86,-45.36,True,1,4635,-17.41,-62531.56,80695.35,18163.79
1946-07-25,17.5,0.09,0.52,31.86,-45.07,True,1,4636,-17.5,-62549.06,81130.0,18580.94
1946-07-26,17.6,0.1,0.57,31.86,-44.76,True,1,4637,-17.6,-62566.66,81611.2,19044.54
1946-07-29,17.66,0.06,0.34,31.86,-44.57,True,1,4638,-17.66,-62584.32,81907.08,19322.76
1946-07-30,17.76,0.1,0.57,31.86,-44.26,True,1,4639,-17.76,-62602.08,82388.64,19786.56
1946-07-31,17.96,0.2,1.13,31.86,-43.63,True,1,4640,-17.96,-62620.04,83334.4,20714.36
1946-08-01,18.01,0.05,0.28,31.86,-43.47,True,1,4641,-18.01,-62638.05,83584.41,20946.36
1946-08-02,18.02,0.01,0.06,31.86,-43.44,True,1,4642,-18.02,-62656.07,83648.84,20992.77
1946-08-05,17.91,-0.11,-0.61,31.86,-43.78,True,1,4643,-17.91,-62673.98,83156.13,20482.15
1946-08-06,17.86,-0.05,-0.28,31.86,-43.94,True,1,4644,-17.86,-62691.84,82941.84,20250.0
1946-08-07,18.03,0.17,0.95,31.86,-43.41,True,1,4645,-18.03,-62709.87,83749.35,21039.48
1946-08-08,18.11,0.08,0.44,31.86,-43.16,True,1,4646,-18.11,-62727.98,84139.06,21411.08
1946-08-09,18.05,-0.06,-0.33,31.86,-43.35,True,1,4647,-18.05,-62746.03,83878.35,21132.32
1946-08-12,18.08,0.03,0.17,31.86,-43.25,True,1,4648,-18.08,-62764.11,84035.84,21271.73
1946-08-13,18.23,0.15,0.83,31.86,-42.78,True,1,4649,-18.23,-62782.34,84751.27,21968.93
1946-08-14,18.2,-0.03,-0.16,31.86,-42.88,True,1,4650,-18.2,-62800.54,84630.0,21829.46
1946-08-15,17.99,-0.21,-1.15,31.86,-43.53,True,1,4651,-17.99,-62818.53,83671.49,20852.96
1946-08-16,17.84,-0.15,-0.83,31.86,-44.0,True,1,4652,-17.84,-62836.37,82991.68,20155.31
1946-08-19,17.81,-0.03,-0.17,31.86,-44.1,True,1,4653,-17.81,-62854.18,82869.93,20015.75
1946-08-20,17.91,0.1,0.56,31.86,-43.78,True,1,4654,-17.91,-62872.09,83353.14,20481.05
1946-08-21,17.74,-0.17,-0.95,31.86,-44.32,True,1,4655,-17.74,-62889.83,82579.7,19689.87
1946-08-22,17.56,-0.18,-1.01,31.86,-44.88,True,1,4656,-17.56,-62907.39,81759.36,18851.97
1946-08-23,17.58,0.02,0.11,31.86,-44.82,True,1,4657,-17.58,-62924.97,81870.06,18945.09
1946-08-26,17.47,-0.11,-0.63,31.86,-45.17,True,1,4658,-17.47,-62942.44,81375.26,18432.82
1946-08-27,16.92,-0.55,-3.15,31.86,-46.89,True,1,4659,-16.92,-62959.36,78830.28,15870.92
1946-08-28,16.73,-0.19,-1.12,31.86,-47.49,True,1,4660,-16.73,-62976.09,77961.8,14985.71
1946-08-29,16.76,0.03,0.18,31.86,-47.4,True,1,4661,-16.76,-62992.85,78118.36,15125.51
1946-08-30,16.65,-0.11,-0.66,31.86,-47.74,True,1,4662,-16.65,-63009.5,77622.3,14612.8
1946-09-03,15.0,-1.65,-9.91,31.86,-52.92,True,1,4663,-15.0,-63024.5,69945.0,6920.5
1946-09-04,15.46,0.46,3.07,31.86,-51.48,True,1,4664,-15.46,-63039.96,72105.44,9065.48
1946-09-05,15.99,0.53,3.43,31.86,-49.81,True,1,4665,-15.99,-63055.95,74593.35,11537.4
1946-09-06,15.84,-0.15,-0.94,31.86,-50.28,True,1,4666,-15.84,-63071.79,73909.44,10837.65
1946-09-09,15.01,-0.83,-5.24,31.86,-52.89,True,1,4667,-15.01,-63086.8,70051.67,6964.87
1946-09-10,14.59,-0.42,-2.8,31.86,-54.21,True,1,4668,-14.59,-63101.39,68106.12,5004.73
1946-09-11,15.05,0.46,3.15,31.86,-52.76,True,1,4669,-15.05,-63116.44,70268.45,7152.01
1946-09-12,15.02,-0.03,-0.2,31.86,-52.86,True,1,4670,-15.02,-63131.46,70143.4,7011.94
1946-09-13,15.31,0.29,1.93,31.86,-51.95,True,1,4671,-15.31,-63146.77,71513.01,8366.24
1946-09-16,15.4,0.09,0.59,31.86,-51.66,True,1,4672,-15.4,-63162.17,71948.8,8786.63
1946-09-17,15.28,-0.12,-0.78,31.86,-52.04,True,1,4673,-15.28,-63177.45,71403.44,8225.99
1946-09-18,14.8,-0.48,-3.14,31.86,-53.55,True,1,4674,-14.8,-63192.25,69175.2,5982.95
1946-09-19,14.33,-0.47,-3.18,31.86,-55.02,True,1,4675,-14.33,-63206.58,66992.75,3786.17
1946-09-20,14.69,0.36,2.51,31.86,-53.89,True,1,4676,-14.69,-63221.27,68690.44,5469.17
1946-09-23,14.41,-0.28,-1.91,31.86,-54.77,True,1,4677,-14.41,-63235.68,67395.57,4159.89
1946-09-24,14.72,0.31,2.15,31.86,-53.8,True,1,4678,-14.72,-63250.4,68860.16,5609.76
1946-09-25,15.1,0.38,2.58,31.86,-52.6,True,1,4679,-15.1,-63265.5,70652.9,7387.4
1946-09-26,15.27,0.17,1.13,31.86,-52.07,True,1,4680,-15.27,-63280.77,71463.6,8182.83
1946-09-27,15.11,-0.16,-1.05,31.86,-52.57,True,1,4681,-15.11,-63295.88,70729.91,7434.03
1946-09-30,14.96,-0.15,-0.99,31.86,-53.04,True,1,4682,-14.96,-63310.84,70042.72,6731.88
1946-10-01,14.92,-0.04,-0.27,31.86,-53.17,True,1,4683,-14.92,-63325.76,69870.36,6544.6
1946-10-02,15.0,0.08,0.54,31.86,-52.92,True,1,4684,-15.0,-63340.76,70260.0,6919.24
1946-10-03,14.98,-0.02,-0.13,31.86,-52.98,True,1,4685,-14.98,-63355.74,70181.3,6825.56
1946-10-04,14.81,-0.17,-1.14,31.86,-53.52,True,1,4686,-14.81,-63370.55,69399.66,6029.11
1946-10-07,14.7,-0.11,-0.74,31.86,-53.86,True,1,4687,-14.7,-63385.25,68898.9,5513.65
1946-10-08,14.53,-0.17,-1.16,31.86,-54.39,True,1,4688,-14.53,-63399.78,68116.64,4716.86
1946-10-09,14.12,-0.41,-2.82,31.86,-55.68,True,1,4689,-14.12,-63413.9,66208.68,2794.78
1946-10-10,14.33,0.21,1.49,31.86,-55.02,True,1,4690,-14.33,-63428.23,67207.7,3779.47
1946-10-11,14.63,0.3,2.09,31.86,-54.08,True,1,4691,-14.63,-63442.86,68629.33,5186.47
1946-10-14,14.71,0.08,0.55,31.86,-53.83,True,1,4692,-14.71,-63457.57,69019.32,5561.75
1946-10-15,15.3,0.59,4.01,31.86,-51.98,True,1,4693,-15.3,-63472.87,71802.9,8330.03
1946-10-16,15.24,-0.06,-0.39,31.86,-52.17,True,1,4694,-15.24,-63488.11,71536.56,8048.45
1946-10-17,15.01,-0.23,-1.51,31.86,-52.89,True,1,4695,-15.01,-63503.12,70471.95,6968.83
1946-10-18,14.97,-0.04,-0.27,31.86,-53.01,True,1,4696,-14.97,-63518.09,70299.12,6781.03
1946-10-21,15.0,0.03,0.2,31.86,-52.92,True,1,4697,-15.0,-63533.09,70455.0,6921.91
1946-10-22,14.88,-0.12,-0.8,31.86,-53.3,True,1,4698,-14.88,-63547.97,69906.24,6358.27
1946-10-23,14.77,-0.11,-0.74,31.86,-53.64,True,1,4699,-14.77,-63562.74,69404.23,5841.49
1946-10-24,14.78,0.01,0.07,31.86,-53.61,True,1,4700,-14.78,-63577.52,69466.0,5888.48
1946-10-25,14.7,-0.08,-0.54,31.86,-53.86,True,1,4701,-14.7,-63592.22,69104.7,5512.48
1946-10-28,14.39,-0.31,-2.11,31.86,-54.83,True,1,4702,-14.39,-63606.61,67661.78,4055.17
1946-10-29,14.26,-0.13,-0.9,31.86,-55.24,True,1,4703,-14.26,-63620.87,67064.78,3443.91
1946-10-30,14.32,0.06,0.42,31.86,-55.05,True,1,4704,-14.32,-63635.19,67361.28,3726.09
1946-10-31,14.84,0.52,3.63,31.86,-53.42,True,1,4705,-14.84,-63650.03,69822.2,6172.17
1946-11-01,15.07,0.23,1.55,31.86,-52.7,True,1,4706,-15.07,-63665.1,70919.42,7254.32
1946-11-04,15.33,0.26,1.72,31.86,-51.88,True,1,4707,-15.33,-63680.43,72158.31,8477.88
1946-11-06,14.67,-0.66,-4.3,31.86,-53.96,True,1,4708,-14.67,-63695.1,69066.36,5371.26
1946-11-07,14.79,0.12,0.82,31.86,-53.58,True,1,4709,-14.79,-63709.89,69646.11,5936.22
1946-11-08,14.85,0.06,0.41,31.86,-53.39,True,1,4710,-14.85,-63724.74,69943.5,6218.76
1946-11-12,14.94,0.09,0.61,31.86,-53.11,True,1,4711,-14.94,-63739.68,70382.34,6642.66
1946-11-13,14.81,-0.13,-0.87,31.86,-53.52,True,1,4712,-14.81,-63754.49,69784.72,6030.23
1946-11-14,14.89,0.08,0.54,31.86,-53.26,True,1,4713,-14.89,-63769.38,70176.57,6407.19
1946-11-15,14.73,-0.16,-1.08,31.86,-53.77,True,1,4714,-14.73,-63784.11,69437.22,5653.11
1946-11-18,14.58,-0.15,-1.02,31.86,-54.24,True,1,4715,-14.58,-63798.69,68744.7,4946.01
1946-11-19,14.57,-0.01,-0.07,31.86,-54.27,True,1,4716,-14.57,-63813.26,68712.12,4898.86
1946-11-20,14.46,-0.11,-0.76,31.86,-54.61,True,1,4717,-14.46,-63827.72,68207.82,4380.1
1946-11-21,14.21,-0.25,-1.73,31.86,-55.4,True,1,4718,-14.21,-63841.93,67042.78,3200.85
1946-11-22,14.13,-0.08,-0.56,31.86,-55.65,True,1,4719,-14.13,-63856.06,66679.47,2823.41
1946-11-25,14.31,0.18,1.27,31.86,-55.08,True,1,4720,-14.31,-63870.37,67543.2,3672.83
1946-11-26,14.45,0.14,0.98,31.86,-54.64,True,1,4721,-14.45,-63884.82,68218.45,4333.63
1946-11-27,14.55,0.1,0.69,31.86,-54.33,True,1,4722,-14.55,-63899.37,68705.1,4805.73
1946-11-29,14.68,0.13,0.89,31.86,-53.92,True,1,4723,-14.68,-63914.05,69333.64,5419.59
1946-12-02,14.44,-0.24,-1.64,31.86,-54.68,True,1,4724,-14.44,-63928.49,68214.56,4286.07
1946-12-03,14.49,0.05,0.35,31.86,-54.52,True,1,4725,-14.49,-63942.98,68465.25,4522.27
1946-12-04,14.72,0.23,1.59,31.86,-53.8,True,1,4726,-14.72,-63957.7,69566.72,5609.02
1946-12-05,14.64,-0.08,-0.54,31.86,-54.05,True,1,4727,-14.64,-63972.34,69203.28,5230.94
1946-12-06,14.7,0.06,0.41,31.86,-53.86,True,1,4728,-14.7,-63987.04,69501.6,5514.56
1946-12-09,15.32,0.62,4.22,31.86,-51.92,True,1,4729,-15.32,-64002.36,72448.28,8445.92
1946-12-10,15.32,0.0,0.0,31.86,-51.92,True,1,4730,-15.32,-64017.68,72463.6,8445.92
1946-12-11,15.36,0.04,0.26,31.86,-51.79,True,1,4731,-15.36,-64033.04,72668.16,8635.12
1946-12-12,15.15,-0.21,-1.37,31.86,-52.45,True,1,4732,-15.15,-64048.19,71689.8,7641.61
1946-12-13,15.17,0.02,0.13,31.86,-52.38,True,1,4733,-15.17,-64063.36,71799.61,7736.25
1946-12-16,15.24,0.07,0.46,31.86,-52.17,True,1,4734,-15.24,-64078.6,72146.16,8067.56
1946-12-17,15.18,-0.06,-0.39,31.86,-52.35,True,1,4735,-15.18,-64093.78,71877.3,7783.52
1946-12-18,15.21,0.03,0.2,31.86,-52.26,True,1,4736,-15.21,-64108.99,72034.56,7925.57
1946-12-19,15.45,0.24,1.58,31.86,-51.51,True,1,4737,-15.45,-64124.44,73186.65,9062.21
1946-12-20,15.5,0.05,0.32,31.86,-51.35,True,1,4738,-15.5,-64139.94,73439.0,9299.06
1946-12-23,15.41,-0.09,-0.58,31.86,-51.63,True,1,4739,-15.41,-64155.35,73027.99,8872.64
1946-12-24,15.37,-0.04,-0.26,31.86,-51.76,True,1,4740,-15.37,-64170.72,72853.8,8683.08
1946-12-26,15.21,-0.16,-1.04,31.86,-52.26,True,1,4741,-15.21,-64185.93,72110.61,7924.68
1946-12-27,15.19,-0.02,-0.13,31.86,-52.32,True,1,4742,-15.19,-64201.12,72030.98,7829.86
1946-12-30,15.17,-0.02,-0.13,31.86,-52.38,True,1,4743,-15.17,-64216.29,71951.31,7735.02
1946-12-31,15.3,0.13,0.86,31.86,-51.98,True,1,4744,-15.3,-64231.59,72583.2,8351.61
1947-01-02,15.2,-0.1,-0.65,31.86,-52.29,True,1,4745,-15.2,-64246.79,72124.0,7877.21
1947-01-03,15.26,0.06,0.4,31.86,-52.1,True,1,4746,-15.26,-64262.05,72423.96,8161.91
1947-01-06,15.44,0.18,1.18,31.86,-51.54,True,1,4747,-15.44,-64277.49,73293.68,9016.19
1947-01-07,15.32,-0.12,-0.78,31.86,-51.92,True,1,4748,-15.32,-64292.81,72739.36,8446.55
1947-01-08,15.41,0.09,0.59,31.86,-51.63,True,1,4749,-15.41,-64308.22,73182.09,8873.87
1947-01-09,15.44,0.03,0.2,31.86,-51.54,True,1,4750,-15.44,-64323.66,73340.0,9016.34
1947-01-10,15.24,-0.2,-1.3,31.86,-52.17,True,1,4751,-15.24,-64338.9,72405.24,8066.34
1947-01-13,14.8,-0.44,-2.89,31.86,-53.55,True,1,4752,-14.8,-64353.7,70329.6,5975.9
1947-01-14,14.87,0.07,0.47,31.86,-53.33,True,1,4753,-14.87,-64368.57,70677.11,6308.54
1947-01-15,14.77,-0.1,-0.67,31.86,-53.64,True,1,4754,-14.77,-64383.34,70216.58,5833.24
1947-01-16,14.78,0.01,0.07,31.86,-53.61,True,1,4755,-14.78,-64398.12,70278.9,5880.78
1947-01-17,15.07,0.29,1.96,31.86,-52.7,True,1,4756,-15.07,-64413.19,71672.92,7259.73
1947-01-20,15.02,-0.05,-0.33,31.86,-52.86,True,1,4757,-15.02,-64428.21,71450.14,7021.93
1947-01-21,14.97,-0.05,-0.33,31.86,-53.01,True,1,4758,-14.97,-64443.18,71227.26,6784.08
1947-01-22,15.04,0.07,0.47,31.86,-52.79,True,1,4759,-15.04,-64458.22,71575.36,7117.14
1947-01-23,15.19,0.15,1.0,31.86,-52.32,True,1,4760,-15.19,-64473.41,72304.4,7830.99
1947-01-24,15.21,0.02,0.13,31.86,-52.26,True,1,4761,-15.21,-64488.62,72414.81,7926.19
1947-01-27,15.34,0.13,0.86,31.86,-51.85,True,1,4762,-15.34,-64503.96,73049.08,8545.12
1947-01-28,15.47,0.13,0.85,31.86,-51.44,True,1,4763,-15.47,-64519.43,73683.61,9164.18
1947-01-29,15.65,0.18,1.16,31.86,-50.88,True,1,4764,-15.65,-64535.08,74556.6,10021.52
1947-01-30,15.6,-0.05,-0.32,31.86,-51.04,True,1,4765,-15.6,-64550.68,74334.0,9783.32
1947-01-31,15.66,0.06,0.38,31.86,-50.85,True,1,4766,-15.66,-64566.34,74635.56,10069.22
1947-02-03,15.8,0.14,0.89,31.86,-50.41,True,1,4767,-15.8,-64582.14,75318.6,10736.46
1947-02-04,15.83,0.03,0.19,31.86,-50.31,True,1,4768,-15.83,-64597.97,75477.44,10879.47
1947-02-05,15.92,0.09,0.57,31.86,-50.03,True,1,4769,-15.92,-64613.89,75922.48,11308.59
1947-02-06,15.86,-0.06,-0.38,31.86,-50.22,True,1,4770,-15.86,-64629.75,75652.2,11022.45
1947-02-07,16.12,0.26,1.64,31.86,-49.4,True,1,4771,-16.12,-64645.87,76908.52,12262.65
1947-02-10,16.05,-0.07,-0.43,31.86,-49.62,True,1,4772,-16.05,-64661.92,76590.6,11928.68
1947-02-11,16.14,0.09,0.56,31.86,-49.34,True,1,4773,-16.14,-64678.06,77036.22,12358.16
1947-02-13,15.93,-0.21,-1.3,31.86,-50.0,True,1,4774,-15.93,-64693.99,76049.82,11355.83
1947-02-14,15.86,-0.07,-0.44,31.86,-50.22,True,1,4775,-15.86,-64709.85,75731.5,11021.65
1947-02-17,15.88,0.02,0.13,31.86,-50.16,True,1,4776,-15.88,-64725.73,75842.88,11117.15
1947-02-18,15.88,0.0,0.0,31.86,-50.16,True,1,4777,-15.88,-64741.61,75858.76,11117.15
1947-02-19,15.69,-0.19,-1.2,31.86,-50.75,True,1,4778,-15.69,-64757.3,74966.82,10209.52
1947-02-20,15.72,0.03,0.19,31.86,-50.66,True,1,4779,-15.72,-64773.02,75125.88,10352.86
1947-02-21,15.8,0.08,0.51,31.86,-50.41,True,1,4780,-15.8,-64788.82,75524.0,10735.18
1947-02-24,15.67,-0.13,-0.82,31.86,-50.82,True,1,4781,-15.67,-64804.49,74918.27,10113.78
1947-02-25,15.47,-0.2,-1.28,31.86,-51.44,True,1,4782,-15.47,-64819.96,73977.54,9157.58
1947-02-26,15.3,-0.17,-1.1,31.86,-51.98,True,1,4783,-15.3,-64835.26,73179.9,8344.64
1947-02-27,15.48,0.18,1.18,31.86,-51.41,True,1,4784,-15.48,-64850.74,74056.32,9205.58
1947-02-28,15.43,-0.05,-0.32,31.86,-51.57,True,1,4785,-15.43,-64866.17,73832.55,8966.38
1947-03-03,15.41,-0.02,-0.13,31.86,-51.63,True,1,4786,-15.41,-64881.58,73752.26,8870.68
1947-03-04,15.41,0.0,0.0,31.86,-51.63,True,1,4787,-15.41,-64896.99,73767.67,8870.68
1947-03-05,15.59,0.18,1.17,31.86,-51.07,True,1,4788,-15.59,-64912.58,74644.92,9732.34
1947-03-06,15.65,0.06,0.38,31.86,-50.88,True,1,4789,-15.65,-64928.23,74947.85,10019.62
1947-03-07,15.16,-0.49,-3.13,31.86,-52.42,True,1,4790,-15.16,-64943.39,72616.4,7673.01
1947-03-10,15.01,-0.15,-0.99,31.86,-52.89,True,1,4791,-15.01,-64958.4,71912.91,6954.51
1947-03-11,14.88,-0.13,-0.87,31.86,-53.3,True,1,4792,-14.88,-64973.28,71304.96,6331.68
1947-03-12,14.97,0.09,0.6,31.86,-53.01,True,1,4793,-14.97,-64988.25,71751.21,6762.96
1947-03-13,14.93,-0.04,-0.27,31.86,-53.14,True,1,4794,-14.93,-65003.18,71574.42,6571.24
1947-03-14,14.78,-0.15,-1.0,31.86,-53.61,True,1,4795,-14.78,-65017.96,70870.1,5852.14
1947-03-17,14.82,0.04,0.27,31.86,-53.48,True,1,4796,-14.82,-65032.78,71076.72,6043.94
1947-03-18,15.01,0.19,1.28,31.86,-52.89,True,1,4797,-15.01,-65047.79,72002.97,6955.18
1947-03-19,15.08,0.07,0.47,31.86,-52.67,True,1,4798,-15.08,-65062.87,72353.84,7290.97
1947-03-20,15.07,-0.01,-0.07,31.86,-52.7,True,1,4799,-15.07,-65077.94,72320.93,7242.99
1947-03-21,15.25,0.18,1.19,31.86,-52.13,True,1,4800,-15.25,-65093.19,73200.0,8106.81
1947-03-24,15.11,-0.14,-0.92,31.86,-52.57,True,1,4801,-15.11,-65108.3,72543.11,7434.81
1947-03-25,15.02,-0.09,-0.6,31.86,-52.86,True,1,4802,-15.02,-65123.32,72126.04,7002.72
1947-03-26,15.23,0.21,1.4,31.86,-52.2,True,1,4803,-15.23,-65138.55,73149.69,8011.14
1947-03-27,15.4,0.17,1.12,31.86,-51.66,True,1,4804,-15.4,-65153.95,73981.6,8827.65
1947-03-28,15.33,-0.07,-0.46,31.86,-51.88,True,1,4805,-15.33,-65169.28,73660.65,8491.37
1947-03-31,15.17,-0.16,-1.04,31.86,-52.38,True,1,4806,-15.17,-65184.45,72907.02,7722.57
1947-04-01,15.23,0.06,0.4,31.86,-52.2,True,1,4807,-15.23,-65199.68,73210.61,8010.93
1947-04-02,15.22,-0.01,-0.07,31.86,-52.23,True,1,4808,-15.22,-65214.9,73177.76,7962.86
1947-04-03,15.18,-0.04,-0.26,31.86,-52.35,True,1,4809,-15.18,-65230.08,73000.62,7770.54
1947-04-07,15.05,-0.13,-0.86,31.86,-52.76,True,1,4810,-15.05,-65245.13,72390.5,7145.37
1947-04-08,14.83,-0.22,-1.46,31.86,-53.45,True,1,4811,-14.83,-65259.96,71347.13,6087.17
1947-04-09,14.82,-0.01,-0.07,31.86,-53.48,True,1,4812,-14.82,-65274.78,71313.84,6039.06
1947-04-10,14.83,0.01,0.07,31.86,-53.45,True,1,4813,-14.83,-65289.61,71376.79,6087.18
1947-04-11,14.72,-0.11,-0.74,31.86,-53.8,True,1,4814,-14.72,-65304.33,70862.08,5557.75
1947-04-14,14.14,-0.58,-3.94,31.86,-55.62,True,1,4815,-14.14,-65318.47,68084.1,2765.63
1947-04-15,14.15,0.01,0.07,31.86,-55.59,True,1,4816,-14.15,-65332.62,68146.4,2813.78
1947-04-16,14.29,0.14,0.99,31.86,-55.15,True,1,4817,-14.29,-65346.91,68834.93,3488.02
1947-04-17,14.27,-0.02,-0.14,31.86,-55.21,True,1,4818,-14.27,-65361.18,68752.86,3391.68
1947-04-18,14.09,-0.18,-1.26,31.86,-55.78,True,1,4819,-14.09,-65375.27,67899.71,2524.44
1947-04-21,14.45,0.36,2.56,31.86,-54.64,True,1,4820,-14.45,-65389.72,69649.0,4259.28
1947-04-22,14.56,0.11,0.76,31.86,-54.3,True,1,4821,-14.56,-65404.28,70193.76,4789.48
1947-04-23,14.58,0.02,0.14,31.86,-54.24,True,1,4822,-14.58,-65418.86,70304.76,4885.9
1947-04-24,14.49,-0.09,-0.62,31.86,-54.52,True,1,4823,-14.49,-65433.35,69885.27,4451.92
1947-04-25,14.39,-0.1,-0.69,31.86,-54.83,True,1,4824,-14.39,-65447.74,69417.36,3969.62
1947-04-28,14.37,-0.02,-0.14,31.86,-54.9,True,1,4825,-14.37,-65462.11,69335.25,3873.14
1947-04-29,14.4,0.03,0.21,31.86,-54.8,True,1,4826,-14.4,-65476.51,69494.4,4017.89
1947-04-30,14.58,0.18,1.25,31.86,-54.24,True,1,4827,-14.58,-65491.09,70377.66,4886.57
1947-05-01,14.69,0.11,0.75,31.86,-53.89,True,1,4828,-14.69,-65505.78,70923.32,5417.54
1947-05-02,14.79,0.1,0.68,31.86,-53.58,True,1,4829,-14.79,-65520.57,71420.91,5900.34
1947-05-05,14.85,0.06,0.41,31.86,-53.39,True,1,4830,-14.85,-65535.42,71725.5,6190.08
1947-05-06,14.69,-0.16,-1.08,31.86,-53.89,True,1,4831,-14.69,-65550.11,70967.39,5417.28
1947-05-07,14.68,-0.01,-0.07,31.86,-53.92,True,1,4832,-14.68,-65564.79,70933.76,5368.97
1947-05-08,14.6,-0.08,-0.55,31.86,-54.18,True,1,4833,-14.6,-65579.39,70561.8,4982.41
1947-05-09,14.63,0.03,0.2,31.86,-54.08,True,1,4834,-14.63,-65594.02,70721.42,5127.4
1947-05-12,14.46,-0.17,-1.16,31.86,-54.61,True,1,4835,-14.46,-65608.48,69914.1,4305.62
1947-05-13,14.15,-0.31,-2.14,31.86,-55.59,True,1,4836,-14.15,-65622.63,68429.4,2806.77
1947-05-14,14.11,-0.04,-0.28,31.86,-55.71,True,1,4837,-14.11,-65636.74,68250.07,2613.33
1947-05-15,14.24,0.13,0.92,31.86,-55.3,True,1,4838,-14.24,-65650.98,68893.12,3242.14
1947-05-16,13.96,-0.28,-1.97,31.86,-56.18,True,1,4839,-13.96,-65664.94,67552.44,1887.5
1947-05-19,13.77,-0.19,-1.36,31.86,-56.78,True,1,4840,-13.77,-65678.71,66646.8,968.09
1947-05-20,13.83,0.06,0.44,31.86,-56.59,True,1,4841,-13.83,-65692.54,66951.03,1258.49
1947-05-21,14.09,0.26,1.88,31.86,-55.78,True,1,4842,-14.09,-65706.63,68223.78,2517.15
1947-05-22,14.19,0.1,0.71,31.86,-55.46,True,1,4843,-14.19,-65720.82,68722.17,3001.35
1947-05-23,14.0,-0.19,-1.34,31.86,-56.06,True,1,4844,-14.0,-65734.82,67816.0,2081.18
1947-05-26,14.14,0.14,1.0,31.86,-55.62,True,1,4845,-14.14,-65748.96,68508.3,2759.34
1947-05-27,14.12,-0.02,-0.14,31.86,-55.68,True,1,4846,-14.12,-65763.08,68425.52,2662.44
1947-05-28,14.34,0.22,1.56,31.86,-54.99,True,1,4847,-14.34,-65777.42,69505.98,3728.56
1947-05-29,14.45,0.11,0.77,31.86,-54.64,True,1,4848,-14.45,-65791.87,70053.6,4261.73
1947-06-02,14.3,-0.15,-1.04,31.86,-55.12,True,1,4849,-14.3,-65806.17,69340.7,3534.53
1947-06-03,14.5,0.2,1.4,31.86,-54.49,True,1,4850,-14.5,-65820.67,70325.0,4504.33
1947-06-04,14.4,-0.1,-0.69,31.86,-54.8,True,1,4851,-14.4,-65835.07,69854.4,4019.33
1947-06-05,14.39,-0.01,-0.07,31.86,-54.83,True,1,4852,-14.39,-65849.46,69820.28,3970.82
1947-06-06,14.5,0.11,0.76,31.86,-54.49,True,1,4853,-14.5,-65863.96,70368.5,4504.54
1947-06-09,14.42,-0.08,-0.55,31.86,-54.74,True,1,4854,-14.42,-65878.38,69994.68,4116.3
1947-06-10,14.56,0.14,0.97,31.86,-54.3,True,1,4855,-14.56,-65892.94,70688.8,4795.86
1947-06-11,14.9,0.34,2.34,31.86,-53.23,True,1,4856,-14.9,-65907.84,72354.4,6446.56
1947-06-12,14.82,-0.08,-0.54,31.86,-53.48,True,1,4857,-14.82,-65922.66,71980.74,6058.08
1947-06-13,14.98,0.16,1.08,31.86,-52.98,True,1,4858,-14.98,-65937.64,72772.84,6835.2
1947-06-16,15.02,0.04,0.27,31.86,-52.86,True,1,4859,-15.02,-65952.66,72982.18,7029.52
1947-06-17,14.96,-0.06,-0.4,31.86,-53.04,True,1,4860,-14.96,-65967.62,72705.6,6737.98
1947-06-18,14.96,0.0,0.0,31.86,-53.04,True,1,4861,-14.96,-65982.58,72720.56,6737.98
1947-06-19,15.14,0.18,1.2,31.86,-52.48,True,1,4862,-15.14,-65997.72,73610.68,7612.96
1947-06-20,15.16,0.02,0.13,31.86,-52.42,True,1,4863,-15.16,-66012.88,73723.08,7710.2
1947-06-23,15.24,0.08,0.53,31.86,-52.17,True,1,4864,-15.24,-66028.12,74127.36,8099.24
1947-06-24,14.94,-0.3,-1.97,31.86,-53.11,True,1,4865,-14.94,-66043.06,72683.1,6640.04
1947-06-25,15.06,0.12,0.8,31.86,-52.73,True,1,4866,-15.06,-66058.12,73281.96,7223.84
1947-06-26,15.12,0.06,0.4,31.86,-52.54,True,1,4867,-15.12,-66073.24,73589.04,7515.8
1947-06-27,15.12,0.0,0.0,31.86,-52.54,True,1,4868,-15.12,-66088.36,73604.16,7515.8
1947-06-30,15.21,0.09,0.6,31.86,-52.26,True,1,4869,-15.21,-66103.57,74057.49,7953.92
1947-07-01,15.46,0.25,1.64,31.86,-51.48,True,1,4870,-15.46,-66119.03,75290.2,9171.17
1947-07-02,15.44,-0.02,-0.13,31.86,-51.54,True,1,4871,-15.44,-66134.47,75208.24,9073.77
1947-07-03,15.6,0.16,1.04,31.86,-51.04,True,1,4872,-15.6,-66150.07,76003.2,9853.13
1947-07-07,15.61,0.01,0.06,31.86,-51.0,True,1,4873,-15.61,-66165.68,76067.53,9901.85
1947-07-08,15.67,0.06,0.38,31.86,-50.82,True,1,4874,-15.67,-66181.35,76375.58,10194.23
1947-07-09,15.52,-0.15,-0.96,31.86,-51.29,True,1,4875,-15.52,-66196.87,75660.0,9463.13
1947-07-10,15.68,0.16,1.03,31.86,-50.78,True,1,4876,-15.68,-66212.55,76455.68,10243.13
1947-07-11,15.87,0.19,1.21,31.86,-50.19,True,1,4877,-15.87,-66228.42,77397.99,11169.57
1947-07-14,15.96,0.09,0.57,31.86,-49.91,True,1,4878,-15.96,-66244.38,77852.88,11608.5
1947-07-15,15.93,-0.03,-0.19,31.86,-50.0,True,1,4879,-15.93,-66260.31,77722.47,11462.16
1947-07-16,15.92,-0.01,-0.06,31.86,-50.03,True,1,4880,-15.92,-66276.23,77689.6,11413.37
1947-07-17,15.75,-0.17,-1.07,31.86,-50.56,True,1,4881,-15.75,-66291.98,76875.75,10583.77
1947-07-18,15.85,0.1,0.64,31.86,-50.25,True,1,4882,-15.85,-66307.83,77379.7,11071.87
1947-07-21,15.8,-0.05,-0.32,31.86,-50.41,True,1,4883,-15.8,-66323.63,77151.4,10827.77
1947-07-22,15.87,0.07,0.44,31.86,-50.19,True,1,4884,-15.87,-66339.5,77509.08,11169.58
1947-07-23,15.95,0.08,0.5,31.86,-49.94,True,1,4885,-15.95,-66355.45,77915.75,11560.3
1947-07-24,16.12,0.17,1.07,31.86,-49.4,True,1,4886,-16.12,-66371.57,78762.32,12390.75
1947-07-25,16.08,-0.04,-0.25,31.86,-49.53,True,1,4887,-16.08,-66387.65,78582.96,12195.31
1947-07-28,15.94,-0.14,-0.87,31.86,-49.97,True,1,4888,-15.94,-66403.59,77914.72,11511.13
1947-07-29,15.59,-0.35,-2.2,31.86,-51.07,True,1,4889,-15.59,-66419.18,76219.51,9800.33
1947-07-30,15.52,-0.07,-0.45,31.86,-51.29,True,1,4890,-15.52,-66434.7,75892.8,9458.1
1947-07-31,15.76,0.24,1.55,31.86,-50.53,True,1,4891,-15.76,-66450.46,77082.16,10631.7
1947-08-01,15.8,0.04,0.25,31.86,-50.41,True,1,4892,-15.8,-66466.26,77293.6,10827.34
1947-08-04,15.62,-0.18,-1.14,31.86,-50.97,True,1,4893,-15.62,-66481.88,76428.66,9946.78
1947-08-05,15.67,0.05,0.32,31.86,-50.82,True,1,4894,-15.67,-66497.55,76688.98,10191.43
1947-08-06,15.62,-0.05,-0.32,31.86,-50.97,True,1,4895,-15.62,-66513.17,76459.9,9946.73
1947-08-07,15.64,0.02,0.13,31.86,-50.91,True,1,4896,-15.64,-66528.81,76573.44,10044.63
1947-08-08,15.43,-0.21,-1.34,31.86,-51.57,True,1,4897,-15.43,-66544.24,75560.71,9016.47
1947-08-11,15.33,-0.1,-0.65,31.86,-51.88,True,1,4898,-15.33,-66559.57,75086.34,8526.77
1947-08-12,15.43,0.1,0.65,31.86,-51.57,True,1,4899,-15.43,-66575.0,75591.57,9016.57
1947-08-13,15.52,0.09,0.58,31.86,-51.29,True,1,4900,-15.52,-66590.52,76048.0,9457.48
1947-08-14,15.47,-0.05,-0.32,31.86,-51.44,True,1,4901,-15.47,-66605.99,75818.47,9212.48
1947-08-15,15.58,0.11,0.71,31.86,-51.1,True,1,4902,-15.58,-66621.57,76373.16,9751.59
1947-08-18,15.5,-0.08,-0.51,31.86,-51.35,True,1,4903,-15.5,-66637.07,75996.5,9359.43
1947-08-19,15.46,-0.04,-0.26,31.86,-51.48,True,1,4904,-15.46,-66652.53,75815.84,9163.31
1947-08-20,15.39,-0.07,-0.45,31.86,-51.7,True,1,4905,-15.39,-66667.92,75487.95,8820.03
1947-08-21,15.43,0.04,0.26,31.86,-51.57,True,1,4906,-15.43,-66683.35,75699.58,9016.23
1947-08-22,15.45,0.02,0.13,31.86,-51.51,True,1,4907,-15.45,-66698.8,75813.15,9114.35
1947-08-25,15.23,-0.22,-1.42,31.86,-52.2,True,1,4908,-15.23,-66714.03,74748.84,8034.81
1947-08-26,15.23,0.0,0.0,31.86,-52.2,True,1,4909,-15.23,-66729.26,74764.07,8034.81
1947-08-27,15.25,0.02,0.13,31.86,-52.13,True,1,4910,-15.25,-66744.51,74877.5,8132.99
1947-08-28,15.22,-0.03,-0.2,31.86,-52.23,True,1,4911,-15.22,-66759.73,74745.42,7985.69
1947-08-29,15.32,0.1,0.66,31.86,-51.92,True,1,4912,-15.32,-66775.05,75251.84,8476.79
1947-09-02,15.37,0.05,0.33,31.86,-51.76,True,1,4913,-15.37,-66790.42,75512.81,8722.39
1947-09-03,15.33,-0.04,-0.26,31.86,-51.88,True,1,4914,-15.33,-66805.75,75331.62,8525.87
1947-09-04,15.14,-0.19,-1.24,31.86,-52.48,True,1,4915,-15.14,-66820.89,74413.1,7592.21
1947-09-05,15.1,-0.04,-0.26,31.86,-52.6,True,1,4916,-15.1,-66835.99,74231.6,7395.61
1947-09-08,14.86,-0.24,-1.59,31.86,-53.36,True,1,4917,-14.86,-66850.85,73066.62,6215.77
1947-09-09,14.89,0.03,0.2,31.86,-53.26,True,1,4918,-14.89,-66865.74,73229.02,6363.28
1947-09-10,15.03,0.14,0.94,31.86,-52.82,True,1,4919,-15.03,-66880.77,73932.57,7051.8
1947-09-11,15.04,0.01,0.07,31.86,-52.79,True,1,4920,-15.04,-66895.81,73996.8,7100.99
1947-09-12,14.99,-0.05,-0.33,31.86,-52.95,True,1,4921,-14.99,-66910.8,73765.79,6854.99
1947-09-15,14.93,-0.06,-0.4,31.86,-53.14,True,1,4922,-14.93,-66925.73,73485.46,6559.73
1947-09-16,15.07,0.14,0.94,31.86,-52.7,True,1,4923,-15.07,-66940.8,74189.61,7248.81
1947-09-17,15.27,0.2,1.33,31.86,-52.07,True,1,4924,-15.27,-66956.07,75189.48,8233.41
1947-09-18,15.21,-0.06,-0.39,31.86,-52.26,True,1,4925,-15.21,-66971.28,74909.25,7937.97
1947-09-19,15.2,-0.01,-0.07,31.86,-52.29,True,1,4926,-15.2,-66986.48,74875.2,7888.72
1947-09-22,15.18,-0.02,-0.13,31.86,-52.35,True,1,4927,-15.18,-67001.66,74791.86,7790.2
1947-09-23,14.93,-0.25,-1.65,31.86,-53.14,True,1,4928,-14.93,-67016.59,73575.04,6558.45
1947-09-24,14.99,0.06,0.4,31.86,-52.95,True,1,4929,-14.99,-67031.58,73885.71,6854.13
1947-09-25,14.9,-0.09,-0.6,31.86,-53.23,True,1,4930,-14.9,-67046.48,73457.0,6410.52
1947-09-26,14.85,-0.05,-0.34,31.86,-53.39,True,1,4931,-14.85,-67061.33,73225.35,6164.02
1947-09-29,14.94,0.09,0.61,31.86,-53.11,True,1,4932,-14.94,-67076.27,73684.08,6607.81
1947-09-30,15.11,0.17,1.14,31.86,-52.57,True,1,4933,-15.11,-67091.38,74537.63,7446.25
1947-10-01,15.16,0.05,0.33,31.86,-52.42,True,1,4934,-15.16,-67106.54,74799.44,7692.9
1947-10-02,15.17,0.01,0.07,31.86,-52.38,True,1,4935,-15.17,-67121.71,74863.95,7742.24
1947-10-03,15.24,0.07,0.46,31.86,-52.17,True,1,4936,-15.24,-67136.95,75224.64,8087.69
1947-10-06,15.28,0.04,0.26,31.86,-52.04,True,1,4937,-15.28,-67152.23,75437.36,8285.13
1947-10-07,15.28,0.0,0.0,31.86,-52.04,True,1,4938,-15.28,-67167.51,75452.64,8285.13
1947-10-08,15.16,-0.12,-0.78,31.86,-52.42,True,1,4939,-15.16,-67182.67,74875.24,7692.57
1947-10-09,15.26,0.1,0.66,31.86,-52.1,True,1,4940,-15.26,-67197.93,75384.4,8186.47
1947-10-10,15.29,0.03,0.2,31.86,-52.01,True,1,4941,-15.29,-67213.22,75547.89,8334.67
1947-10-14,15.55,0.26,1.7,31.86,-51.19,True,1,4942,-15.55,-67228.77,76848.1,9619.33
1947-10-15,15.59,0.04,0.26,31.86,-51.07,True,1,4943,-15.59,-67244.36,77061.37,9817.01
1947-10-16,15.57,-0.02,-0.13,31.86,-51.13,True,1,4944,-15.57,-67259.93,76978.08,9718.15
1947-10-17,15.58,0.01,0.06,31.86,-51.1,True,1,4945,-15.58,-67275.51,77043.1,9767.59
1947-10-20,15.79,0.21,1.35,31.86,-50.44,True,1,4946,-15.79,-67291.3,78097.34,10806.04
1947-10-21,15.76,-0.03,-0.19,31.86,-50.53,True,1,4947,-15.76,-67307.06,77964.72,10657.66
1947-10-22,15.69,-0.07,-0.44,31.86,-50.75,True,1,4948,-15.69,-67322.75,77634.12,10311.37
1947-10-23,15.7,0.01,0.06,31.86,-50.72,True,1,4949,-15.7,-67338.45,77699.3,10360.85
1947-10-24,15.5,-0.2,-1.27,31.86,-51.35,True,1,4950,-15.5,-67353.95,76725.0,9371.05
1947-10-27,15.53,0.03,0.19,31.86,-51.26,True,1,4951,-15.53,-67369.48,76889.03,9519.55
1947-10-28,15.54,0.01,0.06,31.86,-51.22,True,1,4952,-15.54,-67385.02,76954.08,9569.06
1947-10-29,15.49,-0.05,-0.32,31.86,-51.38,True,1,4953,-15.49,-67400.51,76721.97,9321.46
1947-10-30,15.33,-0.16,-1.03,31.86,-51.88,True,1,4954,-15.33,-67415.84,75944.82,8528.98
1947-10-31,15.43,0.1,0.65,31.86,-51.57,True,1,4955,-15.43,-67431.27,76455.65,9024.38
1947-11-03,15.46,0.03,0.19,31.86,-51.48,True,1,4956,-15.46,-67446.73,76619.76,9173.03
1947-11-05,15.34,-0.12,-0.78,31.86,-51.85,True,1,4957,-15.34,-67462.07,76040.38,8578.31
1947-11-06,15.34,0.0,0.0,31.86,-51.85,True,1,4958,-15.34,-67477.41,76055.72,8578.31
1947-11-07,15.31,-0.03,-0.2,31.86,-51.95,True,1,4959,-15.31,-67492.72,75922.29,8429.57
1947-11-10,15.37,0.06,0.39,31.86,-51.76,True,1,4960,-15.37,-67508.09,76235.2,8727.11
1947-11-12,15.31,-0.06,-0.39,31.86,-51.95,True,1,4961,-15.31,-67523.4,75952.91,8429.51
1947-11-13,15.16,-0.15,-0.98,31.86,-52.42,True,1,4962,-15.16,-67538.56,75223.92,7685.36
1947-11-14,15.19,0.03,0.2,31.86,-52.32,True,1,4963,-15.19,-67553.75,75387.97,7834.22
1947-11-17,15.19,0.0,0.0,31.86,-52.32,True,1,4964,-15.19,-67568.94,75403.16,7834.22
1947-11-18,15.3,0.11,0.72,31.86,-51.98,True,1,4965,-15.3,-67584.24,75964.5,8380.26
1947-11-19,15.34,0.04,0.26,31.86,-51.85,True,1,4966,-15.34,-67599.58,76178.44,8578.86
1947-11-20,15.41,0.07,0.46,31.86,-51.63,True,1,4967,-15.41,-67614.99,76541.47,8926.48
1947-11-21,15.33,-0.08,-0.52,31.86,-51.88,True,1,4968,-15.33,-67630.32,76159.44,8529.12
1947-11-24,15.24,-0.09,-0.59,31.86,-52.17,True,1,4969,-15.24,-67645.56,75727.56,8082.0
1947-11-25,15.2,-0.04,-0.26,31.86,-52.29,True,1,4970,-15.2,-67660.76,75544.0,7883.24
1947-11-26,15.13,-0.07,-0.46,31.86,-52.51,True,1,4971,-15.13,-67675.89,75211.23,7535.34
1947-11-28,14.98,-0.15,-0.99,31.86,-52.98,True,1,4972,-14.98,-67690.87,74480.56,6789.69
1947-12-01,15.07,0.09,0.6,31.86,-52.7,True,1,4973,-15.07,-67705.94,74943.11,7237.17
1947-12-02,15.09,0.02,0.13,31.86,-52.64,True,1,4974,-15.09,-67721.03,75057.66,7336.63
1947-12-03,14.95,-0.14,-0.93,31.86,-53.08,True,1,4975,-14.95,-67735.98,74376.25,6640.27
1947-12-04,14.86,-0.09,-0.6,31.86,-53.36,True,1,4976,-14.86,-67750.84,73943.36,6192.52
1947-12-05,14.63,-0.23,-1.55,31.86,-54.08,True,1,4977,-14.63,-67765.47,72813.51,5048.04
1947-12-08,14.77,0.14,0.96,31.86,-53.64,True,1,4978,-14.77,-67780.24,73525.06,5744.82
1947-12-09,14.82,0.05,0.34,31.86,-53.48,True,1,4979,-14.82,-67795.06,73788.78,5993.72
1947-12-10,14.84,0.02,0.14,31.86,-53.42,True,1,4980,-14.84,-67809.9,73903.2,6093.3
1947-12-11,14.83,-0.01,-0.07,31.86,-53.45,True,1,4981,-14.83,-67824.73,73868.23,6043.5
1947-12-12,14.94,0.11,0.74,31.86,-53.11,True,1,4982,-14.94,-67839.67,74431.08,6591.41
1947-12-15,15.11,0.17,1.14,31.86,-52.57,True,1,4983,-15.11,-67854.78,75293.13,7438.35
1947-12-16,15.09,-0.02,-0.13,31.86,-52.64,True,1,4984,-15.09,-67869.87,75208.56,7338.69
1947-12-17,15.12,0.03,0.2,31.86,-52.54,True,1,4985,-15.12,-67884.99,75373.2,7488.21
1947-12-18,15.07,-0.05,-0.33,31.86,-52.7,True,1,4986,-15.07,-67900.06,75139.02,7238.96
1947-12-19,15.12,0.05,0.33,31.86,-52.54,True,1,4987,-15.12,-67915.18,75403.44,7488.26
1947-12-22,15.2,0.08,0.53,31.86,-52.29,True,1,4988,-15.2,-67930.38,75817.6,7887.22
1947-12-23,15.26,0.06,0.4,31.86,-52.1,True,1,4989,-15.26,-67945.64,76132.14,8186.5
1947-12-24,15.25,-0.01,-0.07,31.86,-52.13,True,1,4990,-15.25,-67960.89,76097.5,8136.61
1947-12-26,15.12,-0.13,-0.85,31.86,-52.54,True,1,4991,-15.12,-67976.01,75463.92,7487.91
1947-12-29,15.04,-0.08,-0.53,31.86,-52.79,True,1,4992,-15.04,-67991.05,75079.68,7088.63
1947-12-30,15.22,0.18,1.2,31.86,-52.23,True,1,4993,-15.22,-68006.27,75993.46,7987.19
1947-12-31,15.3,0.08,0.53,31.86,-51.98,True,1,4994,-15.3,-68021.57,76408.2,8386.63
1948-01-02,15.34,0.04,0.26,31.86,-51.85,True,1,4995,-15.34,-68036.91,76623.3,8586.39
1948-01-05,15.2,-0.14,-0.91,31.86,-52.29,True,1,4996,-15.2,-68052.11,75939.2,7887.09
1948-01-06,15.15,-0.05,-0.33,31.86,-52.45,True,1,4997,-15.15,-68067.26,75704.55,7637.29
1948-01-07,15.23,0.08,0.53,31.86,-52.2,True,1,4998,-15.23,-68082.49,76119.54,8037.05
1948-01-08,15.31,0.08,0.52,31.86,-51.95,True,1,4999,-15.31,-68097.8,76534.69,8436.89
1948-01-09,15.23,-0.08,-0.52,31.86,-52.2,True,1,5000,-15.23,-68113.03,76150.0,8036.97
1948-01-12,15.17,-0.06,-0.39,31.86,-52.38,True,1,5001,-15.17,-68128.2,75865.17,7736.97
1948-01-13,14.95,-0.22,-1.45,31.86,-53.08,True,1,5002,-14.95,-68143.15,74779.9,6636.75
1948-01-14,14.95,0.0,0.0,31.86,-53.08,True,1,5003,-14.95,-68158.1,74794.85,6636.75
1948-01-15,14.88,-0.07,-0.47,31.86,-53.3,True,1,5004,-14.88,-68172.98,74459.52,6286.54
1948-01-16,14.87,-0.01,-0.07,31.86,-53.33,True,1,5005,-14.87,-68187.85,74424.35,6236.5
1948-01-19,14.7,-0.17,-1.14,31.86,-53.86,True,1,5006,-14.7,-68202.55,73588.2,5385.65
1948-01-20,14.71,0.01,0.07,31.86,-53.83,True,1,5007,-14.71,-68217.26,73652.97,5435.71
1948-01-21,14.54,-0.17,-1.16,31.86,-54.36,True,1,5008,-14.54,-68231.8,72816.32,4584.52
1948-01-22,14.42,-0.12,-0.82,31.86,-54.74,True,1,5009,-14.42,-68246.22,72229.78,3983.56
1948-01-23,14.35,-0.07,-0.48,31.86,-54.96,True,1,5010,-14.35,-68260.57,71893.5,3632.93
1948-01-26,14.32,-0.03,-0.21,31.86,-55.05,True,1,5011,-14.32,-68274.89,71757.52,3482.63
1948-01-27,14.34,0.02,0.14,31.86,-54.99,True,1,5012,-14.34,-68289.23,71872.08,3582.85
1948-01-28,14.49,0.15,1.05,31.86,-54.52,True,1,5013,-14.49,-68303.72,72638.37,4334.65
1948-01-29,14.65,0.16,1.1,31.86,-54.02,True,1,5014,-14.65,-68318.37,73455.1,5136.73
1948-01-30,14.68,0.03,0.2,31.86,-53.92,True,1,5015,-14.68,-68333.05,73620.2,5287.15
1948-02-02,14.71,0.03,0.2,31.86,-53.83,True,1,5016,-14.71,-68347.76,73785.36,5437.6
1948-02-03,14.62,-0.09,-0.61,31.86,-54.11,True,1,5017,-14.62,-68362.38,73348.54,4986.16
1948-02-04,14.0,-0.62,-4.24,31.86,-56.06,True,1,5018,-14.0,-68376.38,70252.0,1875.62
1948-02-05,14.2,0.2,1.43,31.86,-55.43,True,1,5019,-14.2,-68390.58,71269.8,2879.22
1948-02-06,14.19,-0.01,-0.07,31.86,-55.46,True,1,5020,-14.19,-68404.77,71233.8,2829.03
1948-02-09,14.31,0.12,0.85,31.86,-55.08,True,1,5021,-14.31,-68419.08,71850.51,3431.43
1948-02-10,13.89,-0.42,-2.94,31.86,-56.4,True,1,5022,-13.89,-68432.97,69755.58,1322.61
1948-02-11,13.88,-0.01,-0.07,31.86,-56.43,True,1,5023,-13.88,-68446.85,69719.24,1272.39
1948-02-13,13.85,-0.03,-0.22,31.86,-56.53,True,1,5024,-13.85,-68460.7,69582.4,1121.7
1948-02-16,14.04,0.19,1.37,31.86,-55.93,True,1,5025,-14.04,-68474.74,70551.0,2076.26
1948-02-17,14.04,0.0,0.0,31.86,-55.93,True,1,5026,-14.04,-68488.78,70565.04,2076.26
1948-02-18,14.05,0.01,0.07,31.86,-55.9,True,1,5027,-14.05,-68502.83,70629.35,2126.52
1948-02-19,14.02,-0.03,-0.21,31.86,-56.0,True,1,5028,-14.02,-68516.85,70492.56,1975.71
1948-02-20,13.96,-0.06,-0.43,31.86,-56.18,True,1,5029,-13.96,-68530.81,70204.84,1674.03
1948-02-24,14.0,0.04,0.29,31.86,-56.06,True,1,5030,-14.0,-68544.81,70420.0,1875.19
1948-02-25,14.07,0.07,0.5,31.86,-55.84,True,1,5031,-14.07,-68558.88,70786.17,2227.29
1948-02-26,13.98,-0.09,-0.64,31.86,-56.12,True,1,5032,-13.98,-68572.86,70347.36,1774.5
1948-02-27,13.93,-0.05,-0.36,31.86,-56.28,True,1,5033,-13.93,-68586.79,70109.69,1522.9
1948-03-01,14.07,0.14,1.0,31.86,-55.84,True,1,5034,-14.07,-68600.86,70828.38,2227.52
1948-03-02,14.16,0.09,0.64,31.86,-55.56,True,1,5035,-14.16,-68615.02,71295.6,2680.58
1948-03-03,14.17,0.01,0.07,31.86,-55.52,True,1,5036,-14.17,-68629.19,71360.12,2730.93
1948-03-04,14.08,-0.09,-0.64,31.86,-55.81,True,1,5037,-14.08,-68643.27,70920.96,2277.69
1948-03-05,14.11,0.03,0.21,31.86,-55.71,True,1,5038,-14.11,-68657.38,71086.18,2428.8
1948-03-08,14.04,-0.07,-0.5,31.86,-55.93,True,1,5039,-14.04,-68671.42,70747.56,2076.14
1948-03-09,13.95,-0.09,-0.64,31.86,-56.22,True,1,5040,-13.95,-68685.37,70308.0,1622.63
1948-03-10,14.01,0.06,0.43,31.86,-56.03,True,1,5041,-14.01,-68699.38,70624.41,1925.03
1948-03-11,13.99,-0.02,-0.14,31.86,-56.09,True,1,5042,-13.99,-68713.37,70537.58,1824.21
1948-03-12,13.99,0.0,0.0,31.86,-56.09,True,1,5043,-13.99,-68727.36,70551.57,1824.21
1948-03-15,14.06,0.07,0.5,31.86,-55.87,True,1,5044,-14.06,-68741.42,70918.64,2177.22
1948-03-16,13.84,-0.22,-1.56,31.86,-56.56,True,1,5045,-13.84,-68755.26,69822.8,1067.54
1948-03-17,13.95,0.11,0.8,31.86,-56.22,True,1,5046,-13.95,-68769.21,70391.7,1622.49
1948-03-18,14.03,0.08,0.57,31.86,-55.96,True,1,5047,-14.03,-68783.24,70809.41,2026.17
1948-03-19,14.32,0.29,2.07,31.86,-55.05,True,1,5048,-14.32,-68797.56,72287.36,3489.8
1948-03-22,14.7,0.38,2.65,31.86,-53.86,True,1,5049,-14.7,-68812.26,74220.3,5408.04
1948-03-23,14.7,0.0,0.0,31.86,-53.86,True,1,5050,-14.7,-68826.96,74235.0,5408.04
1948-03-24,14.69,-0.01,-0.07,31.86,-53.89,True,1,5051,-14.69,-68841.65,74199.19,5357.54
1948-03-25,14.75,0.06,0.41,31.86,-53.7,True,1,5052,-14.75,-68856.4,74517.0,5660.6
1948-03-29,14.7,-0.05,-0.34,31.86,-53.86,True,1,5053,-14.7,-68871.1,74279.1,5408.0
1948-03-30,14.87,0.17,1.16,31.86,-53.33,True,1,5054,-14.87,-68885.97,75152.98,6267.01
1948-03-31,15.08,0.21,1.41,31.86,-52.67,True,1,5055,-15.08,-68901.05,76229.4,7328.35
1948-04-01,15.12,0.04,0.26,31.86,-52.54,True,1,5056,-15.12,-68916.17,76446.72,7530.55
1948-04-02,15.15,0.03,0.2,31.86,-52.45,True,1,5057,-15.15,-68931.32,76613.55,7682.23
1948-04-05,15.18,0.03,0.2,31.86,-52.35,True,1,5058,-15.18,-68946.5,76780.44,7833.94
1948-04-06,15.28,0.1,0.66,31.86,-52.04,True,1,5059,-15.28,-68961.78,77301.52,8339.74
1948-04-07,15.23,-0.05,-0.33,31.86,-52.2,True,1,5060,-15.23,-68977.01,77063.8,8086.79
1948-04-08,15.27,0.04,0.26,31.86,-52.07,True,1,5061,-15.27,-68992.28,77281.47,8289.19
1948-04-09,15.29,0.02,0.13,31.86,-52.01,True,1,5062,-15.29,-69007.57,77397.98,8390.41
1948-04-12,15.28,-0.01,-0.06,31.86,-52.04,True,1,5063,-15.28,-69022.85,77362.64,8339.79
1948-04-13,15.3,0.02,0.13,31.86,-51.98,True,1,5064,-15.3,-69038.15,77479.2,8441.05
1948-04-14,15.28,-0.02,-0.13,31.86,-52.04,True,1,5065,-15.28,-69053.43,77393.2,8339.77
1948-04-15,15.38,0.1,0.65,31.86,-51.73,True,1,5066,-15.38,-69068.81,77915.08,8846.27
1948-04-16,15.43,0.05,0.32,31.86,-51.57,True,1,5067,-15.43,-69084.24,78183.81,9099.57
1948-04-19,15.47,0.04,0.26,31.86,-51.44,True,1,5068,-15.47,-69099.71,78401.96,9302.25
1948-04-20,15.46,-0.01,-0.06,31.86,-51.48,True,1,5069,-15.46,-69115.17,78366.74,9251.57
1948-04-21,15.54,0.08,0.52,31.86,-51.22,True,1,5070,-15.54,-69130.71,78787.8,9657.09
1948-04-22,15.68,0.14,0.9,31.86,-50.78,True,1,5071,-15.68,-69146.39,79513.28,10366.89
1948-04-23,15.78,0.1,0.64,31.86,-50.47,True,1,5072,-15.78,-69162.17,80036.16,10873.99
1948-04-26,15.54,-0.24,-1.52,31.86,-51.22,True,1,5073,-15.54,-69177.71,78834.42,9656.71
1948-04-27,15.55,0.01,0.06,31.86,-51.19,True,1,5074,-15.55,-69193.26,78900.7,9707.44
1948-04-28,15.57,0.02,0.13,31.86,-51.13,True,1,5075,-15.57,-69208.83,79017.75,9808.92
1948-04-29,15.52,-0.05,-0.32,31.86,-51.29,True,1,5076,-15.52,-69224.35,78779.52,9555.17
1948-04-30,15.48,-0.04,-0.26,31.86,-51.41,True,1,5077,-15.48,-69239.83,78591.96,9352.13
1948-05-03,15.6,0.12,0.78,31.86,-51.04,True,1,5078,-15.6,-69255.43,79216.8,9961.37
1948-05-04,15.59,-0.01,-0.06,31.86,-51.07,True,1,5079,-15.59,-69271.02,79181.61,9910.59
1948-05-05,15.5,-0.09,-0.58,31.86,-51.35,True,1,5080,-15.5,-69286.52,78740.0,9453.48
1948-05-06,15.63,0.13,0.84,31.86,-50.94,True,1,5081,-15.63,-69302.15,79416.03,10113.88
1948-05-07,15.72,0.09,0.58,31.86,-50.66,True,1,5082,-15.72,-69317.87,79889.04,10571.17
1948-05-10,15.81,0.09,0.57,31.86,-50.38,True,1,5083,-15.81,-69333.68,80362.23,11028.55
1948-05-11,15.86,0.05,0.32,31.86,-50.22,True,1,5084,-15.86,-69349.54,80632.24,11282.7
1948-05-12,15.88,0.02,0.13,31.86,-50.16,True,1,5085,-15.88,-69365.42,80749.8,11384.38
1948-05-13,16.0,0.12,0.76,31.86,-49.78,True,1,5086,-16.0,-69381.42,81376.0,11994.58
1948-05-14,16.39,0.39,2.44,31.86,-48.56,True,1,5087,-16.39,-69397.81,83375.93,13978.12
1948-05-17,16.61,0.22,1.34,31.86,-47.87,True,1,5088,-16.61,-69414.42,84511.68,15097.26
1948-05-18,16.39,-0.22,-1.32,31.86,-48.56,True,1,5089,-16.39,-69430.81,83408.71,13977.9
1948-05-19,16.37,-0.02,-0.12,31.86,-48.62,True,1,5090,-16.37,-69447.18,83323.3,13876.12
1948-05-20,16.46,0.09,0.55,31.86,-48.34,True,1,5091,-16.46,-69463.64,83797.86,14334.22
1948-05-21,16.5,0.04,0.24,31.86,-48.21,True,1,5092,-16.5,-69480.14,84018.0,14537.86
1948-05-24,16.54,0.04,0.24,31.86,-48.08,True,1,5093,-16.54,-69496.68,84238.22,14741.54
1948-05-25,16.53,-0.01,-0.06,31.86,-48.12,True,1,5094,-16.53,-69513.21,84203.82,14690.61
1948-05-26,16.68,0.15,0.91,31.86,-47.65,True,1,5095,-16.68,-69529.89,84984.6,15454.71
1948-05-27,16.68,0.0,0.0,31.86,-47.65,True,1,5096,-16.68,-69546.57,85001.28,15454.71
1948-05-28,16.69,0.01,0.06,31.86,-47.62,True,1,5097,-16.69,-69563.26,85068.93,15505.67
1948-06-01,16.74,0.05,0.3,31.86,-47.46,True,1,5098,-16.74,-69580.0,85340.52,15760.52
1948-06-02,16.76,0.02,0.12,31.86,-47.4,True,1,5099,-16.76,-69596.76,85459.24,15862.48
1948-06-03,16.72,-0.04,-0.24,31.86,-47.52,True,1,5100,-16.72,-69613.48,85272.0,15658.52
1948-06-04,16.59,-0.13,-0.78,31.86,-47.93,True,1,5101,-16.59,-69630.07,84625.59,14995.52
1948-06-07,16.54,-0.05,-0.3,31.86,-48.08,True,1,5102,-16.54,-69646.61,84387.08,14740.47
1948-06-08,16.82,0.28,1.69,31.86,-47.21,True,1,5103,-16.82,-69663.43,85832.46,16169.03
1948-06-09,16.89,0.07,0.42,31.86,-46.99,True,1,5104,-16.89,-69680.32,86206.56,16526.24
1948-06-10,16.9,0.01,0.06,31.86,-46.96,True,1,5105,-16.9,-69697.22,86274.5,16577.28
1948-06-11,16.95,0.05,0.3,31.86,-46.8,True,1,5106,-16.95,-69714.17,86546.7,16832.53
1948-06-14,16.97,0.02,0.12,31.86,-46.74,True,1,5107,-16.97,-69731.14,86665.79,16934.65
1948-06-15,17.06,0.09,0.53,31.86,-46.45,True,1,5108,-17.06,-69748.2,87142.48,17394.28
1948-06-16,17.01,-0.05,-0.29,31.86,-46.61,True,1,5109,-17.01,-69765.21,86904.09,17138.88
1948-06-17,16.99,-0.02,-0.12,31.86,-46.67,True,1,5110,-16.99,-69782.2,86818.9,17036.7
1948-06-18,16.96,-0.03,-0.18,31.86,-46.77,True,1,5111,-16.96,-69799.16,86682.56,16883.4
1948-06-21,16.79,-0.17,-1.0,31.86,-47.3,True,1,5112,-16.79,-69815.95,85830.48,16014.53
1948-06-22,16.76,-0.03,-0.18,31.86,-47.4,True,1,5113,-16.76,-69832.71,85693.88,15861.17
1948-06-23,16.93,0.17,1.01,31.86,-46.86,True,1,5114,-16.93,-69849.64,86580.02,16730.38
1948-06-24,16.89,-0.04,-0.24,31.86,-46.99,True,1,5115,-16.89,-69866.53,86392.35,16525.82
1948-06-25,16.83,-0.06,-0.36,31.86,-47.18,True,1,5116,-16.83,-69883.36,86102.28,16218.92
1948-06-28,16.61,-0.22,-1.31,31.86,-47.87,True,1,5117,-16.61,-69899.97,84993.37,15093.4
1948-06-29,16.69,0.08,0.48,31.86,-47.62,True,1,5118,-16.69,-69916.66,85419.42,15502.76
1948-06-30,16.74,0.05,0.3,31.86,-47.46,True,1,5119,-16.74,-69933.4,85692.06,15758.66
1948-07-01,16.7,-0.04,-0.24,31.86,-47.58,True,1,5120,-16.7,-69950.1,85504.0,15553.9
1948-07-02,16.85,0.15,0.9,31.86,-47.11,True,1,5121,-16.85,-69966.95,86288.85,16321.9
1948-07-06,16.85,0.0,0.0,31.86,-47.11,True,1,5122,-16.85,-69983.8,86305.7,16321.9
1948-07-07,16.79,-0.06,-0.36,31.86,-47.3,True,1,5123,-16.79,-70000.59,86015.17,16014.58
1948-07-08,16.81,0.02,0.12,31.86,-47.24,True,1,5124,-16.81,-70017.4,86134.44,16117.04
1948-07-09,16.92,0.11,0.65,31.86,-46.89,True,1,5125,-16.92,-70034.32,86715.0,16680.68
1948-07-12,16.88,-0.04,-0.24,31.86,-47.02,True,1,5126,-16.88,-70051.2,86526.88,16475.68
1948-07-13,16.78,-0.1,-0.59,31.86,-47.33,True,1,5127,-16.78,-70067.98,86031.06,15963.08
1948-07-14,16.8,0.02,0.12,31.86,-47.27,True,1,5128,-16.8,-70084.78,86150.4,16065.62
1948-07-15,16.48,-0.32,-1.9,31.86,-48.27,True,1,5129,-16.48,-70101.26,84525.92,14424.66
1948-07-16,16.25,-0.23,-1.4,31.86,-49.0,True,1,5130,-16.25,-70117.51,83362.5,13244.99
1948-07-19,15.72,-0.53,-3.26,31.86,-50.66,True,1,5131,-15.72,-70133.23,80659.32,10526.09
1948-07-20,15.96,0.24,1.53,31.86,-49.91,True,1,5132,-15.96,-70149.19,81906.72,11757.53
1948-07-21,16.09,0.13,0.82,31.86,-49.5,True,1,5133,-16.09,-70165.28,82589.97,12424.69
1948-07-22,16.21,0.12,0.75,31.86,-49.12,True,1,5134,-16.21,-70181.49,83222.14,13040.65
1948-07-23,16.27,0.06,0.37,31.86,-48.93,True,1,5135,-16.27,-70197.76,83546.45,13348.69
1948-07-26,16.12,-0.15,-0.92,31.86,-49.4,True,1,5136,-16.12,-70213.88,82792.32,12578.44
1948-07-27,16.29,0.17,1.06,31.86,-48.87,True,1,5137,-16.29,-70230.17,83681.73,13451.56
1948-07-28,16.18,-0.11,-0.68,31.86,-49.22,True,1,5138,-16.18,-70246.35,83132.84,12886.49
1948-07-29,16.05,-0.13,-0.8,31.86,-49.62,True,1,5139,-16.05,-70262.4,82480.95,12218.55
1948-07-30,15.85,-0.2,-1.25,31.86,-50.25,True,1,5140,-15.85,-70278.25,81469.0,11190.75
1948-08-02,15.85,0.0,0.0,31.86,-50.25,True,1,5141,-15.85,-70294.1,81484.85,11190.75
1948-08-03,15.9,0.05,0.32,31.86,-50.09,True,1,5142,-15.9,-70310.0,81757.8,11447.8
1948-08-04,16.15,0.25,1.57,31.86,-49.31,True,1,5143,-16.15,-70326.15,83059.45,12733.3
1948-08-05,16.09,-0.06,-0.37,31.86,-49.5,True,1,5144,-16.09,-70342.24,82766.96,12424.72
1948-08-06,16.12,0.03,0.19,31.86,-49.4,True,1,5145,-16.12,-70358.36,82937.4,12579.04
1948-08-09,15.96,-0.16,-0.99,31.86,-49.91,True,1,5146,-15.96,-70374.32,82130.16,11755.84
1948-08-10,15.74,-0.22,-1.38,31.86,-50.6,True,1,5147,-15.74,-70390.06,81013.78,10623.72
1948-08-11,15.67,-0.07,-0.44,31.86,-50.82,True,1,5148,-15.67,-70405.73,80669.16,10263.43
1948-08-12,15.71,0.04,0.26,31.86,-50.69,True,1,5149,-15.71,-70421.44,80890.79,10469.35
1948-08-13,15.7,-0.01,-0.06,31.86,-50.72,True,1,5150,-15.7,-70437.14,80855.0,10417.86
1948-08-16,15.74,0.04,0.26,31.86,-50.6,True,1,5151,-15.74,-70452.88,81076.74,10623.86
1948-08-17,15.93,0.19,1.21,31.86,-50.0,True,1,5152,-15.93,-70468.81,82071.36,11602.55
1948-08-18,15.93,0.0,0.0,31.86,-50.0,True,1,5153,-15.93,-70484.74,82087.29,11602.55
1948-08-19,15.98,0.05,0.31,31.86,-49.84,True,1,5154,-15.98,-70500.72,82360.92,11860.2
1948-08-20,16.15,0.17,1.06,31.86,-49.31,True,1,5155,-16.15,-70516.87,83253.25,12736.38
1948-08-23,15.94,-0.21,-1.3,31.86,-49.97,True,1,5156,-15.94,-70532.81,82186.64,11653.83
1948-08-24,16.02,0.08,0.5,31.86,-49.72,True,1,5157,-16.02,-70548.83,82615.14,12066.31
1948-08-25,15.99,-0.03,-0.19,31.86,-49.81,True,1,5158,-15.99,-70564.82,82476.42,11911.6
1948-08-26,16.04,0.05,0.31,31.86,-49.66,True,1,5159,-16.04,-70580.86,82750.36,12169.5
1948-08-27,16.11,0.07,0.44,31.86,-49.44,True,1,5160,-16.11,-70596.97,83127.6,12530.63
1948-08-30,15.98,-0.13,-0.81,31.86,-49.84,True,1,5161,-15.98,-70612.95,82472.78,11859.83
1948-08-31,15.97,-0.01,-0.06,31.86,-49.87,True,1,5162,-15.97,-70628.92,82437.14,11808.22
1948-09-01,16.16,0.19,1.19,31.86,-49.28,True,1,5163,-16.16,-70645.08,83434.08,12789.0
1948-09-02,16.24,0.08,0.5,31.86,-49.03,True,1,5164,-16.24,-70661.32,83863.36,13202.04
1948-09-03,16.27,0.03,0.18,31.86,-48.93,True,1,5165,-16.27,-70677.59,84034.55,13356.96
1948-09-07,16.35,0.08,0.49,31.86,-48.68,True,1,5166,-16.35,-70693.94,84464.1,13770.16
1948-09-08,16.07,-0.28,-1.71,31.86,-49.56,True,1,5167,-16.07,-70710.01,83033.69,12323.68
1948-09-09,15.81,-0.26,-1.62,31.86,-50.38,True,1,5168,-15.81,-70725.82,81706.08,10980.26
1948-09-10,15.83,0.02,0.13,31.86,-50.31,True,1,5169,-15.83,-70741.65,81825.27,11083.62
1948-09-13,15.7,-0.13,-0.82,31.86,-50.72,True,1,5170,-15.7,-70757.35,81169.0,10411.65
1948-09-14,15.82,0.12,0.76,31.86,-50.34,True,1,5171,-15.82,-70773.17,81805.22,11032.05
1948-09-15,15.8,-0.02,-0.13,31.86,-50.41,True,1,5172,-15.8,-70788.97,81717.6,10928.63
1948-09-16,15.8,0.0,0.0,31.86,-50.41,True,1,5173,-15.8,-70804.77,81733.4,10928.63
1948-09-17,15.73,-0.07,-0.44,31.86,-50.63,True,1,5174,-15.73,-70820.5,81387.02,10566.52
1948-09-20,15.44,-0.29,-1.84,31.86,-51.54,True,1,5175,-15.44,-70835.94,79902.0,9066.06
1948-09-21,15.55,0.11,0.71,31.86,-51.19,True,1,5176,-15.55,-70851.49,80486.8,9635.31
1948-09-22,15.59,0.04,0.26,31.86,-51.07,True,1,5177,-15.59,-70867.08,80709.43,9842.35
1948-09-23,15.56,-0.03,-0.19,31.86,-51.16,True,1,5178,-15.56,-70882.64,80569.68,9687.04
1948-09-24,15.6,0.04,0.26,31.86,-51.04,True,1,5179,-15.6,-70898.24,80792.4,9894.16
1948-09-27,15.19,-0.41,-2.63,31.86,-52.32,True,1,5180,-15.19,-70913.43,78684.2,7770.77
1948-09-28,15.36,0.17,1.12,31.86,-51.79,True,1,5181,-15.36,-70928.79,79580.16,8651.37
1948-09-29,15.55,0.19,1.24,31.86,-51.19,True,1,5182,-15.55,-70944.34,80580.1,9635.76
1948-09-30,15.49,-0.06,-0.39,31.86,-51.38,True,1,5183,-15.49,-70959.83,80284.67,9324.84
1948-10-01,15.67,0.18,1.16,31.86,-50.82,True,1,5184,-15.67,-70975.5,81233.28,10257.78
1948-10-04,15.85,0.18,1.15,31.86,-50.25,True,1,5185,-15.85,-70991.35,82182.25,11190.9
1948-10-05,15.82,-0.03,-0.19,31.86,-50.34,True,1,5186,-15.82,-71007.17,82042.52,11035.35
1948-10-06,15.84,0.02,0.13,31.86,-50.28,True,1,5187,-15.84,-71023.01,82162.08,11139.07
1948-10-07,15.93,0.09,0.57,31.86,-50.0,True,1,5188,-15.93,-71038.94,82644.84,11605.9
1948-10-08,15.9,-0.03,-0.19,31.86,-50.09,True,1,5189,-15.9,-71054.84,82505.1,11450.26
1948-10-11,15.9,0.0,0.0,31.86,-50.09,True,1,5190,-15.9,-71070.74,82521.0,11450.26
1948-10-13,16.09,0.19,1.2,31.86,-49.5,True,1,5191,-16.09,-71086.83,83523.19,12436.36
1948-10-14,16.14,0.05,0.31,31.86,-49.34,True,1,5192,-16.14,-71102.97,83798.88,12695.91
1948-10-15,16.12,-0.02,-0.12,31.86,-49.4,True,1,5193,-16.12,-71119.09,83711.16,12592.07
1948-10-18,16.19,0.07,0.43,31.86,-49.18,True,1,5194,-16.19,-71135.28,84090.86,12955.58
1948-10-19,16.28,0.09,0.56,31.86,-48.9,True,1,5195,-16.28,-71151.56,84574.6,13423.04
1948-10-20,16.34,0.06,0.37,31.86,-48.71,True,1,5196,-16.34,-71167.9,84902.64,13734.74
1948-10-21,16.36,0.02,0.12,31.86,-48.65,True,1,5197,-16.36,-71184.26,85022.92,13838.66
1948-10-22,16.61,0.25,1.53,31.86,-47.87,True,1,5198,-16.61,-71200.87,86338.78,15137.91
1948-10-25,16.58,-0.03,-0.18,31.86,-47.96,True,1,5199,-16.58,-71217.45,86199.42,14981.97
1948-10-26,16.59,0.01,0.06,31.86,-47.93,True,1,5200,-16.59,-71234.04,86268.0,15033.96
1948-10-27,16.57,-0.02,-0.12,31.86,-47.99,True,1,5201,-16.57,-71250.61,86180.57,14929.96
1948-10-28,16.46,-0.11,-0.66,31.86,-48.34,True,1,5202,-16.46,-71267.07,85624.92,14357.85
1948-10-29,16.5,0.04,0.24,31.86,-48.21,True,1,5203,-16.5,-71283.57,85849.5,14565.93
1948-11-01,16.7,0.2,1.21,31.86,-47.58,True,1,5204,-16.7,-71300.27,86906.8,15606.53
1948-11-03,15.93,-0.77,-4.61,31.86,-50.0,True,1,5205,-15.93,-71316.2,82915.65,11599.45
1948-11-04,16.14,0.21,1.32,31.86,-49.34,True,1,5206,-16.14,-71332.34,84024.84,12692.5
1948-11-05,15.43,-0.71,-4.4,31.86,-51.57,True,1,5207,-15.43,-71347.77,80344.01,8996.24
1948-11-08,15.5,0.07,0.45,31.86,-51.35,True,1,5208,-15.5,-71363.27,80724.0,9360.73
1948-11-09,15.01,-0.49,-3.16,31.86,-52.89,True,1,5209,-15.01,-71378.28,78187.09,6808.81
1948-11-10,15.0,-0.01,-0.07,31.86,-52.92,True,1,5210,-15.0,-71393.28,78150.0,6756.72
1948-11-12,15.04,0.04,0.27,31.86,-52.79,True,1,5211,-15.04,-71408.32,78373.44,6965.12
1948-11-15,15.27,0.23,1.53,31.86,-52.07,True,1,5212,-15.27,-71423.59,79587.24,8163.65
1948-11-16,15.26,-0.01,-0.06,31.86,-52.1,True,1,5213,-15.26,-71438.85,79550.38,8111.53
1948-11-17,15.22,-0.04,-0.26,31.86,-52.23,True,1,5214,-15.22,-71454.07,79357.08,7903.01
1948-11-18,15.26,0.04,0.26,31.86,-52.1,True,1,5215,-15.26,-71469.33,79580.9,8111.57
1948-11-19,15.31,0.05,0.33,31.86,-51.95,True,1,5216,-15.31,-71484.64,79856.96,8372.32
1948-11-22,15.21,-0.1,-0.65,31.86,-52.26,True,1,5217,-15.21,-71499.85,79350.57,7850.72
1948-11-23,15.19,-0.02,-0.13,31.86,-52.32,True,1,5218,-15.19,-71515.04,79261.42,7746.38
1948-11-24,14.91,-0.28,-1.84,31.86,-53.2,True,1,5219,-14.91,-71529.95,77815.29,6285.34
1948-11-26,14.91,0.0,0.0,31.86,-53.2,True,1,5220,-14.91,-71544.86,77830.2,6285.34
1948-11-29,14.79,-0.12,-0.8,31.86,-53.58,True,1,5221,-14.79,-71559.65,77218.59,5658.94
1948-11-30,14.75,-0.04,-0.27,31.86,-53.7,True,1,5222,-14.75,-71574.4,77024.5,5450.1
1948-12-01,15.01,0.26,1.76,31.86,-52.89,True,1,5223,-15.01,-71589.41,78397.23,6807.82
1948-12-02,15.0,-0.01,-0.07,31.86,-52.92,True,1,5224,-15.0,-71604.41,78360.0,6755.59
1948-12-03,15.13,0.13,0.87,31.86,-52.51,True,1,5225,-15.13,-71619.54,79054.25,7434.71
1948-12-06,15.23,0.1,0.66,31.86,-52.2,True,1,5226,-15.23,-71634.77,79591.98,7957.21
1948-12-07,15.24,0.01,0.07,31.86,-52.17,True,1,5227,-15.24,-71650.01,79659.48,8009.47
1948-12-08,15.2,-0.04,-0.26,31.86,-52.29,True,1,5228,-15.2,-71665.21,79465.6,7800.39
1948-12-09,15.17,-0.03,-0.2,31.86,-52.38,True,1,5229,-15.17,-71680.38,79323.93,7643.55
1948-12-10,15.22,0.05,0.33,31.86,-52.23,True,1,5230,-15.22,-71695.6,79600.6,7905.0
1948-12-13,15.33,0.11,0.72,31.86,-51.88,True,1,5231,-15.33,-71710.93,80191.23,8480.3
1948-12-14,15.25,-0.08,-0.52,31.86,-52.13,True,1,5232,-15.25,-71726.18,79788.0,8061.82
1948-12-15,15.17,-0.08,-0.52,31.86,-52.38,True,1,5233,-15.17,-71741.35,79384.61,7643.26
1948-12-16,15.16,-0.01,-0.07,31.86,-52.42,True,1,5234,-15.16,-71756.51,79347.44,7590.93
1948-12-17,15.2,0.04,0.26,31.86,-52.29,True,1,5235,-15.2,-71771.71,79572.0,7800.29
1948-12-20,15.19,-0.01,-0.07,31.86,-52.32,True,1,5236,-15.19,-71786.9,79534.84,7747.94
1948-12-21,15.14,-0.05,-0.33,31.86,-52.48,True,1,5237,-15.14,-71802.04,79288.18,7486.14
1948-12-22,15.15,0.01,0.07,31.86,-52.45,True,1,5238,-15.15,-71817.19,79355.7,7538.51
1948-12-23,15.15,0.0,0.0,31.86,-52.45,True,1,5239,-15.15,-71832.34,79370.85,7538.51
1948-12-24,15.25,0.1,0.66,31.86,-52.13,True,1,5240,-15.25,-71847.59,79910.0,8062.41
1948-12-27,15.19,-0.06,-0.39,31.86,-52.32,True,1,5241,-15.19,-71862.78,79610.79,7748.01
1948-12-28,15.08,-0.11,-0.72,31.86,-52.67,True,1,5242,-15.08,-71877.86,79049.36,7171.5
1948-12-29,15.28,0.2,1.33,31.86,-52.04,True,1,5243,-15.28,-71893.14,80113.04,8219.9
1948-12-30,15.28,0.0,0.0,31.86,-52.04,True,1,5244,-15.28,-71908.42,80128.32,8219.9
1948-12-31,15.2,-0.08,-0.52,31.86,-52.29,True,1,5245,-15.2,-71923.62,79724.0,7800.38
1949-01-03,14.95,-0.25,-1.64,31.86,-53.08,True,1,5246,-14.95,-71938.57,78427.7,6489.13
1949-01-04,15.03,0.08,0.54,31.86,-52.82,True,1,5247,-15.03,-71953.6,78862.41,6908.81
1949-01-05,15.16,0.13,0.86,31.86,-52.42,True,1,5248,-15.16,-71968.76,79559.68,7590.92
1949-01-06,15.5,0.34,2.24,31.86,-51.35,True,1,5249,-15.5,-71984.26,81359.5,9375.24
1949-01-07,15.61,0.11,0.71,31.86,-51.0,True,1,5250,-15.61,-71999.87,81952.5,9952.63
1949-01-10,15.51,-0.1,-0.64,31.86,-51.32,True,1,5251,-15.51,-72015.38,81443.01,9427.63
1949-01-11,15.5,-0.01,-0.06,31.86,-51.35,True,1,5252,-15.5,-72030.88,81406.0,9375.12
1949-01-12,15.47,-0.03,-0.19,31.86,-51.44,True,1,5253,-15.47,-72046.35,81263.91,9217.56
1949-01-13,15.39,-0.08,-0.52,31.86,-51.7,True,1,5254,-15.39,-72061.74,80859.06,8797.32
1949-01-14,15.24,-0.15,-0.98,31.86,-52.17,True,1,5255,-15.24,-72076.98,80086.2,8009.22
1949-01-17,15.38,0.14,0.92,31.86,-51.73,True,1,5256,-15.38,-72092.36,80837.28,8744.92
1949-01-18,15.38,0.0,0.0,31.86,-51.73,True,1,5257,-15.38,-72107.74,80852.66,8744.92
1949-01-19,15.44,0.06,0.39,31.86,-51.54,True,1,5258,-15.44,-72123.18,81183.52,9060.34
1949-01-20,15.5,0.06,0.39,31.86,-51.35,True,1,5259,-15.5,-72138.68,81514.5,9375.82
1949-01-21,15.47,-0.03,-0.19,31.86,-51.44,True,1,5260,-15.47,-72154.15,81372.2,9218.05
1949-01-24,15.0,-0.47,-3.04,31.86,-52.92,True,1,5261,-15.0,-72169.15,78915.0,6745.85
1949-01-25,15.33,0.33,2.2,31.86,-51.88,True,1,5262,-15.33,-72184.48,80666.46,8481.98
1949-01-26,15.29,-0.04,-0.26,31.86,-52.01,True,1,5263,-15.29,-72199.77,80471.27,8271.5
1949-01-27,15.25,-0.04,-0.26,31.86,-52.13,True,1,5264,-15.25,-72215.02,80276.0,8060.98
1949-01-28,15.2,-0.05,-0.33,31.86,-52.29,True,1,5265,-15.2,-72230.22,80028.0,7797.78
1949-01-31,15.22,0.02,0.13,31.86,-52.23,True,1,5266,-15.22,-72245.44,80148.52,7903.08
1949-02-01,15.34,0.12,0.79,31.86,-51.85,True,1,5267,-15.34,-72260.78,80795.78,8535.0
1949-02-02,15.35,0.01,0.06,31.86,-51.82,True,1,5268,-15.35,-72276.13,80863.8,8587.67
1949-02-03,15.32,-0.03,-0.2,31.86,-51.92,True,1,5269,-15.32,-72291.45,80721.08,8429.63
1949-02-04,15.09,-0.23,-1.5,31.86,-52.64,True,1,5270,-15.09,-72306.54,79524.3,7217.76
1949-02-07,14.76,-0.33,-2.19,31.86,-53.67,True,1,5271,-14.76,-72321.3,77799.96,5478.66
1949-02-08,14.7,-0.06,-0.41,31.86,-53.86,True,1,5272,-14.7,-72336.0,77498.4,5162.4
1949-02-09,14.78,0.08,0.54,31.86,-53.61,True,1,5273,-14.78,-72350.78,77934.94,5584.16
1949-02-10,14.58,-0.2,-1.35,31.86,-54.24,True,1,5274,-14.58,-72365.36,76894.92,4529.56
1949-02-11,14.56,-0.02,-0.14,31.86,-54.3,True,1,5275,-14.56,-72379.92,76804.0,4424.08
1949-02-14,14.61,0.05,0.34,31.86,-54.14,True,1,5276,-14.61,-72394.53,77082.36,4687.83
1949-02-15,14.65,0.04,0.27,31.86,-54.02,True,1,5277,-14.65,-72409.18,77308.05,4898.87
1949-02-16,14.73,0.08,0.55,31.86,-53.77,True,1,5278,-14.73,-72423.91,77744.94,5321.03
1949-02-17,14.83,0.1,0.68,31.86,-53.45,True,1,5279,-14.83,-72438.74,78287.57,5848.83
1949-02-18,14.79,-0.04,-0.27,31.86,-53.58,True,1,5280,-14.79,-72453.53,78091.2,5637.67
1949-02-21,14.74,-0.05,-0.34,31.86,-53.74,True,1,5281,-14.74,-72468.27,77841.94,5373.67
1949-02-23,14.6,-0.14,-0.95,31.86,-54.18,True,1,5282,-14.6,-72482.87,77117.2,4634.33
1949-02-24,14.42,-0.18,-1.23,31.86,-54.74,True,1,5283,-14.42,-72497.29,76180.86,3683.57
1949-02-25,14.38,-0.04,-0.28,31.86,-54.86,True,1,5284,-14.38,-72511.67,75983.92,3472.25
1949-02-28,14.62,0.24,1.67,31.86,-54.11,True,1,5285,-14.62,-72526.29,77266.7,4740.41
1949-03-01,14.71,0.09,0.62,31.86,-53.83,True,1,5286,-14.71,-72541.0,77757.06,5216.06
1949-03-02,14.67,-0.04,-0.27,31.86,-53.96,True,1,5287,-14.67,-72555.67,77560.29,5004.62
1949-03-03,14.65,-0.02,-0.14,31.86,-54.02,True,1,5288,-14.65,-72570.32,77469.2,4898.88
1949-03-04,14.67,0.02,0.14,31.86,-53.96,True,1,5289,-14.67,-72584.99,77589.63,5004.64
1949-03-07,14.86,0.19,1.3,31.86,-53.36,True,1,5290,-14.86,-72599.85,78609.4,6009.55
1949-03-08,14.89,0.03,0.2,31.86,-53.26,True,1,5291,-14.89,-72614.74,78782.99,6168.25
1949-03-09,14.86,-0.03,-0.2,31.86,-53.36,True,1,5292,-14.86,-72629.6,78639.12,6009.52
1949-03-10,14.87,0.01,0.07,31.86,-53.33,True,1,5293,-14.87,-72644.47,78706.91,6062.44
1949-03-11,15.02,0.15,1.01,31.86,-52.86,True,1,5294,-15.02,-72659.49,79515.88,6856.39
1949-03-14,15.07,0.05,0.33,31.86,-52.7,True,1,5295,-15.07,-72674.56,79795.65,7121.09
1949-03-15,14.98,-0.09,-0.6,31.86,-52.98,True,1,5296,-14.98,-72689.54,79334.08,6644.54
1949-03-16,14.92,-0.06,-0.4,31.86,-53.17,True,1,5297,-14.92,-72704.46,79031.24,6326.78
1949-03-17,14.97,0.05,0.34,31.86,-53.01,True,1,5298,-14.97,-72719.43,79311.06,6591.63
1949-03-18,14.94,-0.03,-0.2,31.86,-53.11,True,1,5299,-14.94,-72734.37,79167.06,6432.69
1949-03-21,14.87,-0.07,-0.47,31.86,-53.33,True,1,5300,-14.87,-72749.24,78811.0,6061.76
1949-03-22,14.77,-0.1,-0.67,31.86,-53.64,True,1,5301,-14.77,-72764.01,78295.77,5531.76
1949-03-23,14.95,0.18,1.22,31.86,-53.08,True,1,5302,-14.95,-72778.96,79264.9,6485.94
1949-03-24,14.97,0.02,0.13,31.86,-53.01,True,1,5303,-14.97,-72793.93,79385.91,6591.98
1949-03-25,14.89,-0.08,-0.53,31.86,-53.26,True,1,5304,-14.89,-72808.82,78976.56,6167.74
1949-03-28,14.93,0.04,0.27,31.86,-53.14,True,1,5305,-14.93,-72823.75,79203.65,6379.9
1949-03-29,15.22,0.29,1.94,31.86,-52.23,True,1,5306,-15.22,-72838.97,80757.32,7918.35
1949-03-30,15.21,-0.01,-0.07,31.86,-52.26,True,1,5307,-15.21,-72854.18,80719.47,7865.29
1949-03-31,15.06,-0.15,-0.99,31.86,-52.73,True,1,5308,-15.06,-72869.24,79938.48,7069.24
1949-04-01,14.94,-0.12,-0.8,31.86,-53.11,True,1,5309,-14.94,-72884.18,79316.46,6432.28
1949-04-04,14.98,0.04,0.27,31.86,-52.98,True,1,5310,-14.98,-72899.16,79543.8,6644.64
1949-04-05,14.96,-0.02,-0.13,31.86,-53.04,True,1,5311,-14.96,-72914.12,79452.56,6538.44
1949-04-06,14.92,-0.04,-0.27,31.86,-53.17,True,1,5312,-14.92,-72929.04,79255.04,6326.0
1949-04-07,14.93,0.01,0.07,31.86,-53.14,True,1,5313,-14.93,-72943.97,79323.09,6379.12
1949-04-08,14.97,0.04,0.27,31.86,-53.01,True,1,5314,-14.97,-72958.94,79550.58,6591.64
1949-04-11,14.99,0.02,0.13,31.86,-52.95,True,1,5315,-14.99,-72973.93,79671.85,6697.92
1949-04-12,15.03,0.04,0.27,31.86,-52.82,True,1,5316,-15.03,-72988.96,79899.48,6910.52
1949-04-13,15.02,-0.01,-0.07,31.86,-52.86,True,1,5317,-15.02,-73003.98,79861.34,6857.36
1949-04-14,14.99,-0.03,-0.2,31.86,-52.95,True,1,5318,-14.99,-73018.97,79716.82,6697.85
1949-04-18,15.07,0.08,0.53,31.86,-52.7,True,1,5319,-15.07,-73034.04,80157.33,7123.29
1949-04-19,15.01,-0.06,-0.4,31.86,-52.89,True,1,5320,-15.01,-73049.05,79853.2,6804.15
1949-04-20,14.97,-0.04,-0.27,31.86,-53.01,True,1,5321,-14.97,-73064.02,79655.37,6591.35
1949-04-21,14.72,-0.25,-1.67,31.86,-53.8,True,1,5322,-14.72,-73078.74,78339.84,5261.1
1949-04-22,14.7,-0.02,-0.14,31.86,-53.86,True,1,5323,-14.7,-73093.44,78248.1,5154.66
1949-04-25,14.68,-0.02,-0.14,31.86,-53.92,True,1,5324,-14.68,-73108.12,78156.32,5048.2
1949-04-26,14.76,0.08,0.55,31.86,-53.67,True,1,5325,-14.76,-73122.88,78597.0,5474.12
1949-04-27,14.76,0.0,0.0,31.86,-53.67,True,1,5326,-14.76,-73137.64,78611.76,5474.12
1949-04-28,14.69,-0.07,-0.47,31.86,-53.89,True,1,5327,-14.69,-73152.33,78253.63,5101.3
1949-04-29,14.71,0.02,0.14,31.86,-53.83,True,1,5328,-14.71,-73167.04,78374.88,5207.84
1949-05-02,14.78,0.07,0.48,31.86,-53.61,True,1,5329,-14.78,-73181.82,78762.62,5580.8
1949-05-03,14.85,0.07,0.47,31.86,-53.39,True,1,5330,-14.85,-73196.67,79150.5,5953.83
1949-05-04,15.02,0.17,1.14,31.86,-52.86,True,1,5331,-15.02,-73211.69,80071.62,6859.93
1949-05-05,15.01,-0.01,-0.07,31.86,-52.89,True,1,5332,-15.01,-73226.7,80033.32,6806.62
1949-05-06,14.92,-0.09,-0.6,31.86,-53.17,True,1,5333,-14.92,-73241.62,79568.36,6326.74
1949-05-09,14.88,-0.04,-0.27,31.86,-53.3,True,1,5334,-14.88,-73256.5,79369.92,6113.42
1949-05-10,14.82,-0.06,-0.4,31.86,-53.48,True,1,5335,-14.82,-73271.32,79064.7,5793.38
1949-05-11,14.85,0.03,0.2,31.86,-53.39,True,1,5336,-14.85,-73286.17,79239.6,5953.43
1949-05-12,14.87,0.02,0.14,31.86,-53.33,True,1,5337,-14.87,-73301.04,79361.19,6060.15
1949-05-13,14.88,0.01,0.07,31.86,-53.3,True,1,5338,-14.88,-73315.92,79429.44,6113.52
1949-05-16,14.96,0.08,0.54,31.86,-53.04,True,1,5339,-14.96,-73330.88,79871.44,6540.56
1949-05-17,14.93,-0.03,-0.2,31.86,-53.14,True,1,5340,-14.93,-73345.81,79726.2,6380.39
1949-05-18,14.89,-0.04,-0.27,31.86,-53.26,True,1,5341,-14.89,-73360.7,79527.49,6166.79
1949-05-19,14.8,-0.09,-0.6,31.86,-53.55,True,1,5342,-14.8,-73375.5,79061.6,5686.1
1949-05-20,14.73,-0.07,-0.47,31.86,-53.77,True,1,5343,-14.73,-73390.23,78702.39,5312.16
1949-05-23,14.58,-0.15,-1.02,31.86,-54.24,True,1,5344,-14.58,-73404.81,77915.52,4510.71
1949-05-24,14.5,-0.08,-0.55,31.86,-54.49,True,1,5345,-14.5,-73419.31,77502.5,4083.19
1949-05-25,14.57,0.07,0.48,31.86,-54.27,True,1,5346,-14.57,-73433.88,77891.22,4457.34
1949-05-26,14.56,-0.01,-0.07,31.86,-54.3,True,1,5347,-14.56,-73448.44,77852.32,4403.88
1949-05-27,14.51,-0.05,-0.34,31.86,-54.46,True,1,5348,-14.51,-73462.95,77599.48,4136.53
1949-05-31,14.19,-0.32,-2.2,31.86,-55.46,True,1,5349,-14.19,-73477.14,75902.31,2425.17
1949-06-01,14.14,-0.05,-0.35,31.86,-55.62,True,1,5350,-14.14,-73491.28,75649.0,2157.72
1949-06-02,14.14,0.0,0.0,31.86,-55.62,True,1,5351,-14.14,-73505.42,75663.14,2157.72
1949-06-03,14.05,-0.09,-0.64,31.86,-55.9,True,1,5352,-14.05,-73519.47,75195.6,1676.13
1949-06-06,13.82,-0.23,-1.64,31.86,-56.62,True,1,5353,-13.82,-73533.29,73978.46,445.17
1949-06-07,13.84,0.02,0.14,31.86,-56.56,True,1,5354,-13.84,-73547.13,74099.36,552.23
1949-06-08,13.93,0.09,0.65,31.86,-56.28,True,1,5355,-13.93,-73561.06,74595.15,1034.09
1949-06-09,13.93,0.0,0.0,31.86,-56.28,True,1,5356,-13.93,-73574.99,74609.08,1034.09
1949-06-10,13.81,-0.12,-0.86,31.86,-56.65,True,1,5357,-13.81,-73588.8,73980.17,391.37
1949-06-13,13.55,-0.26,-1.88,31.86,-57.47,True,1,5358,-13.55,-73602.35,72600.9,-1001.45
1949-06-14,13.64,0.09,0.66,31.86,-57.19,True,1,5359,-13.64,-73615.99,73096.76,-519.23
1949-06-15,13.9,0.26,1.91,31.86,-56.37,True,1,5360,-13.9,-73629.89,74504.0,874.11
1949-06-16,13.85,-0.05,-0.36,31.86,-56.53,True,1,5361,-13.85,-73643.74,74249.85,606.11
1949-06-17,13.87,0.02,0.14,31.86,-56.47,True,1,5362,-13.87,-73657.61,74370.94,713.33
1949-06-20,14.07,0.2,1.44,31.86,-55.84,True,1,5363,-14.07,-73671.68,75457.41,1785.73
1949-06-21,14.08,0.01,0.07,31.86,-55.81,True,1,5364,-14.08,-73685.76,75525.12,1839.36
1949-06-22,14.04,-0.04,-0.28,31.86,-55.93,True,1,5365,-14.04,-73699.8,75324.6,1624.8
1949-06-23,14.11,0.07,0.5,31.86,-55.71,True,1,5366,-14.11,-73713.91,75714.26,2000.35
1949-06-24,14.13,0.02,0.14,31.86,-55.65,True,1,5367,-14.13,-73728.04,75835.71,2107.67
1949-06-27,14.12,-0.01,-0.07,31.86,-55.68,True,1,5368,-14.12,-73742.16,75796.16,2054.0
1949-06-28,14.0,-0.12,-0.85,31.86,-56.06,True,1,5369,-14.0,-73756.16,75166.0,1409.84
1949-06-29,14.09,0.09,0.64,31.86,-55.78,True,1,5370,-14.09,-73770.25,75663.3,1893.05
1949-06-30,14.16,0.07,0.5,31.86,-55.56,True,1,5371,-14.16,-73784.41,76053.36,2268.95
1949-07-01,14.26,0.1,0.71,31.86,-55.24,True,1,5372,-14.26,-73798.67,76604.72,2806.05
1949-07-05,14.34,0.08,0.56,31.86,-54.99,True,1,5373,-14.34,-73813.01,77048.82,3235.81
1949-07-06,14.52,0.18,1.25,31.86,-54.43,True,1,5374,-14.52,-73827.53,78030.48,4202.95
1949-07-07,14.52,0.0,0.0,31.86,-54.43,True,1,5375,-14.52,-73842.05,78045.0,4202.95
1949-07-08,14.51,-0.01,-0.07,31.86,-54.46,True,1,5376,-14.51,-73856.56,78005.76,4149.2
1949-07-11,14.51,0.0,0.0,31.86,-54.46,True,1,5377,-14.51,-73871.07,78020.27,4149.2
1949-07-12,14.61,0.1,0.69,31.86,-54.14,True,1,5378,-14.61,-73885.68,78572.58,4686.9
1949-07-13,14.78,0.17,1.16,31.86,-53.61,True,1,5379,-14.78,-73900.46,79501.62,5601.16
1949-07-14,14.79,0.01,0.07,31.86,-53.58,True,1,5380,-14.79,-73915.25,79570.2,5654.95
1949-07-15,14.76,-0.03,-0.2,31.86,-53.67,True,1,5381,-14.76,-73930.01,79423.56,5493.55
1949-07-18,14.8,0.04,0.27,31.86,-53.55,True,1,5382,-14.8,-73944.81,79653.6,5708.79
1949-07-19,14.94,0.14,0.95,31.86,-53.11,True,1,5383,-14.94,-73959.75,80422.02,6462.27
1949-07-20,14.97,0.03,0.2,31.86,-53.01,True,1,5384,-14.97,-73974.72,80598.48,6623.76
1949-07-21,14.9,-0.07,-0.47,31.86,-53.23,True,1,5385,-14.9,-73989.62,80236.5,6246.88
1949-07-22,14.89,-0.01,-0.07,31.86,-53.26,True,1,5386,-14.89,-74004.51,80197.54,6193.03
1949-07-25,14.94,0.05,0.34,31.86,-53.11,True,1,5387,-14.94,-74019.45,80481.78,6462.33
1949-07-26,15.06,0.12,0.8,31.86,-52.73,True,1,5388,-15.06,-74034.51,81143.28,7108.77
1949-07-27,15.06,0.0,0.0,31.86,-52.73,True,1,5389,-15.06,-74049.57,81158.34,7108.77
1949-07-28,15.04,-0.02,-0.13,31.86,-52.79,True,1,5390,-15.04,-74064.61,81065.6,7000.99
1949-07-29,15.04,0.0,0.0,31.86,-52.79,True,1,5391,-15.04,-74079.65,81080.64,7000.99
1949-08-01,15.12,0.08,0.53,31.86,-52.54,True,1,5392,-15.12,-74094.77,81527.04,7432.27
1949-08-02,15.16,0.04,0.26,31.86,-52.42,True,1,5393,-15.16,-74109.93,81757.88,7647.95
1949-08-03,15.15,-0.01,-0.07,31.86,-52.45,True,1,5394,-15.15,-74125.08,81719.1,7594.02
1949-08-04,15.13,-0.02,-0.13,31.86,-52.51,True,1,5395,-15.13,-74140.21,81626.35,7486.14
1949-08-05,15.35,0.22,1.45,31.86,-51.82,True,1,5396,-15.35,-74155.56,82828.6,8673.04
1949-08-08,15.51,0.16,1.04,31.86,-51.32,True,1,5397,-15.51,-74171.07,83707.47,9536.4
1949-08-09,15.37,-0.14,-0.9,31.86,-51.76,True,1,5398,-15.37,-74186.44,82967.26,8780.82
1949-08-10,15.44,0.07,0.46,31.86,-51.54,True,1,5399,-15.44,-74201.88,83360.56,9158.68
1949-08-11,15.39,-0.05,-0.32,31.86,-51.7,True,1,5400,-15.39,-74217.27,83106.0,8888.73
1949-08-12,15.32,-0.07,-0.46,31.86,-51.92,True,1,5401,-15.32,-74232.59,82743.32,8510.73
1949-08-15,15.25,-0.07,-0.46,31.86,-52.13,True,1,5402,-15.25,-74247.84,82380.5,8132.66
1949-08-16,15.29,0.04,0.26,31.86,-52.01,True,1,5403,-15.29,-74263.13,82611.87,8348.74
1949-08-17,15.46,0.17,1.11,31.86,-51.48,True,1,5404,-15.46,-74278.59,83545.84,9267.25
1949-08-18,15.5,0.04,0.26,31.86,-51.35,True,1,5405,-15.5,-74294.09,83777.5,9483.41
1949-08-19,15.41,-0.09,-0.58,31.86,-51.63,True,1,5406,-15.41,-74309.5,83306.46,8996.96
1949-08-22,15.37,-0.04,-0.26,31.86,-51.76,True,1,5407,-15.37,-74324.87,83105.59,8780.72
1949-08-23,15.17,-0.2,-1.3,31.86,-52.38,True,1,5408,-15.17,-74340.04,82039.36,7699.32
1949-08-24,15.18,0.01,0.07,31.86,-52.35,True,1,5409,-15.18,-74355.22,82108.62,7753.4
1949-08-25,15.22,0.04,0.26,31.86,-52.23,True,1,5410,-15.22,-74370.44,82340.2,7969.76
1949-08-26,15.28,0.06,0.39,31.86,-52.04,True,1,5411,-15.28,-74385.72,82680.08,8294.36
1949-08-29,15.12,-0.16,-1.05,31.86,-52.54,True,1,5412,-15.12,-74400.84,81829.44,7428.6
1949-08-30,15.21,0.09,0.6,31.86,-52.26,True,1,5413,-15.21,-74416.05,82331.73,7915.68
1949-08-31,15.22,0.01,0.07,31.86,-52.23,True,1,5414,-15.22,-74431.27,82401.08,7969.81
1949-09-01,15.31,0.09,0.59,31.86,-51.95,True,1,5415,-15.31,-74446.58,82903.65,8457.07
1949-09-02,15.29,-0.02,-0.13,31.86,-52.01,True,1,5416,-15.29,-74461.87,82810.64,8348.77
1949-09-06,15.28,-0.01,-0.06,31.86,-52.04,True,1,5417,-15.28,-74477.15,82771.76,8294.61
1949-09-07,15.38,0.1,0.65,31.86,-51.73,True,1,5418,-15.38,-74492.53,83328.84,8836.31
1949-09-08,15.41,0.03,0.2,31.86,-51.63,True,1,5419,-15.41,-74507.94,83506.79,8998.85
1949-09-09,15.4,-0.01,-0.06,31.86,-51.66,True,1,5420,-15.4,-74523.34,83468.0,8944.66
1949-09-12,15.52,0.12,0.78,31.86,-51.29,True,1,5421,-15.52,-74538.86,84133.92,9595.06
1949-09-13,15.74,0.22,1.42,31.86,-50.6,True,1,5422,-15.74,-74554.6,85342.28,10787.68
1949-09-14,15.73,-0.01,-0.06,31.86,-50.63,True,1,5423,-15.73,-74570.33,85303.79,10733.46
1949-09-15,15.61,-0.12,-0.76,31.86,-51.0,True,1,5424,-15.61,-74585.94,84668.64,10082.7
1949-09-16,15.66,0.05,0.32,31.86,-50.85,True,1,5425,-15.66,-74601.6,84955.5,10353.9
1949-09-19,15.55,-0.11,-0.7,31.86,-51.19,True,1,5426,-15.55,-74617.15,84374.3,9757.15
1949-09-20,15.19,-0.36,-2.32,31.86,-52.32,True,1,5427,-15.19,-74632.34,82436.13,7803.79
1949-09-21,15.41,0.22,1.45,31.86,-51.63,True,1,5428,-15.41,-74647.75,83645.48,8997.73
1949-09-22,15.5,0.09,0.58,31.86,-51.35,True,1,5429,-15.5,-74663.25,84149.5,9486.25
1949-09-23,15.57,0.07,0.45,31.86,-51.13,True,1,5430,-15.57,-74678.82,84545.1,9866.28
1949-09-26,15.53,-0.04,-0.26,31.86,-51.26,True,1,5431,-15.53,-74694.35,84343.43,9649.08
1949-09-27,15.41,-0.12,-0.77,31.86,-51.63,True,1,5432,-15.41,-74709.76,83707.12,8997.36
1949-09-28,15.53,0.12,0.78,31.86,-51.26,True,1,5433,-15.53,-74725.29,84374.49,9649.2
1949-09-29,15.62,0.09,0.58,31.86,-50.97,True,1,5434,-15.62,-74740.91,84879.08,10138.17
1949-09-30,15.58,-0.04,-0.26,31.86,-51.1,True,1,5435,-15.58,-74756.49,84677.3,9920.81
1949-10-03,15.6,0.02,0.13,31.86,-51.04,True,1,5436,-15.6,-74772.09,84801.6,10029.51
1949-10-04,15.75,0.15,0.96,31.86,-50.56,True,1,5437,-15.75,-74787.84,85632.75,10844.91
1949-10-05,15.78,0.03,0.19,31.86,-50.47,True,1,5438,-15.78,-74803.62,85811.64,11008.02
1949-10-06,15.84,0.06,0.38,31.86,-50.28,True,1,5439,-15.84,-74819.46,86153.76,11334.3
1949-10-07,15.85,0.01,0.06,31.86,-50.25,True,1,5440,-15.85,-74835.31,86224.0,11388.69
1949-10-10,15.83,-0.02,-0.13,31.86,-50.31,True,1,5441,-15.83,-74851.14,86131.03,11279.89
1949-10-11,15.97,0.14,0.88,31.86,-49.87,True,1,5442,-15.97,-74867.11,86908.74,12041.63
1949-10-13,15.97,0.0,0.0,31.86,-49.87,True,1,5443,-15.97,-74883.08,86924.71,12041.63
1949-10-14,15.91,-0.06,-0.38,31.86,-50.06,True,1,5444,-15.91,-74898.99,86614.04,11715.05
1949-10-17,15.73,-0.18,-1.13,31.86,-50.63,True,1,5445,-15.73,-74914.72,85649.85,10735.13
1949-10-18,15.84,0.11,0.7,31.86,-50.28,True,1,5446,-15.84,-74930.56,86264.64,11334.08
1949-10-19,15.93,0.09,0.57,31.86,-50.0,True,1,5447,-15.93,-74946.49,86770.71,11824.22
1949-10-20,15.9,-0.03,-0.19,31.86,-50.09,True,1,5448,-15.9,-74962.39,86623.2,11660.81
1949-10-21,15.85,-0.05,-0.31,31.86,-50.25,True,1,5449,-15.85,-74978.24,86366.65,11388.41
1949-10-24,15.87,0.02,0.13,31.86,-50.19,True,1,5450,-15.87,-74994.11,86491.5,11497.39
1949-10-25,15.95,0.08,0.5,31.86,-49.94,True,1,5451,-15.95,-75010.06,86943.45,11933.39
1949-10-26,16.06,0.11,0.69,31.86,-49.59,True,1,5452,-16.06,-75026.12,87559.12,12533.0
1949-10-27,16.15,0.09,0.56,31.86,-49.31,True,1,5453,-16.15,-75042.27,88065.95,13023.68
1949-10-28,16.08,-0.07,-0.43,31.86,-49.53,True,1,5454,-16.08,-75058.35,87700.32,12641.97
1949-10-31,16.04,-0.04,-0.25,31.86,-49.66,True,1,5455,-16.04,-75074.39,87498.2,12423.81
1949-11-01,16.2,0.16,1.0,31.86,-49.15,True,1,5456,-16.2,-75090.59,88387.2,13296.61
1949-11-02,16.33,0.13,0.8,31.86,-48.74,True,1,5457,-16.33,-75106.92,89112.81,14005.89
1949-11-03,16.29,-0.04,-0.24,31.86,-48.87,True,1,5458,-16.29,-75123.21,88910.82,13787.61
1949-11-04,16.21,-0.08,-0.49,31.86,-49.12,True,1,5459,-16.21,-75139.42,88490.39,13350.97
1949-11-07,16.16,-0.05,-0.31,31.86,-49.28,True,1,5460,-16.16,-75155.58,88233.6,13078.02
1949-11-09,16.18,0.02,0.12,31.86,-49.22,True,1,5461,-16.18,-75171.76,88358.98,13187.22
1949-11-10,16.14,-0.04,-0.25,31.86,-49.34,True,1,5462,-16.14,-75187.9,88156.68,12968.78
1949-11-14,16.03,-0.11,-0.68,31.86,-49.69,True,1,5463,-16.03,-75203.93,87571.89,12367.96
1949-11-15,15.75,-0.28,-1.75,31.86,-50.56,True,1,5464,-15.75,-75219.68,86058.0,10838.32
1949-11-16,15.84,0.09,0.57,31.86,-50.28,True,1,5465,-15.84,-75235.52,86565.6,11330.08
1949-11-17,15.96,0.12,0.76,31.86,-49.91,True,1,5466,-15.96,-75251.48,87237.36,11985.88
1949-11-18,16.14,0.18,1.13,31.86,-49.34,True,1,5467,-16.14,-75267.62,88237.38,12969.76
1949-11-21,16.07,-0.07,-0.43,31.86,-49.56,True,1,5468,-16.07,-75283.69,87870.76,12587.07
1949-11-22,16.15,0.08,0.5,31.86,-49.31,True,1,5469,-16.15,-75299.84,88324.35,13024.51
1949-11-23,16.19,0.04,0.25,31.86,-49.18,True,1,5470,-16.19,-75316.03,88559.3,13243.27
1949-11-25,16.1,-0.09,-0.56,31.86,-49.47,True,1,5471,-16.1,-75332.13,88083.1,12750.97
1949-11-28,16.05,-0.05,-0.31,31.86,-49.62,True,1,5472,-16.05,-75348.18,87825.6,12477.42
1949-11-29,16.02,-0.03,-0.19,31.86,-49.72,True,1,5473,-16.02,-75364.2,87677.46,12313.26
1949-11-30,16.06,0.04,0.25,31.86,-49.59,True,1,5474,-16.06,-75380.26,87912.44,12532.18
1949-12-01,16.15,0.09,0.56,31.86,-49.31,True,1,5475,-16.15,-75396.41,88421.25,13024.84
1949-12-02,16.28,0.13,0.8,31.86,-48.9,True,1,5476,-16.28,-75412.69,89149.28,13736.59
1949-12-05,16.41,0.13,0.8,31.86,-48.49,True,1,5477,-16.41,-75429.1,89877.57,14448.47
1949-12-06,16.39,-0.02,-0.12,31.86,-48.56,True,1,5478,-16.39,-75445.49,89784.42,14338.93
1949-12-07,16.43,0.04,0.24,31.86,-48.43,True,1,5479,-16.43,-75461.92,90019.97,14558.05
1949-12-08,16.43,0.0,0.0,31.86,-48.43,True,1,5480,-16.43,-75478.35,90036.4,14558.05
1949-12-09,16.42,-0.01,-0.06,31.86,-48.46,True,1,5481,-16.42,-75494.77,89998.02,14503.25
1949-12-12,16.57,0.15,0.91,31.86,-47.99,True,1,5482,-16.57,-75511.34,90836.74,15325.4
1949-12-13,16.64,0.07,0.42,31.86,-47.77,True,1,5483,-16.64,-75527.98,91237.12,15709.14
1949-12-14,16.67,0.03,0.18,31.86,-47.68,True,1,5484,-16.67,-75544.65,91418.28,15873.63
1949-12-15,16.68,0.01,0.06,31.86,-47.65,True,1,5485,-16.68,-75561.33,91489.8,15928.47
1949-12-16,16.66,-0.02,-0.12,31.86,-47.71,True,1,5486,-16.66,-75577.99,91396.76,15818.77
1949-12-19,16.59,-0.07,-0.42,31.86,-47.93,True,1,5487,-16.59,-75594.58,91029.33,15434.75
1949-12-20,16.53,-0.06,-0.36,31.86,-48.12,True,1,5488,-16.53,-75611.11,90716.64,15105.53
1949-12-21,16.49,-0.04,-0.24,31.86,-48.24,True,1,5489,-16.49,-75627.6,90513.61,14886.01
1949-12-22,16.64,0.15,0.91,31.86,-47.77,True,1,5490,-16.64,-75644.24,91353.6,15709.36
1949-12-23,16.64,0.0,0.0,31.86,-47.77,True,1,5491,-16.64,-75660.88,91370.24,15709.36
1949-12-27,16.58,-0.06,-0.36,31.86,-47.96,True,1,5492,-16.58,-75677.46,91057.36,15379.9
1949-12-28,16.66,0.08,0.48,31.86,-47.71,True,1,5493,-16.66,-75694.12,91513.38,15819.26
1949-12-29,16.68,0.02,0.12,31.86,-47.65,True,1,5494,-16.68,-75710.8,91639.92,15929.12
1949-12-30,16.79,0.11,0.66,31.86,-47.3,True,1,5495,-16.79,-75727.59,92261.05,16533.46
1950-01-03,16.66,-0.13,-0.77,31.86,-47.71,True,1,5496,-16.66,-75744.25,91563.36,15819.11
1950-01-04,16.85,0.19,1.14,31.86,-47.11,True,1,5497,-16.85,-75761.1,92624.45,16863.35
1950-01-05,16.93,0.08,0.48,31.86,-46.86,True,1,5498,-16.93,-75778.03,93081.14,17303.11
1950-01-06,16.98,0.05,0.3,31.86,-46.7,True,1,5499,-16.98,-75795.01,93373.02,17578.01
1950-01-09,17.08,0.1,0.59,31.86,-46.39,True,1,5500,-17.08,-75812.09,93940.0,18127.91
1950-01-10,17.03,-0.05,-0.29,31.86,-46.55,True,1,5501,-17.03,-75829.12,93682.03,17852.91
1950-01-11,17.09,0.06,0.35,31.86,-46.36,True,1,5502,-17.09,-75846.21,94029.18,18182.97
1950-01-12,16.76,-0.33,-1.93,31.86,-47.4,True,1,5503,-16.76,-75862.97,92230.28,16367.31
1950-01-13,16.67,-0.09,-0.54,31.86,-47.68,True,1,5504,-16.67,-75879.64,91751.68,15872.04
1950-01-16,16.72,0.05,0.3,31.86,-47.52,True,1,5505,-16.72,-75896.36,92043.6,16147.24
1950-01-17,16.86,0.14,0.84,31.86,-47.08,True,1,5506,-16.86,-75913.22,92831.16,16917.94
1950-01-18,16.85,-0.01,-0.06,31.86,-47.11,True,1,5507,-16.85,-75930.07,92792.95,16862.88
1950-01-19,16.87,0.02,0.12,31.86,-47.05,True,1,5508,-16.87,-75946.94,92919.96,16973.02
1950-01-20,16.9,0.03,0.18,31.86,-46.96,True,1,5509,-16.9,-75963.84,93102.1,17138.26
1950-01-23,16.92,0.02,0.12,31.86,-46.89,True,1,5510,-16.92,-75980.76,93229.2,17248.44
1950-01-24,16.86,-0.06,-0.36,31.86,-47.08,True,1,5511,-16.86,-75997.62,92915.46,16917.84
1950-01-25,16.74,-0.12,-0.71,31.86,-47.46,True,1,5512,-16.74,-76014.36,92270.88,16256.52
1950-01-26,16.73,-0.01,-0.06,31.86,-47.49,True,1,5513,-16.73,-76031.09,92232.49,16201.4
1950-01-27,16.82,0.09,0.54,31.86,-47.21,True,1,5514,-16.82,-76047.91,92745.48,16697.57
1950-01-30,17.02,0.2,1.19,31.86,-46.58,True,1,5515,-17.02,-76064.93,93865.3,17800.37
1950-01-31,17.05,0.03,0.18,31.86,-46.48,True,1,5516,-17.05,-76081.98,94047.8,17965.82
1950-02-01,17.05,0.0,0.0,31.86,-46.48,True,1,5517,-17.05,-76099.03,94064.85,17965.82
1950-02-02,17.23,0.18,1.06,31.86,-45.92,True,1,5518,-17.23,-76116.26,95075.14,18958.88
1950-02-03,17.29,0.06,0.35,31.86,-45.73,True,1,5519,-17.29,-76133.55,95423.51,19289.96
1950-02-06,17.32,0.03,0.17,31.86,-45.64,True,1,5520,-17.32,-76150.87,95606.4,19455.53
1950-02-07,17.23,-0.09,-0.52,31.86,-45.92,True,1,5521,-17.23,-76168.1,95126.83,18958.73
1950-02-08,17.21,-0.02,-0.12,31.86,-45.98,True,1,5522,-17.21,-76185.31,95033.62,18848.31
1950-02-09,17.28,0.07,0.41,31.86,-45.76,True,1,5523,-17.28,-76202.59,95437.44,19234.85
1950-02-10,17.24,-0.04,-0.23,31.86,-45.89,True,1,5524,-17.24,-76219.83,95233.76,19013.93
1950-02-14,17.06,-0.18,-1.04,31.86,-46.45,True,1,5525,-17.06,-76236.89,94256.5,18019.61
1950-02-15,17.06,0.0,0.0,31.86,-46.45,True,1,5526,-17.06,-76253.95,94273.56,18019.61
1950-02-16,16.99,-0.07,-0.41,31.86,-46.67,True,1,5527,-16.99,-76270.94,93903.73,17632.79
1950-02-17,17.15,0.16,0.94,31.86,-46.17,True,1,5528,-17.15,-76288.09,94805.2,18517.11
1950-02-20,17.2,0.05,0.29,31.86,-46.01,True,1,5529,-17.2,-76305.29,95098.8,18793.51
1950-02-21,17.17,-0.03,-0.17,31.86,-46.11,True,1,5530,-17.17,-76322.46,94950.1,18627.64
1950-02-23,17.21,0.04,0.23,31.86,-45.98,True,1,5531,-17.21,-76339.67,95188.51,18848.84
1950-02-24,17.28,0.07,0.41,31.86,-45.76,True,1,5532,-17.28,-76356.95,95592.96,19236.01
1950-02-27,17.28,0.0,0.0,31.86,-45.76,True,1,5533,-17.28,-76374.23,95610.24,19236.01
1950-02-28,17.22,-0.06,-0.35,31.86,-45.95,True,1,5534,-17.22,-76391.45,95295.48,18904.03
1950-03-01,17.24,0.02,0.12,31.86,-45.89,True,1,5535,-17.24,-76408.69,95423.4,19014.71
1950-03-02,17.23,-0.01,-0.06,31.86,-45.92,True,1,5536,-17.23,-76425.92,95385.28,18959.36
1950-03-03,17.29,0.06,0.35,31.86,-45.73,True,1,5537,-17.29,-76443.21,95734.73,19291.52
1950-03-06,17.32,0.03,0.17,31.86,-45.64,True,1,5538,-17.32,-76460.53,95918.16,19457.63
1950-03-07,17.2,-0.12,-0.69,31.86,-46.01,True,1,5539,-17.2,-76477.73,95270.8,18793.07
1950-03-08,17.19,-0.01,-0.06,31.86,-46.04,True,1,5540,-17.19,-76494.92,95232.6,18737.68
1950-03-09,17.07,-0.12,-0.7,31.86,-46.42,True,1,5541,-17.07,-76511.99,94584.87,18072.88
1950-03-10,17.09,0.02,0.12,31.86,-46.36,True,1,5542,-17.09,-76529.08,94712.78,18183.7
1950-03-13,17.12,0.03,0.18,31.86,-46.26,True,1,5543,-17.12,-76546.2,94896.16,18349.96
1950-03-14,17.25,0.13,0.76,31.86,-45.86,True,1,5544,-17.25,-76563.45,95634.0,19070.55
1950-03-15,17.45,0.2,1.16,31.86,-45.23,True,1,5545,-17.45,-76580.9,96760.25,20179.35
1950-03-16,17.49,0.04,0.23,31.86,-45.1,True,1,5546,-17.49,-76598.39,96999.54,20401.15
1950-03-17,17.45,-0.04,-0.23,31.86,-45.23,True,1,5547,-17.45,-76615.84,96795.15,20179.31
1950-03-20,17.44,-0.01,-0.06,31.86,-45.26,True,1,5548,-17.44,-76633.28,96757.12,20123.84
1950-03-21,17.45,0.01,0.06,31.86,-45.23,True,1,5549,-17.45,-76650.73,96830.05,20179.32
1950-03-22,17.55,0.1,0.57,31.86,-44.92,True,1,5550,-17.55,-76668.28,97402.5,20734.22
1950-03-23,17.56,0.01,0.06,31.86,-44.88,True,1,5551,-17.56,-76685.84,97475.56,20789.72
1950-03-24,17.56,0.0,0.0,31.86,-44.88,True,1,5552,-17.56,-76703.4,97493.12,20789.72
1950-03-27,17.46,-0.1,-0.57,31.86,-45.2,True,1,5553,-17.46,-76720.86,96955.38,20234.52
1950-03-28,17.53,0.07,0.4,31.86,-44.98,True,1,5554,-17.53,-76738.39,97361.62,20623.23
1950-03-29,17.44,-0.09,-0.51,31.86,-45.26,True,1,5555,-17.44,-76755.83,96879.2,20123.37
1950-03-30,17.3,-0.14,-0.8,31.86,-45.7,True,1,5556,-17.3,-76773.13,96118.8,19345.67
1950-03-31,17.29,-0.01,-0.06,31.86,-45.73,True,1,5557,-17.29,-76790.42,96080.53,19290.11
1950-04-03,17.53,0.24,1.39,31.86,-44.98,True,1,5558,-17.53,-76807.95,97431.74,20623.79
1950-04-04,17.55,0.02,0.11,31.86,-44.92,True,1,5559,-17.55,-76825.5,97560.45,20734.95
1950-04-05,17.63,0.08,0.46,31.86,-44.66,True,1,5560,-17.63,-76843.13,98022.8,21179.67
1950-04-06,17.78,0.15,0.85,31.86,-44.19,True,1,5561,-17.78,-76860.91,98874.58,22013.67
1950-04-10,17.85,0.07,0.39,31.86,-43.97,True,1,5562,-17.85,-76878.76,99281.7,22402.94
1950-04-11,17.75,-0.1,-0.56,31.86,-44.29,True,1,5563,-17.75,-76896.51,98743.25,21846.74
1950-04-12,17.94,0.19,1.07,31.86,-43.69,True,1,5564,-17.94,-76914.45,99818.16,22903.71
1950-04-13,17.98,0.04,0.22,31.86,-43.57,True,1,5565,-17.98,-76932.43,100058.7,23126.27
1950-04-14,17.96,-0.02,-0.11,31.86,-43.63,True,1,5566,-17.96,-76950.39,99965.36,23014.97
1950-04-17,17.88,-0.08,-0.44,31.86,-43.88,True,1,5567,-17.88,-76968.27,99537.96,22569.69
1950-04-18,18.03,0.15,0.84,31.86,-43.41,True,1,5568,-18.03,-76986.3,100391.04,23404.74
1950-04-19,18.05,0.02,0.11,31.86,-43.35,True,1,5569,-18.05,-77004.35,100520.45,23516.1
1950-04-20,17.93,-0.12,-0.66,31.86,-43.72,True,1,5570,-17.93,-77022.28,99870.1,22847.82
1950-04-21,17.96,0.03,0.17,31.86,-43.63,True,1,5571,-17.96,-77040.24,100055.16,23014.92
1950-04-24,17.83,-0.13,-0.72,31.86,-44.04,True,1,5572,-17.83,-77058.07,99348.76,22290.69
1950-04-25,17.83,0.0,0.0,31.86,-44.04,True,1,5573,-17.83,-77075.9,99366.59,22290.69
1950-04-26,17.76,-0.07,-0.39,31.86,-44.26,True,1,5574,-17.76,-77093.66,98994.24,21900.58
1950-04-27,17.86,0.1,0.56,31.86,-43.94,True,1,5575,-17.86,-77111.52,99569.5,22457.98
1950-04-28,17.96,0.1,0.56,31.86,-43.63,True,1,5576,-17.96,-77129.48,100144.96,23015.48
1950-05-01,18.22,0.26,1.45,31.86,-42.81,True,1,5577,-18.22,-77147.7,101612.94,24465.24
1950-05-02,18.11,-0.11,-0.6,31.86,-43.16,True,1,5578,-18.11,-77165.81,101017.58,23851.77
1950-05-03,18.27,0.16,0.88,31.86,-42.66,True,1,5579,-18.27,-77184.08,101928.33,24744.25
1950-05-04,18.12,-0.15,-0.82,31.86,-43.13,True,1,5580,-18.12,-77202.2,101109.6,23907.4
1950-05-05,18.22,0.1,0.55,31.86,-42.81,True,1,5581,-18.22,-77220.42,101685.82,24465.4
1950-05-08,18.27,0.05,0.27,31.86,-42.66,True,1,5582,-18.27,-77238.69,101983.14,24744.45
1950-05-09,18.27,0.0,0.0,31.86,-42.66,True,1,5583,-18.27,-77256.96,102001.41,24744.45
1950-05-10,18.29,0.02,0.11,31.86,-42.59,True,1,5584,-18.29,-77275.25,102131.36,24856.11
1950-05-11,18.29,0.0,0.0,31.86,-42.59,True,1,5585,-18.29,-77293.54,102149.65,24856.11
1950-05-12,18.18,-0.11,-0.6,31.86,-42.94,True,1,5586,-18.18,-77311.72,101553.48,24241.76
1950-05-15,18.26,0.08,0.44,31.86,-42.69,True,1,5587,-18.26,-77329.98,102018.62,24688.64
1950-05-16,18.44,0.18,0.99,31.86,-42.12,True,1,5588,-18.44,-77348.42,103042.72,25694.3
1950-05-17,18.52,0.08,0.43,31.86,-41.87,True,1,5589,-18.52,-77366.94,103508.28,26141.34
1950-05-18,18.56,0.04,0.22,31.86,-41.74,True,1,5590,-18.56,-77385.5,103750.4,26364.9
1950-05-19,18.68,0.12,0.65,31.86,-41.37,True,1,5591,-18.68,-77404.18,104439.88,27035.7
1950-05-22,18.6,-0.08,-0.43,31.86,-41.62,True,1,5592,-18.6,-77422.78,104011.2,26588.42
1950-05-23,18.71,0.11,0.59,31.86,-41.27,True,1,5593,-18.71,-77441.49,104645.03,27203.54
1950-05-24,18.69,-0.02,-0.11,31.86,-41.34,True,1,5594,-18.69,-77460.18,104551.86,27091.68
1950-05-25,18.69,0.0,0.0,31.86,-41.34,True,1,5595,-18.69,-77478.87,104570.55,27091.68
1950-05-26,18.67,-0.02,-0.11,31.86,-41.4,True,1,5596,-18.67,-77497.54,104477.32,26979.78
1950-05-29,18.72,0.05,0.27,31.86,-41.24,True,1,5597,-18.72,-77516.26,104775.84,27259.58
1950-05-31,18.78,0.06,0.32,31.86,-41.06,True,1,5598,-18.78,-77535.04,105130.44,27595.4
1950-06-01,18.77,-0.01,-0.05,31.86,-41.09,True,1,5599,-18.77,-77553.81,105093.23,27539.42
1950-06-02,18.79,0.02,0.11,31.86,-41.02,True,1,5600,-18.79,-77572.6,105224.0,27651.4
1950-06-05,18.6,-0.19,-1.01,31.86,-41.62,True,1,5601,-18.6,-77591.2,104178.6,26587.4
1950-06-06,18.88,0.28,1.5,31.86,-40.74,True,1,5602,-18.88,-77610.08,105765.76,28155.68
1950-06-07,18.93,0.05,0.26,31.86,-40.58,True,1,5603,-18.93,-77629.01,106064.79,28435.78
1950-06-08,19.14,0.21,1.11,31.86,-39.92,True,1,5604,-19.14,-77648.15,107260.56,29612.41
1950-06-09,19.26,0.12,0.63,31.86,-39.55,True,1,5605,-19.26,-77667.41,107952.3,30284.89
1950-06-12,19.4,0.14,0.73,31.86,-39.11,True,1,5606,-19.4,-77686.81,108756.4,31069.59
1950-06-13,19.25,-0.15,-0.77,31.86,-39.58,True,1,5607,-19.25,-77706.06,107934.75,30228.69
1950-06-14,18.98,-0.27,-1.4,31.86,-40.43,True,1,5608,-18.98,-77725.04,106439.84,28714.8
1950-06-15,18.93,-0.05,-0.26,31.86,-40.58,True,1,5609,-18.93,-77743.97,106178.37,28434.4
1950-06-16,18.97,0.04,0.21,31.86,-40.46,True,1,5610,-18.97,-77762.94,106421.7,28658.76
1950-06-19,18.92,-0.05,-0.26,31.86,-40.62,True,1,5611,-18.92,-77781.86,106160.12,28378.26
1950-06-20,18.83,-0.09,-0.48,31.86,-40.9,True,1,5612,-18.83,-77800.69,105673.96,27873.27
1950-06-21,19.0,0.17,0.9,31.86,-40.36,True,1,5613,-19.0,-77819.69,106647.0,28827.31
1950-06-22,19.16,0.16,0.84,31.86,-39.86,True,1,5614,-19.16,-77838.85,107564.24,29725.39
1950-06-23,19.14,-0.02,-0.1,31.86,-39.92,True,1,5615,-19.14,-77857.99,107471.1,29613.11
1950-06-26,18.11,-1.03,-5.38,31.86,-43.16,True,1,5616,-18.11,-77876.1,101705.76,23829.66
1950-06-27,17.91,-0.2,-1.1,31.86,-43.78,True,1,5617,-17.91,-77894.01,100600.47,22706.46
1950-06-28,18.11,0.2,1.12,31.86,-43.16,True,1,5618,-18.11,-77912.12,101741.98,23829.86
1950-06-29,17.44,-0.67,-3.7,31.86,-45.26,True,1,5619,-17.44,-77929.56,97995.36,20065.8
1950-06-30,17.69,0.25,1.43,31.86,-44.48,True,1,5620,-17.69,-77947.25,99417.8,21470.55
1950-07-03,17.64,-0.05,-0.28,31.86,-44.63,True,1,5621,-17.64,-77964.89,99154.44,21189.55
1950-07-05,17.81,0.17,0.96,31.86,-44.1,True,1,5622,-17.81,-77982.7,100127.82,22145.12
1950-07-06,17.91,0.1,0.56,31.86,-43.78,True,1,5623,-17.91,-78000.61,100707.93,22707.32
1950-07-07,17.67,-0.24,-1.34,31.86,-44.54,True,1,5624,-17.67,-78018.28,99376.08,21357.8
1950-07-10,17.59,-0.08,-0.45,31.86,-44.79,True,1,5625,-17.59,-78035.87,98943.75,20907.88
1950-07-11,17.32,-0.27,-1.54,31.86,-45.64,True,1,5626,-17.32,-78053.19,97442.32,19389.13
1950-07-12,16.87,-0.45,-2.6,31.86,-47.05,True,1,5627,-16.87,-78070.06,94927.49,16857.43
1950-07-13,16.69,-0.18,-1.07,31.86,-47.62,True,1,5628,-16.69,-78086.75,93931.32,15844.57
1950-07-14,16.87,0.18,1.08,31.86,-47.05,True,1,5629,-16.87,-78103.62,94961.23,16857.61
1950-07-17,16.68,-0.19,-1.13,31.86,-47.65,True,1,5630,-16.68,-78120.3,93908.4,15788.1
1950-07-18,17.06,0.38,2.28,31.86,-46.45,True,1,5631,-17.06,-78137.36,96064.86,17927.5
1950-07-19,17.36,0.3,1.76,31.86,-45.51,True,1,5632,-17.36,-78154.72,97771.52,19616.8
1950-07-20,17.61,0.25,1.44,31.86,-44.73,True,1,5633,-17.61,-78172.33,99197.13,21024.8
1950-07-21,17.59,-0.02,-0.11,31.86,-44.79,True,1,5634,-17.59,-78189.92,99102.06,20912.14
1950-07-24,17.48,-0.11,-0.62,31.86,-45.14,True,1,5635,-17.48,-78207.4,98499.8,20292.4
1950-07-25,17.23,-0.25,-1.43,31.86,-45.92,True,1,5636,-17.23,-78224.63,97108.28,18883.65
1950-07-26,17.27,0.04,0.23,31.86,-45.79,True,1,5637,-17.27,-78241.9,97350.99,19109.09
1950-07-27,17.5,0.23,1.33,31.86,-45.07,True,1,5638,-17.5,-78259.4,98665.0,20405.6
1950-07-28,17.69,0.19,1.09,31.86,-44.48,True,1,5639,-17.69,-78277.09,99753.91,21476.82
1950-07-31,17.84,0.15,0.85,31.86,-44.0,True,1,5640,-17.84,-78294.93,100617.6,22322.67
1950-08-01,18.02,0.18,1.01,31.86,-43.44,True,1,5641,-18.02,-78312.95,101650.82,23337.87
1950-08-02,17.95,-0.07,-0.39,31.86,-43.66,True,1,5642,-17.95,-78330.9,101273.9,22943.0
1950-08-03,17.99,0.04,0.22,31.86,-43.53,True,1,5643,-17.99,-78348.89,101517.57,23168.68
1950-08-04,18.14,0.15,0.83,31.86,-43.06,True,1,5644,-18.14,-78367.03,102382.16,24015.13
1950-08-07,18.41,0.27,1.49,31.86,-42.22,True,1,5645,-18.41,-78385.44,103924.45,25539.01
1950-08-08,18.46,0.05,0.27,31.86,-42.06,True,1,5646,-18.46,-78403.9,104225.16,25821.26
1950-08-09,18.61,0.15,0.81,31.86,-41.59,True,1,5647,-18.61,-78422.51,105090.67,26668.16
1950-08-10,18.48,-0.13,-0.7,31.86,-42.0,True,1,5648,-18.48,-78440.99,104375.04,25934.05
1950-08-11,18.28,-0.2,-1.08,31.86,-42.62,True,1,5649,-18.28,-78459.27,103263.72,24804.45
1950-08-14,18.29,0.01,0.06,31.86,-42.59,True,1,5650,-18.29,-78477.56,103338.5,24860.94
1950-08-15,18.32,0.03,0.16,31.86,-42.5,True,1,5651,-18.32,-78495.88,103526.32,25030.44
1950-08-16,18.34,0.02,0.11,31.86,-42.44,True,1,5652,-18.34,-78514.22,103657.68,25143.46
1950-08-17,18.54,0.2,1.09,31.86,-41.81,True,1,5653,-18.54,-78532.76,104806.62,26273.86
1950-08-18,18.68,0.14,0.76,31.86,-41.37,True,1,5654,-18.68,-78551.44,105616.72,27065.28
1950-08-21,18.7,0.02,0.11,31.86,-41.31,True,1,5655,-18.7,-78570.14,105748.5,27178.36
1950-08-22,18.68,-0.02,-0.11,31.86,-41.37,True,1,5656,-18.68,-78588.82,105654.08,27065.26
1950-08-23,18.82,0.14,0.75,31.86,-40.93,True,1,5657,-18.82,-78607.64,106464.74,27857.1
1950-08-24,18.79,-0.03,-0.16,31.86,-41.02,True,1,5658,-18.79,-78626.43,106313.82,27687.39
1950-08-25,18.54,-0.25,-1.33,31.86,-41.81,True,1,5659,-18.54,-78644.97,104917.86,26272.89
1950-08-28,18.53,-0.01,-0.05,31.86,-41.84,True,1,5660,-18.53,-78663.5,104879.8,26216.3
1950-08-29,18.54,0.01,0.05,31.86,-41.81,True,1,5661,-18.54,-78682.04,104954.94,26272.9
1950-08-30,18.43,-0.11,-0.59,31.86,-42.15,True,1,5662,-18.43,-78700.47,104350.66,25650.19
1950-08-31,18.42,-0.01,-0.05,31.86,-42.18,True,1,5663,-18.42,-78718.89,104312.46,25593.57
1950-09-01,18.55,0.13,0.71,31.86,-41.78,True,1,5664,-18.55,-78737.44,105067.2,26329.76
1950-09-05,18.68,0.13,0.7,31.86,-41.37,True,1,5665,-18.68,-78756.12,105822.2,27066.08
1950-09-06,18.54,-0.14,-0.75,31.86,-41.81,True,1,5666,-18.54,-78774.66,105047.64,26272.98
1950-09-07,18.59,0.05,0.27,31.86,-41.65,True,1,5667,-18.59,-78793.25,105349.53,26556.28
1950-09-08,18.75,0.16,0.86,31.86,-41.15,True,1,5668,-18.75,-78812.0,106275.0,27463.0
1950-09-11,18.61,-0.14,-0.75,31.86,-41.59,True,1,5669,-18.61,-78830.61,105500.09,26669.48
1950-09-12,18.87,0.26,1.4,31.86,-40.77,True,1,5670,-18.87,-78849.48,106992.9,28143.42
1950-09-13,19.09,0.22,1.17,31.86,-40.08,True,1,5671,-19.09,-78868.57,108259.39,29390.82
1950-09-14,19.18,0.09,0.47,31.86,-39.8,True,1,5672,-19.18,-78887.75,108788.96,29901.21
1950-09-15,19.29,0.11,0.57,31.86,-39.45,True,1,5673,-19.29,-78907.04,109432.17,30525.13
1950-09-18,19.37,0.08,0.42,31.86,-39.2,True,1,5674,-19.37,-78926.41,109905.38,30978.97
1950-09-19,19.31,-0.06,-0.31,31.86,-39.39,True,1,5675,-19.31,-78945.72,109584.25,30638.53
1950-09-20,19.21,-0.1,-0.52,31.86,-39.7,True,1,5676,-19.21,-78964.93,109035.96,30071.03
1950-09-21,19.37,0.16,0.83,31.86,-39.2,True,1,5677,-19.37,-78984.3,109963.49,30979.19
1950-09-22,19.44,0.07,0.36,31.86,-38.98,True,1,5678,-19.44,-79003.74,110380.32,31376.58
1950-09-25,19.42,-0.02,-0.1,31.86,-39.05,True,1,5679,-19.42,-79023.16,110286.18,31263.02
1950-09-26,19.14,-0.28,-1.44,31.86,-39.92,True,1,5680,-19.14,-79042.3,108715.2,29672.9
1950-09-27,19.41,0.27,1.41,31.86,-39.08,True,1,5681,-19.41,-79061.71,110268.21,31206.5
1950-09-28,19.42,0.01,0.05,31.86,-39.05,True,1,5682,-19.42,-79081.13,110344.44,31263.31
1950-09-29,19.45,0.03,0.15,31.86,-38.95,True,1,5683,-19.45,-79100.58,110534.35,31433.77
1950-10-02,19.69,0.24,1.23,31.86,-38.2,True,1,5684,-19.69,-79120.27,111917.96,32797.69
1950-10-03,19.66,-0.03,-0.15,31.86,-38.29,True,1,5685,-19.66,-79139.93,111767.1,32627.17
1950-10-04,20.0,0.34,1.73,31.86,-37.22,True,1,5686,-20.0,-79159.93,113720.0,34560.07
1950-10-05,19.89,-0.11,-0.55,31.86,-37.57,True,1,5687,-19.89,-79179.82,113114.43,33934.61
1950-10-06,20.12,0.23,1.16,31.86,-36.85,True,1,5688,-20.12,-79199.94,114442.56,35242.62
1950-10-09,20.0,-0.12,-0.6,31.86,-37.22,True,1,5689,-20.0,-79219.94,113780.0,34560.06
1950-10-10,19.78,-0.22,-1.1,31.86,-37.92,True,1,5690,-19.78,-79239.72,112548.2,33308.48
1950-10-11,19.86,0.08,0.4,31.86,-37.66,True,1,5691,-19.86,-79259.58,113023.26,33763.68
1950-10-13,19.85,-0.01,-0.05,31.86,-37.7,True,1,5692,-19.85,-79279.43,112986.2,33706.77
1950-10-16,19.71,-0.14,-0.7,31.86,-38.14,True,1,5693,-19.71,-79299.14,112209.03,32909.89
1950-10-17,19.89,0.18,0.91,31.86,-37.57,True,1,5694,-19.89,-79319.03,113253.66,33934.63
1950-10-18,20.01,0.12,0.6,31.86,-37.19,True,1,5695,-20.01,-79339.04,113956.95,34617.91
1950-10-19,20.02,0.01,0.05,31.86,-37.16,True,1,5696,-20.02,-79359.06,114033.92,34674.86
1950-10-20,19.96,-0.06,-0.3,31.86,-37.35,True,1,5697,-19.96,-79379.02,113712.12,34333.1
1950-10-23,19.96,0.0,0.0,31.86,-37.35,True,1,5698,-19.96,-79398.98,113732.08,34333.1
1950-10-24,20.08,0.12,0.6,31.86,-36.97,True,1,5699,-20.08,-79419.06,114435.92,35016.86
1950-10-25,20.05,-0.03,-0.15,31.86,-37.07,True,1,5700,-20.05,-79439.11,114285.0,34845.89
1950-10-26,19.61,-0.44,-2.19,31.86,-38.45,True,1,5701,-19.61,-79458.72,111796.61,32337.89
1950-10-27,19.77,0.16,0.82,31.86,-37.95,True,1,5702,-19.77,-79478.49,112728.54,33250.05
1950-10-30,19.61,-0.16,-0.81,31.86,-38.45,True,1,5703,-19.61,-79498.1,111835.83,32337.73
1950-10-31,19.53,-0.08,-0.41,31.86,-38.7,True,1,5704,-19.53,-79517.63,111399.12,31881.49
1950-11-01,19.56,0.03,0.15,31.86,-38.61,True,1,5705,-19.56,-79537.19,111589.8,32052.61
1950-11-02,19.73,0.17,0.87,31.86,-38.07,True,1,5706,-19.73,-79556.92,112579.38,33022.46
1950-11-03,19.85,0.12,0.61,31.86,-37.7,True,1,5707,-19.85,-79576.77,113283.95,33707.18
1950-11-06,19.36,-0.49,-2.47,31.86,-39.23,True,1,5708,-19.36,-79596.13,110506.88,30910.75
1950-11-08,19.56,0.2,1.03,31.86,-38.61,True,1,5709,-19.56,-79615.69,111668.04,32052.35
1950-11-09,19.79,0.23,1.18,31.86,-37.88,True,1,5710,-19.79,-79635.48,113000.9,33365.42
1950-11-10,19.94,0.15,0.76,31.86,-37.41,True,1,5711,-19.94,-79655.42,113877.34,34221.92
1950-11-13,20.01,0.07,0.35,31.86,-37.19,True,1,5712,-20.01,-79675.43,114297.12,34621.69
1950-11-14,19.86,-0.15,-0.75,31.86,-37.66,True,1,5713,-19.86,-79695.29,113460.18,33764.89
1950-11-15,19.82,-0.04,-0.2,31.86,-37.79,True,1,5714,-19.82,-79715.11,113251.48,33536.37
1950-11-16,19.72,-0.1,-0.5,31.86,-38.1,True,1,5715,-19.72,-79734.83,112699.8,32964.97
1950-11-17,19.86,0.14,0.71,31.86,-37.66,True,1,5716,-19.86,-79754.69,113519.76,33765.07
1950-11-20,19.93,0.07,0.35,31.86,-37.44,True,1,5717,-19.93,-79774.62,113939.81,34165.19
1950-11-21,19.88,-0.05,-0.25,31.86,-37.6,True,1,5718,-19.88,-79794.5,113673.84,33879.34
1950-11-22,20.16,0.28,1.41,31.86,-36.72,True,1,5719,-20.16,-79814.66,115295.04,35480.38
1950-11-24,20.32,0.16,0.79,31.86,-36.22,True,1,5720,-20.32,-79834.98,116230.4,36395.42
1950-11-27,20.18,-0.14,-0.69,31.86,-36.66,True,1,5721,-20.18,-79855.16,115449.78,35594.62
1950-11-28,19.56,-0.62,-3.07,31.86,-38.61,True,1,5722,-19.56,-79874.72,111922.32,32047.6
1950-11-29,19.37,-0.19,-0.97,31.86,-39.2,True,1,5723,-19.37,-79894.09,110854.51,30960.42
1950-11-30,19.51,0.14,0.72,31.86,-38.76,True,1,5724,-19.51,-79913.6,111675.24,31761.64
1950-12-01,19.66,0.15,0.77,31.86,-38.29,True,1,5725,-19.66,-79933.26,112553.5,32620.24
1950-12-04,19.0,-0.66,-3.36,31.86,-40.36,True,1,5726,-19.0,-79952.26,108794.0,28841.74
1950-12-05,19.31,0.31,1.63,31.86,-39.39,True,1,5727,-19.31,-79971.57,110588.37,30616.8
1950-12-06,19.45,0.14,0.72,31.86,-38.95,True,1,5728,-19.45,-79991.02,111409.6,31418.58
1950-12-07,19.4,-0.05,-0.26,31.86,-39.11,True,1,5729,-19.4,-80010.42,111142.6,31132.18
1950-12-08,19.4,0.0,0.0,31.86,-39.11,True,1,5730,-19.4,-80029.82,111162.0,31132.18
1950-12-11,19.72,0.32,1.65,31.86,-38.1,True,1,5731,-19.72,-80049.54,113015.32,32965.78
1950-12-12,19.68,-0.04,-0.2,31.86,-38.23,True,1,5732,-19.68,-80069.22,112805.76,32736.54
1950-12-13,19.67,-0.01,-0.05,31.86,-38.26,True,1,5733,-19.67,-80088.89,112768.11,32679.22
1950-12-14,19.43,-0.24,-1.22,31.86,-39.01,True,1,5734,-19.43,-80108.32,111411.62,31303.3
1950-12-15,19.33,-0.1,-0.52,31.86,-39.33,True,1,5735,-19.33,-80127.65,110857.55,30729.9
1950-12-18,19.85,0.52,2.69,31.86,-37.7,True,1,5736,-19.85,-80147.5,113859.6,33712.1
1950-12-19,19.96,0.11,0.55,31.86,-37.35,True,1,5737,-19.96,-80167.46,114510.52,34343.06
1950-12-20,19.97,0.01,0.05,31.86,-37.32,True,1,5738,-19.97,-80187.43,114587.86,34400.43
1950-12-21,19.98,0.01,0.05,31.86,-37.29,True,1,5739,-19.98,-80207.41,114665.22,34457.81
1950-12-22,20.07,0.09,0.45,31.86,-37.01,True,1,5740,-20.07,-80227.48,115201.8,34974.32
1950-12-26,19.92,-0.15,-0.75,31.86,-37.48,True,1,5741,-19.92,-80247.4,114360.72,34113.32
1950-12-27,20.3,0.38,1.91,31.86,-36.28,True,1,5742,-20.3,-80267.7,116562.6,36294.9
1950-12-28,20.38,0.08,0.39,31.86,-36.03,True,1,5743,-20.38,-80288.08,117042.34,36754.26
1950-12-29,20.43,0.05,0.24,31.86,-35.88,True,1,5744,-20.43,-80308.51,117349.92,37041.41
1951-01-02,20.77,0.34,1.66,31.86,-34.81,True,1,5745,-20.77,-80329.28,119323.65,38994.37
1951-01-03,20.69,-0.08,-0.38,31.86,-35.06,True,1,5746,-20.69,-80349.97,118884.74,38534.77
1951-01-04,20.87,0.18,0.87,31.86,-34.49,True,1,5747,-20.87,-80370.84,119939.89,39569.05
1951-01-05,20.87,0.0,0.0,31.86,-34.49,True,1,5748,-20.87,-80391.71,119960.76,39569.05
1951-01-08,21.0,0.13,0.62,31.86,-34.09,True,1,5749,-21.0,-80412.71,120729.0,40316.29
1951-01-09,21.12,0.12,0.57,31.86,-33.71,True,1,5750,-21.12,-80433.83,121440.0,41006.17
1951-01-10,20.85,-0.27,-1.28,31.86,-34.56,True,1,5751,-20.85,-80454.68,119908.35,39453.67
1951-01-11,21.19,0.34,1.63,31.86,-33.49,True,1,5752,-21.19,-80475.87,121884.88,41409.01
1951-01-12,21.11,-0.08,-0.38,31.86,-33.74,True,1,5753,-21.11,-80496.98,121445.83,40948.85
1951-01-15,21.3,0.19,0.9,31.86,-33.15,True,1,5754,-21.3,-80518.28,122560.2,42041.92
1951-01-16,21.46,0.16,0.75,31.86,-32.64,True,1,5755,-21.46,-80539.74,123502.3,42962.56
1951-01-17,21.55,0.09,0.42,31.86,-32.36,True,1,5756,-21.55,-80561.29,124041.8,43480.51
1951-01-18,21.4,-0.15,-0.7,31.86,-32.83,True,1,5757,-21.4,-80582.69,123199.8,42617.11
1951-01-19,21.36,-0.04,-0.19,31.86,-32.96,True,1,5758,-21.36,-80604.05,122990.88,42386.83
1951-01-22,21.18,-0.18,-0.84,31.86,-33.52,True,1,5759,-21.18,-80625.23,121975.62,41350.39
1951-01-23,21.26,0.08,0.38,31.86,-33.27,True,1,5760,-21.26,-80646.49,122457.6,41811.11
1951-01-24,21.16,-0.1,-0.47,31.86,-33.58,True,1,5761,-21.16,-80667.65,121902.76,41235.11
1951-01-25,21.03,-0.13,-0.61,31.86,-33.99,True,1,5762,-21.03,-80688.68,121174.86,40486.18
1951-01-26,21.26,0.23,1.09,31.86,-33.27,True,1,5763,-21.26,-80709.94,122521.38,41811.44
1951-01-29,21.67,0.41,1.93,31.86,-31.98,True,1,5764,-21.67,-80731.61,124905.88,44174.27
1951-01-30,21.74,0.07,0.32,31.86,-31.76,True,1,5765,-21.74,-80753.35,125331.1,44577.75
1951-01-31,21.66,-0.08,-0.37,31.86,-32.02,True,1,5766,-21.66,-80775.01,124891.56,44116.55
1951-02-01,21.77,0.11,0.51,31.86,-31.67,True,1,5767,-21.77,-80796.78,125547.59,44750.81
1951-02-02,21.96,0.19,0.87,31.86,-31.07,True,1,5768,-21.96,-80818.74,126665.28,45846.54
1951-02-05,22.2,0.24,1.09,31.86,-30.32,True,1,5769,-22.2,-80840.94,128071.8,47230.86
1951-02-06,22.12,-0.08,-0.36,31.86,-30.57,True,1,5770,-22.12,-80863.06,127632.4,46769.34
1951-02-07,21.99,-0.13,-0.59,31.86,-30.98,True,1,5771,-21.99,-80885.05,126904.29,46019.24
1951-02-08,22.09,0.1,0.46,31.86,-30.66,True,1,5772,-22.09,-80907.14,127503.48,46596.34
1951-02-09,22.17,0.08,0.36,31.86,-30.41,True,1,5773,-22.17,-80929.31,127987.41,47058.1
1951-02-13,22.18,0.01,0.04,31.86,-30.38,True,1,5774,-22.18,-80951.49,128067.32,47115.83
1951-02-14,22.12,-0.06,-0.27,31.86,-30.57,True,1,5775,-22.12,-80973.61,127743.0,46769.39
1951-02-15,22.0,-0.12,-0.54,31.86,-30.95,True,1,5776,-22.0,-80995.61,127072.0,46076.39
1951-02-16,22.13,0.13,0.59,31.86,-30.54,True,1,5777,-22.13,-81017.74,127845.01,46827.27
1951-02-19,21.83,-0.3,-1.36,31.86,-31.48,True,1,5778,-21.83,-81039.57,126133.74,45094.17
1951-02-20,21.79,-0.04,-0.18,31.86,-31.61,True,1,5779,-21.79,-81061.36,125924.41,44863.05
1951-02-21,21.86,0.07,0.32,31.86,-31.39,True,1,5780,-21.86,-81083.22,126350.8,45267.58
1951-02-23,21.92,0.06,0.27,31.86,-31.2,True,1,5781,-21.92,-81105.14,126719.52,45614.38
1951-02-26,21.93,0.01,0.05,31.86,-31.17,True,1,5782,-21.93,-81127.07,126799.26,45672.19
1951-02-27,21.76,-0.17,-0.78,31.86,-31.7,True,1,5783,-21.76,-81148.83,125838.08,44689.25
1951-02-28,21.8,0.04,0.18,31.86,-31.58,True,1,5784,-21.8,-81170.63,126091.2,44920.57
1951-03-01,21.85,0.05,0.23,31.86,-31.42,True,1,5785,-21.85,-81192.48,126402.25,45209.77
1951-03-02,21.93,0.08,0.37,31.86,-31.17,True,1,5786,-21.93,-81214.41,126886.98,45672.57
1951-03-05,21.79,-0.14,-0.64,31.86,-31.61,True,1,5787,-21.79,-81236.2,126098.73,44862.53
1951-03-06,21.79,0.0,0.0,31.86,-31.61,True,1,5788,-21.79,-81257.99,126120.52,44862.53
1951-03-07,21.86,0.07,0.32,31.86,-31.39,True,1,5789,-21.86,-81279.85,126547.54,45267.69
1951-03-08,21.95,0.09,0.41,31.86,-31.1,True,1,5790,-21.95,-81301.8,127090.5,45788.7
1951-03-09,21.95,0.0,0.0,31.86,-31.1,True,1,5791,-21.95,-81323.75,127112.45,45788.7
1951-03-12,21.7,-0.25,-1.14,31.86,-31.89,True,1,5792,-21.7,-81345.45,125686.4,44340.95
1951-03-13,21.41,-0.29,-1.34,31.86,-32.8,True,1,5793,-21.41,-81366.86,124028.13,42661.27
1951-03-14,21.25,-0.16,-0.75,31.86,-33.3,True,1,5794,-21.25,-81388.11,123122.5,41734.39
1951-03-15,21.29,0.04,0.19,31.86,-33.18,True,1,5795,-21.29,-81409.4,123375.55,41966.15
1951-03-16,21.64,0.35,1.64,31.86,-32.08,True,1,5796,-21.64,-81431.04,125425.44,43994.4
1951-03-19,21.56,-0.08,-0.37,31.86,-32.33,True,1,5797,-21.56,-81452.6,124983.32,43530.72
1951-03-20,21.52,-0.04,-0.19,31.86,-32.45,True,1,5798,-21.52,-81474.12,124772.96,43298.84
1951-03-21,21.64,0.12,0.56,31.86,-32.08,True,1,5799,-21.64,-81495.76,125490.36,43994.6
1951-03-22,21.73,0.09,0.42,31.86,-31.8,True,1,5800,-21.73,-81517.49,126034.0,44516.51
1951-03-26,21.53,-0.2,-0.92,31.86,-32.42,True,1,5801,-21.53,-81539.02,124895.53,43356.51
1951-03-27,21.51,-0.02,-0.09,31.86,-32.49,True,1,5802,-21.51,-81560.53,124801.02,43240.49
1951-03-28,21.26,-0.25,-1.16,31.86,-33.27,True,1,5803,-21.26,-81581.79,123371.78,41789.99
1951-03-29,21.33,0.07,0.33,31.86,-33.05,True,1,5804,-21.33,-81603.12,123799.32,42196.2
1951-03-30,21.48,0.15,0.7,31.86,-32.58,True,1,5805,-21.48,-81624.6,124691.4,43066.8
1951-04-02,21.32,-0.16,-0.74,31.86,-33.08,True,1,5806,-21.32,-81645.92,123783.92,42138.0
1951-04-03,21.26,-0.06,-0.28,31.86,-33.27,True,1,5807,-21.26,-81667.18,123456.82,41789.64
1951-04-04,21.4,0.14,0.66,31.86,-32.83,True,1,5808,-21.4,-81688.58,124291.2,42602.62
1951-04-05,21.69,0.29,1.36,31.86,-31.92,True,1,5809,-21.69,-81710.27,125997.21,44286.94
1951-04-06,21.72,0.03,0.14,31.86,-31.83,True,1,5810,-21.72,-81731.99,126193.2,44461.21
1951-04-09,21.68,-0.04,-0.18,31.86,-31.95,True,1,5811,-21.68,-81753.67,125982.48,44228.81
1951-04-10,21.65,-0.03,-0.14,31.86,-32.05,True,1,5812,-21.65,-81775.32,125829.8,44054.48
1951-04-11,21.64,-0.01,-0.05,31.86,-32.08,True,1,5813,-21.64,-81796.96,125793.32,43996.36
1951-04-12,21.83,0.19,0.88,31.86,-31.48,True,1,5814,-21.83,-81818.79,126919.62,45100.83
1951-04-13,22.09,0.26,1.19,31.86,-30.66,True,1,5815,-22.09,-81840.88,128453.35,46612.47
1951-04-16,22.04,-0.05,-0.23,31.86,-30.82,True,1,5816,-22.04,-81862.92,128184.64,46321.72
1951-04-17,22.09,0.05,0.23,31.86,-30.66,True,1,5817,-22.09,-81885.01,128497.53,46612.52
1951-04-18,22.13,0.04,0.18,31.86,-30.54,True,1,5818,-22.13,-81907.14,128752.34,46845.2
1951-04-19,22.04,-0.09,-0.41,31.86,-30.82,True,1,5819,-22.04,-81929.18,128250.76,46321.58
1951-04-20,22.04,0.0,0.0,31.86,-30.82,True,1,5820,-22.04,-81951.22,128272.8,46321.58
1951-04-23,22.05,0.01,0.04,31.86,-30.79,True,1,5821,-22.05,-81973.27,128353.05,46379.78
1951-04-24,21.96,-0.09,-0.41,31.86,-31.07,True,1,5822,-21.96,-81995.23,127851.12,45855.89
1951-04-25,21.97,0.01,0.05,31.86,-31.04,True,1,5823,-21.97,-82017.2,127931.31,45914.11
1951-04-26,22.16,0.19,0.86,31.86,-30.45,True,1,5824,-22.16,-82039.36,129059.84,47020.48
1951-04-27,22.39,0.23,1.04,31.86,-29.72,True,1,5825,-22.39,-82061.75,130421.75,48360.0
1951-04-30,22.43,0.04,0.18,31.86,-29.6,True,1,5826,-22.43,-82084.18,130677.18,48593.0
1951-05-01,22.53,0.1,0.45,31.86,-29.28,True,1,5827,-22.53,-82106.71,131282.31,49175.6
1951-05-02,22.62,0.09,0.4,31.86,-29.0,True,1,5828,-22.62,-82129.33,131829.36,49700.03
1951-05-03,22.81,0.19,0.84,31.86,-28.41,True,1,5829,-22.81,-82152.14,132959.49,50807.35
1951-05-04,22.77,-0.04,-0.18,31.86,-28.53,True,1,5830,-22.77,-82174.91,132749.1,50574.19
1951-05-07,22.63,-0.14,-0.62,31.86,-28.97,True,1,5831,-22.63,-82197.54,131955.53,49757.99
1951-05-08,22.61,-0.02,-0.09,31.86,-29.03,True,1,5832,-22.61,-82220.15,131861.52,49641.37
1951-05-09,22.64,0.03,0.13,31.86,-28.94,True,1,5833,-22.64,-82242.79,132059.12,49816.33
1951-05-10,22.51,-0.13,-0.57,31.86,-29.35,True,1,5834,-22.51,-82265.3,131323.34,49058.04
1951-05-11,22.33,-0.18,-0.8,31.86,-29.91,True,1,5835,-22.33,-82287.63,130295.55,48007.92
1951-05-14,22.18,-0.15,-0.67,31.86,-30.38,True,1,5836,-22.18,-82309.81,129442.48,47132.67
1951-05-15,21.76,-0.42,-1.89,31.86,-31.7,True,1,5837,-21.76,-82331.57,127013.12,44681.55
1951-05-16,21.69,-0.07,-0.32,31.86,-31.92,True,1,5838,-21.69,-82353.26,126626.22,44272.96
1951-05-17,21.91,0.22,1.01,31.86,-31.23,True,1,5839,-21.91,-82375.17,127932.49,45557.32
1951-05-18,21.51,-0.4,-1.83,31.86,-32.49,True,1,5840,-21.51,-82396.68,125618.4,43221.72
1951-05-21,21.46,-0.05,-0.23,31.86,-32.64,True,1,5841,-21.46,-82418.14,125347.86,42929.72
1951-05-22,21.36,-0.1,-0.47,31.86,-32.96,True,1,5842,-21.36,-82439.5,124785.12,42345.62
1951-05-23,21.16,-0.2,-0.94,31.86,-33.58,True,1,5843,-21.16,-82460.66,123637.88,41177.22
1951-05-24,21.05,-0.11,-0.52,31.86,-33.93,True,1,5844,-21.05,-82481.71,123016.2,40534.49
1951-05-25,21.03,-0.02,-0.1,31.86,-33.99,True,1,5845,-21.03,-82502.74,122920.35,40417.61
1951-05-28,21.21,0.18,0.86,31.86,-33.43,True,1,5846,-21.21,-82523.95,123993.66,41469.71
1951-05-29,21.35,0.14,0.66,31.86,-32.99,True,1,5847,-21.35,-82545.3,124833.45,42288.15
1951-05-31,21.52,0.17,0.8,31.86,-32.45,True,1,5848,-21.52,-82566.82,125848.96,43282.14
1951-06-01,21.48,-0.04,-0.19,31.86,-32.58,True,1,5849,-21.48,-82588.3,125636.52,43048.22
1951-06-04,21.24,-0.24,-1.12,31.86,-33.33,True,1,5850,-21.24,-82609.54,124254.0,41644.46
1951-06-05,21.33,0.09,0.42,31.86,-33.05,True,1,5851,-21.33,-82630.87,124801.83,42170.96
1951-06-06,21.48,0.15,0.7,31.86,-32.58,True,1,5852,-21.48,-82652.35,125700.96,43048.61
1951-06-07,21.56,0.08,0.37,31.86,-32.33,True,1,5853,-21.56,-82673.91,126190.68,43516.77
1951-06-08,21.49,-0.07,-0.32,31.86,-32.55,True,1,5854,-21.49,-82695.4,125802.46,43107.06
1951-06-11,21.61,0.12,0.56,31.86,-32.17,True,1,5855,-21.61,-82717.01,126526.55,43809.54
1951-06-12,21.52,-0.09,-0.42,31.86,-32.45,True,1,5856,-21.52,-82738.53,126021.12,43282.59
1951-06-13,21.55,0.03,0.14,31.86,-32.36,True,1,5857,-21.55,-82760.08,126218.35,43458.27
1951-06-14,21.84,0.29,1.35,31.86,-31.45,True,1,5858,-21.84,-82781.92,127938.72,45156.8
1951-06-15,22.04,0.2,0.92,31.86,-30.82,True,1,5859,-22.04,-82803.96,129132.36,46328.4
1951-06-18,22.05,0.01,0.04,31.86,-30.79,True,1,5860,-22.05,-82826.01,129213.0,46386.99
1951-06-19,22.02,-0.03,-0.14,31.86,-30.88,True,1,5861,-22.02,-82848.03,129059.22,46211.19
1951-06-20,21.91,-0.11,-0.5,31.86,-31.23,True,1,5862,-21.91,-82869.94,128436.42,45566.48
1951-06-21,21.78,-0.13,-0.59,31.86,-31.64,True,1,5863,-21.78,-82891.72,127696.14,44804.42
1951-06-22,21.55,-0.23,-1.06,31.86,-32.36,True,1,5864,-21.55,-82913.27,126369.2,43455.93
1951-06-25,21.29,-0.26,-1.21,31.86,-33.18,True,1,5865,-21.29,-82934.56,124865.85,41931.29
1951-06-26,21.3,0.01,0.05,31.86,-33.15,True,1,5866,-21.3,-82955.86,124945.8,41989.94
1951-06-27,21.37,0.07,0.33,31.86,-32.92,True,1,5867,-21.37,-82977.23,125377.79,42400.56
1951-06-28,21.1,-0.27,-1.26,31.86,-33.77,True,1,5868,-21.1,-82998.33,123814.8,40816.47
1951-06-29,20.96,-0.14,-0.66,31.86,-34.21,True,1,5869,-20.96,-83019.29,123014.24,39994.95
1951-07-02,21.1,0.14,0.67,31.86,-33.77,True,1,5870,-21.1,-83040.39,123857.0,40816.61
1951-07-03,21.23,0.13,0.62,31.86,-33.36,True,1,5871,-21.23,-83061.62,124641.33,41579.71
1951-07-05,21.64,0.41,1.93,31.86,-32.08,True,1,5872,-21.64,-83083.26,127070.08,43986.82
1951-07-06,21.64,0.0,0.0,31.86,-32.08,True,1,5873,-21.64,-83104.9,127091.72,43986.82
1951-07-09,21.73,0.09,0.42,31.86,-31.8,True,1,5874,-21.73,-83126.63,127642.02,44515.39
1951-07-10,21.63,-0.1,-0.46,31.86,-32.11,True,1,5875,-21.63,-83148.26,127076.25,43927.99
1951-07-11,21.68,0.05,0.23,31.86,-31.95,True,1,5876,-21.68,-83169.94,127391.68,44221.74
1951-07-12,21.8,0.12,0.55,31.86,-31.58,True,1,5877,-21.8,-83191.74,128118.6,44926.86
1951-07-13,21.98,0.18,0.83,31.86,-31.01,True,1,5878,-21.98,-83213.72,129198.44,45984.72
1951-07-16,21.73,-0.25,-1.14,31.86,-31.8,True,1,5879,-21.73,-83235.45,127750.67,44515.22
1951-07-17,21.92,0.19,0.87,31.86,-31.2,True,1,5880,-21.92,-83257.37,128889.6,45632.23
1951-07-18,21.88,-0.04,-0.18,31.86,-31.32,True,1,5881,-21.88,-83279.25,128676.28,45397.03
1951-07-19,21.84,-0.04,-0.18,31.86,-31.45,True,1,5882,-21.84,-83301.09,128462.88,45161.79
1951-07-20,21.88,0.04,0.18,31.86,-31.32,True,1,5883,-21.88,-83322.97,128720.04,45397.07
1951-07-23,22.1,0.22,1.0,31.86,-30.63,True,1,5884,-22.1,-83345.07,130036.4,46691.33
1951-07-24,22.44,0.34,1.54,31.86,-29.57,True,1,5885,-22.44,-83367.51,132059.4,48691.89
1951-07-25,22.32,-0.12,-0.54,31.86,-29.94,True,1,5886,-22.32,-83389.83,131375.52,47985.69
1951-07-26,22.47,0.15,0.67,31.86,-29.47,True,1,5887,-22.47,-83412.3,132280.89,48868.59
1951-07-27,22.53,0.06,0.27,31.86,-29.28,True,1,5888,-22.53,-83434.83,132656.64,49221.81
1951-07-30,22.63,0.1,0.44,31.86,-28.97,True,1,5889,-22.63,-83457.46,133268.07,49810.61
1951-07-31,22.4,-0.23,-1.02,31.86,-29.69,True,1,5890,-22.4,-83479.86,131936.0,48456.14
1951-08-01,22.51,0.11,0.49,31.86,-29.35,True,1,5891,-22.51,-83502.37,132606.41,49104.04
1951-08-02,22.82,0.31,1.38,31.86,-28.37,True,1,5892,-22.82,-83525.19,134455.44,50930.25
1951-08-03,22.85,0.03,0.13,31.86,-28.28,True,1,5893,-22.85,-83548.04,134655.05,51107.01
1951-08-06,23.01,0.16,0.7,31.86,-27.78,True,1,5894,-23.01,-83571.05,135620.94,52049.89
1951-08-07,23.03,0.02,0.09,31.86,-27.72,True,1,5895,-23.03,-83594.08,135761.85,52167.77
1951-08-08,22.93,-0.1,-0.43,31.86,-28.03,True,1,5896,-22.93,-83617.01,135195.28,51578.27
1951-08-09,22.84,-0.09,-0.39,31.86,-28.31,True,1,5897,-22.84,-83639.85,134687.48,51047.63
1951-08-10,22.79,-0.05,-0.22,31.86,-28.47,True,1,5898,-22.79,-83662.64,134415.42,50752.78
1951-08-13,22.8,0.01,0.04,31.86,-28.44,True,1,5899,-22.8,-83685.44,134497.2,50811.76
1951-08-14,22.7,-0.1,-0.44,31.86,-28.75,True,1,5900,-22.7,-83708.14,133930.0,50221.86
1951-08-15,22.79,0.09,0.4,31.86,-28.47,True,1,5901,-22.79,-83730.93,134483.79,50752.86
1951-08-16,22.87,0.08,0.35,31.86,-28.22,True,1,5902,-22.87,-83753.8,134978.74,51224.94
1951-08-17,22.94,0.07,0.31,31.86,-28.0,True,1,5903,-22.94,-83776.74,135414.82,51638.08
1951-08-20,22.93,-0.01,-0.04,31.86,-28.03,True,1,5904,-22.93,-83799.67,135378.72,51579.05
1951-08-21,22.83,-0.1,-0.44,31.86,-28.34,True,1,5905,-22.83,-83822.5,134811.15,50988.65
1951-08-22,22.75,-0.08,-0.35,31.86,-28.59,True,1,5906,-22.75,-83845.25,134361.5,50516.25
1951-08-23,22.9,0.15,0.66,31.86,-28.12,True,1,5907,-22.9,-83868.15,135270.3,51402.15
1951-08-24,22.88,-0.02,-0.09,31.86,-28.19,True,1,5908,-22.88,-83891.03,135175.04,51284.01
1951-08-27,22.85,-0.03,-0.13,31.86,-28.28,True,1,5909,-22.85,-83913.88,135020.65,51106.77
1951-08-28,22.9,0.05,0.22,31.86,-28.12,True,1,5910,-22.9,-83936.78,135339.0,51402.22
1951-08-29,23.08,0.18,0.79,31.86,-27.56,True,1,5911,-23.08,-83959.86,136425.88,52466.02
1951-08-30,23.24,0.16,0.69,31.86,-27.06,True,1,5912,-23.24,-83983.1,137394.88,53411.78
1951-08-31,23.28,0.04,0.17,31.86,-26.93,True,1,5913,-23.28,-84006.38,137654.64,53648.26
1951-09-04,23.28,0.0,0.0,31.86,-26.93,True,1,5914,-23.28,-84029.66,137677.92,53648.26
1951-09-05,23.42,0.14,0.6,31.86,-26.49,True,1,5915,-23.42,-84053.08,138529.3,54476.22
1951-09-06,23.47,0.05,0.21,31.86,-26.33,True,1,5916,-23.47,-84076.55,138848.52,54771.97
1951-09-07,23.53,0.06,0.26,31.86,-26.15,True,1,5917,-23.53,-84100.08,139227.01,55126.93
1951-09-10,23.62,0.09,0.38,31.86,-25.86,True,1,5918,-23.62,-84123.7,139783.16,55659.46
1951-09-11,23.5,-0.12,-0.51,31.86,-26.24,True,1,5919,-23.5,-84147.2,139096.5,54949.3
1951-09-12,23.6,0.1,0.43,31.86,-25.93,True,1,5920,-23.6,-84170.8,139712.0,55541.2
1951-09-13,23.71,0.11,0.47,31.86,-25.58,True,1,5921,-23.71,-84194.51,140386.91,56192.4
1951-09-14,23.69,-0.02,-0.08,31.86,-25.64,True,1,5922,-23.69,-84218.2,140292.18,56073.98
1951-09-17,23.62,-0.07,-0.3,31.86,-25.86,True,1,5923,-23.62,-84241.82,139901.26,55659.44
1951-09-18,23.59,-0.03,-0.13,31.86,-25.96,True,1,5924,-23.59,-84265.41,139747.16,55481.75
1951-09-19,23.59,0.0,0.0,31.86,-25.96,True,1,5925,-23.59,-84289.0,139770.75,55481.75
1951-09-20,23.57,-0.02,-0.08,31.86,-26.02,True,1,5926,-23.57,-84312.57,139675.82,55363.25
1951-09-21,23.4,-0.17,-0.72,31.86,-26.55,True,1,5927,-23.4,-84335.97,138691.8,54355.83
1951-09-24,23.3,-0.1,-0.43,31.86,-26.87,True,1,5928,-23.3,-84359.27,138122.4,53763.13
1951-09-25,23.38,0.08,0.34,31.86,-26.62,True,1,5929,-23.38,-84382.65,138620.02,54237.37
1951-09-26,23.4,0.02,0.09,31.86,-26.55,True,1,5930,-23.4,-84406.05,138762.0,54355.95
1951-09-27,23.27,-0.13,-0.56,31.86,-26.96,True,1,5931,-23.27,-84429.32,138014.37,53585.05
1951-09-28,23.26,-0.01,-0.04,31.86,-26.99,True,1,5932,-23.26,-84452.58,137978.32,53525.74
1951-10-01,23.47,0.21,0.9,31.86,-26.33,True,1,5933,-23.47,-84476.05,139247.51,54771.46
1951-10-02,23.64,0.17,0.72,31.86,-25.8,True,1,5934,-23.64,-84499.69,140279.76,55780.07
1951-10-03,23.79,0.15,0.64,31.86,-25.33,True,1,5935,-23.79,-84523.48,141193.65,56670.17
1951-10-04,23.72,-0.07,-0.29,31.86,-25.55,True,1,5936,-23.72,-84547.2,140801.92,56254.72
1951-10-05,23.78,0.06,0.25,31.86,-25.36,True,1,5937,-23.78,-84570.98,141181.86,56610.88
1951-10-08,23.75,-0.03,-0.13,31.86,-25.46,True,1,5938,-23.75,-84594.73,141027.5,56432.77
1951-10-09,23.65,-0.1,-0.42,31.86,-25.77,True,1,5939,-23.65,-84618.38,140457.35,55838.97
1951-10-10,23.61,-0.04,-0.17,31.86,-25.9,True,1,5940,-23.61,-84641.99,140243.4,55601.41
1951-10-11,23.7,0.09,0.38,31.86,-25.61,True,1,5941,-23.7,-84665.69,140801.7,56136.01
1951-10-15,23.85,0.15,0.63,31.86,-25.14,True,1,5942,-23.85,-84689.54,141716.7,57027.16
1951-10-16,23.77,-0.08,-0.34,31.86,-25.39,True,1,5943,-23.77,-84713.31,141265.11,56551.8
1951-10-17,23.69,-0.08,-0.34,31.86,-25.64,True,1,5944,-23.69,-84737.0,140813.36,56076.36
1951-10-18,23.67,-0.02,-0.08,31.86,-25.71,True,1,5945,-23.67,-84760.67,140718.15,55957.48
1951-10-19,23.32,-0.35,-1.48,31.86,-26.8,True,1,5946,-23.32,-84783.99,138660.72,53876.73
1951-10-22,22.75,-0.57,-2.44,31.86,-28.59,True,1,5947,-22.75,-84806.74,135294.25,50487.51
1951-10-23,22.84,0.09,0.4,31.86,-28.31,True,1,5948,-22.84,-84829.58,135852.32,51022.74
1951-10-24,23.03,0.19,0.83,31.86,-27.72,True,1,5949,-23.03,-84852.61,137005.47,52152.86
1951-10-25,22.96,-0.07,-0.3,31.86,-27.94,True,1,5950,-22.96,-84875.57,136612.0,51736.43
1951-10-26,22.81,-0.15,-0.65,31.86,-28.41,True,1,5951,-22.81,-84898.38,135742.31,50843.93
1951-10-29,22.69,-0.12,-0.53,31.86,-28.78,True,1,5952,-22.69,-84921.07,135050.88,50129.81
1951-10-30,22.66,-0.03,-0.13,31.86,-28.88,True,1,5953,-22.66,-84943.73,134894.98,49951.25
1951-10-31,22.94,0.28,1.24,31.86,-28.0,True,1,5954,-22.94,-84966.67,136584.76,51618.09
1951-11-01,23.1,0.16,0.7,31.86,-27.5,True,1,5955,-23.1,-84989.77,137560.5,52570.73
1951-11-02,22.93,-0.17,-0.74,31.86,-28.03,True,1,5956,-22.93,-85012.7,136571.08,51558.38
1951-11-05,22.82,-0.11,-0.48,31.86,-28.37,True,1,5957,-22.82,-85035.52,135938.74,50903.22
1951-11-07,22.49,-0.33,-1.45,31.86,-29.41,True,1,5958,-22.49,-85058.01,133995.42,48937.41
1951-11-08,22.47,-0.02,-0.09,31.86,-29.47,True,1,5959,-22.47,-85080.48,133898.73,48818.25
1951-11-09,22.75,0.28,1.25,31.86,-28.59,True,1,5960,-22.75,-85103.23,135590.0,50486.77
1951-11-13,22.79,0.04,0.18,31.86,-28.47,True,1,5961,-22.79,-85126.02,135851.19,50725.17
1951-11-14,22.85,0.06,0.26,31.86,-28.28,True,1,5962,-22.85,-85148.87,136231.7,51082.83
1951-11-15,22.84,-0.01,-0.04,31.86,-28.31,True,1,5963,-22.84,-85171.71,136194.92,51023.21
1951-11-16,22.82,-0.02,-0.09,31.86,-28.37,True,1,5964,-22.82,-85194.53,136098.48,50903.95
1951-11-19,22.73,-0.09,-0.39,31.86,-28.66,True,1,5965,-22.73,-85217.26,135584.45,50367.19
1951-11-20,22.68,-0.05,-0.22,31.86,-28.81,True,1,5966,-22.68,-85239.94,135308.88,50068.94
1951-11-21,22.64,-0.04,-0.18,31.86,-28.94,True,1,5967,-22.64,-85262.58,135092.88,49830.3
1951-11-23,22.4,-0.24,-1.06,31.86,-29.69,True,1,5968,-22.4,-85284.98,133683.2,48398.22
1951-11-26,22.43,0.03,0.13,31.86,-29.6,True,1,5969,-22.43,-85307.41,133884.67,48577.26
1951-11-27,22.66,0.23,1.02,31.86,-28.88,True,1,5970,-22.66,-85330.07,135280.2,49950.13
1951-11-28,22.61,-0.05,-0.22,31.86,-29.03,True,1,5971,-22.61,-85352.68,135004.31,49651.63
1951-11-29,22.67,0.06,0.26,31.86,-28.84,True,1,5972,-22.67,-85375.35,135385.24,50009.89
1951-11-30,22.88,0.21,0.93,31.86,-28.19,True,1,5973,-22.88,-85398.23,136662.24,51264.01
1951-12-03,23.01,0.13,0.57,31.86,-27.78,True,1,5974,-23.01,-85421.24,137461.74,52040.5
1951-12-04,23.14,0.13,0.56,31.86,-27.37,True,1,5975,-23.14,-85444.38,138261.5,52817.12
1951-12-05,23.07,-0.07,-0.3,31.86,-27.59,True,1,5976,-23.07,-85467.45,137866.32,52398.87
1951-12-06,23.34,0.27,1.17,31.86,-26.74,True,1,5977,-23.34,-85490.79,139503.18,54012.39
1951-12-07,23.38,0.04,0.17,31.86,-26.62,True,1,5978,-23.38,-85514.17,139765.64,54251.47
1951-12-10,23.42,0.04,0.17,31.86,-26.49,True,1,5979,-23.42,-85537.59,140028.18,54490.59
1951-12-11,23.3,-0.12,-0.51,31.86,-26.87,True,1,5980,-23.3,-85560.89,139334.0,53773.11
1951-12-12,23.37,0.07,0.3,31.86,-26.65,True,1,5981,-23.37,-85584.26,139775.97,54191.71
1951-12-13,23.39,0.02,0.09,31.86,-26.58,True,1,5982,-23.39,-85607.65,139918.98,54311.33
1951-12-14,23.37,-0.02,-0.08,31.86,-26.65,True,1,5983,-23.37,-85631.02,139822.71,54191.69
1951-12-17,23.41,0.04,0.17,31.86,-26.52,True,1,5984,-23.41,-85654.43,140085.44,54431.01
1951-12-18,23.49,0.08,0.34,31.86,-26.27,True,1,5985,-23.49,-85677.92,140587.65,54909.73
1951-12-19,23.57,0.08,0.34,31.86,-26.02,True,1,5986,-23.57,-85701.49,141090.02,55388.53
1951-12-20,23.57,0.0,0.0,31.86,-26.02,True,1,5987,-23.57,-85725.06,141113.59,55388.53
1951-12-21,23.51,-0.06,-0.26,31.86,-26.21,True,1,5988,-23.51,-85748.57,140777.88,55029.31
1951-12-24,23.54,0.03,0.13,31.86,-26.11,True,1,5989,-23.54,-85772.11,140981.06,55208.95
1951-12-26,23.44,-0.1,-0.42,31.86,-26.43,True,1,5990,-23.44,-85795.55,140405.6,54610.05
1951-12-27,23.65,0.21,0.9,31.86,-25.77,True,1,5991,-23.65,-85819.2,141687.15,55867.95
1951-12-28,23.69,0.04,0.17,31.86,-25.64,True,1,5992,-23.69,-85842.89,141950.48,56107.59
1951-12-31,23.77,0.08,0.34,31.86,-25.39,True,1,5993,-23.77,-85866.66,142453.61,56586.95
1952-01-02,23.8,0.03,0.13,31.86,-25.3,True,1,5994,-23.8,-85890.46,142657.2,56766.74
1952-01-03,23.88,0.08,0.34,31.86,-25.05,True,1,5995,-23.88,-85914.34,143160.6,57246.26
1952-01-04,23.92,0.04,0.17,31.86,-24.92,True,1,5996,-23.92,-85938.26,143424.32,57486.06
1952-01-07,23.91,-0.01,-0.04,31.86,-24.95,True,1,5997,-23.91,-85962.17,143388.27,57426.1
1952-01-08,23.82,-0.09,-0.38,31.86,-25.24,True,1,5998,-23.82,-85985.99,142872.36,56886.37
1952-01-09,23.74,-0.08,-0.34,31.86,-25.49,True,1,5999,-23.74,-86009.73,142416.26,56406.53
1952-01-10,23.86,0.12,0.5,31.86,-25.11,True,1,6000,-23.86,-86033.59,143160.0,57126.41
1952-01-11,23.98,0.12,0.5,31.86,-24.73,True,1,6001,-23.98,-86057.57,143903.98,57846.41
1952-01-14,24.16,0.18,0.75,31.86,-24.17,True,1,6002,-24.16,-86081.73,145008.32,58926.59
1952-01-15,24.06,-0.1,-0.41,31.86,-24.48,True,1,6003,-24.06,-86105.79,144432.18,58326.39
1952-01-16,24.09,0.03,0.12,31.86,-24.39,True,1,6004,-24.09,-86129.88,144636.36,58506.48
1952-01-17,24.2,0.11,0.46,31.86,-24.04,True,1,6005,-24.2,-86154.08,145321.0,59166.92
1952-01-18,24.25,0.05,0.21,31.86,-23.89,True,1,6006,-24.25,-86178.33,145645.5,59467.17
1952-01-21,24.46,0.21,0.87,31.86,-23.23,True,1,6007,-24.46,-86202.79,146931.22,60728.43
1952-01-22,24.66,0.2,0.82,31.86,-22.6,True,1,6008,-24.66,-86227.45,148157.28,61929.83
1952-01-23,24.54,-0.12,-0.49,31.86,-22.98,True,1,6009,-24.54,-86251.99,147460.86,61208.87
1952-01-24,24.56,0.02,0.08,31.86,-22.91,True,1,6010,-24.56,-86276.55,147605.6,61329.05
1952-01-25,24.55,-0.01,-0.04,31.86,-22.94,True,1,6011,-24.55,-86301.1,147570.05,61268.95
1952-01-28,24.61,0.06,0.24,31.86,-22.76,True,1,6012,-24.61,-86325.71,147955.32,61629.61
1952-01-29,24.57,-0.04,-0.16,31.86,-22.88,True,1,6013,-24.57,-86350.28,147739.41,61389.13
1952-01-30,24.23,-0.34,-1.38,31.86,-23.95,True,1,6014,-24.23,-86374.51,145719.22,59344.71
1952-01-31,24.14,-0.09,-0.37,31.86,-24.23,True,1,6015,-24.14,-86398.65,145202.1,58803.45
1952-02-01,24.3,0.16,0.66,31.86,-23.73,True,1,6016,-24.3,-86422.95,146188.8,59765.85
1952-02-04,24.12,-0.18,-0.74,31.86,-24.29,True,1,6017,-24.12,-86447.07,145130.04,58682.97
1952-02-05,24.11,-0.01,-0.04,31.86,-24.32,True,1,6018,-24.11,-86471.18,145093.98,58622.8
1952-02-06,24.18,0.07,0.29,31.86,-24.1,True,1,6019,-24.18,-86495.36,145539.42,59044.06
1952-02-07,24.11,-0.07,-0.29,31.86,-24.32,True,1,6020,-24.11,-86519.47,145142.2,58622.73
1952-02-08,24.24,0.13,0.54,31.86,-23.92,True,1,6021,-24.24,-86543.71,145949.04,59405.33
1952-02-11,24.11,-0.13,-0.54,31.86,-24.32,True,1,6022,-24.11,-86567.82,145190.42,58622.6
1952-02-13,23.92,-0.19,-0.79,31.86,-24.92,True,1,6023,-23.92,-86591.74,144070.16,57478.42
1952-02-14,23.87,-0.05,-0.21,31.86,-25.08,True,1,6024,-23.87,-86615.61,143792.88,57177.27
1952-02-15,23.86,-0.01,-0.04,31.86,-25.11,True,1,6025,-23.86,-86639.47,143756.5,57117.03
1952-02-18,23.74,-0.12,-0.5,31.86,-25.49,True,1,6026,-23.74,-86663.21,143057.24,56394.03
1952-02-19,23.36,-0.38,-1.6,31.86,-26.68,True,1,6027,-23.36,-86686.57,140790.72,54104.15
1952-02-20,23.09,-0.27,-1.16,31.86,-27.53,True,1,6028,-23.09,-86709.66,139186.52,52476.86
1952-02-21,23.16,0.07,0.3,31.86,-27.31,True,1,6029,-23.16,-86732.82,139631.64,52898.82
1952-02-25,23.23,0.07,0.3,31.86,-27.09,True,1,6030,-23.23,-86756.05,140076.9,53320.85
1952-02-26,23.15,-0.08,-0.34,31.86,-27.34,True,1,6031,-23.15,-86779.2,139617.65,52838.45
1952-02-27,23.18,0.03,0.13,31.86,-27.24,True,1,6032,-23.18,-86802.38,139821.76,53019.38
1952-02-28,23.29,0.11,0.48,31.86,-26.9,True,1,6033,-23.29,-86825.67,140508.57,53682.9
1952-02-29,23.26,-0.03,-0.13,31.86,-26.99,True,1,6034,-23.26,-86848.93,140350.84,53501.91
1952-03-03,23.29,0.03,0.13,31.86,-26.9,True,1,6035,-23.29,-86872.22,140555.15,53682.93
1952-03-04,23.68,0.39,1.68,31.86,-25.68,True,1,6036,-23.68,-86895.9,142932.48,56036.58
1952-03-05,23.71,0.03,0.13,31.86,-25.58,True,1,6037,-23.71,-86919.61,143137.27,56217.66
1952-03-06,23.69,-0.02,-0.08,31.86,-25.64,True,1,6038,-23.69,-86943.3,143040.22,56096.92
1952-03-07,23.72,0.03,0.13,31.86,-25.55,True,1,6039,-23.72,-86967.02,143245.08,56278.06
1952-03-10,23.6,-0.12,-0.51,31.86,-25.93,True,1,6040,-23.6,-86990.62,142544.0,55553.38
1952-03-11,23.62,0.02,0.08,31.86,-25.86,True,1,6041,-23.62,-87014.24,142688.42,55674.18
1952-03-12,23.73,0.11,0.47,31.86,-25.52,True,1,6042,-23.73,-87037.97,143376.66,56338.69
1952-03-13,23.75,0.02,0.08,31.86,-25.46,True,1,6043,-23.75,-87061.72,143521.25,56459.53
1952-03-14,23.75,0.0,0.0,31.86,-25.46,True,1,6044,-23.75,-87085.47,143545.0,56459.53
1952-03-17,23.92,0.17,0.72,31.86,-24.92,True,1,6045,-23.92,-87109.39,144596.4,57487.01
1952-03-18,23.87,-0.05,-0.21,31.86,-25.08,True,1,6046,-23.87,-87133.26,144318.02,57184.76
1952-03-19,23.82,-0.05,-0.21,31.86,-25.24,True,1,6047,-23.82,-87157.08,144039.54,56882.46
1952-03-20,23.89,0.07,0.29,31.86,-25.02,True,1,6048,-23.89,-87180.97,144486.72,57305.75
1952-03-21,23.93,0.04,0.17,31.86,-24.89,True,1,6049,-23.93,-87204.9,144752.57,57547.67
1952-03-24,23.93,0.0,0.0,31.86,-24.89,True,1,6050,-23.93,-87228.83,144776.5,57547.67
1952-03-25,23.79,-0.14,-0.58,31.86,-25.33,True,1,6051,-23.79,-87252.62,143953.29,56700.67
1952-03-26,23.78,-0.01,-0.04,31.86,-25.36,True,1,6052,-23.78,-87276.4,143916.56,56640.16
1952-03-27,23.99,0.21,0.88,31.86,-24.7,True,1,6053,-23.99,-87300.39,145211.47,57911.08
1952-03-28,24.18,0.19,0.79,31.86,-24.1,True,1,6054,-24.18,-87324.57,146385.72,59061.15
1952-03-31,24.37,0.19,0.79,31.86,-23.51,True,1,6055,-24.37,-87348.94,147560.35,60211.41
1952-04-01,24.18,-0.19,-0.78,31.86,-24.1,True,1,6056,-24.18,-87373.12,146434.08,59060.96
1952-04-02,24.12,-0.06,-0.25,31.86,-24.29,True,1,6057,-24.12,-87397.24,146094.84,58697.6
1952-04-03,24.12,0.0,0.0,31.86,-24.29,True,1,6058,-24.12,-87421.36,146118.96,58697.6
1952-04-04,24.02,-0.1,-0.42,31.86,-24.61,True,1,6059,-24.02,-87445.38,145537.18,58091.8
1952-04-07,23.8,-0.22,-0.92,31.86,-25.3,True,1,6060,-23.8,-87469.18,144228.0,56758.82
1952-04-08,23.91,0.11,0.46,31.86,-24.95,True,1,6061,-23.91,-87493.09,144918.51,57425.42
1952-04-09,23.94,0.03,0.12,31.86,-24.86,True,1,6062,-23.94,-87517.03,145124.28,57607.25
1952-04-10,24.11,0.17,0.71,31.86,-24.32,True,1,6063,-24.11,-87541.14,146178.93,58637.79
1952-04-14,23.95,-0.16,-0.66,31.86,-24.83,True,1,6064,-23.95,-87565.09,145232.8,57667.71
1952-04-15,23.65,-0.3,-1.25,31.86,-25.77,True,1,6065,-23.65,-87588.74,143437.25,55848.51
1952-04-16,23.58,-0.07,-0.3,31.86,-25.99,True,1,6066,-23.58,-87612.32,143036.28,55423.96
1952-04-17,23.41,-0.17,-0.72,31.86,-26.52,True,1,6067,-23.41,-87635.73,142028.47,54392.74
1952-04-18,23.5,0.09,0.38,31.86,-26.24,True,1,6068,-23.5,-87659.23,142598.0,54938.77
1952-04-21,23.69,0.19,0.81,31.86,-25.64,True,1,6069,-23.69,-87682.92,143774.61,56091.69
1952-04-22,23.58,-0.11,-0.46,31.86,-25.99,True,1,6070,-23.58,-87706.5,143130.6,55424.1
1952-04-23,23.48,-0.1,-0.42,31.86,-26.3,True,1,6071,-23.48,-87729.98,142547.08,54817.1
1952-04-24,23.43,-0.05,-0.21,31.86,-26.46,True,1,6072,-23.43,-87753.41,142266.96,54513.55
1952-04-25,23.54,0.11,0.47,31.86,-26.11,True,1,6073,-23.54,-87776.95,142958.42,55181.47
1952-04-28,23.55,0.01,0.04,31.86,-26.08,True,1,6074,-23.55,-87800.5,143042.7,55242.2
1952-04-29,23.49,-0.06,-0.26,31.86,-26.27,True,1,6075,-23.49,-87823.99,142701.75,54877.76
1952-04-30,23.32,-0.17,-0.72,31.86,-26.8,True,1,6076,-23.32,-87847.31,141692.32,53845.01
1952-05-01,23.17,-0.15,-0.64,31.86,-27.28,True,1,6077,-23.17,-87870.48,140804.09,52933.61
1952-05-02,23.56,0.39,1.68,31.86,-26.05,True,1,6078,-23.56,-87894.04,143197.68,55303.64
1952-05-05,23.66,0.1,0.42,31.86,-25.74,True,1,6079,-23.66,-87917.7,143829.14,55911.44
1952-05-06,23.67,0.01,0.04,31.86,-25.71,True,1,6080,-23.67,-87941.37,143913.6,55972.23
1952-05-07,23.81,0.14,0.59,31.86,-25.27,True,1,6081,-23.81,-87965.18,144788.61,56823.43
1952-05-08,23.86,0.05,0.21,31.86,-25.11,True,1,6082,-23.86,-87989.04,145116.52,57127.48
1952-05-09,23.84,-0.02,-0.08,31.86,-25.17,True,1,6083,-23.84,-88012.88,145018.72,57005.84
1952-05-12,23.75,-0.09,-0.38,31.86,-25.46,True,1,6084,-23.75,-88036.63,144495.0,56458.37
1952-05-13,23.78,0.03,0.13,31.86,-25.36,True,1,6085,-23.78,-88060.41,144701.3,56640.89
1952-05-14,23.68,-0.1,-0.42,31.86,-25.68,True,1,6086,-23.68,-88084.09,144116.48,56032.39
1952-05-15,23.6,-0.08,-0.34,31.86,-25.93,True,1,6087,-23.6,-88107.69,143653.2,55545.51
1952-05-16,23.56,-0.04,-0.17,31.86,-26.05,True,1,6088,-23.56,-88131.25,143433.28,55302.03
1952-05-19,23.61,0.05,0.21,31.86,-25.9,True,1,6089,-23.61,-88154.86,143761.29,55606.43
1952-05-20,23.74,0.13,0.55,31.86,-25.49,True,1,6090,-23.74,-88178.6,144576.6,56398.0
1952-05-21,23.78,0.04,0.17,31.86,-25.36,True,1,6091,-23.78,-88202.38,144843.98,56641.6
1952-05-22,23.91,0.13,0.55,31.86,-24.95,True,1,6092,-23.91,-88226.29,145659.72,57433.43
1952-05-23,23.89,-0.02,-0.08,31.86,-25.02,True,1,6093,-23.89,-88250.18,145561.77,57311.59
1952-05-26,23.94,0.05,0.21,31.86,-24.86,True,1,6094,-23.94,-88274.12,145890.36,57616.24
1952-05-27,23.88,-0.06,-0.25,31.86,-25.05,True,1,6095,-23.88,-88298.0,145548.6,57250.6
1952-05-28,23.84,-0.04,-0.17,31.86,-25.17,True,1,6096,-23.84,-88321.84,145328.64,57006.8
1952-05-29,23.86,0.02,0.08,31.86,-25.11,True,1,6097,-23.86,-88345.7,145474.42,57128.72
1952-06-02,23.8,-0.06,-0.25,31.86,-25.3,True,1,6098,-23.8,-88369.5,145132.4,56762.9
1952-06-03,23.78,-0.02,-0.08,31.86,-25.36,True,1,6099,-23.78,-88393.28,145034.22,56640.94
1952-06-04,23.95,0.17,0.72,31.86,-24.83,True,1,6100,-23.95,-88417.23,146095.0,57677.77
1952-06-05,24.1,0.15,0.63,31.86,-24.36,True,1,6101,-24.1,-88441.33,147034.1,58592.77
1952-06-06,24.26,0.16,0.66,31.86,-23.85,True,1,6102,-24.26,-88465.59,148034.52,59568.93
1952-06-09,24.37,0.11,0.45,31.86,-23.51,True,1,6103,-24.37,-88489.96,148730.11,60240.15
1952-06-10,24.23,-0.14,-0.57,31.86,-23.95,True,1,6104,-24.23,-88514.19,147899.92,59385.73
1952-06-11,24.31,0.08,0.33,31.86,-23.7,True,1,6105,-24.31,-88538.5,148412.55,59874.05
1952-06-12,24.31,0.0,0.0,31.86,-23.7,True,1,6106,-24.31,-88562.81,148436.86,59874.05
1952-06-13,24.37,0.06,0.25,31.86,-23.51,True,1,6107,-24.37,-88587.18,148827.59,60240.41
1952-06-16,24.3,-0.07,-0.29,31.86,-23.73,True,1,6108,-24.3,-88611.48,148424.4,59812.92
1952-06-17,24.33,0.03,0.12,31.86,-23.64,True,1,6109,-24.33,-88635.81,148631.97,59996.16
1952-06-18,24.43,0.1,0.41,31.86,-23.32,True,1,6110,-24.43,-88660.24,149267.3,60607.06
1952-06-19,24.51,0.08,0.33,31.86,-23.07,True,1,6111,-24.51,-88684.75,149780.61,61095.86
1952-06-20,24.59,0.08,0.33,31.86,-22.82,True,1,6112,-24.59,-88709.34,150294.08,61584.74
1952-06-23,24.56,-0.03,-0.12,31.86,-22.91,True,1,6113,-24.56,-88733.9,150135.28,61401.38
1952-06-24,24.6,0.04,0.16,31.86,-22.79,True,1,6114,-24.6,-88758.5,150404.4,61645.9
1952-06-25,24.66,0.06,0.24,31.86,-22.6,True,1,6115,-24.66,-88783.16,150795.9,62012.74
1952-06-26,24.75,0.09,0.36,31.86,-22.32,True,1,6116,-24.75,-88807.91,151371.0,62563.09
1952-06-27,24.83,0.08,0.32,31.86,-22.06,True,1,6117,-24.83,-88832.74,151885.11,63052.37
1952-06-30,24.96,0.13,0.52,31.86,-21.66,True,1,6118,-24.96,-88857.7,152705.28,63847.58
1952-07-01,25.12,0.16,0.64,31.86,-21.16,True,1,6119,-25.12,-88882.82,153709.28,64826.46
1952-07-02,25.06,-0.06,-0.24,31.86,-21.34,True,1,6120,-25.06,-88907.88,153367.2,64459.32
1952-07-03,25.05,-0.01,-0.04,31.86,-21.38,True,1,6121,-25.05,-88932.93,153331.05,64398.12
1952-07-07,24.97,-0.08,-0.32,31.86,-21.63,True,1,6122,-24.97,-88957.9,152866.34,63908.44
1952-07-08,24.96,-0.01,-0.04,31.86,-21.66,True,1,6123,-24.96,-88982.86,152830.08,63847.22
1952-07-09,24.86,-0.1,-0.4,31.86,-21.97,True,1,6124,-24.86,-89007.72,152242.64,63234.92
1952-07-10,24.81,-0.05,-0.2,31.86,-22.13,True,1,6125,-24.81,-89032.53,151961.25,62928.72
1952-07-11,24.98,0.17,0.68,31.86,-21.59,True,1,6126,-24.98,-89057.51,153027.48,63969.97
1952-07-14,25.03,0.05,0.2,31.86,-21.44,True,1,6127,-25.03,-89082.54,153358.81,64276.27
1952-07-15,25.16,0.13,0.52,31.86,-21.03,True,1,6128,-25.16,-89107.7,154180.48,65072.78
1952-07-16,25.16,0.0,0.0,31.86,-21.03,True,1,6129,-25.16,-89132.86,154205.64,65072.78
1952-07-17,25.05,-0.11,-0.44,31.86,-21.38,True,1,6130,-25.05,-89157.91,153556.5,64398.59
1952-07-18,24.85,-0.2,-0.8,31.86,-22.0,True,1,6131,-24.85,-89182.76,152355.35,63172.59
1952-07-21,24.95,0.1,0.4,31.86,-21.69,True,1,6132,-24.95,-89207.71,152993.4,63785.69
1952-07-22,25.0,0.05,0.2,31.86,-21.53,True,1,6133,-25.0,-89232.71,153325.0,64092.29
1952-07-23,25.11,0.11,0.44,31.86,-21.19,True,1,6134,-25.11,-89257.82,154024.74,64766.92
1952-07-24,25.24,0.13,0.52,31.86,-20.78,True,1,6135,-25.24,-89283.06,154847.4,65564.34
1952-07-25,25.16,-0.08,-0.32,31.86,-21.03,True,1,6136,-25.16,-89308.22,154381.76,65073.54
1952-07-28,25.2,0.04,0.16,31.86,-20.9,True,1,6137,-25.2,-89333.42,154652.4,65318.98
1952-07-29,25.26,0.06,0.24,31.86,-20.72,True,1,6138,-25.26,-89358.68,155045.88,65687.2
1952-07-30,25.37,0.11,0.44,31.86,-20.37,True,1,6139,-25.37,-89384.05,155746.43,66362.38
1952-07-31,25.4,0.03,0.12,31.86,-20.28,True,1,6140,-25.4,-89409.45,155956.0,66546.55
1952-08-01,25.45,0.05,0.2,31.86,-20.12,True,1,6141,-25.45,-89434.9,156288.45,66853.55
1952-08-04,25.43,-0.02,-0.08,31.86,-20.18,True,1,6142,-25.43,-89460.33,156191.06,66730.73
1952-08-05,25.46,0.03,0.12,31.86,-20.09,True,1,6143,-25.46,-89485.79,156400.78,66914.99
1952-08-06,25.44,-0.02,-0.08,31.86,-20.15,True,1,6144,-25.44,-89511.23,156303.36,66792.13
1952-08-07,25.52,0.08,0.31,31.86,-19.9,True,1,6145,-25.52,-89536.75,156820.4,67283.65
1952-08-08,25.55,0.03,0.12,31.86,-19.8,True,1,6146,-25.55,-89562.3,157030.3,67468.0
1952-08-11,25.52,-0.03,-0.12,31.86,-19.9,True,1,6147,-25.52,-89587.82,156871.44,67283.62
1952-08-12,25.31,-0.21,-0.82,31.86,-20.56,True,1,6148,-25.31,-89613.13,155605.88,65992.75
1952-08-13,25.28,-0.03,-0.12,31.86,-20.65,True,1,6149,-25.28,-89638.41,155446.72,65808.31
1952-08-14,25.28,0.0,0.0,31.86,-20.65,True,1,6150,-25.28,-89663.69,155472.0,65808.31
1952-08-15,25.2,-0.08,-0.32,31.86,-20.9,True,1,6151,-25.2,-89688.89,155005.2,65316.31
1952-08-18,24.94,-0.26,-1.03,31.86,-21.72,True,1,6152,-24.94,-89713.83,153430.88,63717.05
1952-08-19,24.89,-0.05,-0.2,31.86,-21.88,True,1,6153,-24.89,-89738.72,153148.17,63409.45
1952-08-20,24.95,0.06,0.24,31.86,-21.69,True,1,6154,-24.95,-89763.67,153542.3,63778.63
1952-08-21,24.98,0.03,0.12,31.86,-21.59,True,1,6155,-24.98,-89788.65,153751.9,63963.25
1952-08-22,24.99,0.01,0.04,31.86,-21.56,True,1,6156,-24.99,-89813.64,153838.44,64024.8
1952-08-25,24.87,-0.12,-0.48,31.86,-21.94,True,1,6157,-24.87,-89838.51,153124.59,63286.08
1952-08-26,24.83,-0.04,-0.16,31.86,-22.06,True,1,6158,-24.83,-89863.34,152903.14,63039.8
1952-08-27,24.94,0.11,0.44,31.86,-21.72,True,1,6159,-24.94,-89888.28,153605.46,63717.18
1952-08-28,24.97,0.03,0.12,31.86,-21.63,True,1,6160,-24.97,-89913.25,153815.2,63901.95
1952-08-29,25.03,0.06,0.24,31.86,-21.44,True,1,6161,-25.03,-89938.28,154209.83,64271.55
1952-09-02,25.15,0.12,0.48,31.86,-21.06,True,1,6162,-25.15,-89963.43,154974.3,65010.87
1952-09-03,25.25,0.1,0.4,31.86,-20.75,True,1,6163,-25.25,-89988.68,155615.75,65627.07
1952-09-04,25.24,-0.01,-0.04,31.86,-20.78,True,1,6164,-25.24,-90013.92,155579.36,65565.44
1952-09-05,25.21,-0.03,-0.12,31.86,-20.87,True,1,6165,-25.21,-90039.13,155419.65,65380.52
1952-09-08,25.11,-0.1,-0.4,31.86,-21.19,True,1,6166,-25.11,-90064.24,154828.26,64764.02
1952-09-09,24.86,-0.25,-1.0,31.86,-21.97,True,1,6167,-24.86,-90089.1,153311.62,63222.52
1952-09-10,24.69,-0.17,-0.68,31.86,-22.5,True,1,6168,-24.69,-90113.79,152287.92,62174.13
1952-09-11,24.72,0.03,0.12,31.86,-22.41,True,1,6169,-24.72,-90138.51,152497.68,62359.17
1952-09-12,24.71,-0.01,-0.04,31.86,-22.44,True,1,6170,-24.71,-90163.22,152460.7,62297.48
1952-09-15,24.45,-0.26,-1.05,31.86,-23.26,True,1,6171,-24.45,-90187.67,150880.95,60693.28
1952-09-16,24.53,0.08,0.33,31.86,-23.01,True,1,6172,-24.53,-90212.2,151399.16,61186.96
1952-09-17,24.58,0.05,0.2,31.86,-22.85,True,1,6173,-24.58,-90236.78,151732.34,61495.56
1952-09-18,24.51,-0.07,-0.28,31.86,-23.07,True,1,6174,-24.51,-90261.29,151324.74,61063.45
1952-09-19,24.57,0.06,0.24,31.86,-22.88,True,1,6175,-24.57,-90285.86,151719.75,61433.89
1952-09-22,24.59,0.02,0.08,31.86,-22.82,True,1,6176,-24.59,-90310.45,151867.84,61557.39
1952-09-23,24.7,0.11,0.45,31.86,-22.47,True,1,6177,-24.7,-90335.15,152571.9,62236.75
1952-09-24,24.79,0.09,0.36,31.86,-22.19,True,1,6178,-24.79,-90359.94,153152.62,62792.68
1952-09-25,24.81,0.02,0.08,31.86,-22.13,True,1,6179,-24.81,-90384.75,153300.99,62916.24
1952-09-26,24.73,-0.08,-0.32,31.86,-22.38,True,1,6180,-24.73,-90409.48,152831.4,62421.92
1952-09-29,24.68,-0.05,-0.2,31.86,-22.54,True,1,6181,-24.68,-90434.16,152547.08,62112.92
1952-09-30,24.54,-0.14,-0.57,31.86,-22.98,True,1,6182,-24.54,-90458.7,151706.28,61247.58
1952-10-01,24.48,-0.06,-0.24,31.86,-23.16,True,1,6183,-24.48,-90483.18,151359.84,60876.66
1952-10-02,24.52,0.04,0.16,31.86,-23.04,True,1,6184,-24.52,-90507.7,151631.68,61123.98
1952-10-03,24.5,-0.02,-0.08,31.86,-23.1,True,1,6185,-24.5,-90532.2,151532.5,61000.3
1952-10-06,24.44,-0.06,-0.24,31.86,-23.29,True,1,6186,-24.44,-90556.64,151185.84,60629.2
1952-10-07,24.4,-0.04,-0.16,31.86,-23.42,True,1,6187,-24.4,-90581.04,150962.8,60381.76
1952-10-08,24.58,0.18,0.74,31.86,-22.85,True,1,6188,-24.58,-90605.62,152101.04,61495.42
1952-10-09,24.57,-0.01,-0.04,31.86,-22.88,True,1,6189,-24.57,-90630.19,152063.73,61433.54
1952-10-10,24.55,-0.02,-0.08,31.86,-22.94,True,1,6190,-24.55,-90654.74,151964.5,61309.76
1952-10-14,24.48,-0.07,-0.28,31.86,-23.16,True,1,6191,-24.48,-90679.22,151555.68,60876.46
1952-10-15,24.06,-0.42,-1.72,31.86,-24.48,True,1,6192,-24.06,-90703.28,148979.52,58276.24
1952-10-16,23.91,-0.15,-0.62,31.86,-24.95,True,1,6193,-23.91,-90727.19,148074.63,57347.44
1952-10-17,24.2,0.29,1.21,31.86,-24.04,True,1,6194,-24.2,-90751.39,149894.8,59143.41
1952-10-20,24.13,-0.07,-0.29,31.86,-24.26,True,1,6195,-24.13,-90775.52,149485.35,58709.83
1952-10-21,24.07,-0.06,-0.25,31.86,-24.45,True,1,6196,-24.07,-90799.59,149137.72,58338.13
1952-10-22,23.8,-0.27,-1.12,31.86,-25.3,True,1,6197,-23.8,-90823.39,147488.6,56665.21
1952-10-23,23.87,0.07,0.29,31.86,-25.08,True,1,6198,-23.87,-90847.26,147946.26,57099.0
1952-10-24,24.03,0.16,0.67,31.86,-24.58,True,1,6199,-24.03,-90871.29,148961.97,58090.68
1952-10-27,24.09,0.06,0.25,31.86,-24.39,True,1,6200,-24.09,-90895.38,149358.0,58462.62
1952-10-28,24.13,0.04,0.17,31.86,-24.26,True,1,6201,-24.13,-90919.51,149630.13,58710.62
1952-10-29,24.15,0.02,0.08,31.86,-24.2,True,1,6202,-24.15,-90943.66,149778.3,58834.64
1952-10-30,24.15,0.0,0.0,31.86,-24.2,True,1,6203,-24.15,-90967.81,149802.45,58834.64
1952-10-31,24.52,0.37,1.53,31.86,-23.04,True,1,6204,-24.52,-90992.33,152122.08,61129.75
1952-11-03,24.6,0.08,0.33,31.86,-22.79,True,1,6205,-24.6,-91016.93,152643.0,61626.07
1952-11-05,24.67,0.07,0.28,31.86,-22.57,True,1,6206,-24.67,-91041.6,153102.02,62060.42
1952-11-06,24.77,0.1,0.4,31.86,-22.25,True,1,6207,-24.77,-91066.37,153747.39,62681.02
1952-11-07,24.78,0.01,0.04,31.86,-22.22,True,1,6208,-24.78,-91091.15,153834.24,62743.09
1952-11-10,24.77,-0.01,-0.04,31.86,-22.25,True,1,6209,-24.77,-91115.92,153796.93,62681.01
1952-11-12,24.65,-0.12,-0.48,31.86,-22.63,True,1,6210,-24.65,-91140.57,153076.5,61935.93
1952-11-13,24.71,0.06,0.24,31.86,-22.44,True,1,6211,-24.71,-91165.28,153473.81,62308.53
1952-11-14,24.75,0.04,0.16,31.86,-22.32,True,1,6212,-24.75,-91190.03,153747.0,62556.97
1952-11-17,24.8,0.05,0.2,31.86,-22.16,True,1,6213,-24.8,-91214.83,154082.4,62867.57
1952-11-18,25.16,0.36,1.45,31.86,-21.03,True,1,6214,-25.16,-91239.99,156344.24,65104.25
1952-11-19,25.33,0.17,0.68,31.86,-20.5,True,1,6215,-25.33,-91265.32,157425.95,66160.63
1952-11-20,25.28,-0.05,-0.2,31.86,-20.65,True,1,6216,-25.28,-91290.6,157140.48,65849.88
1952-11-21,25.27,-0.01,-0.04,31.86,-20.68,True,1,6217,-25.27,-91315.87,157103.59,65787.72
1952-11-24,25.42,0.15,0.59,31.86,-20.21,True,1,6218,-25.42,-91341.29,158061.56,66720.27
1952-11-25,25.36,-0.06,-0.24,31.86,-20.4,True,1,6219,-25.36,-91366.65,157713.84,66347.19
1952-11-26,25.52,0.16,0.63,31.86,-19.9,True,1,6220,-25.52,-91392.17,158734.4,67342.23
1952-11-28,25.66,0.14,0.55,31.86,-19.46,True,1,6221,-25.66,-91417.83,159630.86,68213.03
1952-12-01,25.68,0.02,0.08,31.86,-19.4,True,1,6222,-25.68,-91443.51,159780.96,68337.45
1952-12-02,25.74,0.06,0.23,31.86,-19.21,True,1,6223,-25.74,-91469.25,160180.02,68710.77
1952-12-03,25.71,-0.03,-0.12,31.86,-19.3,True,1,6224,-25.71,-91494.96,160019.04,68524.08
1952-12-04,25.61,-0.1,-0.39,31.86,-19.62,True,1,6225,-25.61,-91520.57,159422.25,67901.68
1952-12-05,25.62,0.01,0.04,31.86,-19.59,True,1,6226,-25.62,-91546.19,159510.12,67963.93
1952-12-08,25.76,0.14,0.55,31.86,-19.15,True,1,6227,-25.76,-91571.95,160407.52,68835.57
1952-12-09,25.93,0.17,0.66,31.86,-18.61,True,1,6228,-25.93,-91597.88,161492.04,69894.16
1952-12-10,25.98,0.05,0.19,31.86,-18.46,True,1,6229,-25.98,-91623.86,161829.42,70205.56
1952-12-11,25.96,-0.02,-0.08,31.86,-18.52,True,1,6230,-25.96,-91649.82,161730.8,70080.98
1952-12-12,26.04,0.08,0.31,31.86,-18.27,True,1,6231,-26.04,-91675.86,162255.24,70579.38
1952-12-15,26.04,0.0,0.0,31.86,-18.27,True,1,6232,-26.04,-91701.9,162281.28,70579.38
1952-12-16,26.07,0.03,0.12,31.86,-18.17,True,1,6233,-26.07,-91727.97,162494.31,70766.34
1952-12-17,26.04,-0.03,-0.12,31.86,-18.27,True,1,6234,-26.04,-91754.01,162333.36,70579.35
1952-12-18,26.03,-0.01,-0.04,31.86,-18.3,True,1,6235,-26.03,-91780.04,162297.05,70517.01
1952-12-19,26.15,0.12,0.46,31.86,-17.92,True,1,6236,-26.15,-91806.19,163071.4,71265.21
1952-12-22,26.3,0.15,0.57,31.86,-17.45,True,1,6237,-26.3,-91832.49,164033.1,72200.61
1952-12-23,26.19,-0.11,-0.42,31.86,-17.8,True,1,6238,-26.19,-91858.68,163373.22,71514.54
1952-12-24,26.21,0.02,0.08,31.86,-17.73,True,1,6239,-26.21,-91884.89,163524.19,71639.3
1952-12-26,26.25,0.04,0.15,31.86,-17.61,True,1,6240,-26.25,-91911.14,163800.0,71888.86
1952-12-29,26.4,0.15,0.57,31.86,-17.14,True,1,6241,-26.4,-91937.54,164762.4,72824.86
1952-12-30,26.59,0.19,0.72,31.86,-16.54,True,1,6242,-26.59,-91964.13,165974.78,74010.65
1952-12-31,26.57,-0.02,-0.08,31.86,-16.6,True,1,6243,-26.57,-91990.7,165876.51,73885.81
1953-01-02,26.54,-0.03,-0.11,31.86,-16.7,True,1,6244,-26.54,-92017.24,165715.76,73698.52
1953-01-05,26.66,0.12,0.45,31.86,-16.32,True,1,6245,-26.66,-92043.9,166491.7,74447.8
1953-01-06,26.48,-0.18,-0.68,31.86,-16.89,True,1,6246,-26.48,-92070.38,165394.08,73323.7
1953-01-07,26.37,-0.11,-0.42,31.86,-17.23,True,1,6247,-26.37,-92096.75,164733.39,72636.64
1953-01-08,26.33,-0.04,-0.15,31.86,-17.36,True,1,6248,-26.33,-92123.08,164509.84,72386.76
1953-01-09,26.08,-0.25,-0.95,31.86,-18.14,True,1,6249,-26.08,-92149.16,162973.92,70824.76
1953-01-12,25.86,-0.22,-0.84,31.86,-18.83,True,1,6250,-25.86,-92175.02,161625.0,69449.98
1953-01-13,26.02,0.16,0.62,31.86,-18.33,True,1,6251,-26.02,-92201.04,162651.02,70449.98
1953-01-14,26.08,0.06,0.23,31.86,-18.14,True,1,6252,-26.08,-92227.12,163052.16,70825.04
1953-01-15,26.13,0.05,0.19,31.86,-17.98,True,1,6253,-26.13,-92253.25,163390.89,71137.64
1953-01-16,26.02,-0.11,-0.42,31.86,-18.33,True,1,6254,-26.02,-92279.27,162729.08,70449.81
1953-01-19,26.01,-0.01,-0.04,31.86,-18.36,True,1,6255,-26.01,-92305.28,162692.55,70387.27
1953-01-20,26.14,0.13,0.5,31.86,-17.95,True,1,6256,-26.14,-92331.42,163531.84,71200.42
1953-01-21,26.09,-0.05,-0.19,31.86,-18.11,True,1,6257,-26.09,-92357.51,163245.13,70887.62
1953-01-22,26.12,0.03,0.12,31.86,-18.02,True,1,6258,-26.12,-92383.63,163458.96,71075.33
1953-01-23,26.07,-0.05,-0.19,31.86,-18.17,True,1,6259,-26.07,-92409.7,163172.13,70762.43
1953-01-26,26.02,-0.05,-0.19,31.86,-18.33,True,1,6260,-26.02,-92435.72,162885.2,70449.48
1953-01-27,26.05,0.03,0.12,31.86,-18.24,True,1,6261,-26.05,-92461.77,163099.05,70637.28
1953-01-28,26.13,0.08,0.31,31.86,-17.98,True,1,6262,-26.13,-92487.9,163626.06,71138.16
1953-01-29,26.2,0.07,0.27,31.86,-17.76,True,1,6263,-26.2,-92514.1,164090.6,71576.5
1953-01-30,26.38,0.18,0.69,31.86,-17.2,True,1,6264,-26.38,-92540.48,165244.32,72703.84
1953-02-02,26.51,0.13,0.49,31.86,-16.79,True,1,6265,-26.51,-92566.99,166085.15,73518.16
1953-02-03,26.54,0.03,0.11,31.86,-16.7,True,1,6266,-26.54,-92593.53,166299.64,73706.11
1953-02-04,26.42,-0.12,-0.45,31.86,-17.08,True,1,6267,-26.42,-92619.95,165574.14,72954.19
1953-02-05,26.15,-0.27,-1.02,31.86,-17.92,True,1,6268,-26.15,-92646.1,163908.2,71262.1
1953-02-06,26.51,0.36,1.38,31.86,-16.79,True,1,6269,-26.51,-92672.61,166191.19,73518.58
1953-02-09,25.69,-0.82,-3.09,31.86,-19.37,True,1,6270,-25.69,-92698.3,161076.3,68378.0
1953-02-10,25.62,-0.07,-0.27,31.86,-19.59,True,1,6271,-25.62,-92723.92,160663.02,67939.1
1953-02-11,25.64,0.02,0.08,31.86,-19.52,True,1,6272,-25.64,-92749.56,160814.08,68064.52
1953-02-13,25.74,0.1,0.39,31.86,-19.21,True,1,6273,-25.74,-92775.3,161467.02,68691.72
1953-02-16,25.65,-0.09,-0.35,31.86,-19.49,True,1,6274,-25.65,-92800.95,160928.1,68127.15
1953-02-17,25.5,-0.15,-0.58,31.86,-19.96,True,1,6275,-25.5,-92826.45,160012.5,67186.05
1953-02-18,25.48,-0.02,-0.08,31.86,-20.02,True,1,6276,-25.48,-92851.93,159912.48,67060.55
1953-02-19,25.57,0.09,0.35,31.86,-19.74,True,1,6277,-25.57,-92877.5,160502.89,67625.39
1953-02-20,25.63,0.06,0.24,31.86,-19.55,True,1,6278,-25.63,-92903.13,160905.14,68002.01
1953-02-24,25.75,0.12,0.47,31.86,-19.18,True,1,6279,-25.75,-92928.88,161684.25,68755.37
1953-02-25,25.91,0.16,0.62,31.86,-18.68,True,1,6280,-25.91,-92954.79,162714.8,69760.01
1953-02-26,25.95,0.04,0.15,31.86,-18.55,True,1,6281,-25.95,-92980.74,162991.95,70011.21
1953-02-27,25.9,-0.05,-0.19,31.86,-18.71,True,1,6282,-25.9,-93006.64,162703.8,69697.16
1953-03-02,25.93,0.03,0.12,31.86,-18.61,True,1,6283,-25.93,-93032.57,162918.19,69885.62
1953-03-03,26.0,0.07,0.27,31.86,-18.39,True,1,6284,-26.0,-93058.57,163384.0,70325.43
1953-03-04,25.78,-0.22,-0.85,31.86,-19.08,True,1,6285,-25.78,-93084.35,162027.3,68942.95
1953-03-05,25.79,0.01,0.04,31.86,-19.05,True,1,6286,-25.79,-93110.14,162115.94,69005.8
1953-03-06,25.84,0.05,0.19,31.86,-18.9,True,1,6287,-25.84,-93135.98,162456.08,69320.1
1953-03-09,25.83,-0.01,-0.04,31.86,-18.93,True,1,6288,-25.83,-93161.81,162419.04,69257.23
1953-03-10,25.91,0.08,0.31,31.86,-18.68,True,1,6289,-25.91,-93187.72,162947.99,69760.27
1953-03-11,26.12,0.21,0.81,31.86,-18.02,True,1,6290,-26.12,-93213.84,164294.8,71080.96
1953-03-12,26.13,0.01,0.04,31.86,-17.98,True,1,6291,-26.13,-93239.97,164383.83,71143.86
1953-03-13,26.18,0.05,0.19,31.86,-17.83,True,1,6292,-26.18,-93266.15,164724.56,71458.41
1953-03-16,26.22,0.04,0.15,31.86,-17.7,True,1,6293,-26.22,-93292.37,165002.46,71710.09
1953-03-17,26.33,0.11,0.42,31.86,-17.36,True,1,6294,-26.33,-93318.7,165721.02,72402.32
1953-03-18,26.24,-0.09,-0.34,31.86,-17.64,True,1,6295,-26.24,-93344.94,165180.8,71835.86
1953-03-19,26.22,-0.02,-0.08,31.86,-17.7,True,1,6296,-26.22,-93371.16,165081.12,71709.96
1953-03-20,26.18,-0.04,-0.15,31.86,-17.83,True,1,6297,-26.18,-93397.34,164855.46,71458.12
1953-03-23,26.02,-0.16,-0.61,31.86,-18.33,True,1,6298,-26.02,-93423.36,163873.96,70450.6
1953-03-24,26.17,0.15,0.58,31.86,-17.86,True,1,6299,-26.17,-93449.53,164844.83,71395.3
1953-03-25,26.1,-0.07,-0.27,31.86,-18.08,True,1,6300,-26.1,-93475.63,164430.0,70954.37
1953-03-26,25.95,-0.15,-0.57,31.86,-18.55,True,1,6301,-25.95,-93501.58,163510.95,70009.37
1953-03-27,25.99,0.04,0.15,31.86,-18.42,True,1,6302,-25.99,-93527.57,163788.98,70261.41
1953-03-30,25.61,-0.38,-1.46,31.86,-19.62,True,1,6303,-25.61,-93553.18,161419.83,67866.65
1953-03-31,25.29,-0.32,-1.25,31.86,-20.62,True,1,6304,-25.29,-93578.47,159428.16,65849.69
1953-04-01,25.25,-0.04,-0.16,31.86,-20.75,True,1,6305,-25.25,-93603.72,159201.25,65597.53
1953-04-02,25.23,-0.02,-0.08,31.86,-20.81,True,1,6306,-25.23,-93628.95,159100.38,65471.43
1953-04-06,24.61,-0.62,-2.46,31.86,-22.76,True,1,6307,-24.61,-93653.56,155215.27,61561.71
1953-04-07,24.71,0.1,0.41,31.86,-22.44,True,1,6308,-24.71,-93678.27,155870.68,62192.41
1953-04-08,24.93,0.22,0.89,31.86,-21.75,True,1,6309,-24.93,-93703.2,157283.37,63580.17
1953-04-09,24.88,-0.05,-0.2,31.86,-21.91,True,1,6310,-24.88,-93728.08,156992.8,63264.72
1953-04-10,24.82,-0.06,-0.24,31.86,-22.1,True,1,6311,-24.82,-93752.9,156639.02,62886.12
1953-04-13,24.77,-0.05,-0.2,31.86,-22.25,True,1,6312,-24.77,-93777.67,156348.24,62570.57
1953-04-14,24.86,0.09,0.36,31.86,-21.97,True,1,6313,-24.86,-93802.53,156941.18,63138.65
1953-04-15,24.96,0.1,0.4,31.86,-21.66,True,1,6314,-24.96,-93827.49,157597.44,63769.95
1953-04-16,24.91,-0.05,-0.2,31.86,-21.81,True,1,6315,-24.91,-93852.4,157306.65,63454.25
1953-04-17,24.62,-0.29,-1.16,31.86,-22.72,True,1,6316,-24.62,-93877.02,155499.92,61622.9
1953-04-20,24.73,0.11,0.45,31.86,-22.38,True,1,6317,-24.73,-93901.75,156219.41,62317.66
1953-04-21,24.67,-0.06,-0.24,31.86,-22.57,True,1,6318,-24.67,-93926.42,155865.06,61938.64
1953-04-22,24.46,-0.21,-0.85,31.86,-23.23,True,1,6319,-24.46,-93950.88,154562.74,60611.86
1953-04-23,24.19,-0.27,-1.1,31.86,-24.07,True,1,6320,-24.19,-93975.07,152880.8,58905.73
1953-04-24,24.2,0.01,0.04,31.86,-24.04,True,1,6321,-24.2,-93999.27,152968.2,58968.93
1953-04-27,24.34,0.14,0.58,31.86,-23.6,True,1,6322,-24.34,-94023.61,153877.48,59853.87
1953-04-28,24.52,0.18,0.74,31.86,-23.04,True,1,6323,-24.52,-94048.13,155039.96,60991.83
1953-04-29,24.68,0.16,0.65,31.86,-22.54,True,1,6324,-24.68,-94072.81,156076.32,62003.51
1953-04-30,24.62,-0.06,-0.24,31.86,-22.72,True,1,6325,-24.62,-94097.43,155721.5,61624.07
1953-05-01,24.73,0.11,0.45,31.86,-22.38,True,1,6326,-24.73,-94122.16,156441.98,62319.82
1953-05-04,25.0,0.27,1.09,31.86,-21.53,True,1,6327,-25.0,-94147.16,158175.0,64027.84
1953-05-05,25.03,0.03,0.12,31.86,-21.44,True,1,6328,-25.03,-94172.19,158389.84,64217.65
1953-05-06,25.0,-0.03,-0.12,31.86,-21.53,True,1,6329,-25.0,-94197.19,158225.0,64027.81
1953-05-07,24.9,-0.1,-0.4,31.86,-21.85,True,1,6330,-24.9,-94222.09,157617.0,63394.91
1953-05-08,24.9,0.0,0.0,31.86,-21.85,True,1,6331,-24.9,-94246.99,157641.9,63394.91
1953-05-11,24.91,0.01,0.04,31.86,-21.81,True,1,6332,-24.91,-94271.9,157730.12,63458.22
1953-05-12,24.74,-0.17,-0.68,31.86,-22.35,True,1,6333,-24.74,-94296.64,156678.42,62381.78
1953-05-13,24.71,-0.03,-0.12,31.86,-22.44,True,1,6334,-24.71,-94321.35,156513.14,62191.79
1953-05-14,24.85,0.14,0.57,31.86,-22.0,True,1,6335,-24.85,-94346.2,157424.75,63078.55
1953-05-15,24.84,-0.01,-0.04,31.86,-22.03,True,1,6336,-24.84,-94371.04,157386.24,63015.2
1953-05-18,24.75,-0.09,-0.36,31.86,-22.32,True,1,6337,-24.75,-94395.79,156840.75,62444.96
1953-05-19,24.7,-0.05,-0.2,31.86,-22.47,True,1,6338,-24.7,-94420.49,156548.6,62128.11
1953-05-20,24.93,0.23,0.93,31.86,-21.75,True,1,6339,-24.93,-94445.42,158031.27,63585.85
1953-05-21,25.06,0.13,0.52,31.86,-21.34,True,1,6340,-25.06,-94470.48,158880.4,64409.92
1953-05-22,25.03,-0.03,-0.12,31.86,-21.44,True,1,6341,-25.03,-94495.51,158715.23,64219.72
1953-05-25,24.99,-0.04,-0.16,31.86,-21.56,True,1,6342,-24.99,-94520.5,158486.58,63966.08
1953-05-26,24.87,-0.12,-0.48,31.86,-21.94,True,1,6343,-24.87,-94545.37,157750.41,63205.04
1953-05-27,24.64,-0.23,-0.92,31.86,-22.66,True,1,6344,-24.64,-94570.01,156316.16,61746.15
1953-05-28,24.46,-0.18,-0.73,31.86,-23.23,True,1,6345,-24.46,-94594.47,155198.7,60604.23
1953-05-29,24.54,0.08,0.33,31.86,-22.98,True,1,6346,-24.54,-94619.01,155730.84,61111.83
1953-06-01,24.15,-0.39,-1.59,31.86,-24.2,True,1,6347,-24.15,-94643.16,153280.05,58636.89
1953-06-02,24.22,0.07,0.29,31.86,-23.98,True,1,6348,-24.22,-94667.38,153748.56,59081.18
1953-06-03,24.18,-0.04,-0.16,31.86,-24.1,True,1,6349,-24.18,-94691.56,153518.82,58827.26
1953-06-04,24.03,-0.15,-0.62,31.86,-24.58,True,1,6350,-24.03,-94715.59,152590.5,57874.91
1953-06-05,24.09,0.06,0.25,31.86,-24.39,True,1,6351,-24.09,-94739.68,152995.59,58255.91
1953-06-08,24.01,-0.08,-0.33,31.86,-24.64,True,1,6352,-24.01,-94763.69,152511.52,57747.83
1953-06-09,23.6,-0.41,-1.71,31.86,-25.93,True,1,6353,-23.6,-94787.29,149930.8,55143.51
1953-06-10,23.54,-0.06,-0.25,31.86,-26.11,True,1,6354,-23.54,-94810.83,149573.16,54762.33
1953-06-11,23.75,0.21,0.89,31.86,-25.46,True,1,6355,-23.75,-94834.58,150931.25,56096.67
1953-06-12,23.82,0.07,0.3,31.86,-25.24,True,1,6356,-23.82,-94858.4,151399.92,56541.52
1953-06-15,23.62,-0.2,-0.84,31.86,-25.86,True,1,6357,-23.62,-94882.02,150152.34,55270.32
1953-06-16,23.55,-0.07,-0.3,31.86,-26.08,True,1,6358,-23.55,-94905.57,149730.9,54825.33
1953-06-17,23.85,0.3,1.27,31.86,-25.14,True,1,6359,-23.85,-94929.42,151662.15,56732.73
1953-06-18,23.84,-0.01,-0.04,31.86,-25.17,True,1,6360,-23.84,-94953.26,151622.4,56669.14
1953-06-19,23.84,0.0,0.0,31.86,-25.17,True,1,6361,-23.84,-94977.1,151646.24,56669.14
1953-06-22,23.96,0.12,0.5,31.86,-24.8,True,1,6362,-23.96,-95001.06,152433.52,57432.46
1953-06-23,24.12,0.16,0.67,31.86,-24.29,True,1,6363,-24.12,-95025.18,153475.56,58450.38
1953-06-24,24.09,-0.03,-0.12,31.86,-24.39,True,1,6364,-24.09,-95049.27,153308.76,58259.49
1953-06-25,24.19,0.1,0.42,31.86,-24.07,True,1,6365,-24.19,-95073.46,153969.35,58895.89
1953-06-26,24.21,0.02,0.08,31.86,-24.01,True,1,6366,-24.21,-95097.67,154120.86,59023.19
1953-06-29,24.14,-0.07,-0.29,31.86,-24.23,True,1,6367,-24.14,-95121.81,153699.38,58577.57
1953-06-30,24.14,0.0,0.0,31.86,-24.23,True,1,6368,-24.14,-95145.95,153723.52,58577.57
1953-07-01,24.24,0.1,0.41,31.86,-23.92,True,1,6369,-24.24,-95170.19,154384.56,59214.37
1953-07-02,24.31,0.07,0.29,31.86,-23.7,True,1,6370,-24.31,-95194.5,154854.7,59660.2
1953-07-03,24.36,0.05,0.21,31.86,-23.54,True,1,6371,-24.36,-95218.86,155197.56,59978.7
1953-07-06,24.38,0.02,0.08,31.86,-23.48,True,1,6372,-24.38,-95243.24,155349.36,60106.12
1953-07-07,24.51,0.13,0.53,31.86,-23.07,True,1,6373,-24.51,-95267.75,156202.23,60934.48
1953-07-08,24.5,-0.01,-0.04,31.86,-23.1,True,1,6374,-24.5,-95292.25,156163.0,60870.75
1953-07-09,24.43,-0.07,-0.29,31.86,-23.32,True,1,6375,-24.43,-95316.68,155741.25,60424.57
1953-07-10,24.41,-0.02,-0.08,31.86,-23.38,True,1,6376,-24.41,-95341.09,155638.16,60297.07
1953-07-13,24.17,-0.24,-0.98,31.86,-24.14,True,1,6377,-24.17,-95365.26,154132.09,58766.83
1953-07-14,24.08,-0.09,-0.37,31.86,-24.42,True,1,6378,-24.08,-95389.34,153582.24,58192.9
1953-07-15,24.15,0.07,0.29,31.86,-24.2,True,1,6379,-24.15,-95413.49,154052.85,58639.36
1953-07-16,24.18,0.03,0.12,31.86,-24.1,True,1,6380,-24.18,-95437.67,154268.4,58830.73
1953-07-17,24.35,0.17,0.7,31.86,-23.57,True,1,6381,-24.35,-95462.02,155377.35,59915.33
1953-07-20,24.22,-0.13,-0.53,31.86,-23.98,True,1,6382,-24.22,-95486.24,154572.04,59085.8
1953-07-21,24.16,-0.06,-0.25,31.86,-24.17,True,1,6383,-24.16,-95510.4,154213.28,58702.88
1953-07-22,24.19,0.03,0.12,31.86,-24.07,True,1,6384,-24.19,-95534.59,154428.96,58894.37
1953-07-23,24.23,0.04,0.16,31.86,-23.95,True,1,6385,-24.23,-95558.82,154708.55,59149.73
1953-07-24,24.23,0.0,0.0,31.86,-23.95,True,1,6386,-24.23,-95583.05,154732.78,59149.73
1953-07-27,24.07,-0.16,-0.66,31.86,-24.45,True,1,6387,-24.07,-95607.12,153735.09,58127.97
1953-07-28,24.11,0.04,0.17,31.86,-24.32,True,1,6388,-24.11,-95631.23,154014.68,58383.45
1953-07-29,24.26,0.15,0.62,31.86,-23.85,True,1,6389,-24.26,-95655.49,154997.14,59341.65
1953-07-30,24.49,0.23,0.95,31.86,-23.13,True,1,6390,-24.49,-95679.98,156491.1,60811.12
1953-07-31,24.75,0.26,1.06,31.86,-22.32,True,1,6391,-24.75,-95704.73,158177.25,62472.52
1953-08-03,24.84,0.09,0.36,31.86,-22.03,True,1,6392,-24.84,-95729.57,158777.28,63047.71
1953-08-04,24.78,-0.06,-0.24,31.86,-22.22,True,1,6393,-24.78,-95754.35,158418.54,62664.19
1953-08-05,24.68,-0.1,-0.4,31.86,-22.54,True,1,6394,-24.68,-95779.03,157803.92,62024.89
1953-08-06,24.8,0.12,0.49,31.86,-22.16,True,1,6395,-24.8,-95803.83,158596.0,62792.17
1953-08-07,24.78,-0.02,-0.08,31.86,-22.22,True,1,6396,-24.78,-95828.61,158492.88,62664.27
1953-08-10,24.75,-0.03,-0.12,31.86,-22.32,True,1,6397,-24.75,-95853.36,158325.75,62472.39
1953-08-11,24.72,-0.03,-0.12,31.86,-22.41,True,1,6398,-24.72,-95878.08,158158.56,62280.48
1953-08-12,24.78,0.06,0.24,31.86,-22.22,True,1,6399,-24.78,-95902.86,158567.22,62664.36
1953-08-13,24.73,-0.05,-0.2,31.86,-22.38,True,1,6400,-24.73,-95927.59,158272.0,62344.41
1953-08-14,24.62,-0.11,-0.44,31.86,-22.72,True,1,6401,-24.62,-95952.21,157592.62,61640.41
1953-08-17,24.56,-0.06,-0.24,31.86,-22.91,True,1,6402,-24.56,-95976.77,157233.12,61256.35
1953-08-18,24.46,-0.1,-0.41,31.86,-23.23,True,1,6403,-24.46,-96001.23,156617.38,60616.15
1953-08-19,24.31,-0.15,-0.61,31.86,-23.7,True,1,6404,-24.31,-96025.54,155681.24,59655.7
1953-08-20,24.29,-0.02,-0.08,31.86,-23.76,True,1,6405,-24.29,-96049.83,155577.45,59527.62
1953-08-21,24.35,0.06,0.25,31.86,-23.57,True,1,6406,-24.35,-96074.18,155986.1,59911.92
1953-08-24,24.09,-0.26,-1.07,31.86,-24.39,True,1,6407,-24.09,-96098.27,154344.63,58246.36
1953-08-25,23.93,-0.16,-0.66,31.86,-24.89,True,1,6408,-23.93,-96122.2,153343.44,57221.24
1953-08-26,23.86,-0.07,-0.29,31.86,-25.11,True,1,6409,-23.86,-96146.06,152918.74,56772.68
1953-08-27,23.79,-0.07,-0.29,31.86,-25.33,True,1,6410,-23.79,-96169.85,152493.9,56324.05
1953-08-28,23.74,-0.05,-0.21,31.86,-25.49,True,1,6411,-23.74,-96193.59,152197.14,56003.55
1953-08-31,23.32,-0.42,-1.77,31.86,-26.8,True,1,6412,-23.32,-96216.91,149527.84,53310.93
1953-09-01,23.42,0.1,0.43,31.86,-26.49,True,1,6413,-23.42,-96240.33,150192.46,53952.13
1953-09-02,23.56,0.14,0.6,31.86,-26.05,True,1,6414,-23.56,-96263.89,151113.84,54849.95
1953-09-03,23.51,-0.05,-0.21,31.86,-26.21,True,1,6415,-23.51,-96287.4,150816.65,54529.25
1953-09-04,23.57,0.06,0.26,31.86,-26.02,True,1,6416,-23.57,-96310.97,151225.12,54914.15
1953-09-08,23.61,0.04,0.17,31.86,-25.9,True,1,6417,-23.61,-96334.58,151505.37,55170.79
1953-09-09,23.65,0.04,0.17,31.86,-25.77,True,1,6418,-23.65,-96358.23,151785.7,55427.47
1953-09-10,23.41,-0.24,-1.01,31.86,-26.52,True,1,6419,-23.41,-96381.64,150268.79,53887.15
1953-09-11,23.14,-0.27,-1.15,31.86,-27.37,True,1,6420,-23.14,-96404.78,148558.8,52154.02
1953-09-14,22.71,-0.43,-1.86,31.86,-28.72,True,1,6421,-22.71,-96427.49,145820.91,49393.42
1953-09-15,22.9,0.19,0.84,31.86,-28.12,True,1,6422,-22.9,-96450.39,147063.8,50613.41
1953-09-16,23.01,0.11,0.48,31.86,-27.78,True,1,6423,-23.01,-96473.4,147793.23,51319.83
1953-09-17,23.07,0.06,0.26,31.86,-27.59,True,1,6424,-23.07,-96496.47,148201.68,51705.21
1953-09-18,22.95,-0.12,-0.52,31.86,-27.97,True,1,6425,-22.95,-96519.42,147453.75,50934.33
1953-09-21,22.88,-0.07,-0.3,31.86,-28.19,True,1,6426,-22.88,-96542.3,147026.88,50484.58
1953-09-22,23.2,0.32,1.4,31.86,-27.18,True,1,6427,-23.2,-96565.5,149106.4,52540.9
1953-09-23,23.23,0.03,0.13,31.86,-27.09,True,1,6428,-23.23,-96588.73,149322.44,52733.71
1953-09-24,23.24,0.01,0.04,31.86,-27.06,True,1,6429,-23.24,-96611.97,149409.96,52797.99
1953-09-25,23.3,0.06,0.26,31.86,-26.87,True,1,6430,-23.3,-96635.27,149819.0,53183.73
1953-09-28,23.45,0.15,0.64,31.86,-26.4,True,1,6431,-23.45,-96658.72,150806.95,54148.23
1953-09-29,23.49,0.04,0.17,31.86,-26.27,True,1,6432,-23.49,-96682.21,151087.68,54405.47
1953-09-30,23.35,-0.14,-0.6,31.86,-26.71,True,1,6433,-23.35,-96705.56,150210.55,53504.99
1953-10-01,23.49,0.14,0.6,31.86,-26.27,True,1,6434,-23.49,-96729.05,151134.66,54405.61
1953-10-02,23.59,0.1,0.43,31.86,-25.96,True,1,6435,-23.59,-96752.64,151801.65,55049.01
1953-10-05,23.48,-0.11,-0.47,31.86,-26.3,True,1,6436,-23.48,-96776.12,151117.28,54341.16
1953-10-06,23.39,-0.09,-0.38,31.86,-26.58,True,1,6437,-23.39,-96799.51,150561.43,53761.92
1953-10-07,23.58,0.19,0.81,31.86,-25.99,True,1,6438,-23.58,-96823.09,151808.04,54984.95
1953-10-08,23.62,0.04,0.17,31.86,-25.86,True,1,6439,-23.62,-96846.71,152089.18,55242.47
1953-10-09,23.66,0.04,0.17,31.86,-25.74,True,1,6440,-23.66,-96870.37,152370.4,55500.03
1953-10-13,23.57,-0.09,-0.38,31.86,-26.02,True,1,6441,-23.57,-96893.94,151814.37,54920.43
1953-10-14,23.68,0.11,0.47,31.86,-25.68,True,1,6442,-23.68,-96917.62,152546.56,55628.94
1953-10-15,23.95,0.27,1.14,31.86,-24.83,True,1,6443,-23.95,-96941.57,154309.85,57368.28
1953-10-16,24.14,0.19,0.79,31.86,-24.23,True,1,6444,-24.14,-96965.71,155558.16,58592.45
1953-10-19,24.16,0.02,0.08,31.86,-24.17,True,1,6445,-24.16,-96989.87,155711.2,58721.33
1953-10-20,24.17,0.01,0.04,31.86,-24.14,True,1,6446,-24.17,-97014.04,155799.82,58785.78
1953-10-21,24.19,0.02,0.08,31.86,-24.07,True,1,6447,-24.19,-97038.23,155952.93,58914.7
1953-10-22,24.3,0.11,0.46,31.86,-23.73,True,1,6448,-24.3,-97062.53,156686.4,59623.87
1953-10-23,24.35,0.05,0.21,31.86,-23.57,True,1,6449,-24.35,-97086.88,157033.15,59946.27
1953-10-26,24.31,-0.04,-0.16,31.86,-23.7,True,1,6450,-24.31,-97111.19,156799.5,59688.31
1953-10-27,24.26,-0.05,-0.21,31.86,-23.85,True,1,6451,-24.26,-97135.45,156501.26,59365.81
1953-10-28,24.29,0.03,0.12,31.86,-23.76,True,1,6452,-24.29,-97159.74,156719.08,59559.34
1953-10-29,24.58,0.29,1.19,31.86,-22.85,True,1,6453,-24.58,-97184.32,158614.74,61430.42
1953-10-30,24.54,-0.04,-0.16,31.86,-22.98,True,1,6454,-24.54,-97208.86,158381.16,61172.3
1953-11-02,24.66,0.12,0.49,31.86,-22.6,True,1,6455,-24.66,-97233.52,159180.3,61946.78
1953-11-04,24.51,-0.15,-0.61,31.86,-23.07,True,1,6456,-24.51,-97258.03,158236.56,60978.53
1953-11-05,24.64,0.13,0.53,31.86,-22.66,True,1,6457,-24.64,-97282.67,159100.48,61817.81
1953-11-06,24.61,-0.03,-0.12,31.86,-22.76,True,1,6458,-24.61,-97307.28,158931.38,61624.1
1953-11-09,24.66,0.05,0.2,31.86,-22.6,True,1,6459,-24.66,-97331.94,159278.94,61947.0
1953-11-10,24.37,-0.29,-1.18,31.86,-23.51,True,1,6460,-24.37,-97356.31,157430.2,60073.89
1953-11-12,24.46,0.09,0.37,31.86,-23.23,True,1,6461,-24.46,-97380.77,158036.06,60655.29
1953-11-13,24.54,0.08,0.33,31.86,-22.98,True,1,6462,-24.54,-97405.31,158577.48,61172.17
1953-11-16,24.38,-0.16,-0.65,31.86,-23.48,True,1,6463,-24.38,-97429.69,157567.94,60138.25
1953-11-17,24.25,-0.13,-0.53,31.86,-23.89,True,1,6464,-24.25,-97453.94,156752.0,59298.06
1953-11-18,24.29,0.04,0.16,31.86,-23.76,True,1,6465,-24.29,-97478.23,157034.85,59556.62
1953-11-19,24.4,0.11,0.45,31.86,-23.42,True,1,6466,-24.4,-97502.63,157770.4,60267.77
1953-11-20,24.44,0.04,0.16,31.86,-23.29,True,1,6467,-24.44,-97527.07,158053.48,60526.41
1953-11-23,24.36,-0.08,-0.33,31.86,-23.54,True,1,6468,-24.36,-97551.43,157560.48,60009.05
1953-11-24,24.5,0.14,0.57,31.86,-23.1,True,1,6469,-24.5,-97575.93,158490.5,60914.57
1953-11-25,24.52,0.02,0.08,31.86,-23.04,True,1,6470,-24.52,-97600.45,158644.4,61043.95
1953-11-27,24.66,0.14,0.57,31.86,-22.6,True,1,6471,-24.66,-97625.11,159574.86,61949.75
1953-11-30,24.76,0.1,0.41,31.86,-22.28,True,1,6472,-24.76,-97649.87,160246.72,62596.85
1953-12-01,24.78,0.02,0.08,31.86,-22.22,True,1,6473,-24.78,-97674.65,160400.94,62726.29
1953-12-02,24.95,0.17,0.69,31.86,-21.69,True,1,6474,-24.95,-97699.6,161526.3,63826.7
1953-12-03,24.97,0.02,0.08,31.86,-21.63,True,1,6475,-24.97,-97724.57,161680.75,63956.18
1953-12-04,24.98,0.01,0.04,31.86,-21.59,True,1,6476,-24.98,-97749.55,161770.48,64020.93
1953-12-07,24.95,-0.03,-0.12,31.86,-21.69,True,1,6477,-24.95,-97774.5,161601.15,63826.65
1953-12-08,24.87,-0.08,-0.32,31.86,-21.94,True,1,6478,-24.87,-97799.37,161107.86,63308.49
1953-12-09,24.84,-0.03,-0.12,31.86,-22.03,True,1,6479,-24.84,-97824.21,160938.36,63114.15
1953-12-10,24.78,-0.06,-0.24,31.86,-22.22,True,1,6480,-24.78,-97848.99,160574.4,62725.41
1953-12-11,24.76,-0.02,-0.08,31.86,-22.28,True,1,6481,-24.76,-97873.75,160469.56,62595.81
1953-12-14,24.69,-0.07,-0.28,31.86,-22.5,True,1,6482,-24.69,-97898.44,160040.58,62142.14
1953-12-15,24.71,0.02,0.08,31.86,-22.44,True,1,6483,-24.71,-97923.15,160194.93,62271.78
1953-12-16,24.96,0.25,1.01,31.86,-21.66,True,1,6484,-24.96,-97948.11,161840.64,63892.53
1953-12-17,24.94,-0.02,-0.08,31.86,-21.72,True,1,6485,-24.94,-97973.05,161735.9,63762.85
1953-12-18,24.99,0.05,0.2,31.86,-21.56,True,1,6486,-24.99,-97998.04,162085.14,64087.1
1953-12-21,24.95,-0.04,-0.16,31.86,-21.69,True,1,6487,-24.95,-98022.99,161850.65,63827.66
1953-12-22,24.76,-0.19,-0.76,31.86,-22.28,True,1,6488,-24.76,-98047.75,160642.88,62595.13
1953-12-23,24.69,-0.07,-0.28,31.86,-22.5,True,1,6489,-24.69,-98072.44,160213.41,62140.97
1953-12-24,24.8,0.11,0.45,31.86,-22.16,True,1,6490,-24.8,-98097.24,160952.0,62854.76
1953-12-28,24.71,-0.09,-0.36,31.86,-22.44,True,1,6491,-24.71,-98121.95,160392.61,62270.66
1953-12-29,24.55,-0.16,-0.65,31.86,-22.94,True,1,6492,-24.55,-98146.5,159378.6,61232.1
1953-12-30,24.76,0.21,0.86,31.86,-22.28,True,1,6493,-24.76,-98171.26,160766.68,62595.42
1953-12-31,24.81,0.05,0.2,31.86,-22.13,True,1,6494,-24.81,-98196.07,161116.14,62920.07
1954-01-04,24.95,0.14,0.56,31.86,-21.69,True,1,6495,-24.95,-98221.02,162050.25,63829.23
1954-01-05,25.1,0.15,0.6,31.86,-21.22,True,1,6496,-25.1,-98246.12,163049.6,64803.48
1954-01-06,25.14,0.04,0.16,31.86,-21.09,True,1,6497,-25.14,-98271.26,163334.58,65063.32
1954-01-07,25.06,-0.08,-0.32,31.86,-21.34,True,1,6498,-25.06,-98296.32,162839.88,64543.56
1954-01-08,24.93,-0.13,-0.52,31.86,-21.75,True,1,6499,-24.93,-98321.25,162020.07,63698.82
1954-01-11,24.8,-0.13,-0.52,31.86,-22.16,True,1,6500,-24.8,-98346.05,161200.0,62853.95
1954-01-12,24.93,0.13,0.52,31.86,-21.75,True,1,6501,-24.93,-98370.98,162069.93,63698.95
1954-01-13,25.07,0.14,0.56,31.86,-21.31,True,1,6502,-25.07,-98396.05,163005.14,64609.09
1954-01-14,25.19,0.12,0.48,31.86,-20.94,True,1,6503,-25.19,-98421.24,163810.57,65389.33
1954-01-15,25.43,0.24,0.95,31.86,-20.18,True,1,6504,-25.43,-98446.67,165396.72,66950.05
1954-01-18,25.43,0.0,0.0,31.86,-20.18,True,1,6505,-25.43,-98472.1,165422.15,66950.05
1954-01-19,25.68,0.25,0.98,31.86,-19.4,True,1,6506,-25.68,-98497.78,167074.08,68576.3
1954-01-20,25.75,0.07,0.27,31.86,-19.18,True,1,6507,-25.75,-98523.53,167555.25,69031.72
1954-01-21,25.79,0.04,0.16,31.86,-19.05,True,1,6508,-25.79,-98549.32,167841.32,69292.0
1954-01-22,25.85,0.06,0.23,31.86,-18.86,True,1,6509,-25.85,-98575.17,168257.65,69682.48
1954-01-25,25.93,0.08,0.31,31.86,-18.61,True,1,6510,-25.93,-98601.1,168804.3,70203.2
1954-01-26,26.09,0.16,0.62,31.86,-18.11,True,1,6511,-26.09,-98627.19,169871.99,71244.8
1954-01-27,26.01,-0.08,-0.31,31.86,-18.36,True,1,6512,-26.01,-98653.2,169377.12,70723.92
1954-01-28,26.02,0.01,0.04,31.86,-18.33,True,1,6513,-26.02,-98679.22,169468.26,70789.04
1954-01-29,26.08,0.06,0.23,31.86,-18.14,True,1,6514,-26.08,-98705.3,169885.12,71179.82
1954-02-01,25.99,-0.09,-0.34,31.86,-18.42,True,1,6515,-25.99,-98731.29,169324.85,70593.56
1954-02-02,25.92,-0.07,-0.27,31.86,-18.64,True,1,6516,-25.92,-98757.21,168894.72,70137.51
1954-02-03,26.01,0.09,0.35,31.86,-18.36,True,1,6517,-26.01,-98783.22,169507.17,70723.95
1954-02-04,26.2,0.19,0.73,31.86,-17.76,True,1,6518,-26.2,-98809.42,170771.6,71962.18
1954-02-05,26.3,0.1,0.38,31.86,-17.45,True,1,6519,-26.3,-98835.72,171449.7,72613.98
1954-02-08,26.23,-0.07,-0.27,31.86,-17.67,True,1,6520,-26.23,-98861.95,171019.6,72157.65
1954-02-09,26.17,-0.06,-0.23,31.86,-17.86,True,1,6521,-26.17,-98888.12,170654.57,71766.45
1954-02-10,26.14,-0.03,-0.12,31.86,-17.95,True,1,6522,-26.14,-98914.26,170485.08,71570.82
1954-02-11,26.06,-0.08,-0.31,31.86,-18.2,True,1,6523,-26.06,-98940.32,169989.38,71049.06
1954-02-12,26.12,0.06,0.23,31.86,-18.02,True,1,6524,-26.12,-98966.44,170406.88,71440.44
1954-02-15,26.04,-0.08,-0.31,31.86,-18.27,True,1,6525,-26.04,-98992.48,169911.0,70918.52
1954-02-16,25.81,-0.23,-0.88,31.86,-18.99,True,1,6526,-25.81,-99018.29,168436.06,69417.77
1954-02-17,25.86,0.05,0.19,31.86,-18.83,True,1,6527,-25.86,-99044.15,168788.22,69744.07
1954-02-18,25.86,0.0,0.0,31.86,-18.83,True,1,6528,-25.86,-99070.01,168814.08,69744.07
1954-02-19,25.92,0.06,0.23,31.86,-18.64,True,1,6529,-25.92,-99095.93,169231.68,70135.75
1954-02-23,25.83,-0.09,-0.35,31.86,-18.93,True,1,6530,-25.83,-99121.76,168669.9,69548.14
1954-02-24,25.83,0.0,0.0,31.86,-18.93,True,1,6531,-25.83,-99147.59,168695.73,69548.14
1954-02-25,25.91,0.08,0.31,31.86,-18.68,True,1,6532,-25.91,-99173.5,169244.12,70070.62
1954-02-26,26.15,0.24,0.93,31.86,-17.92,True,1,6533,-26.15,-99199.65,170837.95,71638.3
1954-03-01,26.25,0.1,0.38,31.86,-17.61,True,1,6534,-26.25,-99225.9,171517.5,72291.6
1954-03-02,26.32,0.07,0.27,31.86,-17.39,True,1,6535,-26.32,-99252.22,172001.2,72748.98
1954-03-03,26.32,0.0,0.0,31.86,-17.39,True,1,6536,-26.32,-99278.54,172027.52,72748.98
1954-03-04,26.41,0.09,0.34,31.86,-17.11,True,1,6537,-26.41,-99304.95,172642.17,73337.22
1954-03-05,26.52,0.11,0.42,31.86,-16.76,True,1,6538,-26.52,-99331.47,173387.76,74056.29
1954-03-08,26.45,-0.07,-0.26,31.86,-16.98,True,1,6539,-26.45,-99357.92,172956.55,73598.63
1954-03-09,26.51,0.06,0.23,31.86,-16.79,True,1,6540,-26.51,-99384.43,173375.4,73990.97
1954-03-10,26.57,0.06,0.23,31.86,-16.6,True,1,6541,-26.57,-99411.0,173794.37,74383.37
1954-03-11,26.69,0.12,0.45,31.86,-16.23,True,1,6542,-26.69,-99437.69,174605.98,75168.29
1954-03-12,26.69,0.0,0.0,31.86,-16.23,True,1,6543,-26.69,-99464.38,174632.67,75168.29
1954-03-15,26.57,-0.12,-0.45,31.86,-16.6,True,1,6544,-26.57,-99490.95,173874.08,74383.13
1954-03-16,26.56,-0.01,-0.04,31.86,-16.64,True,1,6545,-26.56,-99517.51,173835.2,74317.69
1954-03-17,26.62,0.06,0.23,31.86,-16.45,True,1,6546,-26.62,-99544.13,174254.52,74710.39
1954-03-18,26.73,0.11,0.41,31.86,-16.1,True,1,6547,-26.73,-99570.86,175001.31,75430.45
1954-03-19,26.81,0.08,0.3,31.86,-15.85,True,1,6548,-26.81,-99597.67,175551.88,75954.21
1954-03-22,26.79,-0.02,-0.08,31.86,-15.91,True,1,6549,-26.79,-99624.46,175447.71,75823.25
1954-03-23,26.6,-0.19,-0.71,31.86,-16.51,True,1,6550,-26.6,-99651.06,174230.0,74578.94
1954-03-24,26.47,-0.13,-0.49,31.86,-16.92,True,1,6551,-26.47,-99677.53,173404.97,73727.44
1954-03-25,26.42,-0.05,-0.19,31.86,-17.08,True,1,6552,-26.42,-99703.95,173103.84,73399.89
1954-03-26,26.56,0.14,0.53,31.86,-16.64,True,1,6553,-26.56,-99730.51,174047.68,74317.17
1954-03-29,26.66,0.1,0.38,31.86,-16.32,True,1,6554,-26.66,-99757.17,174729.64,74972.47
1954-03-30,26.69,0.03,0.11,31.86,-16.23,True,1,6555,-26.69,-99783.86,174952.95,75169.09
1954-03-31,26.94,0.25,0.94,31.86,-15.44,True,1,6556,-26.94,-99810.8,176618.64,76807.84
1954-04-01,27.17,0.23,0.85,31.86,-14.72,True,1,6557,-27.17,-99837.97,178153.69,78315.72
1954-04-02,27.21,0.04,0.15,31.86,-14.6,True,1,6558,-27.21,-99865.18,178443.18,78578.0
1954-04-05,27.26,0.05,0.18,31.86,-14.44,True,1,6559,-27.26,-99892.44,178798.34,78905.9
1954-04-06,27.01,-0.25,-0.92,31.86,-15.22,True,1,6560,-27.01,-99919.45,177185.6,77266.15
1954-04-07,27.11,0.1,0.37,31.86,-14.91,True,1,6561,-27.11,-99946.56,177868.71,77922.15
1954-04-08,27.38,0.27,1.0,31.86,-14.06,True,1,6562,-27.38,-99973.94,179667.56,79693.62
1954-04-09,27.38,0.0,0.0,31.86,-14.06,True,1,6563,-27.38,-100001.32,179694.94,79693.62
1954-04-12,27.57,0.19,0.69,31.86,-13.46,True,1,6564,-27.57,-100028.89,180969.48,80940.59
1954-04-13,27.64,0.07,0.25,31.86,-13.24,True,1,6565,-27.64,-100056.53,181456.6,81400.07
1954-04-14,27.85,0.21,0.76,31.86,-12.59,True,1,6566,-27.85,-100084.38,182863.1,82778.72
1954-04-15,27.94,0.09,0.32,31.86,-12.3,True,1,6567,-27.94,-100112.32,183481.98,83369.66
1954-04-19,27.76,-0.18,-0.64,31.86,-12.87,True,1,6568,-27.76,-100140.08,182327.68,82187.6
1954-04-20,27.75,-0.01,-0.04,31.86,-12.9,True,1,6569,-27.75,-100167.83,182289.75,82121.92
1954-04-21,27.64,-0.11,-0.4,31.86,-13.24,True,1,6570,-27.64,-100195.47,181594.8,81399.33
1954-04-22,27.68,0.04,0.14,31.86,-13.12,True,1,6571,-27.68,-100223.15,181885.28,81662.13
1954-04-23,27.78,0.1,0.36,31.86,-12.81,True,1,6572,-27.78,-100250.93,182570.16,82319.23
1954-04-26,27.88,0.1,0.36,31.86,-12.49,True,1,6573,-27.88,-100278.81,183255.24,82976.43
1954-04-27,27.71,-0.17,-0.61,31.86,-13.03,True,1,6574,-27.71,-100306.52,182165.54,81859.02
1954-04-28,27.76,0.05,0.18,31.86,-12.87,True,1,6575,-27.76,-100334.28,182522.0,82187.72
1954-04-29,28.18,0.42,1.51,31.86,-11.55,True,1,6576,-28.18,-100362.46,185311.68,84949.22
1954-04-30,28.26,0.08,0.28,31.86,-11.3,True,1,6577,-28.26,-100390.72,185866.02,85475.3
1954-05-03,28.21,-0.05,-0.18,31.86,-11.46,True,1,6578,-28.21,-100418.93,185565.38,85146.45
1954-05-04,28.28,0.07,0.25,31.86,-11.24,True,1,6579,-28.28,-100447.21,186054.12,85606.91
1954-05-05,28.29,0.01,0.04,31.86,-11.2,True,1,6580,-28.29,-100475.5,186148.2,85672.7
1954-05-06,28.51,0.22,0.78,31.86,-10.52,True,1,6581,-28.51,-100504.01,187624.31,87120.3
1954-05-07,28.65,0.14,0.49,31.86,-10.07,True,1,6582,-28.65,-100532.66,188574.3,88041.64
1954-05-10,28.62,-0.03,-0.1,31.86,-10.17,True,1,6583,-28.62,-100561.28,188405.46,87844.18
1954-05-11,28.49,-0.13,-0.45,31.86,-10.58,True,1,6584,-28.49,-100589.77,187578.16,86988.39
1954-05-12,28.72,0.23,0.81,31.86,-9.86,True,1,6585,-28.72,-100618.49,189121.2,88502.71
1954-05-13,28.56,-0.16,-0.56,31.86,-10.36,True,1,6586,-28.56,-100647.05,188096.16,87449.11
1954-05-14,28.8,0.24,0.84,31.86,-9.6,True,1,6587,-28.8,-100675.85,189705.6,89029.75
1954-05-17,28.84,0.04,0.14,31.86,-9.48,True,1,6588,-28.84,-100704.69,189997.92,89293.23
1954-05-18,28.85,0.01,0.04,31.86,-9.45,True,1,6589,-28.85,-100733.54,190092.65,89359.11
1954-05-19,28.72,-0.13,-0.45,31.86,-9.86,True,1,6590,-28.72,-100762.26,189264.8,88502.54
1954-05-20,28.82,0.1,0.35,31.86,-9.54,True,1,6591,-28.82,-100791.08,189952.62,89161.54
1954-05-21,28.99,0.17,0.59,31.86,-9.01,True,1,6592,-28.99,-100820.07,191102.08,90282.01
1954-05-24,29.0,0.01,0.03,31.86,-8.98,True,1,6593,-29.0,-100849.07,191197.0,90347.93
1954-05-25,28.93,-0.07,-0.24,31.86,-9.2,True,1,6594,-28.93,-100878.0,190764.42,89886.42
1954-05-26,29.17,0.24,0.83,31.86,-8.44,True,1,6595,-29.17,-100907.17,192376.15,91468.98
1954-05-27,29.05,-0.12,-0.41,31.86,-8.82,True,1,6596,-29.05,-100936.22,191613.8,90677.58
1954-05-28,29.19,0.14,0.48,31.86,-8.38,True,1,6597,-29.19,-100965.41,192566.43,91601.02
1954-06-01,29.19,0.0,0.0,31.86,-8.38,True,1,6598,-29.19,-100994.6,192595.62,91601.02
1954-06-02,29.16,-0.03,-0.1,31.86,-8.48,True,1,6599,-29.16,-101023.76,192426.84,91403.08
1954-06-03,29.15,-0.01,-0.03,31.86,-8.51,True,1,6600,-29.15,-101052.91,192390.0,91337.09
1954-06-04,29.1,-0.05,-0.17,31.86,-8.66,True,1,6601,-29.1,-101082.01,192089.1,91007.09
1954-06-07,28.99,-0.11,-0.38,31.86,-9.01,True,1,6602,-28.99,-101111.0,191391.98,90280.98
1954-06-08,28.34,-0.65,-2.24,31.86,-11.05,True,1,6603,-28.34,-101139.34,187129.02,85989.68
1954-06-09,28.15,-0.19,-0.67,31.86,-11.64,True,1,6604,-28.15,-101167.49,185902.6,84735.11
1954-06-10,28.34,0.19,0.68,31.86,-11.05,True,1,6605,-28.34,-101195.83,187185.7,85989.87
1954-06-11,28.58,0.24,0.85,31.86,-10.3,True,1,6606,-28.58,-101224.41,188799.48,87575.07
1954-06-14,28.62,0.04,0.14,31.86,-10.17,True,1,6607,-28.62,-101253.03,189092.34,87839.31
1954-06-15,28.83,0.21,0.73,31.86,-9.51,True,1,6608,-28.83,-101281.86,190508.64,89226.78
1954-06-16,29.04,0.21,0.73,31.86,-8.85,True,1,6609,-29.04,-101310.9,191925.36,90614.46
1954-06-17,28.96,-0.08,-0.28,31.86,-9.1,True,1,6610,-28.96,-101339.86,191425.6,90085.74
1954-06-18,29.04,0.08,0.28,31.86,-8.85,True,1,6611,-29.04,-101368.9,191983.44,90614.54
1954-06-21,29.06,0.02,0.07,31.86,-8.79,True,1,6612,-29.06,-101397.96,192144.72,90746.76
1954-06-22,29.08,0.02,0.07,31.86,-8.73,True,1,6613,-29.08,-101427.04,192306.04,90879.0
1954-06-23,29.13,0.05,0.17,31.86,-8.57,True,1,6614,-29.13,-101456.17,192665.82,91209.65
1954-06-24,29.26,0.13,0.45,31.86,-8.16,True,1,6615,-29.26,-101485.43,193554.9,92069.47
1954-06-25,29.2,-0.06,-0.2,31.86,-8.35,True,1,6616,-29.2,-101514.63,193187.2,91672.57
1954-06-28,29.28,0.08,0.27,31.86,-8.1,True,1,6617,-29.28,-101543.91,193745.76,92201.85
1954-06-29,29.43,0.15,0.51,31.86,-7.63,True,1,6618,-29.43,-101573.34,194767.74,93194.4
1954-06-30,29.21,-0.22,-0.75,31.86,-8.32,True,1,6619,-29.21,-101602.55,193340.99,91738.44
1954-07-01,29.21,0.0,0.0,31.86,-8.32,True,1,6620,-29.21,-101631.76,193370.2,91738.44
1954-07-02,29.59,0.38,1.3,31.86,-7.12,True,1,6621,-29.59,-101661.35,195915.39,94254.04
1954-07-06,29.92,0.33,1.12,31.86,-6.09,True,1,6622,-29.92,-101691.27,198130.24,96438.97
1954-07-07,29.94,0.02,0.07,31.86,-6.03,True,1,6623,-29.94,-101721.21,198292.62,96571.41
1954-07-08,29.94,0.0,0.0,31.86,-6.03,True,1,6624,-29.94,-101751.15,198322.56,96571.41
1954-07-09,30.14,0.2,0.67,31.86,-5.4,True,1,6625,-30.14,-101781.29,199677.5,97896.21
1954-07-12,30.12,-0.02,-0.07,31.86,-5.46,True,1,6626,-30.12,-101811.41,199575.12,97763.71
1954-07-13,30.02,-0.1,-0.33,31.86,-5.78,True,1,6627,-30.02,-101841.43,198942.54,97101.11
1954-07-14,30.09,0.07,0.23,31.86,-5.56,True,1,6628,-30.09,-101871.52,199436.52,97565.0
1954-07-15,30.19,0.1,0.33,31.86,-5.24,True,1,6629,-30.19,-101901.71,200129.51,98227.8
1954-07-16,30.06,-0.13,-0.43,31.86,-5.65,True,1,6630,-30.06,-101931.77,199297.8,97366.03
1954-07-19,29.98,-0.08,-0.27,31.86,-5.9,True,1,6631,-29.98,-101961.75,198797.38,96835.63
1954-07-20,29.84,-0.14,-0.47,31.86,-6.34,True,1,6632,-29.84,-101991.59,197898.88,95907.29
1954-07-21,30.03,0.19,0.64,31.86,-5.74,True,1,6633,-30.03,-102021.62,199188.99,97167.37
1954-07-22,30.27,0.24,0.8,31.86,-4.99,True,1,6634,-30.27,-102051.89,200811.18,98759.29
1954-07-23,30.31,0.04,0.13,31.86,-4.86,True,1,6635,-30.31,-102082.2,201106.85,99024.65
1954-07-26,30.34,0.03,0.1,31.86,-4.77,True,1,6636,-30.34,-102112.54,201336.24,99223.7
1954-07-27,30.52,0.18,0.59,31.86,-4.21,True,1,6637,-30.52,-102143.06,202561.24,100418.18
1954-07-28,30.58,0.06,0.2,31.86,-4.02,True,1,6638,-30.58,-102173.64,202990.04,100816.4
1954-07-29,30.69,0.11,0.36,31.86,-3.67,True,1,6639,-30.69,-102204.33,203750.91,101546.58
1954-07-30,30.88,0.19,0.62,31.86,-3.08,True,1,6640,-30.88,-102235.21,205043.2,102807.99
1954-08-02,30.99,0.11,0.36,31.86,-2.73,True,1,6641,-30.99,-102266.2,205804.59,103538.39
1954-08-03,30.93,-0.06,-0.19,31.86,-2.92,True,1,6642,-30.93,-102297.13,205437.06,103139.93
1954-08-04,30.9,-0.03,-0.1,31.86,-3.01,True,1,6643,-30.9,-102328.03,205268.7,102940.67
1954-08-05,30.77,-0.13,-0.42,31.86,-3.42,True,1,6644,-30.77,-102358.8,204435.88,102077.08
1954-08-06,30.38,-0.39,-1.27,31.86,-4.64,True,1,6645,-30.38,-102389.18,201875.1,99485.92
1954-08-09,30.12,-0.26,-0.86,31.86,-5.46,True,1,6646,-30.12,-102419.3,200177.52,97758.22
1954-08-10,30.37,0.25,0.83,31.86,-4.68,True,1,6647,-30.37,-102449.67,201869.39,99419.72
1954-08-11,30.72,0.35,1.15,31.86,-3.58,True,1,6648,-30.72,-102480.39,204226.56,101746.17
1954-08-12,30.59,-0.13,-0.42,31.86,-3.99,True,1,6649,-30.59,-102510.98,203392.91,100881.93
1954-08-13,30.72,0.13,0.42,31.86,-3.58,True,1,6650,-30.72,-102541.7,204288.0,101746.3
1954-08-16,31.05,0.33,1.07,31.86,-2.54,True,1,6651,-31.05,-102572.75,206513.55,103940.8
1954-08-17,31.12,0.07,0.22,31.86,-2.32,True,1,6652,-31.12,-102603.87,207010.24,104406.37
1954-08-18,31.09,-0.03,-0.1,31.86,-2.42,True,1,6653,-31.09,-102634.96,206841.77,104206.81
1954-08-19,31.16,0.07,0.22,31.86,-2.2,True,1,6654,-31.16,-102666.12,207338.64,104672.52
1954-08-20,31.21,0.05,0.16,31.86,-2.04,True,1,6655,-31.21,-102697.33,207702.55,105005.22
1954-08-23,31.0,-0.21,-0.67,31.86,-2.7,True,1,6656,-31.0,-102728.33,206336.0,103607.67
1954-08-24,30.87,-0.13,-0.42,31.86,-3.11,True,1,6657,-30.87,-102759.2,205501.59,102742.39
1954-08-25,30.65,-0.22,-0.71,31.86,-3.8,True,1,6658,-30.65,-102789.85,204067.7,101277.85
1954-08-26,30.57,-0.08,-0.26,31.86,-4.05,True,1,6659,-30.57,-102820.42,203565.63,100745.21
1954-08-27,30.66,0.09,0.29,31.86,-3.77,True,1,6660,-30.66,-102851.08,204195.6,101344.52
1954-08-30,30.35,-0.31,-1.01,31.86,-4.74,True,1,6661,-30.35,-102881.43,202161.35,99279.92
1954-08-31,29.83,-0.52,-1.71,31.86,-6.37,True,1,6662,-29.83,-102911.26,198727.46,95816.2
1954-09-01,30.04,0.21,0.7,31.86,-5.71,True,1,6663,-30.04,-102941.3,200156.52,97215.22
1954-09-02,30.27,0.23,0.77,31.86,-4.99,True,1,6664,-30.27,-102971.57,201719.28,98747.71
1954-09-03,30.5,0.23,0.76,31.86,-4.27,True,1,6665,-30.5,-103002.07,203282.5,100280.43
1954-09-07,30.66,0.16,0.52,31.86,-3.77,True,1,6666,-30.66,-103032.73,204379.56,101346.83
1954-09-08,30.68,0.02,0.06,31.86,-3.7,True,1,6667,-30.68,-103063.41,204543.56,101480.15
1954-09-09,30.73,0.05,0.16,31.86,-3.55,True,1,6668,-30.73,-103094.14,204907.64,101813.5
1954-09-10,30.84,0.11,0.36,31.86,-3.2,True,1,6669,-30.84,-103124.98,205671.96,102546.98
1954-09-13,31.12,0.28,0.91,31.86,-2.32,True,1,6670,-31.12,-103156.1,207570.4,104414.3
1954-09-14,31.28,0.16,0.51,31.86,-1.82,True,1,6671,-31.28,-103187.38,208668.88,105481.5
1954-09-15,31.29,0.01,0.03,31.86,-1.79,True,1,6672,-31.29,-103218.67,208766.88,105548.21
1954-09-16,31.46,0.17,0.54,31.86,-1.25,True,1,6673,-31.46,-103250.13,209932.58,106682.45
1954-09-17,31.71,0.25,0.8,31.86,-0.47,True,1,6674,-31.71,-103281.84,211632.54,108350.7
1954-09-20,31.57,-0.14,-0.44,31.86,-0.91,True,1,6675,-31.57,-103313.41,210729.75,107416.34
1954-09-21,31.79,0.22,0.7,31.86,-0.22,True,1,6676,-31.79,-103345.2,212230.04,108884.84
1954-09-22,32.0,0.21,0.66,32.0,0.0,True,1,6677,-32.0,-103377.2,213664.0,110286.8
1954-09-23,32.18,0.18,0.56,32.18,0.0,True,1,6678,-32.18,-103409.38,214898.04,111488.66
1954-09-24,32.4,0.22,0.68,32.4,0.0,True,1,6679,-32.4,-103441.78,216399.6,112957.82
1954-09-27,32.53,0.13,0.4,32.53,0.0,True,1,6680,-32.53,-103474.31,217300.4,113826.09
1954-09-28,32.69,0.16,0.49,32.69,0.0,True,1,6681,-32.69,-103507.0,218401.89,114894.89
1954-09-29,32.5,-0.19,-0.58,32.69,-0.58,True,1,6682,-32.5,-103539.5,217165.0,113625.5
1954-09-30,32.31,-0.19,-0.58,32.69,-1.16,True,1,6683,-32.31,-103571.81,215927.73,112355.92
1954-10-01,32.29,-0.02,-0.06,32.69,-1.22,True,1,6684,-32.29,-103604.1,215826.36,112222.26
1954-10-04,32.47,0.18,0.56,32.69,-0.67,True,1,6685,-32.47,-103636.57,217061.95,113425.38
1954-10-05,32.63,0.16,0.49,32.69,-0.18,True,1,6686,-32.63,-103669.2,218164.18,114494.98
1954-10-06,32.76,0.13,0.4,32.76,0.0,True,1,6687,-32.76,-103701.96,219066.12,115364.16
1954-10-07,32.69,-0.07,-0.21,32.76,-0.21,True,1,6688,-32.69,-103734.65,218630.72,114896.07
1954-10-08,32.67,-0.02,-0.06,32.76,-0.28,True,1,6689,-32.67,-103767.32,218529.63,114762.31
1954-10-11,32.41,-0.26,-0.8,32.76,-1.07,True,1,6690,-32.41,-103799.73,216822.9,113023.17
1954-10-12,32.28,-0.13,-0.4,32.76,-1.46,True,1,6691,-32.28,-103832.01,215985.48,112153.47
1954-10-13,32.27,-0.01,-0.03,32.76,-1.5,True,1,6692,-32.27,-103864.28,215950.84,112086.56
1954-10-14,31.88,-0.39,-1.21,32.76,-2.69,True,1,6693,-31.88,-103896.16,213372.84,109476.68
1954-10-15,31.71,-0.17,-0.53,32.76,-3.2,True,1,6694,-31.71,-103927.87,212266.74,108338.87
1954-10-18,31.83,0.12,0.38,32.76,-2.84,True,1,6695,-31.83,-103959.7,213101.85,109142.15
1954-10-19,31.91,0.08,0.25,32.76,-2.6,True,1,6696,-31.91,-103991.61,213669.36,109677.75
1954-10-20,32.17,0.26,0.82,32.76,-1.8,True,1,6697,-32.17,-104023.78,215442.49,111418.71
1954-10-21,32.13,-0.04,-0.12,32.76,-1.92,True,1,6698,-32.13,-104055.91,215206.74,111150.83
1954-10-22,32.13,0.0,0.0,32.76,-1.92,True,1,6699,-32.13,-104088.04,215238.87,111150.83
1954-10-25,31.96,-0.17,-0.53,32.76,-2.44,True,1,6700,-31.96,-104120.0,214132.0,110012.0
1954-10-26,31.94,-0.02,-0.06,32.76,-2.5,True,1,6701,-31.94,-104151.94,214029.94,109878.0
1954-10-27,32.02,0.08,0.25,32.76,-2.26,True,1,6702,-32.02,-104183.96,214598.04,110414.08
1954-10-28,31.88,-0.14,-0.44,32.76,-2.69,True,1,6703,-31.88,-104215.84,213691.64,109475.8
1954-10-29,31.68,-0.2,-0.63,32.76,-3.3,True,1,6704,-31.68,-104247.52,212382.72,108135.2
1954-11-01,31.79,0.11,0.35,32.76,-2.96,True,1,6705,-31.79,-104279.31,213151.95,108872.64
1954-11-03,32.44,0.65,2.04,32.76,-0.98,True,1,6706,-32.44,-104311.75,217542.64,113230.89
1954-11-04,32.82,0.38,1.17,32.82,0.0,True,1,6707,-32.82,-104344.57,220123.74,115779.17
1954-11-05,32.71,-0.11,-0.34,32.82,-0.34,True,1,6708,-32.71,-104377.28,219418.68,115041.4
1954-11-08,33.02,0.31,0.95,33.02,0.0,True,1,6709,-33.02,-104410.3,221531.18,117120.88
1954-11-09,33.15,0.13,0.39,33.15,0.0,True,1,6710,-33.15,-104443.45,222436.5,117993.05
1954-11-10,33.18,0.03,0.09,33.18,0.0,True,1,6711,-33.18,-104476.63,222670.98,118194.35
1954-11-11,33.47,0.29,0.87,33.47,0.0,True,1,6712,-33.47,-104510.1,224650.64,120140.54
1954-11-12,33.54,0.07,0.21,33.54,0.0,True,1,6713,-33.54,-104543.64,225154.02,120610.38
1954-11-15,33.47,-0.07,-0.21,33.54,-0.21,True,1,6714,-33.47,-104577.11,224717.58,120140.47
1954-11-16,33.57,0.1,0.3,33.57,0.0,True,1,6715,-33.57,-104610.68,225422.55,120811.87
1954-11-17,33.63,0.06,0.18,33.63,0.0,True,1,6716,-33.63,-104644.31,225859.08,121214.77
1954-11-18,33.44,-0.19,-0.56,33.63,-0.56,True,1,6717,-33.44,-104677.75,224616.48,119938.73
1954-11-19,33.45,0.01,0.03,33.63,-0.54,True,1,6718,-33.45,-104711.2,224717.1,120005.9
1954-11-22,33.58,0.13,0.39,33.63,-0.15,True,1,6719,-33.58,-104744.78,225624.02,120879.24
1954-11-23,34.03,0.45,1.34,34.03,0.0,True,1,6720,-34.03,-104778.81,228681.6,123902.79
1954-11-24,34.22,0.19,0.56,34.22,0.0,True,1,6721,-34.22,-104813.03,229992.62,125179.59
1954-11-26,34.55,0.33,0.96,34.55,0.0,True,1,6722,-34.55,-104847.58,232245.1,127397.52
1954-11-29,34.54,-0.01,-0.03,34.55,-0.03,True,1,6723,-34.54,-104882.12,232212.42,127330.3
1954-11-30,34.24,-0.3,-0.87,34.55,-0.9,True,1,6724,-34.24,-104916.36,230229.76,125313.4
1954-12-01,33.99,-0.25,-0.73,34.55,-1.62,True,1,6725,-33.99,-104950.35,228582.75,123632.4
1954-12-02,34.18,0.19,0.56,34.55,-1.07,True,1,6726,-34.18,-104984.53,229894.68,124910.15
1954-12-03,34.49,0.31,0.91,34.55,-0.17,True,1,6727,-34.49,-105019.02,232014.23,126995.21
1954-12-06,34.76,0.27,0.78,34.76,0.0,True,1,6728,-34.76,-105053.78,233865.28,128811.5
1954-12-07,34.92,0.16,0.46,34.92,0.0,True,1,6729,-34.92,-105088.7,234976.68,129887.98
1954-12-08,34.86,-0.06,-0.17,34.92,-0.17,True,1,6730,-34.86,-105123.56,234607.8,129484.24
1954-12-09,34.69,-0.17,-0.49,34.92,-0.66,True,1,6731,-34.69,-105158.25,233498.39,128340.14
1954-12-10,34.56,-0.13,-0.38,34.92,-1.03,True,1,6732,-34.56,-105192.81,232657.92,127465.11
1954-12-13,34.59,0.03,0.09,34.92,-0.94,True,1,6733,-34.59,-105227.4,232894.47,127667.07
1954-12-14,34.35,-0.24,-0.69,34.92,-1.63,True,1,6734,-34.35,-105261.75,231312.9,126051.15
1954-12-15,34.56,0.21,0.61,34.92,-1.03,True,1,6735,-34.56,-105296.31,232761.6,127465.29
1954-12-16,34.93,0.37,1.07,34.93,0.0,True,1,6736,-34.93,-105331.24,235288.48,129957.24
1954-12-17,35.92,0.99,2.83,35.92,0.0,True,1,6737,-35.92,-105367.16,241993.04,136625.88
1954-12-20,35.33,-0.59,-1.64,35.92,-1.64,True,1,6738,-35.33,-105402.49,238053.54,132651.05
1954-12-21,35.38,0.05,0.14,35.92,-1.5,True,1,6739,-35.38,-105437.87,238425.82,132987.95
1954-12-22,35.34,-0.04,-0.11,35.92,-1.62,True,1,6740,-35.34,-105473.21,238191.6,132718.39
1954-12-23,35.37,0.03,0.08,35.92,-1.53,True,1,6741,-35.37,-105508.58,238429.17,132920.59
1954-12-27,35.07,-0.3,-0.85,35.92,-2.37,True,1,6742,-35.07,-105543.65,236441.94,130898.29
1954-12-28,35.43,0.36,1.03,35.92,-1.36,True,1,6743,-35.43,-105579.08,238904.49,133325.41
1954-12-29,35.74,0.31,0.88,35.92,-0.5,True,1,6744,-35.74,-105614.82,241030.56,135415.74
1954-12-30,35.74,0.0,0.0,35.92,-0.5,True,1,6745,-35.74,-105650.56,241066.3,135415.74
1954-12-31,35.98,0.24,0.67,35.98,0.0,True,1,6746,-35.98,-105686.54,242721.08,137034.54
1955-01-03,36.75,0.77,2.14,36.75,0.0,True,1,6747,-36.75,-105723.29,247952.25,142228.96
1955-01-04,36.42,-0.33,-0.9,36.75,-0.9,True,1,6748,-36.42,-105759.71,245762.16,140002.45
1955-01-05,35.52,-0.9,-2.47,36.75,-3.35,True,1,6749,-35.52,-105795.23,239724.48,133929.25
1955-01-06,35.04,-0.48,-1.35,36.75,-4.65,True,1,6750,-35.04,-105830.27,236520.0,130689.73
1955-01-07,35.33,0.29,0.83,36.75,-3.86,True,1,6751,-35.33,-105865.6,238512.83,132647.23
1955-01-10,35.79,0.46,1.3,36.75,-2.61,True,1,6752,-35.79,-105901.39,241654.08,135752.69
1955-01-11,35.68,-0.11,-0.31,36.75,-2.91,True,1,6753,-35.68,-105937.07,240947.04,135009.97
1955-01-12,35.58,-0.1,-0.28,36.75,-3.18,True,1,6754,-35.58,-105972.65,240307.32,134334.67
1955-01-13,35.43,-0.15,-0.42,36.75,-3.59,True,1,6755,-35.43,-106008.08,239329.65,133321.57
1955-01-14,35.28,-0.15,-0.42,36.75,-4.0,True,1,6756,-35.28,-106043.36,238351.68,132308.32
1955-01-17,34.58,-0.7,-1.98,36.75,-5.9,True,1,6757,-34.58,-106077.94,233657.06,127579.12
1955-01-18,34.8,0.22,0.64,36.75,-5.31,True,1,6758,-34.8,-106112.74,235178.4,129065.66
1955-01-19,34.96,0.16,0.46,36.75,-4.87,True,1,6759,-34.96,-106147.7,236294.64,130146.94
1955-01-20,35.13,0.17,0.49,36.75,-4.41,True,1,6760,-35.13,-106182.83,237478.8,131295.97
1955-01-21,35.44,0.31,0.88,36.75,-3.56,True,1,6761,-35.44,-106218.27,239609.84,133391.57
1955-01-24,35.52,0.08,0.23,36.75,-3.35,True,1,6762,-35.52,-106253.79,240186.24,133932.45
1955-01-25,35.51,-0.01,-0.03,36.75,-3.37,True,1,6763,-35.51,-106289.3,240154.13,133864.83
1955-01-26,35.95,0.44,1.24,36.75,-2.18,True,1,6764,-35.95,-106325.25,243165.8,136840.55
1955-01-27,35.99,0.04,0.11,36.75,-2.07,True,1,6765,-35.99,-106361.24,243472.35,137111.11
1955-01-28,36.19,0.2,0.56,36.75,-1.52,True,1,6766,-36.19,-106397.43,244861.54,138464.11
1955-01-31,36.63,0.44,1.22,36.75,-0.33,True,1,6767,-36.63,-106434.06,247875.21,141441.15
1955-02-01,36.72,0.09,0.25,36.75,-0.08,True,1,6768,-36.72,-106470.78,248520.96,142050.18
1955-02-02,36.61,-0.11,-0.3,36.75,-0.38,True,1,6769,-36.61,-106507.39,247813.09,141305.7
1955-02-03,36.44,-0.17,-0.46,36.75,-0.84,True,1,6770,-36.44,-106543.83,246698.8,140154.97
1955-02-04,36.96,0.52,1.43,36.96,0.0,True,1,6771,-36.96,-106580.79,250256.16,143675.37
1955-02-07,36.96,0.0,0.0,36.96,0.0,True,1,6772,-36.96,-106617.75,250293.12,143675.37
1955-02-08,36.46,-0.5,-1.35,36.96,-1.35,True,1,6773,-36.46,-106654.21,246943.58,140289.37
1955-02-09,36.75,0.29,0.8,36.96,-0.57,True,1,6774,-36.75,-106690.96,248944.5,142253.54
1955-02-10,37.08,0.33,0.9,37.08,0.0,True,1,6775,-37.08,-106728.04,251217.0,144488.96
1955-02-11,37.15,0.07,0.19,37.15,0.0,True,1,6776,-37.15,-106765.19,251728.4,144963.21
1955-02-14,36.89,-0.26,-0.7,37.15,-0.7,True,1,6777,-36.89,-106802.08,250003.53,143201.45
1955-02-15,36.89,0.0,0.0,37.15,-0.7,True,1,6778,-36.89,-106838.97,250040.42,143201.45
1955-02-16,36.77,-0.12,-0.32,37.15,-1.02,True,1,6779,-36.77,-106875.74,249263.83,142388.09
1955-02-17,36.84,0.07,0.19,37.15,-0.83,True,1,6780,-36.84,-106912.58,249775.2,142862.62
1955-02-18,36.89,0.05,0.14,37.15,-0.7,True,1,6781,-36.89,-106949.47,250151.09,143201.62
1955-02-21,36.85,-0.04,-0.11,37.15,-0.81,True,1,6782,-36.85,-106986.32,249916.7,142930.38
1955-02-23,36.82,-0.03,-0.08,37.15,-0.89,True,1,6783,-36.82,-107023.14,249750.06,142726.92
1955-02-24,36.62,-0.2,-0.54,37.15,-1.43,True,1,6784,-36.62,-107059.76,248430.08,141370.32
1955-02-25,36.57,-0.05,-0.14,37.15,-1.56,True,1,6785,-36.57,-107096.33,248127.45,141031.12
1955-02-28,36.76,0.19,0.52,37.15,-1.05,True,1,6786,-36.76,-107133.09,249453.36,142320.27
1955-03-01,36.83,0.07,0.19,37.15,-0.86,True,1,6787,-36.83,-107169.92,249965.21,142795.29
1955-03-02,37.15,0.32,0.87,37.15,0.0,True,1,6788,-37.15,-107207.07,252174.2,144967.13
1955-03-03,37.29,0.14,0.38,37.29,0.0,True,1,6789,-37.29,-107244.36,253161.81,145917.45
1955-03-04,37.52,0.23,0.62,37.52,0.0,True,1,6790,-37.52,-107281.88,254760.8,147478.92
1955-03-07,37.28,-0.24,-0.64,37.52,-0.64,True,1,6791,-37.28,-107319.16,253168.48,145849.32
1955-03-08,36.58,-0.7,-1.88,37.52,-2.5,True,1,6792,-36.58,-107355.74,248451.36,141095.62
1955-03-09,36.22,-0.36,-0.98,37.52,-3.46,True,1,6793,-36.22,-107391.96,246042.46,138650.5
1955-03-10,36.45,0.23,0.64,37.52,-2.85,True,1,6794,-36.45,-107428.41,247641.3,140212.89
1955-03-11,35.82,-0.63,-1.73,37.52,-4.53,True,1,6795,-35.82,-107464.23,243396.9,135932.67
1955-03-14,34.96,-0.86,-2.4,37.52,-6.82,True,1,6796,-34.96,-107499.19,237588.16,130088.97
1955-03-15,35.71,0.75,2.14,37.52,-4.82,True,1,6797,-35.71,-107534.9,242720.87,135185.97
1955-03-16,35.98,0.27,0.76,37.52,-4.1,True,1,6798,-35.98,-107570.88,244592.04,137021.16
1955-03-17,36.12,0.14,0.39,37.52,-3.73,True,1,6799,-36.12,-107607.0,245579.88,137972.88
1955-03-18,36.18,0.06,0.17,37.52,-3.57,True,1,6800,-36.18,-107643.18,246024.0,138380.82
1955-03-21,35.95,-0.23,-0.64,37.52,-4.18,True,1,6801,-35.95,-107679.13,244495.95,136816.82
1955-03-22,36.17,0.22,0.61,37.52,-3.6,True,1,6802,-36.17,-107715.3,246028.34,138313.04
1955-03-23,36.64,0.47,1.3,37.52,-2.35,True,1,6803,-36.64,-107751.94,249261.92,141509.98
1955-03-24,36.93,0.29,0.79,37.52,-1.57,True,1,6804,-36.93,-107788.87,251271.72,143482.85
1955-03-25,36.96,0.03,0.08,37.52,-1.49,True,1,6805,-36.96,-107825.83,251512.8,143686.97
1955-03-28,36.83,-0.13,-0.35,37.52,-1.84,True,1,6806,-36.83,-107862.66,250664.98,142802.32
1955-03-29,36.85,0.02,0.05,37.52,-1.79,True,1,6807,-36.85,-107899.51,250837.95,142938.44
1955-03-30,36.52,-0.33,-0.9,37.52,-2.66,True,1,6808,-36.52,-107936.03,248628.16,140692.13
1955-03-31,36.58,0.06,0.16,37.52,-2.5,True,1,6809,-36.58,-107972.61,249073.22,141100.61
1955-04-01,36.95,0.37,1.01,37.52,-1.52,True,1,6810,-36.95,-108009.56,251629.5,143619.94
1955-04-04,36.83,-0.12,-0.32,37.52,-1.84,True,1,6811,-36.83,-108046.39,250849.13,142802.74
1955-04-05,36.98,0.15,0.41,37.52,-1.44,True,1,6812,-36.98,-108083.37,251907.76,143824.39
1955-04-06,37.17,0.19,0.51,37.52,-0.93,True,1,6813,-37.17,-108120.54,253239.21,145118.67
1955-04-07,37.34,0.17,0.46,37.52,-0.48,True,1,6814,-37.34,-108157.88,254434.76,146276.88
1955-04-11,37.44,0.1,0.27,37.52,-0.21,True,1,6815,-37.44,-108195.32,255153.6,146958.28
1955-04-12,37.66,0.22,0.59,37.66,0.0,True,1,6816,-37.66,-108232.98,256690.56,148457.58
1955-04-13,37.71,0.05,0.13,37.71,0.0,True,1,6817,-37.71,-108270.69,257069.07,148798.38
1955-04-14,37.79,0.08,0.21,37.79,0.0,True,1,6818,-37.79,-108308.48,257652.22,149343.74
1955-04-15,37.96,0.17,0.45,37.96,0.0,True,1,6819,-37.96,-108346.44,258849.24,150502.8
1955-04-18,38.27,0.31,0.82,38.27,0.0,True,1,6820,-38.27,-108384.71,261001.4,152616.69
1955-04-19,38.22,-0.05,-0.13,38.27,-0.13,True,1,6821,-38.22,-108422.93,260698.62,152275.69
1955-04-20,38.28,0.06,0.16,38.28,0.0,True,1,6822,-38.28,-108461.21,261146.16,152684.95
1955-04-21,38.32,0.04,0.1,38.32,0.0,True,1,6823,-38.32,-108499.53,261457.36,152957.83
1955-04-22,38.01,-0.31,-0.81,38.32,-0.81,True,1,6824,-38.01,-108537.54,259380.24,150842.7
1955-04-25,38.11,0.1,0.26,38.32,-0.55,True,1,6825,-38.11,-108575.65,260100.75,151525.1
1955-04-26,38.31,0.2,0.52,38.32,-0.03,True,1,6826,-38.31,-108613.96,261504.06,152890.1
1955-04-27,38.11,-0.2,-0.52,38.32,-0.55,True,1,6827,-38.11,-108652.07,260176.97,151524.9
1955-04-28,37.68,-0.43,-1.13,38.32,-1.67,True,1,6828,-37.68,-108689.75,257279.04,148589.29
1955-04-29,37.96,0.28,0.74,38.32,-0.94,True,1,6829,-37.96,-108727.71,259228.84,150501.13
1955-05-02,38.04,0.08,0.21,38.32,-0.73,True,1,6830,-38.04,-108765.75,259813.2,151047.45
1955-05-03,37.7,-0.34,-0.89,38.32,-1.62,True,1,6831,-37.7,-108803.45,257528.7,148725.25
1955-05-04,37.64,-0.06,-0.16,38.32,-1.78,True,1,6832,-37.64,-108841.09,257156.48,148315.39
1955-05-05,37.82,0.18,0.48,38.32,-1.3,True,1,6833,-37.82,-108878.91,258424.06,149545.15
1955-05-06,37.89,0.07,0.18,38.32,-1.12,True,1,6834,-37.89,-108916.8,258940.26,150023.46
1955-05-09,37.93,0.04,0.11,38.32,-1.02,True,1,6835,-37.93,-108954.73,259251.55,150296.82
1955-05-10,37.85,-0.08,-0.21,38.32,-1.23,True,1,6836,-37.85,-108992.58,258742.6,149750.02
1955-05-11,37.42,-0.43,-1.14,38.32,-2.35,True,1,6837,-37.42,-109030.0,255840.54,146810.54
1955-05-12,37.2,-0.22,-0.59,38.32,-2.92,True,1,6838,-37.2,-109067.2,254373.6,145306.4
1955-05-13,37.44,0.24,0.64,38.32,-2.3,True,1,6839,-37.44,-109104.64,256052.16,146947.52
1955-05-16,37.02,-0.42,-1.12,38.32,-3.39,True,1,6840,-37.02,-109141.66,253216.8,144075.14
1955-05-17,36.97,-0.05,-0.14,38.32,-3.52,True,1,6841,-36.97,-109178.63,252911.77,143733.14
1955-05-18,37.28,0.31,0.84,38.32,-2.71,True,1,6842,-37.28,-109215.91,255069.76,145853.85
1955-05-19,37.49,0.21,0.56,38.32,-2.17,True,1,6843,-37.49,-109253.4,256544.07,147290.67
1955-05-20,37.74,0.25,0.67,38.32,-1.51,True,1,6844,-37.74,-109291.14,258292.56,149001.42
1955-05-23,37.48,-0.26,-0.69,38.32,-2.19,True,1,6845,-37.48,-109328.62,256550.6,147221.98
1955-05-24,37.46,-0.02,-0.05,38.32,-2.24,True,1,6846,-37.46,-109366.08,256451.16,147085.08
1955-05-25,37.6,0.14,0.37,38.32,-1.88,True,1,6847,-37.6,-109403.68,257447.2,148043.52
1955-05-26,37.85,0.25,0.66,38.32,-1.23,True,1,6848,-37.85,-109441.53,259196.8,149755.27
1955-05-27,37.93,0.08,0.21,38.32,-1.02,True,1,6849,-37.93,-109479.46,259782.57,150303.11
1955-05-31,37.91,-0.02,-0.05,38.32,-1.07,True,1,6850,-37.91,-109517.37,259683.5,150166.13
1955-06-01,37.96,0.05,0.13,38.32,-0.94,True,1,6851,-37.96,-109555.33,260063.96,150508.63
1955-06-02,38.01,0.05,0.13,38.32,-0.81,True,1,6852,-38.01,-109593.34,260444.52,150851.18
1955-06-03,38.37,0.36,0.95,38.37,0.0,True,1,6853,-38.37,-109631.71,262949.61,153317.9
1955-06-06,39.69,1.32,3.44,39.69,0.0,True,1,6854,-39.69,-109671.4,272035.26,162363.86
1955-06-07,39.96,0.27,0.68,39.96,0.0,True,1,6855,-39.96,-109711.36,273925.8,164214.44
1955-06-08,39.22,-0.74,-1.85,39.96,-1.85,True,1,6856,-39.22,-109750.58,268892.32,159141.74
1955-06-09,39.01,-0.21,-0.54,39.96,-2.38,True,1,6857,-39.01,-109789.59,267491.57,157701.98
1955-06-10,39.25,0.24,0.62,39.96,-1.78,True,1,6858,-39.25,-109828.84,269176.5,159347.66
1955-06-13,39.62,0.37,0.94,39.96,-0.85,True,1,6859,-39.62,-109868.46,271753.58,161885.12
1955-06-14,39.67,0.05,0.13,39.96,-0.73,True,1,6860,-39.67,-109908.13,272136.2,162228.07
1955-06-15,39.89,0.22,0.56,39.96,-0.18,True,1,6861,-39.89,-109948.02,273685.29,163737.27
1955-06-16,39.96,0.07,0.18,39.96,0.0,True,1,6862,-39.96,-109987.98,274205.52,164217.54
1955-06-17,40.1,0.14,0.35,40.1,0.0,True,1,6863,-40.1,-110028.08,275206.3,165178.22
1955-06-20,40.14,0.04,0.1,40.14,0.0,True,1,6864,-40.14,-110068.22,275520.96,165452.74
1955-06-21,40.51,0.37,0.92,40.51,0.0,True,1,6865,-40.51,-110108.73,278101.15,167992.42
1955-06-22,40.6,0.09,0.22,40.6,0.0,True,1,6866,-40.6,-110149.33,278759.6,168610.27
1955-06-23,40.75,0.15,0.37,40.75,0.0,True,1,6867,-40.75,-110190.08,279830.25,169640.17
1955-06-24,40.96,0.21,0.52,40.96,0.0,True,1,6868,-40.96,-110231.04,281313.28,171082.24
1955-06-27,40.99,0.03,0.07,40.99,0.0,True,1,6869,-40.99,-110272.03,281560.31,171288.28
1955-06-28,40.77,-0.22,-0.54,40.99,-0.54,True,1,6870,-40.77,-110312.8,280089.9,169777.1
1955-06-29,40.79,0.02,0.05,40.99,-0.49,True,1,6871,-40.79,-110353.59,280268.09,169914.5
1955-06-30,41.03,0.24,0.59,41.03,0.0,True,1,6872,-41.03,-110394.62,281958.16,171563.54
1955-07-01,41.19,0.16,0.39,41.19,0.0,True,1,6873,-41.19,-110435.81,283098.87,172663.06
1955-07-05,41.69,0.5,1.21,41.69,0.0,True,1,6874,-41.69,-110477.5,286577.06,176099.56
1955-07-06,43.18,1.49,3.57,43.18,0.0,True,1,6875,-43.18,-110520.68,296862.5,186341.82
1955-07-07,42.58,-0.6,-1.39,43.18,-1.39,True,1,6876,-42.58,-110563.26,292780.08,182216.82
1955-07-08,42.64,0.06,0.14,43.18,-1.25,True,1,6877,-42.64,-110605.9,293235.28,182629.38
1955-07-11,42.75,0.11,0.26,43.18,-1.0,True,1,6878,-42.75,-110648.65,294034.5,183385.85
1955-07-12,42.75,0.0,0.0,43.18,-1.0,True,1,6879,-42.75,-110691.4,294077.25,183385.85
1955-07-13,42.24,-0.51,-1.19,43.18,-2.18,True,1,6880,-42.24,-110733.64,290611.2,179877.56
1955-07-14,42.25,0.01,0.02,43.18,-2.15,True,1,6881,-42.25,-110775.89,290722.25,179946.36
1955-07-15,42.4,0.15,0.36,43.18,-1.81,True,1,6882,-42.4,-110818.29,291796.8,180978.51
1955-07-18,42.36,-0.04,-0.09,43.18,-1.9,True,1,6883,-42.36,-110860.65,291563.88,180703.23
1955-07-19,42.1,-0.26,-0.61,43.18,-2.5,True,1,6884,-42.1,-110902.75,289816.4,178913.65
1955-07-20,42.23,0.13,0.31,43.18,-2.2,True,1,6885,-42.23,-110944.98,290753.55,179808.57
1955-07-21,42.64,0.41,0.97,43.18,-1.25,True,1,6886,-42.64,-110987.62,293619.04,182631.42
1955-07-22,43.0,0.36,0.84,43.18,-0.42,True,1,6887,-43.0,-111030.62,296141.0,185110.38
1955-07-25,43.48,0.48,1.12,43.48,0.0,True,1,6888,-43.48,-111074.1,299490.24,188416.14
1955-07-26,43.58,0.1,0.23,43.58,0.0,True,1,6889,-43.58,-111117.68,300222.62,189104.94
1955-07-27,43.76,0.18,0.41,43.76,0.0,True,1,6890,-43.76,-111161.44,301506.4,190344.96
1955-07-28,43.5,-0.26,-0.59,43.76,-0.59,True,1,6891,-43.5,-111204.94,299758.5,188553.56
1955-07-29,43.52,0.02,0.05,43.76,-0.55,True,1,6892,-43.52,-111248.46,299939.84,188691.38
1955-08-01,42.93,-0.59,-1.36,43.76,-1.9,True,1,6893,-42.93,-111291.39,295916.49,184625.1
1955-08-02,43.03,0.1,0.23,43.76,-1.67,True,1,6894,-43.03,-111334.42,296648.82,185314.4
1955-08-03,43.09,0.06,0.14,43.76,-1.53,True,1,6895,-43.09,-111377.51,297105.55,185728.04
1955-08-04,42.36,-0.73,-1.69,43.76,-3.2,True,1,6896,-42.36,-111419.87,292114.56,180694.69
1955-08-05,42.56,0.2,0.47,43.76,-2.74,True,1,6897,-42.56,-111462.43,293536.32,182073.89
1955-08-08,42.31,-0.25,-0.59,43.76,-3.31,True,1,6898,-42.31,-111504.74,291854.38,180349.64
1955-08-09,41.75,-0.56,-1.32,43.76,-4.59,True,1,6899,-41.75,-111546.49,288033.25,176486.76
1955-08-10,41.74,-0.01,-0.02,43.76,-4.62,True,1,6900,-41.74,-111588.23,288006.0,176417.77
1955-08-11,42.13,0.39,0.93,43.76,-3.72,True,1,6901,-42.13,-111630.36,290739.13,179108.77
1955-08-12,42.21,0.08,0.19,43.76,-3.54,True,1,6902,-42.21,-111672.57,291333.42,179660.85
1955-08-15,42.17,-0.04,-0.1,43.76,-3.63,True,1,6903,-42.17,-111714.74,291099.51,179384.77
1955-08-16,41.86,-0.31,-0.74,43.76,-4.34,True,1,6904,-41.86,-111756.6,289001.44,177244.84
1955-08-17,41.9,0.04,0.1,43.76,-4.25,True,1,6905,-41.9,-111798.5,289319.5,177521.0
1955-08-18,41.84,-0.06,-0.14,43.76,-4.39,True,1,6906,-41.84,-111840.34,288947.04,177106.7
1955-08-19,42.02,0.18,0.43,43.76,-3.98,True,1,6907,-42.02,-111882.36,290232.14,178349.78
1955-08-22,41.98,-0.04,-0.1,43.76,-4.07,True,1,6908,-41.98,-111924.34,289997.84,178073.5
1955-08-23,42.55,0.57,1.36,43.76,-2.76,True,1,6909,-42.55,-111966.89,293977.95,182011.06
1955-08-24,42.61,0.06,0.14,43.76,-2.63,True,1,6910,-42.61,-112009.5,294435.1,182425.6
1955-08-25,42.8,0.19,0.45,43.76,-2.19,True,1,6911,-42.8,-112052.3,295790.8,183738.5
1955-08-26,42.99,0.19,0.44,43.76,-1.76,True,1,6912,-42.99,-112095.29,297146.88,185051.59
1955-08-29,42.96,-0.03,-0.07,43.76,-1.83,True,1,6913,-42.96,-112138.25,296982.48,184844.23
1955-08-30,42.92,-0.04,-0.09,43.76,-1.92,True,1,6914,-42.92,-112181.17,296748.88,184567.71
1955-08-31,43.18,0.26,0.61,43.76,-1.32,True,1,6915,-43.18,-112224.35,298589.7,186365.35
1955-09-01,43.37,0.19,0.44,43.76,-0.89,True,1,6916,-43.37,-112267.72,299946.92,187679.2
1955-09-02,43.6,0.23,0.53,43.76,-0.37,True,1,6917,-43.6,-112311.32,301581.2,189269.88
1955-09-06,43.86,0.26,0.6,43.86,0.0,True,1,6918,-43.86,-112355.18,303423.48,191068.3
1955-09-07,43.85,-0.01,-0.02,43.86,-0.02,True,1,6919,-43.85,-112399.03,303398.15,190999.12
1955-09-08,43.88,0.03,0.07,43.88,0.0,True,1,6920,-43.88,-112442.91,303649.6,191206.69
1955-09-09,43.89,0.01,0.02,43.89,0.0,True,1,6921,-43.89,-112486.8,303762.69,191275.89
1955-09-12,44.19,0.3,0.68,44.19,0.0,True,1,6922,-44.19,-112530.99,305883.18,193352.19
1955-09-13,44.8,0.61,1.38,44.8,0.0,True,1,6923,-44.8,-112575.79,310150.4,197574.61
1955-09-14,44.99,0.19,0.42,44.99,0.0,True,1,6924,-44.99,-112620.78,311510.76,198889.98
1955-09-15,44.75,-0.24,-0.53,44.99,-0.53,True,1,6925,-44.75,-112665.53,309893.75,197228.22
1955-09-16,45.09,0.34,0.76,45.09,0.0,True,1,6926,-45.09,-112710.62,312293.34,199582.72
1955-09-19,45.16,0.07,0.16,45.16,0.0,True,1,6927,-45.16,-112755.78,312823.32,200067.54
1955-09-20,45.13,-0.03,-0.07,45.16,-0.07,True,1,6928,-45.13,-112800.91,312660.64,199859.73
1955-09-21,45.39,0.26,0.58,45.39,0.0,True,1,6929,-45.39,-112846.3,314507.31,201661.01
1955-09-22,45.39,0.0,0.0,45.39,0.0,True,1,6930,-45.39,-112891.69,314552.7,201661.01
1955-09-23,45.63,0.24,0.53,45.63,0.0,True,1,6931,-45.63,-112937.32,316261.53,203324.21
1955-09-26,42.61,-3.02,-6.62,45.63,-6.62,True,1,6932,-42.61,-112979.93,295372.52,182392.59
1955-09-27,43.58,0.97,2.28,45.63,-4.49,True,1,6933,-43.58,-113023.51,302140.14,189116.63
1955-09-28,44.31,0.73,1.68,45.63,-2.89,True,1,6934,-44.31,-113067.82,307245.54,194177.72
1955-09-29,44.03,-0.28,-0.63,45.63,-3.51,True,1,6935,-44.03,-113111.85,305348.05,192236.2
1955-09-30,43.67,-0.36,-0.82,45.63,-4.3,True,1,6936,-43.67,-113155.52,302895.12,189739.6
1955-10-03,42.49,-1.18,-2.7,45.63,-6.88,True,1,6937,-42.49,-113198.01,294753.13,181555.12
1955-10-04,42.82,0.33,0.78,45.63,-6.16,True,1,6938,-42.82,-113240.83,297085.16,183844.33
1955-10-05,42.99,0.17,0.4,45.63,-5.79,True,1,6939,-42.99,-113283.82,298307.61,185023.79
1955-10-06,42.7,-0.29,-0.68,45.63,-6.42,True,1,6940,-42.7,-113326.52,296338.0,183011.48
1955-10-07,42.38,-0.32,-0.75,45.63,-7.12,True,1,6941,-42.38,-113368.9,294159.58,180790.68
1955-10-10,41.15,-1.23,-2.9,45.63,-9.82,True,1,6942,-41.15,-113410.05,285663.3,172253.25
1955-10-11,40.8,-0.35,-0.85,45.63,-10.58,True,1,6943,-40.8,-113450.85,283274.4,169823.55
1955-10-12,41.52,0.72,1.76,45.63,-9.01,True,1,6944,-41.52,-113492.37,288314.88,174822.51
1955-10-13,41.39,-0.13,-0.31,45.63,-9.29,True,1,6945,-41.39,-113533.76,287453.55,173919.79
1955-10-14,41.22,-0.17,-0.41,45.63,-9.66,True,1,6946,-41.22,-113574.98,286314.12,172739.14
1955-10-17,41.35,0.13,0.32,45.63,-9.38,True,1,6947,-41.35,-113616.33,287258.45,173642.12
1955-10-18,41.65,0.3,0.73,45.63,-8.72,True,1,6948,-41.65,-113657.98,289384.2,175726.22
1955-10-19,42.07,0.42,1.01,45.63,-7.8,True,1,6949,-42.07,-113700.05,292344.43,178644.38
1955-10-20,42.59,0.52,1.24,45.63,-6.66,True,1,6950,-42.59,-113742.64,296000.5,182257.86
1955-10-21,42.59,0.0,0.0,45.63,-6.66,True,1,6951,-42.59,-113785.23,296043.09,182257.86
1955-10-24,42.91,0.32,0.75,45.63,-5.96,True,1,6952,-42.91,-113828.14,298310.32,184482.18
1955-10-25,42.63,-0.28,-0.65,45.63,-6.58,True,1,6953,-42.63,-113870.77,296406.39,182535.62
1955-10-26,42.29,-0.34,-0.8,45.63,-7.32,True,1,6954,-42.29,-113913.06,294084.66,180171.6
1955-10-27,42.34,0.05,0.12,45.63,-7.21,True,1,6955,-42.34,-113955.4,294474.7,180519.3
1955-10-28,42.37,0.03,0.07,45.63,-7.14,True,1,6956,-42.37,-113997.77,294725.72,180727.95
1955-10-31,42.34,-0.03,-0.07,45.63,-7.21,True,1,6957,-42.34,-114040.11,294559.38,180519.27
1955-11-01,42.28,-0.06,-0.14,45.63,-7.34,True,1,6958,-42.28,-114082.39,294184.24,180101.85
1955-11-02,42.35,0.07,0.17,45.63,-7.19,True,1,6959,-42.35,-114124.74,294713.65,180588.91
1955-11-03,43.24,0.89,2.1,45.63,-5.24,True,1,6960,-43.24,-114167.98,300950.4,186782.42
1955-11-04,43.96,0.72,1.66,45.63,-3.66,True,1,6961,-43.96,-114211.94,306005.56,191793.62
1955-11-07,44.15,0.19,0.43,45.63,-3.24,True,1,6962,-44.15,-114256.09,307372.3,193116.21
1955-11-09,44.61,0.46,1.04,45.63,-2.24,True,1,6963,-44.61,-114300.7,310619.43,196318.73
1955-11-10,44.72,0.11,0.25,45.63,-1.99,True,1,6964,-44.72,-114345.42,311430.08,197084.66
1955-11-11,45.24,0.52,1.16,45.63,-0.86,True,1,6965,-45.24,-114390.66,315096.6,200705.94
1955-11-14,46.41,1.17,2.59,46.41,0.0,True,1,6966,-46.41,-114437.07,323292.06,208854.99
1955-11-15,46.21,-0.2,-0.43,46.41,-0.43,True,1,6967,-46.21,-114483.28,321945.07,207461.79
1955-11-16,45.91,-0.3,-0.65,46.41,-1.08,True,1,6968,-45.91,-114529.19,319900.88,205371.69
1955-11-17,45.59,-0.32,-0.7,46.41,-1.77,True,1,6969,-45.59,-114574.78,317716.71,203141.93
1955-11-18,45.54,-0.05,-0.11,46.41,-1.88,True,1,6970,-45.54,-114620.32,317413.8,202793.48
1955-11-21,45.22,-0.32,-0.7,46.41,-2.56,True,1,6971,-45.22,-114665.54,315228.62,200563.08
1955-11-22,45.66,0.44,0.97,46.41,-1.62,True,1,6972,-45.66,-114711.2,318341.52,203630.32
1955-11-23,45.72,0.06,0.13,46.41,-1.49,True,1,6973,-45.72,-114756.92,318805.56,204048.64
1955-11-25,45.68,-0.04,-0.09,46.41,-1.57,True,1,6974,-45.68,-114802.6,318572.32,203769.72
1955-11-28,45.38,-0.3,-0.66,46.41,-2.22,True,1,6975,-45.38,-114847.98,316525.5,201677.52
1955-11-29,45.56,0.18,0.4,46.41,-1.83,True,1,6976,-45.56,-114893.54,317826.56,202933.02
1955-11-30,45.51,-0.05,-0.11,46.41,-1.94,True,1,6977,-45.51,-114939.05,317523.27,202584.22
1955-12-01,45.35,-0.16,-0.35,46.41,-2.28,True,1,6978,-45.35,-114984.4,316452.3,201467.9
1955-12-02,45.44,0.09,0.2,46.41,-2.09,True,1,6979,-45.44,-115029.84,317125.76,202095.92
1955-12-05,45.7,0.26,0.57,46.41,-1.53,True,1,6980,-45.7,-115075.54,318986.0,203910.46
1955-12-06,45.7,0.0,0.0,46.41,-1.53,True,1,6981,-45.7,-115121.24,319031.7,203910.46
1955-12-07,45.55,-0.15,-0.33,46.41,-1.85,True,1,6982,-45.55,-115166.79,318030.1,202863.31
1955-12-08,45.82,0.27,0.59,46.41,-1.27,True,1,6983,-45.82,-115212.61,319961.06,204748.45
1955-12-09,45.89,0.07,0.15,46.41,-1.12,True,1,6984,-45.89,-115258.5,320495.76,205237.26
1955-12-12,45.42,-0.47,-1.02,46.41,-2.13,True,1,6985,-45.42,-115303.92,317258.7,201954.78
1955-12-13,45.45,0.03,0.07,46.41,-2.07,True,1,6986,-45.45,-115349.37,317513.7,202164.33
1955-12-14,45.07,-0.38,-0.84,46.41,-2.89,True,1,6987,-45.07,-115394.44,314904.09,199509.65
1955-12-15,45.06,-0.01,-0.02,46.41,-2.91,True,1,6988,-45.06,-115439.5,314879.28,199439.78
1955-12-16,45.13,0.07,0.16,46.41,-2.76,True,1,6989,-45.13,-115484.63,315413.57,199928.94
1955-12-19,45.02,-0.11,-0.24,46.41,-3.0,True,1,6990,-45.02,-115529.65,314689.8,199160.15
1955-12-20,44.95,-0.07,-0.16,46.41,-3.15,True,1,6991,-44.95,-115574.6,314245.45,198670.85
1955-12-21,45.84,0.89,1.98,46.41,-1.23,True,1,6992,-45.84,-115620.44,320513.28,204892.84
1955-12-22,45.41,-0.43,-0.94,46.41,-2.15,True,1,6993,-45.41,-115665.85,317552.13,201886.28
1955-12-23,45.5,0.09,0.2,46.41,-1.96,True,1,6994,-45.5,-115711.35,318227.0,202515.65
1955-12-27,45.22,-0.28,-0.62,46.41,-2.56,True,1,6995,-45.22,-115756.57,316313.9,200557.33
1955-12-28,45.05,-0.17,-0.38,46.41,-2.93,True,1,6996,-45.05,-115801.62,315169.8,199368.18
1955-12-29,45.15,0.1,0.22,46.41,-2.72,True,1,6997,-45.15,-115846.77,315914.55,200067.78
1955-12-30,45.48,0.33,0.73,46.41,-2.0,True,1,6998,-45.48,-115892.25,318269.04,202376.79
1956-01-03,45.16,-0.32,-0.7,46.41,-2.69,True,1,6999,-45.16,-115937.41,316074.84,200137.43
1956-01-04,45.0,-0.16,-0.35,46.41,-3.04,True,1,7000,-45.0,-115982.41,315000.0,199017.59
1956-01-05,44.95,-0.05,-0.11,46.41,-3.15,True,1,7001,-44.95,-116027.36,314694.95,198667.59
1956-01-06,45.14,0.19,0.42,46.41,-2.74,True,1,7002,-45.14,-116072.5,316070.28,199997.78
1956-01-09,44.51,-0.63,-1.4,46.41,-4.09,True,1,7003,-44.51,-116117.01,311703.53,195586.52
1956-01-10,44.16,-0.35,-0.79,46.41,-4.85,True,1,7004,-44.16,-116161.17,309296.64,193135.47
1956-01-11,44.38,0.22,0.5,46.41,-4.37,True,1,7005,-44.38,-116205.55,310881.9,194676.35
1956-01-12,44.75,0.37,0.83,46.41,-3.58,True,1,7006,-44.75,-116250.3,313518.5,197268.2
1956-01-13,44.67,-0.08,-0.18,46.41,-3.75,True,1,7007,-44.67,-116294.97,313002.69,196707.72
1956-01-16,44.14,-0.53,-1.19,46.41,-4.89,True,1,7008,-44.14,-116339.11,309333.12,192994.01
1956-01-17,44.47,0.33,0.75,46.41,-4.18,True,1,7009,-44.47,-116383.58,311690.23,195306.65
1956-01-18,44.17,-0.3,-0.68,46.41,-4.83,True,1,7010,-44.17,-116427.75,309631.7,193203.95
1956-01-19,43.72,-0.45,-1.02,46.41,-5.8,True,1,7011,-43.72,-116471.47,306520.92,190049.45
1956-01-20,43.22,-0.5,-1.14,46.41,-6.87,True,1,7012,-43.22,-116514.69,303058.64,186543.95
1956-01-23,43.11,-0.11,-0.26,46.41,-7.11,True,1,7013,-43.11,-116557.8,302330.43,185772.63
1956-01-24,43.65,0.54,1.25,46.41,-5.95,True,1,7014,-43.65,-116601.45,306161.1,189559.65
1956-01-25,43.72,0.07,0.16,46.41,-5.8,True,1,7015,-43.72,-116645.17,306695.8,190050.63
1956-01-26,43.46,-0.26,-0.6,46.41,-6.36,True,1,7016,-43.46,-116688.63,304915.36,188226.73
1956-01-27,43.35,-0.11,-0.25,46.41,-6.59,True,1,7017,-43.35,-116731.98,304186.95,187454.97
1956-01-30,43.5,0.15,0.35,46.41,-6.27,True,1,7018,-43.5,-116775.48,305283.0,188507.52
1956-01-31,43.82,0.32,0.74,46.41,-5.58,True,1,7019,-43.82,-116819.3,307572.58,190753.28
1956-02-01,44.03,0.21,0.48,46.41,-5.13,True,1,7020,-44.03,-116863.33,309090.6,192227.27
1956-02-02,44.22,0.19,0.43,46.41,-4.72,True,1,7021,-44.22,-116907.55,310468.62,193561.07
1956-02-03,44.78,0.56,1.27,46.41,-3.51,True,1,7022,-44.78,-116952.33,314445.16,197492.83
1956-02-06,44.81,0.03,0.07,46.41,-3.45,True,1,7023,-44.81,-116997.14,314700.63,197703.49
1956-02-07,44.6,-0.21,-0.47,46.41,-3.9,True,1,7024,-44.6,-117041.74,313270.4,196228.66
1956-02-08,44.16,-0.44,-0.99,46.41,-4.85,True,1,7025,-44.16,-117085.9,310224.0,193138.1
1956-02-09,43.66,-0.5,-1.13,46.41,-5.92,True,1,7026,-43.66,-117129.56,306755.16,189625.6
1956-02-10,43.64,-0.02,-0.05,46.41,-5.97,True,1,7027,-43.64,-117173.2,306658.28,189485.08
1956-02-13,43.58,-0.06,-0.14,46.41,-6.1,True,1,7028,-43.58,-117216.78,306280.24,189063.46
1956-02-14,43.42,-0.16,-0.37,46.41,-6.44,True,1,7029,-43.42,-117260.2,305199.18,187938.98
1956-02-15,44.04,0.62,1.43,46.41,-5.11,True,1,7030,-44.04,-117304.24,309601.2,192296.96
1956-02-16,43.82,-0.22,-0.5,46.41,-5.58,True,1,7031,-43.82,-117348.06,308098.42,190750.36
1956-02-17,44.52,0.7,1.6,46.41,-4.07,True,1,7032,-44.52,-117392.58,313064.64,195672.06
1956-02-20,44.45,-0.07,-0.16,46.41,-4.22,True,1,7033,-44.45,-117437.03,312616.85,195179.82
1956-02-21,44.56,0.11,0.25,46.41,-3.99,True,1,7034,-44.56,-117481.59,313435.04,195953.45
1956-02-23,44.95,0.39,0.88,46.41,-3.15,True,1,7035,-44.95,-117526.54,316223.25,198696.71
1956-02-24,45.32,0.37,0.82,46.41,-2.35,True,1,7036,-45.32,-117571.86,318871.52,201299.66
1956-02-27,45.27,-0.05,-0.11,46.41,-2.46,True,1,7037,-45.27,-117617.13,318564.99,200947.86
1956-02-28,45.43,0.16,0.35,46.41,-2.11,True,1,7038,-45.43,-117662.56,319736.34,202073.78
1956-02-29,45.34,-0.09,-0.2,46.41,-2.31,True,1,7039,-45.34,-117707.9,319148.26,201440.36
1956-03-01,45.54,0.2,0.44,46.41,-1.88,True,1,7040,-45.54,-117753.44,320601.6,202848.16
1956-03-02,45.81,0.27,0.59,46.41,-1.29,True,1,7041,-45.81,-117799.25,322548.21,204748.96
1956-03-05,46.06,0.25,0.55,46.41,-0.75,True,1,7042,-46.06,-117845.31,324354.52,206509.21
1956-03-06,46.04,-0.02,-0.04,46.41,-0.8,True,1,7043,-46.04,-117891.35,324259.72,206368.37
1956-03-07,46.01,-0.03,-0.06,46.41,-0.86,True,1,7044,-46.01,-117937.36,324094.44,206157.08
1956-03-08,46.12,0.11,0.24,46.41,-0.62,True,1,7045,-46.12,-117983.48,324915.4,206931.92
1956-03-09,46.7,0.58,1.26,46.7,0.0,True,1,7046,-46.7,-118030.18,329048.2,211018.02
1956-03-12,47.13,0.43,0.92,47.13,0.0,True,1,7047,-47.13,-118077.31,332125.11,214047.8
1956-03-13,47.06,-0.07,-0.15,47.13,-0.15,True,1,7048,-47.06,-118124.37,331678.88,213554.51
1956-03-14,47.53,0.47,1.0,47.53,0.0,True,1,7049,-47.53,-118171.9,335038.97,216867.07
1956-03-15,47.99,0.46,0.97,47.99,0.0,True,1,7050,-47.99,-118219.89,338329.5,220109.61
1956-03-16,48.14,0.15,0.31,48.14,0.0,True,1,7051,-48.14,-118268.03,339435.14,221167.11
1956-03-19,48.59,0.45,0.94,48.59,0.0,True,1,7052,-48.59,-118316.62,342656.68,224340.06
1956-03-20,48.87,0.28,0.58,48.87,0.0,True,1,7053,-48.87,-118365.49,344680.11,226314.62
1956-03-21,48.23,-0.64,-1.31,48.87,-1.31,True,1,7054,-48.23,-118413.72,340214.42,221800.7
1956-03-22,48.72,0.49,1.02,48.87,-0.31,True,1,7055,-48.72,-118462.44,343719.6,225257.16
1956-03-23,48.83,0.11,0.23,48.87,-0.08,True,1,7056,-48.83,-118511.27,344544.48,226033.21
1956-03-26,48.62,-0.21,-0.43,48.87,-0.51,True,1,7057,-48.62,-118559.89,343111.34,224551.45
1956-03-27,48.25,-0.37,-0.76,48.87,-1.27,True,1,7058,-48.25,-118608.14,340548.5,221940.36
1956-03-28,48.51,0.26,0.54,48.87,-0.74,True,1,7059,-48.51,-118656.65,342432.09,223775.44
1956-03-29,48.48,-0.03,-0.06,48.87,-0.8,True,1,7060,-48.48,-118705.13,342268.8,223563.67
1956-04-02,48.7,0.22,0.45,48.87,-0.35,True,1,7061,-48.7,-118753.83,343870.7,225116.87
1956-04-03,48.53,-0.17,-0.35,48.87,-0.7,True,1,7062,-48.53,-118802.36,342718.86,223916.5
1956-04-04,48.8,0.27,0.56,48.87,-0.14,True,1,7063,-48.8,-118851.16,344674.4,225823.24
1956-04-05,48.57,-0.23,-0.47,48.87,-0.61,True,1,7064,-48.57,-118899.73,343098.48,224198.75
1956-04-06,48.85,0.28,0.58,48.87,-0.04,True,1,7065,-48.85,-118948.58,345125.25,226176.67
1956-04-09,48.61,-0.24,-0.49,48.87,-0.53,True,1,7066,-48.61,-118997.19,343478.26,224481.07
1956-04-10,47.93,-0.68,-1.4,48.87,-1.92,True,1,7067,-47.93,-119045.12,338721.31,219676.19
1956-04-11,48.31,0.38,0.79,48.87,-1.15,True,1,7068,-48.31,-119093.43,341455.08,222361.65
1956-04-12,48.02,-0.29,-0.6,48.87,-1.74,True,1,7069,-48.02,-119141.45,339453.38,220311.93
1956-04-13,47.95,-0.07,-0.15,48.87,-1.88,True,1,7070,-47.95,-119189.4,339006.5,219817.1
1956-04-16,47.96,0.01,0.02,48.87,-1.86,True,1,7071,-47.96,-119237.36,339125.16,219887.8
1956-04-17,47.93,-0.03,-0.06,48.87,-1.92,True,1,7072,-47.93,-119285.29,338960.96,219675.67
1956-04-18,47.74,-0.19,-0.4,48.87,-2.31,True,1,7073,-47.74,-119333.03,337665.02,218331.99
1956-04-19,47.57,-0.17,-0.36,48.87,-2.66,True,1,7074,-47.57,-119380.6,336510.18,217129.58
1956-04-20,47.76,0.19,0.4,48.87,-2.27,True,1,7075,-47.76,-119428.36,337902.0,218473.64
1956-04-23,47.65,-0.11,-0.23,48.87,-2.5,True,1,7076,-47.65,-119476.01,337171.4,217695.39
1956-04-24,47.26,-0.39,-0.82,48.87,-3.29,True,1,7077,-47.26,-119523.27,334459.02,214935.75
1956-04-25,47.09,-0.17,-0.36,48.87,-3.64,True,1,7078,-47.09,-119570.36,333303.02,213732.66
1956-04-26,47.49,0.4,0.85,48.87,-2.82,True,1,7079,-47.49,-119617.85,336181.71,216563.86
1956-04-27,47.99,0.5,1.05,48.87,-1.8,True,1,7080,-47.99,-119665.84,339769.2,220103.36
1956-04-30,48.38,0.39,0.81,48.87,-1.0,True,1,7081,-48.38,-119714.22,342578.78,222864.56
1956-05-01,48.16,-0.22,-0.46,48.87,-1.45,True,1,7082,-48.16,-119762.38,341069.12,221306.74
1956-05-02,48.17,0.01,0.02,48.87,-1.43,True,1,7083,-48.17,-119810.55,341188.11,221377.56
1956-05-03,48.34,0.17,0.35,48.87,-1.08,True,1,7084,-48.34,-119858.89,342440.56,222581.67
1956-05-04,48.51,0.17,0.35,48.87,-0.74,True,1,7085,-48.51,-119907.4,343693.35,223785.95
1956-05-07,48.22,-0.29,-0.6,48.87,-1.33,True,1,7086,-48.22,-119955.62,341686.92,221731.3
1956-05-08,48.02,-0.2,-0.42,48.87,-1.74,True,1,7087,-48.02,-120003.64,340317.74,220314.1
1956-05-09,47.94,-0.08,-0.17,48.87,-1.9,True,1,7088,-47.94,-120051.58,339798.72,219747.14
1956-05-10,47.16,-0.78,-1.63,48.87,-3.5,True,1,7089,-47.16,-120098.74,334317.24,214218.5
1956-05-11,47.12,-0.04,-0.08,48.87,-3.58,True,1,7090,-47.12,-120145.86,334080.8,213934.94
1956-05-14,46.86,-0.26,-0.55,48.87,-4.11,True,1,7091,-46.86,-120192.72,332284.26,212091.54
1956-05-15,46.37,-0.49,-1.05,48.87,-5.12,True,1,7092,-46.37,-120239.09,328856.04,208616.95
1956-05-16,46.05,-0.32,-0.69,48.87,-5.77,True,1,7093,-46.05,-120285.14,326632.65,206347.51
1956-05-17,46.61,0.56,1.22,48.87,-4.62,True,1,7094,-46.61,-120331.75,330651.34,210319.59
1956-05-18,46.39,-0.22,-0.47,48.87,-5.08,True,1,7095,-46.39,-120378.14,329137.05,208758.91
1956-05-21,45.99,-0.4,-0.86,48.87,-5.89,True,1,7096,-45.99,-120424.13,326345.04,205920.91
1956-05-22,45.26,-0.73,-1.59,48.87,-7.39,True,1,7097,-45.26,-120469.39,321210.22,200740.83
1956-05-23,45.02,-0.24,-0.53,48.87,-7.88,True,1,7098,-45.02,-120514.41,319551.96,199037.55
1956-05-24,44.6,-0.42,-0.93,48.87,-8.74,True,1,7099,-44.6,-120559.01,316615.4,196056.39
1956-05-25,44.62,0.02,0.04,48.87,-8.7,True,1,7100,-44.62,-120603.63,316802.0,196198.37
1956-05-28,44.1,-0.52,-1.16,48.87,-9.76,True,1,7101,-44.1,-120647.73,313154.1,192506.37
1956-05-29,45.11,1.01,2.29,48.87,-7.69,True,1,7102,-45.11,-120692.84,320371.22,199678.38
1956-05-31,45.2,0.09,0.2,48.87,-7.51,True,1,7103,-45.2,-120738.04,321055.6,200317.56
1956-06-01,45.58,0.38,0.84,48.87,-6.73,True,1,7104,-45.58,-120783.62,323800.32,203016.7
1956-06-04,45.85,0.27,0.59,48.87,-6.18,True,1,7105,-45.85,-120829.47,325764.25,204934.78
1956-06-05,45.86,0.01,0.02,48.87,-6.16,True,1,7106,-45.86,-120875.33,325881.16,205005.83
1956-06-06,45.63,-0.23,-0.5,48.87,-6.63,True,1,7107,-45.63,-120920.96,324292.41,203371.45
1956-06-07,45.99,0.36,0.79,48.87,-5.89,True,1,7108,-45.99,-120966.95,326896.92,205929.97
1956-06-08,45.14,-0.85,-1.85,48.87,-7.63,True,1,7109,-45.14,-121012.09,320900.26,199888.17
1956-06-11,45.71,0.57,1.26,48.87,-6.47,True,1,7110,-45.71,-121057.8,324998.1,203940.3
1956-06-12,46.36,0.65,1.42,48.87,-5.14,True,1,7111,-46.36,-121104.16,329665.96,208561.8
1956-06-13,46.42,0.06,0.13,48.87,-5.01,True,1,7112,-46.42,-121150.58,330139.04,208988.46
1956-06-14,46.31,-0.11,-0.24,48.87,-5.24,True,1,7113,-46.31,-121196.89,329403.03,208206.14
1956-06-15,46.37,0.06,0.13,48.87,-5.12,True,1,7114,-46.37,-121243.26,329876.18,208632.92
1956-06-18,46.17,-0.2,-0.43,48.87,-5.52,True,1,7115,-46.17,-121289.43,328499.55,207210.12
1956-06-19,46.22,0.05,0.11,48.87,-5.42,True,1,7116,-46.22,-121335.65,328901.52,207565.87
1956-06-20,46.41,0.19,0.41,48.87,-5.03,True,1,7117,-46.41,-121382.06,330299.97,208917.91
1956-06-21,46.73,0.32,0.69,48.87,-4.38,True,1,7118,-46.73,-121428.79,332624.14,211195.35
1956-06-22,46.59,-0.14,-0.3,48.87,-4.66,True,1,7119,-46.59,-121475.38,331674.21,210198.83
1956-06-25,46.41,-0.18,-0.39,48.87,-5.03,True,1,7120,-46.41,-121521.79,330439.2,208917.41
1956-06-26,46.72,0.31,0.67,48.87,-4.4,True,1,7121,-46.72,-121568.51,332693.12,211124.61
1956-06-27,47.07,0.35,0.75,48.87,-3.68,True,1,7122,-47.07,-121615.58,335232.54,213616.96
1956-06-28,47.13,0.06,0.13,48.87,-3.56,True,1,7123,-47.13,-121662.71,335706.99,214044.28
1956-06-29,46.97,-0.16,-0.34,48.87,-3.89,True,1,7124,-46.97,-121709.68,334614.28,212904.6
1956-07-02,46.93,-0.04,-0.08,48.87,-3.97,True,1,7125,-46.93,-121756.61,334376.25,212619.64
1956-07-03,47.32,0.39,0.83,48.87,-3.17,True,1,7126,-47.32,-121803.93,337202.32,215398.39
1956-07-05,47.8,0.48,1.01,48.87,-2.19,True,1,7127,-47.8,-121851.73,340670.6,218818.87
1956-07-06,48.04,0.24,0.5,48.87,-1.7,True,1,7128,-48.04,-121899.77,342429.12,220529.35
1956-07-09,48.25,0.21,0.44,48.87,-1.27,True,1,7129,-48.25,-121948.02,343974.25,222026.23
1956-07-10,48.54,0.29,0.6,48.87,-0.68,True,1,7130,-48.54,-121996.56,346090.2,224093.64
1956-07-11,48.69,0.15,0.31,48.87,-0.37,True,1,7131,-48.69,-122045.25,347208.39,225163.14
1956-07-12,48.58,-0.11,-0.23,48.87,-0.59,True,1,7132,-48.58,-122093.83,346472.56,224378.73
1956-07-13,48.72,0.14,0.29,48.87,-0.31,True,1,7133,-48.72,-122142.55,347519.76,225377.21
1956-07-16,49.14,0.42,0.86,49.14,0.0,True,1,7134,-49.14,-122191.69,350564.76,228373.07
1956-07-17,49.31,0.17,0.35,49.31,0.0,True,1,7135,-49.31,-122241.0,351826.85,229585.85
1956-07-18,49.3,-0.01,-0.02,49.31,-0.02,True,1,7136,-49.3,-122290.3,351804.8,229514.5
1956-07-19,49.32,0.02,0.04,49.32,0.0,True,1,7137,-49.32,-122339.62,351996.84,229657.22
1956-07-20,49.35,0.03,0.06,49.35,0.0,True,1,7138,-49.35,-122388.97,352260.3,229871.33
1956-07-23,49.33,-0.02,-0.04,49.35,-0.04,True,1,7139,-49.33,-122438.3,352166.87,229728.57
1956-07-24,49.33,0.0,0.0,49.35,-0.04,True,1,7140,-49.33,-122487.63,352216.2,229728.57
1956-07-25,49.44,0.11,0.22,49.44,0.0,True,1,7141,-49.44,-122537.07,353051.04,230513.97
1956-07-26,49.48,0.04,0.08,49.48,0.0,True,1,7142,-49.48,-122586.55,353386.16,230799.61
1956-07-27,49.08,-0.4,-0.81,49.48,-0.81,True,1,7143,-49.08,-122635.63,350578.44,227942.81
1956-07-30,49.0,-0.08,-0.16,49.48,-0.97,True,1,7144,-49.0,-122684.63,350056.0,227371.37
1956-07-31,49.39,0.39,0.8,49.48,-0.18,True,1,7145,-49.39,-122734.02,352891.55,230157.53
1956-08-01,49.62,0.23,0.47,49.62,0.0,True,1,7146,-49.62,-122783.64,354584.52,231800.88
1956-08-02,49.64,0.02,0.04,49.64,0.0,True,1,7147,-49.64,-122833.28,354777.08,231943.8
1956-08-03,49.64,0.0,0.0,49.64,0.0,True,1,7148,-49.64,-122882.92,354826.72,231943.8
1956-08-06,48.96,-0.68,-1.37,49.64,-1.37,True,1,7149,-48.96,-122931.88,350015.04,227083.16
1956-08-07,49.16,0.2,0.41,49.64,-0.97,True,1,7150,-49.16,-122981.04,351494.0,228512.96
1956-08-08,49.36,0.2,0.41,49.64,-0.56,True,1,7151,-49.36,-123030.4,352973.36,229942.96
1956-08-09,49.32,-0.04,-0.08,49.64,-0.64,True,1,7152,-49.32,-123079.72,352736.64,229656.92
1956-08-10,49.09,-0.23,-0.47,49.64,-1.11,True,1,7153,-49.09,-123128.81,351140.77,228011.96
1956-08-13,48.58,-0.51,-1.04,49.64,-2.13,True,1,7154,-48.58,-123177.39,347541.32,224363.93
1956-08-14,48.0,-0.58,-1.19,49.64,-3.3,True,1,7155,-48.0,-123225.39,343440.0,220214.61
1956-08-15,48.99,0.99,2.06,49.64,-1.31,True,1,7156,-48.99,-123274.38,350572.44,227298.06
1956-08-16,48.88,-0.11,-0.22,49.64,-1.53,True,1,7157,-48.88,-123323.26,349834.16,226510.9
1956-08-17,48.82,-0.06,-0.12,49.64,-1.65,True,1,7158,-48.82,-123372.08,349453.56,226081.48
1956-08-20,48.25,-0.57,-1.17,49.64,-2.8,True,1,7159,-48.25,-123420.33,345421.75,222001.42
1956-08-21,47.89,-0.36,-0.75,49.64,-3.52,True,1,7160,-47.89,-123468.22,342892.4,219424.18
1956-08-22,47.42,-0.47,-0.98,49.64,-4.47,True,1,7161,-47.42,-123515.64,339574.62,216058.98
1956-08-23,48.0,0.58,1.22,49.64,-3.3,True,1,7162,-48.0,-123563.64,343776.0,220212.36
1956-08-24,47.95,-0.05,-0.1,49.64,-3.4,True,1,7163,-47.95,-123611.59,343465.85,219854.26
1956-08-27,47.66,-0.29,-0.6,49.64,-3.99,True,1,7164,-47.66,-123659.25,341436.24,217776.99
1956-08-28,47.57,-0.09,-0.19,49.64,-4.17,True,1,7165,-47.57,-123706.82,340839.05,217132.23
1956-08-29,47.36,-0.21,-0.44,49.64,-4.59,True,1,7166,-47.36,-123754.18,339381.76,215627.58
1956-08-30,46.94,-0.42,-0.89,49.64,-5.44,True,1,7167,-46.94,-123801.12,336418.98,212617.86
1956-08-31,47.51,0.57,1.21,49.64,-4.29,True,1,7168,-47.51,-123848.63,340551.68,216703.05
1956-09-04,47.89,0.38,0.8,49.64,-3.52,True,1,7169,-47.89,-123896.52,343323.41,219426.89
1956-09-05,48.02,0.13,0.27,49.64,-3.26,True,1,7170,-48.02,-123944.54,344303.4,220358.86
1956-09-06,48.1,0.08,0.17,49.64,-3.1,True,1,7171,-48.1,-123992.64,344925.1,220932.46
1956-09-07,47.81,-0.29,-0.6,49.64,-3.69,True,1,7172,-47.81,-124040.45,342893.32,218852.87
1956-09-10,47.56,-0.25,-0.52,49.64,-4.19,True,1,7173,-47.56,-124088.01,341147.88,217059.87
1956-09-11,47.38,-0.18,-0.38,49.64,-4.55,True,1,7174,-47.38,-124135.39,339904.12,215768.73
1956-09-12,47.05,-0.33,-0.7,49.64,-5.22,True,1,7175,-47.05,-124182.44,337583.75,213401.31
1956-09-13,46.09,-0.96,-2.04,49.64,-7.15,True,1,7176,-46.09,-124228.53,330741.84,206513.31
1956-09-14,47.21,1.12,2.43,49.64,-4.89,True,1,7177,-47.21,-124275.74,338826.17,214550.43
1956-09-17,47.1,-0.11,-0.23,49.64,-5.12,True,1,7178,-47.1,-124322.84,338083.8,213760.96
1956-09-18,46.79,-0.31,-0.66,49.64,-5.74,True,1,7179,-46.79,-124369.63,335905.41,211535.78
1956-09-19,46.24,-0.55,-1.18,49.64,-6.85,True,1,7180,-46.24,-124415.87,332003.2,207587.33
1956-09-20,46.21,-0.03,-0.06,49.64,-6.91,True,1,7181,-46.21,-124462.08,331834.01,207371.93
1956-09-21,46.58,0.37,0.8,49.64,-6.16,True,1,7182,-46.58,-124508.66,334537.56,210028.9
1956-09-24,46.4,-0.18,-0.39,49.64,-6.53,True,1,7183,-46.4,-124555.06,333291.2,208736.14
1956-09-25,45.75,-0.65,-1.4,49.64,-7.84,True,1,7184,-45.75,-124600.81,328668.0,204067.19
1956-09-26,45.82,0.07,0.15,49.64,-7.7,True,1,7185,-45.82,-124646.63,329216.7,204570.07
1956-09-27,45.6,-0.22,-0.48,49.64,-8.14,True,1,7186,-45.6,-124692.23,327681.6,202989.37
1956-09-28,45.35,-0.25,-0.55,49.64,-8.64,True,1,7187,-45.35,-124737.58,325930.45,201192.87
1956-10-01,44.7,-0.65,-1.43,49.64,-9.95,True,1,7188,-44.7,-124782.28,321303.6,196521.32
1956-10-02,45.52,0.82,1.83,49.64,-8.3,True,1,7189,-45.52,-124827.8,327243.28,202415.48
1956-10-03,46.28,0.76,1.67,49.64,-6.77,True,1,7190,-46.28,-124874.08,332753.2,207879.12
1956-10-04,46.29,0.01,0.02,49.64,-6.75,True,1,7191,-46.29,-124920.37,332871.39,207951.02
1956-10-05,46.45,0.16,0.35,49.64,-6.43,True,1,7192,-46.45,-124966.82,334068.4,209101.58
1956-10-08,46.43,-0.02,-0.04,49.64,-6.47,True,1,7193,-46.43,-125013.25,333970.99,208957.74
1956-10-09,46.2,-0.23,-0.5,49.64,-6.93,True,1,7194,-46.2,-125059.45,332362.8,207303.35
1956-10-10,46.84,0.64,1.38,49.64,-5.64,True,1,7195,-46.84,-125106.29,337013.8,211907.51
1956-10-11,46.81,-0.03,-0.06,49.64,-5.7,True,1,7196,-46.81,-125153.1,336844.76,211691.66
1956-10-12,47.0,0.19,0.41,49.64,-5.32,True,1,7197,-47.0,-125200.1,338259.0,213058.9
1956-10-15,46.86,-0.14,-0.3,49.64,-5.6,True,1,7198,-46.86,-125246.96,337298.28,212051.32
1956-10-16,46.62,-0.24,-0.51,49.64,-6.08,True,1,7199,-46.62,-125293.58,335617.38,210323.8
1956-10-17,46.26,-0.36,-0.77,49.64,-6.81,True,1,7200,-46.26,-125339.84,333072.0,207732.16
1956-10-18,46.34,0.08,0.17,49.64,-6.65,True,1,7201,-46.34,-125386.18,333694.34,208308.16
1956-10-19,46.24,-0.1,-0.22,49.64,-6.85,True,1,7202,-46.24,-125432.42,333020.48,207588.06
1956-10-22,46.23,-0.01,-0.02,49.64,-6.87,True,1,7203,-46.23,-125478.65,332994.69,207516.04
1956-10-23,46.12,-0.11,-0.24,49.64,-7.09,True,1,7204,-46.12,-125524.77,332248.48,206723.71
1956-10-24,45.93,-0.19,-0.41,49.64,-7.47,True,1,7205,-45.93,-125570.7,330925.65,205354.95
1956-10-25,45.85,-0.08,-0.17,49.64,-7.64,True,1,7206,-45.85,-125616.55,330395.1,204778.55
1956-10-26,46.27,0.42,0.92,49.64,-6.79,True,1,7207,-46.27,-125662.82,333467.89,207805.07
1956-10-29,46.4,0.13,0.28,49.64,-6.53,True,1,7208,-46.4,-125709.22,334451.2,208741.98
1956-10-30,46.37,-0.03,-0.06,49.64,-6.59,True,1,7209,-46.37,-125755.59,334281.33,208525.74
1956-10-31,45.58,-0.79,-1.7,49.64,-8.18,True,1,7210,-45.58,-125801.17,328631.8,202830.63
1956-11-01,46.52,0.94,2.06,49.64,-6.28,True,1,7211,-46.52,-125847.69,335455.72,209608.03
1956-11-02,46.98,0.46,0.99,49.64,-5.36,True,1,7212,-46.98,-125894.67,338819.76,212925.09
1956-11-05,47.6,0.62,1.32,49.64,-4.11,True,1,7213,-47.6,-125942.27,343338.8,217396.53
1956-11-07,47.11,-0.49,-1.03,49.64,-5.1,True,1,7214,-47.11,-125989.38,339851.54,213862.16
1956-11-08,46.73,-0.38,-0.81,49.64,-5.86,True,1,7215,-46.73,-126036.11,337156.95,211120.84
1956-11-09,46.34,-0.39,-0.84,49.64,-6.65,True,1,7216,-46.34,-126082.45,334389.44,208306.99
1956-11-12,46.49,0.15,0.32,49.64,-6.35,True,1,7217,-46.49,-126128.94,335518.33,209389.39
1956-11-13,46.27,-0.22,-0.47,49.64,-6.79,True,1,7218,-46.27,-126175.21,333976.86,207801.65
1956-11-14,46.01,-0.26,-0.56,49.64,-7.31,True,1,7219,-46.01,-126221.22,332146.19,205924.97
1956-11-15,45.72,-0.29,-0.63,49.64,-7.9,True,1,7220,-45.72,-126266.94,330098.4,203831.46
1956-11-16,45.74,0.02,0.04,49.64,-7.86,True,1,7221,-45.74,-126312.68,330288.54,203975.86
1956-11-19,45.29,-0.45,-0.98,49.64,-8.76,True,1,7222,-45.29,-126357.97,327084.38,200726.41
1956-11-20,44.89,-0.4,-0.88,49.64,-9.57,True,1,7223,-44.89,-126402.86,324240.47,197837.61
1956-11-21,44.67,-0.22,-0.49,49.64,-10.01,True,1,7224,-44.67,-126447.53,322696.08,196248.55
1956-11-23,45.14,0.47,1.05,49.64,-9.06,True,1,7225,-45.14,-126492.67,326136.5,199643.83
1956-11-26,44.87,-0.27,-0.6,49.64,-9.61,True,1,7226,-44.87,-126537.54,324230.62,197693.08
1956-11-27,44.91,0.04,0.09,49.64,-9.53,True,1,7227,-44.91,-126582.45,324564.57,197982.12
1956-11-28,44.43,-0.48,-1.07,49.64,-10.5,True,1,7228,-44.43,-126626.88,321140.04,194513.16
1956-11-29,44.38,-0.05,-0.11,49.64,-10.6,True,1,7229,-44.38,-126671.26,320823.02,194151.76
1956-11-30,45.08,0.7,1.58,49.64,-9.19,True,1,7230,-45.08,-126716.34,325928.4,199212.06
1956-12-03,45.98,0.9,2.0,49.64,-7.37,True,1,7231,-45.98,-126762.32,332481.38,205719.06
1956-12-04,45.84,-0.14,-0.3,49.64,-7.66,True,1,7232,-45.84,-126808.16,331514.88,204706.72
1956-12-05,46.39,0.55,1.2,49.64,-6.55,True,1,7233,-46.39,-126854.55,335538.87,208684.32
1956-12-06,46.81,0.42,0.9,49.64,-5.7,True,1,7234,-46.81,-126901.36,338623.54,211722.18
1956-12-07,47.04,0.23,0.49,49.64,-5.24,True,1,7235,-47.04,-126948.4,340334.4,213386.0
1956-12-10,46.8,-0.24,-0.51,49.64,-5.72,True,1,7236,-46.8,-126995.2,338644.8,211649.6
1956-12-11,46.48,-0.32,-0.68,49.64,-6.37,True,1,7237,-46.48,-127041.68,336375.76,209334.08
1956-12-12,46.13,-0.35,-0.75,49.64,-7.07,True,1,7238,-46.13,-127087.81,333888.94,206801.13
1956-12-13,46.5,0.37,0.8,49.64,-6.33,True,1,7239,-46.5,-127134.31,336613.5,209479.19
1956-12-14,46.54,0.04,0.09,49.64,-6.24,True,1,7240,-46.54,-127180.85,336949.6,209768.75
1956-12-17,46.54,0.0,0.0,49.64,-6.24,True,1,7241,-46.54,-127227.39,336996.14,209768.75
1956-12-18,46.54,0.0,0.0,49.64,-6.24,True,1,7242,-46.54,-127273.93,337042.68,209768.75
1956-12-19,46.43,-0.11,-0.24,49.64,-6.47,True,1,7243,-46.43,-127320.36,336292.49,208972.13
1956-12-20,46.07,-0.36,-0.78,49.64,-7.19,True,1,7244,-46.07,-127366.43,333731.08,206364.65
1956-12-21,46.37,0.3,0.65,49.64,-6.59,True,1,7245,-46.37,-127412.8,335950.65,208537.85
1956-12-26,46.39,0.02,0.04,49.64,-6.55,True,1,7246,-46.39,-127459.19,336141.94,208682.75
1956-12-27,46.35,-0.04,-0.09,49.64,-6.63,True,1,7247,-46.35,-127505.54,335898.45,208392.91
1956-12-28,46.56,0.21,0.45,49.64,-6.2,True,1,7248,-46.56,-127552.1,337466.88,209914.78
1956-12-31,46.67,0.11,0.24,49.64,-5.98,True,1,7249,-46.67,-127598.77,338310.83,210712.06
1957-01-02,46.2,-0.47,-1.01,49.64,-6.93,True,1,7250,-46.2,-127644.97,334950.0,207305.03
1957-01-03,46.6,0.4,0.87,49.64,-6.12,True,1,7251,-46.6,-127691.57,337896.6,210205.03
1957-01-04,46.66,0.06,0.13,49.64,-6.0,True,1,7252,-46.66,-127738.23,338378.32,210640.09
1957-01-07,46.42,-0.24,-0.51,49.64,-6.49,True,1,7253,-46.42,-127784.65,336684.26,208899.61
1957-01-08,46.25,-0.17,-0.37,49.64,-6.83,True,1,7254,-46.25,-127830.9,335497.5,207666.6
1957-01-09,46.16,-0.09,-0.2,49.64,-7.01,True,1,7255,-46.16,-127877.06,334890.8,207013.74
1957-01-10,46.27,0.11,0.24,49.64,-6.79,True,1,7256,-46.27,-127923.33,335735.12,207811.79
1957-01-11,46.18,-0.09,-0.2,49.64,-6.97,True,1,7257,-46.18,-127969.51,335128.26,207158.75
1957-01-14,45.86,-0.32,-0.69,49.64,-7.62,True,1,7258,-45.86,-128015.37,332851.88,204836.51
1957-01-15,45.18,-0.68,-1.48,49.64,-8.98,True,1,7259,-45.18,-128060.55,327961.62,199901.07
1957-01-16,45.23,0.05,0.11,49.64,-8.88,True,1,7260,-45.23,-128105.78,328369.8,200264.02
1957-01-17,45.22,-0.01,-0.02,49.64,-8.9,True,1,7261,-45.22,-128151.0,328342.42,200191.42
1957-01-18,44.64,-0.58,-1.28,49.64,-10.07,True,1,7262,-44.64,-128195.64,324175.68,195980.04
1957-01-21,44.4,-0.24,-0.54,49.64,-10.56,True,1,7263,-44.4,-128240.04,322477.2,194237.16
1957-01-22,44.53,0.13,0.29,49.64,-10.29,True,1,7264,-44.53,-128284.57,323465.92,195181.35
1957-01-23,44.87,0.34,0.76,49.64,-9.61,True,1,7265,-44.87,-128329.44,325980.55,197651.11
1957-01-24,45.03,0.16,0.36,49.64,-9.29,True,1,7266,-45.03,-128374.47,327187.98,198813.51
1957-01-25,44.82,-0.21,-0.47,49.64,-9.71,True,1,7267,-44.82,-128419.29,325706.94,197287.65
1957-01-28,44.49,-0.33,-0.74,49.64,-10.38,True,1,7268,-44.49,-128463.78,323353.32,194889.54
1957-01-29,44.71,0.22,0.49,49.64,-9.93,True,1,7269,-44.71,-128508.49,324996.99,196488.5
1957-01-30,44.91,0.2,0.45,49.64,-9.53,True,1,7270,-44.91,-128553.4,326495.7,197942.3
1957-01-31,44.72,-0.19,-0.42,49.64,-9.91,True,1,7271,-44.72,-128598.12,325159.12,196561.0
1957-02-01,44.62,-0.1,-0.22,49.64,-10.11,True,1,7272,-44.62,-128642.74,324476.64,195833.9
1957-02-04,44.53,-0.09,-0.2,49.64,-10.29,True,1,7273,-44.53,-128687.27,323866.69,195179.42
1957-02-05,43.89,-0.64,-1.44,49.64,-11.58,True,1,7274,-43.89,-128731.16,319255.86,190524.7
1957-02-06,43.82,-0.07,-0.16,49.64,-11.72,True,1,7275,-43.82,-128774.98,318790.5,190015.52
1957-02-07,43.62,-0.2,-0.46,49.64,-12.13,True,1,7276,-43.62,-128818.6,317379.12,188560.52
1957-02-08,43.32,-0.3,-0.69,49.64,-12.73,True,1,7277,-43.32,-128861.92,315239.64,186377.72
1957-02-11,42.57,-0.75,-1.73,49.64,-14.24,True,1,7278,-42.57,-128904.49,309824.46,180919.97
1957-02-12,42.39,-0.18,-0.42,49.64,-14.6,True,1,7279,-42.39,-128946.88,308556.81,179609.93
1957-02-13,43.04,0.65,1.53,49.64,-13.3,True,1,7280,-43.04,-128989.92,313331.2,184341.28
1957-02-14,42.99,-0.05,-0.12,49.64,-13.4,True,1,7281,-42.99,-129032.91,313010.19,183977.28
1957-02-15,43.51,0.52,1.21,49.64,-12.35,True,1,7282,-43.51,-129076.42,316839.82,187763.4
1957-02-18,43.46,-0.05,-0.12,49.64,-12.45,True,1,7283,-43.46,-129119.88,316519.18,187399.3
1957-02-19,43.49,0.03,0.07,49.64,-12.39,True,1,7284,-43.49,-129163.37,316781.16,187617.79
1957-02-20,43.63,0.14,0.32,49.64,-12.11,True,1,7285,-43.63,-129207.0,317844.55,188637.55
1957-02-21,43.48,-0.15,-0.34,49.64,-12.41,True,1,7286,-43.48,-129250.48,316795.28,187544.8
1957-02-25,43.38,-0.1,-0.23,49.64,-12.61,True,1,7287,-43.38,-129293.86,316110.06,186816.2
1957-02-26,43.45,0.07,0.16,49.64,-12.47,True,1,7288,-43.45,-129337.31,316663.6,187326.29
1957-02-27,43.41,-0.04,-0.09,49.64,-12.55,True,1,7289,-43.41,-129380.72,316415.49,187034.77
1957-02-28,43.26,-0.15,-0.35,49.64,-12.85,True,1,7290,-43.26,-129423.98,315365.4,185941.42
1957-03-01,43.74,0.48,1.11,49.64,-11.89,True,1,7291,-43.74,-129467.72,318908.34,189440.62
1957-03-04,44.06,0.32,0.73,49.64,-11.24,True,1,7292,-44.06,-129511.78,321285.52,191773.74
1957-03-05,44.22,0.16,0.36,49.64,-10.92,True,1,7293,-44.22,-129556.0,322496.46,192940.46
1957-03-06,44.23,0.01,0.02,49.64,-10.9,True,1,7294,-44.23,-129600.23,322613.62,193013.39
1957-03-07,44.21,-0.02,-0.04,49.64,-10.94,True,1,7295,-44.21,-129644.44,322511.95,192867.51
1957-03-08,44.07,-0.14,-0.32,49.64,-11.22,True,1,7296,-44.07,-129688.51,321534.72,191846.21
1957-03-11,43.78,-0.29,-0.66,49.64,-11.8,True,1,7297,-43.78,-129732.29,319462.66,189730.37
1957-03-12,43.75,-0.03,-0.07,49.64,-11.86,True,1,7298,-43.75,-129776.04,319287.5,189511.46
1957-03-13,44.04,0.29,0.66,49.64,-11.28,True,1,7299,-44.04,-129820.08,321447.96,191627.88
1957-03-14,44.07,0.03,0.07,49.64,-11.22,True,1,7300,-44.07,-129864.15,321711.0,191846.85
1957-03-15,44.05,-0.02,-0.04,49.64,-11.26,True,1,7301,-44.05,-129908.2,321609.05,191700.85
1957-03-18,43.85,-0.2,-0.45,49.64,-11.66,True,1,7302,-43.85,-129952.05,320192.7,190240.65
1957-03-19,44.04,0.19,0.43,49.64,-11.28,True,1,7303,-44.04,-129996.09,321624.12,191628.03
1957-03-20,44.1,0.06,0.14,49.64,-11.16,True,1,7304,-44.1,-130040.19,322106.4,192066.21
1957-03-21,44.11,0.01,0.02,49.64,-11.14,True,1,7305,-44.11,-130084.3,322223.55,192139.25
1957-03-22,44.06,-0.05,-0.11,49.64,-11.24,True,1,7306,-44.06,-130128.36,321902.36,191774.0
1957-03-25,43.88,-0.18,-0.41,49.64,-11.6,True,1,7307,-43.88,-130172.24,320631.16,190458.92
1957-03-26,43.91,0.03,0.07,49.64,-11.54,True,1,7308,-43.91,-130216.15,320894.28,190678.13
1957-03-27,44.09,0.18,0.41,49.64,-11.18,True,1,7309,-44.09,-130260.24,322253.81,191993.57
1957-03-28,44.18,0.09,0.2,49.64,-11.0,True,1,7310,-44.18,-130304.42,322955.8,192651.38
1957-03-29,44.11,-0.07,-0.16,49.64,-11.14,True,1,7311,-44.11,-130348.53,322488.21,192139.68
1957-04-01,44.14,0.03,0.07,49.64,-11.08,True,1,7312,-44.14,-130392.67,322751.68,192359.01
1957-04-02,44.42,0.28,0.63,49.64,-10.52,True,1,7313,-44.42,-130437.09,324843.46,194406.37
1957-04-03,44.54,0.12,0.27,49.64,-10.27,True,1,7314,-44.54,-130481.63,325765.56,195283.93
1957-04-04,44.44,-0.1,-0.22,49.64,-10.48,True,1,7315,-44.44,-130526.07,325078.6,194552.53
1957-04-05,44.49,0.05,0.11,49.64,-10.38,True,1,7316,-44.49,-130570.56,325488.84,194918.28
1957-04-08,44.39,-0.1,-0.22,49.64,-10.58,True,1,7317,-44.39,-130614.95,324801.63,194186.68
1957-04-09,44.79,0.4,0.9,49.64,-9.77,True,1,7318,-44.79,-130659.74,327773.22,197113.48
1957-04-10,44.98,0.19,0.42,49.64,-9.39,True,1,7319,-44.98,-130704.72,329208.62,198503.9
1957-04-11,44.98,0.0,0.0,49.64,-9.39,True,1,7320,-44.98,-130749.7,329253.6,198503.9
1957-04-12,44.98,0.0,0.0,49.64,-9.39,True,1,7321,-44.98,-130794.68,329298.58,198503.9
1957-04-15,44.95,-0.03,-0.07,49.64,-9.45,True,1,7322,-44.95,-130839.63,329123.9,198284.27
1957-04-16,45.02,0.07,0.16,49.64,-9.31,True,1,7323,-45.02,-130884.65,329681.46,198796.81
1957-04-17,45.08,0.06,0.13,49.64,-9.19,True,1,7324,-45.08,-130929.73,330165.92,199236.19
1957-04-18,45.41,0.33,0.73,49.64,-8.52,True,1,7325,-45.41,-130975.14,332628.25,201653.11
1957-04-22,45.48,0.07,0.15,49.64,-8.38,True,1,7326,-45.48,-131020.62,333186.48,202165.86
1957-04-23,45.65,0.17,0.37,49.64,-8.04,True,1,7327,-45.65,-131066.27,334477.55,203411.28
1957-04-24,45.72,0.07,0.15,49.64,-7.9,True,1,7328,-45.72,-131111.99,335036.16,203924.17
1957-04-25,45.56,-0.16,-0.35,49.64,-8.22,True,1,7329,-45.56,-131157.55,333909.24,202751.69
1957-04-26,45.5,-0.06,-0.13,49.64,-8.34,True,1,7330,-45.5,-131203.05,333515.0,202311.95
1957-04-29,45.73,0.23,0.5,49.64,-7.88,True,1,7331,-45.73,-131248.78,335246.63,203997.85
1957-04-30,45.74,0.01,0.02,49.64,-7.86,True,1,7332,-45.74,-131294.52,335365.68,204071.16
1957-05-01,46.02,0.28,0.61,49.64,-7.29,True,1,7333,-46.02,-131340.54,337464.66,206124.12
1957-05-02,46.39,0.37,0.8,49.64,-6.55,True,1,7334,-46.39,-131386.93,340224.26,208837.33
1957-05-03,46.34,-0.05,-0.11,49.64,-6.65,True,1,7335,-46.34,-131433.27,339903.9,208470.63
1957-05-06,46.27,-0.07,-0.15,49.64,-6.79,True,1,7336,-46.27,-131479.54,339436.72,207957.18
1957-05-07,46.13,-0.14,-0.3,49.64,-7.07,True,1,7337,-46.13,-131525.67,338455.81,206930.14
1957-05-08,46.31,0.18,0.39,49.64,-6.71,True,1,7338,-46.31,-131571.98,339822.78,208250.8
1957-05-09,46.36,0.05,0.11,49.64,-6.61,True,1,7339,-46.36,-131618.34,340236.04,208617.7
1957-05-10,46.59,0.23,0.5,49.64,-6.14,True,1,7340,-46.59,-131664.93,341970.6,210305.67
1957-05-13,46.88,0.29,0.62,49.64,-5.56,True,1,7341,-46.88,-131711.81,344146.08,212434.27
1957-05-14,46.67,-0.21,-0.45,49.64,-5.98,True,1,7342,-46.67,-131758.48,342651.14,210892.66
1957-05-15,46.83,0.16,0.34,49.64,-5.66,True,1,7343,-46.83,-131805.31,343872.69,212067.38
1957-05-16,47.02,0.19,0.41,49.64,-5.28,True,1,7344,-47.02,-131852.33,345314.88,213462.55
1957-05-17,47.15,0.13,0.28,49.64,-5.02,True,1,7345,-47.15,-131899.48,346316.75,214417.27
1957-05-20,47.35,0.2,0.42,49.64,-4.61,True,1,7346,-47.35,-131946.83,347833.1,215886.27
1957-05-21,47.33,-0.02,-0.04,49.64,-4.65,True,1,7347,-47.33,-131994.16,347733.51,215739.35
1957-05-22,47.14,-0.19,-0.4,49.64,-5.04,True,1,7348,-47.14,-132041.3,346384.72,214343.42
1957-05-23,47.15,0.01,0.02,49.64,-5.02,True,1,7349,-47.15,-132088.45,346505.35,214416.9
1957-05-24,47.21,0.06,0.13,49.64,-4.89,True,1,7350,-47.21,-132135.66,346993.5,214857.84
1957-05-27,46.78,-0.43,-0.91,49.64,-5.76,True,1,7351,-46.78,-132182.44,343879.78,211697.34
1957-05-28,46.69,-0.09,-0.19,49.64,-5.94,True,1,7352,-46.69,-132229.13,343264.88,211035.75
1957-05-29,47.11,0.42,0.9,49.64,-5.1,True,1,7353,-47.11,-132276.24,346399.83,214123.59
1957-05-31,47.43,0.32,0.68,49.64,-4.45,True,1,7354,-47.43,-132323.67,348800.22,216476.55
1957-06-03,47.37,-0.06,-0.13,49.64,-4.57,True,1,7355,-47.37,-132371.04,348406.35,216035.31
1957-06-04,47.28,-0.09,-0.19,49.64,-4.75,True,1,7356,-47.28,-132418.32,347791.68,215373.36
1957-06-05,47.27,-0.01,-0.02,49.64,-4.77,True,1,7357,-47.27,-132465.59,347765.39,215299.8
1957-06-06,47.8,0.53,1.12,49.64,-3.71,True,1,7358,-47.8,-132513.39,351712.4,219199.01
1957-06-07,47.85,0.05,0.1,49.64,-3.61,True,1,7359,-47.85,-132561.24,352128.15,219566.91
1957-06-10,47.9,0.05,0.1,49.64,-3.5,True,1,7360,-47.9,-132609.14,352544.0,219934.86
1957-06-11,47.94,0.04,0.08,49.64,-3.42,True,1,7361,-47.94,-132657.08,352886.34,220229.26
1957-06-12,48.05,0.11,0.23,49.64,-3.2,True,1,7362,-48.05,-132705.13,353744.1,221038.97
1957-06-13,48.14,0.09,0.19,49.64,-3.02,True,1,7363,-48.14,-132753.27,354454.82,221701.55
1957-06-14,48.15,0.01,0.02,49.64,-3.0,True,1,7364,-48.15,-132801.42,354576.6,221775.18
1957-06-17,48.24,0.09,0.19,49.64,-2.82,True,1,7365,-48.24,-132849.66,355287.6,222437.94
1957-06-18,48.04,-0.2,-0.42,49.64,-3.22,True,1,7366,-48.04,-132897.7,353862.64,220964.94
1957-06-19,47.72,-0.32,-0.67,49.64,-3.87,True,1,7367,-47.72,-132945.42,351553.24,218607.82
1957-06-20,47.43,-0.29,-0.61,49.64,-4.45,True,1,7368,-47.43,-132992.85,349464.24,216471.39
1957-06-21,47.15,-0.28,-0.59,49.64,-5.02,True,1,7369,-47.15,-133040.0,347448.35,214408.35
1957-06-24,46.78,-0.37,-0.78,49.64,-5.76,True,1,7370,-46.78,-133086.78,344768.6,211681.82
1957-06-25,47.15,0.37,0.79,49.64,-5.02,True,1,7371,-47.15,-133133.93,347542.65,214408.72
1957-06-26,47.09,-0.06,-0.13,49.64,-5.14,True,1,7372,-47.09,-133181.02,347147.48,213966.46
1957-06-27,47.26,0.17,0.36,49.64,-4.8,True,1,7373,-47.26,-133228.28,348447.98,215219.7
1957-06-28,47.37,0.11,0.23,49.64,-4.57,True,1,7374,-47.37,-133275.65,349306.38,216030.73
1957-07-01,47.43,0.06,0.13,49.64,-4.45,True,1,7375,-47.43,-133323.08,349796.25,216473.17
1957-07-02,47.9,0.47,0.99,49.64,-3.5,True,1,7376,-47.9,-133370.98,353310.4,219939.42
1957-07-03,48.46,0.56,1.17,49.64,-2.38,True,1,7377,-48.46,-133419.44,357489.42,224069.98
1957-07-05,48.69,0.23,0.48,49.64,-1.91,True,1,7378,-48.69,-133468.13,359234.82,225766.69
1957-07-08,48.9,0.21,0.43,49.64,-1.49,True,1,7379,-48.9,-133517.03,360833.1,227316.07
1957-07-09,48.9,0.0,0.0,49.64,-1.49,True,1,7380,-48.9,-133565.93,360882.0,227316.07
1957-07-10,49.0,0.1,0.2,49.64,-1.29,True,1,7381,-49.0,-133614.93,361669.0,228054.07
1957-07-11,48.86,-0.14,-0.29,49.64,-1.57,True,1,7382,-48.86,-133663.79,360684.52,227020.73
1957-07-12,49.08,0.22,0.45,49.64,-1.13,True,1,7383,-49.08,-133712.87,362357.64,228644.77
1957-07-15,49.13,0.05,0.1,49.64,-1.03,True,1,7384,-49.13,-133762.0,362775.92,229013.92
1957-07-16,48.88,-0.25,-0.51,49.64,-1.53,True,1,7385,-48.88,-133810.88,360978.8,227167.92
1957-07-17,48.58,-0.3,-0.61,49.64,-2.13,True,1,7386,-48.58,-133859.46,358811.88,224952.42
1957-07-18,48.53,-0.05,-0.1,49.64,-2.24,True,1,7387,-48.53,-133907.99,358491.11,224583.12
1957-07-19,48.58,0.05,0.1,49.64,-2.13,True,1,7388,-48.58,-133956.57,358909.04,224952.47
1957-07-22,48.47,-0.11,-0.23,49.64,-2.36,True,1,7389,-48.47,-134005.04,358144.83,224139.79
1957-07-23,48.56,0.09,0.19,49.64,-2.18,True,1,7390,-48.56,-134053.6,358858.4,224804.8
1957-07-24,48.61,0.05,0.1,49.64,-2.08,True,1,7391,-48.61,-134102.21,359276.51,225174.3
1957-07-25,48.61,0.0,0.0,49.64,-2.08,True,1,7392,-48.61,-134150.82,359325.12,225174.3
1957-07-26,48.45,-0.16,-0.33,49.64,-2.4,True,1,7393,-48.45,-134199.27,358190.85,223991.58
1957-07-29,47.92,-0.53,-1.09,49.64,-3.46,True,1,7394,-47.92,-134247.19,354320.48,220073.29
1957-07-30,47.92,0.0,0.0,49.64,-3.46,True,1,7395,-47.92,-134295.11,354368.4,220073.29
1957-07-31,47.91,-0.01,-0.02,49.64,-3.48,True,1,7396,-47.91,-134343.02,354342.36,219999.34
1957-08-01,47.79,-0.12,-0.25,49.64,-3.73,True,1,7397,-47.79,-134390.81,353502.63,219111.82
1957-08-02,47.68,-0.11,-0.23,49.64,-3.95,True,1,7398,-47.68,-134438.49,352736.64,218298.15
1957-08-05,47.26,-0.42,-0.88,49.64,-4.8,True,1,7399,-47.26,-134485.75,349676.74,215190.99
1957-08-06,46.67,-0.59,-1.25,49.64,-5.98,True,1,7400,-46.67,-134532.42,345358.0,210825.58
1957-08-07,47.03,0.36,0.77,49.64,-5.26,True,1,7401,-47.03,-134579.45,348069.03,213489.58
1957-08-08,46.9,-0.13,-0.28,49.64,-5.52,True,1,7402,-46.9,-134626.35,347153.8,212527.45
1957-08-09,46.92,0.02,0.04,49.64,-5.48,True,1,7403,-46.92,-134673.27,347348.76,212675.49
1957-08-12,46.33,-0.59,-1.26,49.64,-6.67,True,1,7404,-46.33,-134719.6,343027.32,208307.72
1957-08-13,46.3,-0.03,-0.06,49.64,-6.73,True,1,7405,-46.3,-134765.9,342851.5,208085.6
1957-08-14,45.73,-0.57,-1.23,49.64,-7.88,True,1,7406,-45.73,-134811.63,338676.38,203864.75
1957-08-15,45.75,0.02,0.04,49.64,-7.84,True,1,7407,-45.75,-134857.38,338870.25,204012.87
1957-08-16,45.83,0.08,0.18,49.64,-7.68,True,1,7408,-45.83,-134903.21,339508.64,204605.43
1957-08-19,44.91,-0.92,-2.01,49.64,-9.53,True,1,7409,-44.91,-134948.12,332738.19,197790.07
1957-08-20,45.29,0.38,0.85,49.64,-8.76,True,1,7410,-45.29,-134993.41,335598.9,200605.49
1957-08-21,45.49,0.2,0.44,49.64,-8.36,True,1,7411,-45.49,-135038.9,337126.39,202087.49
1957-08-22,45.16,-0.33,-0.72,49.64,-9.02,True,1,7412,-45.16,-135084.06,334725.92,199641.86
1957-08-23,44.51,-0.65,-1.44,49.64,-10.33,True,1,7413,-44.51,-135128.57,329952.63,194824.06
1957-08-26,43.89,-0.62,-1.39,49.64,-11.58,True,1,7414,-43.89,-135172.46,325400.46,190228.0
1957-08-27,44.61,0.72,1.64,49.64,-10.13,True,1,7415,-44.61,-135217.07,330783.15,195566.08
1957-08-28,44.64,0.03,0.07,49.64,-10.07,True,1,7416,-44.64,-135261.71,331050.24,195788.53
1957-08-29,44.46,-0.18,-0.4,49.64,-10.44,True,1,7417,-44.46,-135306.17,329759.82,194453.65
1957-08-30,45.22,0.76,1.71,49.64,-8.9,True,1,7418,-45.22,-135351.39,335441.96,200090.57
1957-09-03,45.44,0.22,0.49,49.64,-8.46,True,1,7419,-45.44,-135396.83,337119.36,201722.53
1957-09-04,45.05,-0.39,-0.86,49.64,-9.25,True,1,7420,-45.05,-135441.88,334271.0,198829.12
1957-09-05,44.82,-0.23,-0.51,49.64,-9.71,True,1,7421,-44.82,-135486.7,332609.22,197122.52
1957-09-06,44.68,-0.14,-0.31,49.64,-9.99,True,1,7422,-44.68,-135531.38,331614.96,196083.58
1957-09-09,44.28,-0.4,-0.9,49.64,-10.8,True,1,7423,-44.28,-135575.66,328690.44,193114.78
1957-09-10,43.87,-0.41,-0.93,49.64,-11.62,True,1,7424,-43.87,-135619.53,325690.88,190071.35
1957-09-11,44.26,0.39,0.89,49.64,-10.84,True,1,7425,-44.26,-135663.79,328630.5,192966.71
1957-09-12,44.82,0.56,1.26,49.64,-9.71,True,1,7426,-44.82,-135708.61,332833.32,197124.71
1957-09-13,44.8,-0.02,-0.04,49.64,-9.75,True,1,7427,-44.8,-135753.41,332729.6,196976.19
1957-09-16,44.58,-0.22,-0.49,49.64,-10.19,True,1,7428,-44.58,-135797.99,331140.24,195342.25
1957-09-17,44.64,0.06,0.14,49.64,-10.07,True,1,7429,-44.64,-135842.63,331630.56,195787.93
1957-09-18,44.69,0.05,0.11,49.64,-9.97,True,1,7430,-44.69,-135887.32,332046.7,196159.38
1957-09-19,44.4,-0.29,-0.65,49.64,-10.56,True,1,7431,-44.4,-135931.72,329936.4,194004.68
1957-09-20,43.69,-0.71,-1.6,49.64,-11.99,True,1,7432,-43.69,-135975.41,324704.08,188728.67
1957-09-23,42.69,-1.0,-2.29,49.64,-14.0,True,1,7433,-42.69,-136018.1,317314.77,181296.67
1957-09-24,42.98,0.29,0.68,49.64,-13.42,True,1,7434,-42.98,-136061.08,319513.32,183452.24
1957-09-25,42.98,0.0,0.0,49.64,-13.42,True,1,7435,-42.98,-136104.06,319556.3,183452.24
1957-09-26,42.57,-0.41,-0.95,49.64,-14.24,True,1,7436,-42.57,-136146.63,316550.52,180403.89
1957-09-27,42.55,-0.02,-0.05,49.64,-14.28,True,1,7437,-42.55,-136189.18,316444.35,180255.17
1957-09-30,42.42,-0.13,-0.31,49.64,-14.54,True,1,7438,-42.42,-136231.6,315519.96,179288.36
1957-10-01,42.76,0.34,0.8,49.64,-13.86,True,1,7439,-42.76,-136274.36,318091.64,181817.28
1957-10-02,43.1,0.34,0.8,49.64,-13.18,True,1,7440,-43.1,-136317.46,320664.0,184346.54
1957-10-03,43.14,0.04,0.09,49.64,-13.09,True,1,7441,-43.14,-136360.6,321004.74,184644.14
1957-10-04,42.79,-0.35,-0.81,49.64,-13.8,True,1,7442,-42.79,-136403.39,318443.18,182039.79
1957-10-07,42.22,-0.57,-1.33,49.64,-14.95,True,1,7443,-42.22,-136445.61,314243.46,177797.85
1957-10-08,41.95,-0.27,-0.64,49.64,-15.49,True,1,7444,-41.95,-136487.56,312275.8,175788.24
1957-10-09,41.99,0.04,0.1,49.64,-15.41,True,1,7445,-41.99,-136529.55,312615.55,176086.0
1957-10-10,40.96,-1.03,-2.45,49.64,-17.49,True,1,7446,-40.96,-136570.51,304988.16,168417.65
1957-10-11,40.94,-0.02,-0.05,49.64,-17.53,True,1,7447,-40.94,-136611.45,304880.18,168268.73
1957-10-14,41.24,0.3,0.73,49.64,-16.92,True,1,7448,-41.24,-136652.69,307155.52,170502.83
1957-10-15,41.67,0.43,1.04,49.64,-16.06,True,1,7449,-41.67,-136694.36,310399.83,173705.47
1957-10-16,41.33,-0.34,-0.82,49.64,-16.74,True,1,7450,-41.33,-136735.69,307908.5,171172.81
1957-10-17,40.65,-0.68,-1.64,49.64,-18.11,True,1,7451,-40.65,-136776.34,302883.15,166106.81
1957-10-18,40.33,-0.32,-0.79,49.64,-18.76,True,1,7452,-40.33,-136816.67,300539.16,163722.49
1957-10-21,39.15,-1.18,-2.93,49.64,-21.13,True,1,7453,-39.15,-136855.82,291784.95,154929.13
1957-10-22,38.98,-0.17,-0.43,49.64,-21.48,True,1,7454,-38.98,-136894.8,290556.92,153662.12
1957-10-23,40.73,1.75,4.49,49.64,-17.95,True,1,7455,-40.73,-136935.53,303642.15,166706.62
1957-10-24,40.71,-0.02,-0.05,49.64,-17.99,True,1,7456,-40.71,-136976.24,303533.76,166557.52
1957-10-25,40.59,-0.12,-0.3,49.64,-18.23,True,1,7457,-40.59,-137016.83,302679.63,165662.8
1957-10-28,40.42,-0.17,-0.42,49.64,-18.57,True,1,7458,-40.42,-137057.25,301452.36,164395.11
1957-10-29,40.69,0.27,0.67,49.64,-18.03,True,1,7459,-40.69,-137097.94,303506.71,166408.77
1957-10-30,41.02,0.33,0.81,49.64,-17.36,True,1,7460,-41.02,-137138.96,306009.2,168870.24
1957-10-31,41.06,0.04,0.1,49.64,-17.28,True,1,7461,-41.06,-137180.02,306348.66,169168.64
1957-11-01,40.44,-0.62,-1.51,49.64,-18.53,True,1,7462,-40.44,-137220.46,301763.28,164542.82
1957-11-04,40.37,-0.07,-0.17,49.64,-18.67,True,1,7463,-40.37,-137260.83,301281.31,164020.48
1957-11-06,40.43,0.06,0.15,49.64,-18.55,True,1,7464,-40.43,-137301.26,301769.52,164468.26
1957-11-07,40.67,0.24,0.59,49.64,-18.07,True,1,7465,-40.67,-137341.93,303601.55,166259.62
1957-11-08,40.19,-0.48,-1.18,49.64,-19.04,True,1,7466,-40.19,-137382.12,300058.54,162676.42
1957-11-11,40.18,-0.01,-0.02,49.64,-19.06,True,1,7467,-40.18,-137422.3,300024.06,162601.76
1957-11-12,39.6,-0.58,-1.44,49.64,-20.23,True,1,7468,-39.6,-137461.9,295732.8,158270.9
1957-11-13,39.55,-0.05,-0.13,49.64,-20.33,True,1,7469,-39.55,-137501.45,295398.95,157897.5
1957-11-14,39.44,-0.11,-0.28,49.64,-20.55,True,1,7470,-39.44,-137540.89,294616.8,157075.91
1957-11-15,40.37,0.93,2.36,49.64,-18.67,True,1,7471,-40.37,-137581.26,301604.27,164023.01
1957-11-18,40.04,-0.33,-0.82,49.64,-19.34,True,1,7472,-40.04,-137621.3,299178.88,161557.58
1957-11-19,39.81,-0.23,-0.57,49.64,-19.8,True,1,7473,-39.81,-137661.11,297500.13,159839.02
1957-11-20,39.92,0.11,0.28,49.64,-19.58,True,1,7474,-39.92,-137701.03,298362.08,160661.05
1957-11-21,40.48,0.56,1.4,49.64,-18.45,True,1,7475,-40.48,-137741.51,302588.0,164846.49
1957-11-22,40.87,0.39,0.96,49.64,-17.67,True,1,7476,-40.87,-137782.38,305544.12,167761.74
1957-11-25,41.18,0.31,0.76,49.64,-17.04,True,1,7477,-41.18,-137823.56,307902.86,170079.3
1957-11-26,40.09,-1.09,-2.65,49.64,-19.24,True,1,7478,-40.09,-137863.65,299793.02,161929.37
1957-11-27,41.25,1.16,2.89,49.64,-16.9,True,1,7479,-41.25,-137904.9,308508.75,170603.85
1957-11-29,41.72,0.47,1.14,49.64,-15.96,True,1,7480,-41.72,-137946.62,312065.6,174118.98
1957-12-02,41.36,-0.36,-0.86,49.64,-16.68,True,1,7481,-41.36,-137987.98,309414.16,171426.18
1957-12-03,41.37,0.01,0.02,49.64,-16.66,True,1,7482,-41.37,-138029.35,309530.34,171500.99
1957-12-04,41.54,0.17,0.41,49.64,-16.32,True,1,7483,-41.54,-138070.89,310843.82,172772.93
1957-12-05,41.52,-0.02,-0.05,49.64,-16.36,True,1,7484,-41.52,-138112.41,310735.68,172623.27
1957-12-06,41.31,-0.21,-0.51,49.64,-16.78,True,1,7485,-41.31,-138153.72,309205.35,171051.63
1957-12-09,40.92,-0.39,-0.94,49.64,-17.57,True,1,7486,-40.92,-138194.64,306327.12,168132.48
1957-12-10,40.56,-0.36,-0.88,49.64,-18.29,True,1,7487,-40.56,-138235.2,303672.72,165437.52
1957-12-11,40.51,-0.05,-0.12,49.64,-18.39,True,1,7488,-40.51,-138275.71,303338.88,165063.17
1957-12-12,40.55,0.04,0.1,49.64,-18.31,True,1,7489,-40.55,-138316.26,303678.95,165362.69
1957-12-13,40.73,0.18,0.44,49.64,-17.95,True,1,7490,-40.73,-138356.99,305067.7,166710.71
1957-12-16,40.12,-0.61,-1.5,49.64,-19.18,True,1,7491,-40.12,-138397.11,300538.92,162141.81
1957-12-17,39.42,-0.7,-1.74,49.64,-20.59,True,1,7492,-39.42,-138436.53,295334.64,156898.11
1957-12-18,39.38,-0.04,-0.1,49.64,-20.67,True,1,7493,-39.38,-138475.91,295074.34,156598.43
1957-12-19,39.8,0.42,1.07,49.64,-19.82,True,1,7494,-39.8,-138515.71,298261.2,159745.49
1957-12-20,39.48,-0.32,-0.8,49.64,-20.47,True,1,7495,-39.48,-138555.19,295902.6,157347.41
1957-12-23,39.48,0.0,0.0,49.64,-20.47,True,1,7496,-39.48,-138594.67,295942.08,157347.41
1957-12-24,39.52,0.04,0.1,49.64,-20.39,True,1,7497,-39.52,-138634.19,296281.44,157647.25
1957-12-26,39.92,0.4,1.01,49.64,-19.58,True,1,7498,-39.92,-138674.11,299320.16,160646.05
1957-12-27,39.78,-0.14,-0.35,49.64,-19.86,True,1,7499,-39.78,-138713.89,298310.22,159596.33
1957-12-30,39.58,-0.2,-0.5,49.64,-20.27,True,1,7500,-39.58,-138753.47,296850.0,158096.53
1957-12-31,39.99,0.41,1.04,49.64,-19.44,True,1,7501,-39.99,-138793.46,299964.99,161171.53
1958-01-02,40.33,0.34,0.85,49.64,-18.76,True,1,7502,-40.33,-138833.79,302555.66,163721.87
1958-01-03,40.87,0.54,1.34,49.64,-17.67,True,1,7503,-40.87,-138874.66,306647.61,167772.95
1958-01-06,40.68,-0.19,-0.46,49.64,-18.05,True,1,7504,-40.68,-138915.34,305262.72,166347.38
1958-01-07,41.0,0.32,0.79,49.64,-17.4,True,1,7505,-41.0,-138956.34,307705.0,168748.66
1958-01-08,40.99,-0.01,-0.02,49.64,-17.42,True,1,7506,-40.99,-138997.33,307670.94,168673.61
1958-01-09,40.75,-0.24,-0.59,49.64,-17.91,True,1,7507,-40.75,-139038.08,305910.25,166872.17
1958-01-10,40.37,-0.38,-0.93,49.64,-18.67,True,1,7508,-40.37,-139078.45,303097.96,164019.51
1958-01-13,40.49,0.12,0.3,49.64,-18.43,True,1,7509,-40.49,-139118.94,304039.41,164920.47
1958-01-14,40.67,0.18,0.44,49.64,-18.07,True,1,7510,-40.67,-139159.61,305431.7,166272.09
1958-01-15,40.99,0.32,0.79,49.64,-17.42,True,1,7511,-40.99,-139200.6,307875.89,168675.29
1958-01-16,41.06,0.07,0.17,49.64,-17.28,True,1,7512,-41.06,-139241.66,308442.72,169201.06
1958-01-17,41.1,0.04,0.1,49.64,-17.2,True,1,7513,-41.1,-139282.76,308784.3,169501.54
1958-01-20,41.35,0.25,0.61,49.64,-16.7,True,1,7514,-41.35,-139324.11,310703.9,171379.79
1958-01-21,41.3,-0.05,-0.12,49.64,-16.8,True,1,7515,-41.3,-139365.41,310369.5,171004.09
1958-01-22,41.2,-0.1,-0.24,49.64,-17.0,True,1,7516,-41.2,-139406.61,309659.2,170252.59
1958-01-23,41.36,0.16,0.39,49.64,-16.68,True,1,7517,-41.36,-139447.97,310903.12,171455.15
1958-01-24,41.71,0.35,0.85,49.64,-15.98,True,1,7518,-41.71,-139489.68,313575.78,174086.1
1958-01-27,41.59,-0.12,-0.29,49.64,-16.22,True,1,7519,-41.59,-139531.27,312715.21,173183.94
1958-01-28,41.63,0.04,0.1,49.64,-16.14,True,1,7520,-41.63,-139572.9,313057.6,173484.7
1958-01-29,41.88,0.25,0.6,49.64,-15.63,True,1,7521,-41.88,-139614.78,314979.48,175364.7
1958-01-30,41.68,-0.2,-0.48,49.64,-16.04,True,1,7522,-41.68,-139656.46,313516.96,173860.5
1958-01-31,41.7,0.02,0.05,49.64,-16.0,True,1,7523,-41.7,-139698.16,313709.1,174010.94
1958-02-03,42.04,0.34,0.82,49.64,-15.31,True,1,7524,-42.04,-139740.2,316308.96,176568.76
1958-02-04,42.46,0.42,1.0,49.64,-14.46,True,1,7525,-42.46,-139782.66,319511.5,179728.84
1958-02-05,42.19,-0.27,-0.64,49.64,-15.01,True,1,7526,-42.19,-139824.85,317521.94,177697.09
1958-02-06,42.1,-0.09,-0.21,49.64,-15.19,True,1,7527,-42.1,-139866.95,316886.7,177019.75
1958-02-07,41.73,-0.37,-0.88,49.64,-15.94,True,1,7528,-41.73,-139908.68,314143.44,174234.76
1958-02-10,41.48,-0.25,-0.6,49.64,-16.44,True,1,7529,-41.48,-139950.16,312302.92,172352.76
1958-02-11,41.11,-0.37,-0.89,49.64,-17.18,True,1,7530,-41.11,-139991.27,309558.3,169567.03
1958-02-12,40.93,-0.18,-0.44,49.64,-17.55,True,1,7531,-40.93,-140032.2,308243.83,168211.63
1958-02-13,40.94,0.01,0.02,49.64,-17.53,True,1,7532,-40.94,-140073.14,308360.08,168286.94
1958-02-14,41.33,0.39,0.95,49.64,-16.74,True,1,7533,-41.33,-140114.47,311338.89,171224.42
1958-02-17,41.11,-0.22,-0.53,49.64,-17.18,True,1,7534,-41.11,-140155.58,309722.74,169567.16
1958-02-18,41.17,0.06,0.15,49.64,-17.06,True,1,7535,-41.17,-140196.75,310215.95,170019.2
1958-02-19,41.15,-0.02,-0.05,49.64,-17.1,True,1,7536,-41.15,-140237.9,310106.4,169868.5
1958-02-20,40.91,-0.24,-0.58,49.64,-17.59,True,1,7537,-40.91,-140278.81,308338.67,168059.86
1958-02-21,40.88,-0.03,-0.07,49.64,-17.65,True,1,7538,-40.88,-140319.69,308153.44,167833.75
1958-02-24,40.65,-0.23,-0.56,49.64,-18.11,True,1,7539,-40.65,-140360.34,306460.35,166100.01
1958-02-25,40.61,-0.04,-0.1,49.64,-18.19,True,1,7540,-40.61,-140400.95,306199.4,165798.45
1958-02-26,40.92,0.31,0.76,49.64,-17.57,True,1,7541,-40.92,-140441.87,308577.72,168135.85
1958-02-27,40.68,-0.24,-0.59,49.64,-18.05,True,1,7542,-40.68,-140482.55,306808.56,166326.01
1958-02-28,40.84,0.16,0.39,49.64,-17.73,True,1,7543,-40.84,-140523.39,308056.12,167532.73
1958-03-03,41.13,0.29,0.71,49.64,-17.14,True,1,7544,-41.13,-140564.52,310284.72,169720.2
1958-03-04,41.35,0.22,0.54,49.64,-16.7,True,1,7545,-41.35,-140605.87,311985.75,171379.88
1958-03-05,41.47,0.12,0.29,49.64,-16.46,True,1,7546,-41.47,-140647.34,312932.62,172285.28
1958-03-06,42.0,0.53,1.28,49.64,-15.39,True,1,7547,-42.0,-140689.34,316974.0,176284.66
1958-03-07,42.07,0.07,0.17,49.64,-15.25,True,1,7548,-42.07,-140731.41,317544.36,176812.95
1958-03-10,42.21,0.14,0.33,49.64,-14.97,True,1,7549,-42.21,-140773.62,318643.29,177869.67
1958-03-11,42.51,0.3,0.71,49.64,-14.36,True,1,7550,-42.51,-140816.13,320950.5,180134.37
1958-03-12,42.41,-0.1,-0.24,49.64,-14.56,True,1,7551,-42.41,-140858.54,320237.91,179379.37
1958-03-13,42.46,0.05,0.12,49.64,-14.46,True,1,7552,-42.46,-140901.0,320657.92,179756.92
1958-03-14,42.33,-0.13,-0.31,49.64,-14.73,True,1,7553,-42.33,-140943.33,319718.49,178775.16
1958-03-17,42.04,-0.29,-0.68,49.64,-15.31,True,1,7554,-42.04,-140985.37,317570.16,176584.79
1958-03-18,41.89,-0.15,-0.36,49.64,-15.61,True,1,7555,-41.89,-141027.26,316478.95,175451.69
1958-03-19,42.09,0.2,0.48,49.64,-15.21,True,1,7556,-42.09,-141069.35,318032.04,176962.69
1958-03-20,42.11,0.02,0.05,49.64,-15.17,True,1,7557,-42.11,-141111.46,318225.27,177113.81
1958-03-21,42.42,0.31,0.74,49.64,-14.54,True,1,7558,-42.42,-141153.88,320610.36,179456.48
1958-03-24,42.58,0.16,0.38,49.64,-14.22,True,1,7559,-42.58,-141196.46,321862.22,180665.76
1958-03-25,42.44,-0.14,-0.33,49.64,-14.5,True,1,7560,-42.44,-141238.9,320846.4,179607.5
1958-03-26,42.3,-0.14,-0.33,49.64,-14.79,True,1,7561,-42.3,-141281.2,319830.3,178549.1
1958-03-27,42.17,-0.13,-0.31,49.64,-15.05,True,1,7562,-42.17,-141323.37,318889.54,177566.17
1958-03-28,42.2,0.03,0.07,49.64,-14.99,True,1,7563,-42.2,-141365.57,319158.6,177793.03
1958-03-31,42.1,-0.1,-0.24,49.64,-15.19,True,1,7564,-42.1,-141407.67,318444.4,177036.73
1958-04-01,41.93,-0.17,-0.4,49.64,-15.53,True,1,7565,-41.93,-141449.6,317200.45,175750.85
1958-04-02,41.6,-0.33,-0.79,49.64,-16.2,True,1,7566,-41.6,-141491.2,314745.6,173254.4
1958-04-03,41.48,-0.12,-0.29,49.64,-16.44,True,1,7567,-41.48,-141532.68,313879.16,172346.48
1958-04-07,41.33,-0.15,-0.36,49.64,-16.74,True,1,7568,-41.33,-141574.01,312785.44,171211.43
1958-04-08,41.43,0.1,0.24,49.64,-16.54,True,1,7569,-41.43,-141615.44,313583.67,171968.23
1958-04-09,41.65,0.22,0.53,49.64,-16.1,True,1,7570,-41.65,-141657.09,315290.5,173633.41
1958-04-10,41.7,0.05,0.12,49.64,-16.0,True,1,7571,-41.7,-141698.79,315710.7,174011.91
1958-04-11,41.74,0.04,0.1,49.64,-15.92,True,1,7572,-41.74,-141740.53,316055.28,174314.75
1958-04-14,42.0,0.26,0.62,49.64,-15.39,True,1,7573,-42.0,-141782.53,318066.0,176283.47
1958-04-15,42.43,0.43,1.02,49.64,-14.52,True,1,7574,-42.43,-141824.96,321364.82,179539.86
1958-04-16,42.1,-0.33,-0.78,49.64,-15.19,True,1,7575,-42.1,-141867.06,318907.5,177040.44
1958-04-17,42.25,0.15,0.36,49.64,-14.89,True,1,7576,-42.25,-141909.31,320086.0,178176.69
1958-04-18,42.71,0.46,1.09,49.64,-13.96,True,1,7577,-42.71,-141952.02,323613.67,181661.65
1958-04-21,42.93,0.22,0.52,49.64,-13.52,True,1,7578,-42.93,-141994.95,325323.54,183328.59
1958-04-22,42.8,-0.13,-0.3,49.64,-13.78,True,1,7579,-42.8,-142037.75,324381.2,182343.45
1958-04-23,42.8,0.0,0.0,49.64,-13.78,True,1,7580,-42.8,-142080.55,324424.0,182343.45
1958-04-24,43.14,0.34,0.79,49.64,-13.09,True,1,7581,-43.14,-142123.69,327044.34,184920.65
1958-04-25,43.36,0.22,0.51,49.64,-12.65,True,1,7582,-43.36,-142167.05,328755.52,186588.47
1958-04-28,43.22,-0.14,-0.32,49.64,-12.93,True,1,7583,-43.22,-142210.27,327737.26,185526.99
1958-04-29,43.0,-0.22,-0.51,49.64,-13.38,True,1,7584,-43.0,-142253.27,326112.0,183858.73
1958-04-30,43.44,0.44,1.02,49.64,-12.49,True,1,7585,-43.44,-142296.71,329492.4,187195.69
1958-05-01,43.54,0.1,0.23,49.64,-12.29,True,1,7586,-43.54,-142340.25,330294.44,187954.19
1958-05-02,43.69,0.15,0.34,49.64,-11.99,True,1,7587,-43.69,-142383.94,331476.03,189092.09
1958-05-05,43.79,0.1,0.23,49.64,-11.78,True,1,7588,-43.79,-142427.73,332278.52,189850.79
1958-05-06,44.01,0.22,0.5,49.64,-11.34,True,1,7589,-44.01,-142471.74,333991.89,191520.15
1958-05-07,43.93,-0.08,-0.18,49.64,-11.5,True,1,7590,-43.93,-142515.67,333428.7,190913.03
1958-05-08,43.99,0.06,0.14,49.64,-11.38,True,1,7591,-43.99,-142559.66,333928.09,191368.43
1958-05-09,44.09,0.1,0.23,49.64,-11.18,True,1,7592,-44.09,-142603.75,334731.28,192127.53
1958-05-12,43.75,-0.34,-0.77,49.64,-11.86,True,1,7593,-43.75,-142647.5,332193.75,189546.25
1958-05-13,43.62,-0.13,-0.3,49.64,-12.13,True,1,7594,-43.62,-142691.12,331250.28,188559.16
1958-05-14,43.12,-0.5,-1.15,49.64,-13.14,True,1,7595,-43.12,-142734.24,327496.4,184762.16
1958-05-15,43.34,0.22,0.51,49.64,-12.69,True,1,7596,-43.34,-142777.58,329210.64,186433.06
1958-05-16,43.36,0.02,0.05,49.64,-12.65,True,1,7597,-43.36,-142820.94,329405.92,186584.98
1958-05-19,43.24,-0.12,-0.28,49.64,-12.89,True,1,7598,-43.24,-142864.18,328537.52,185673.34
1958-05-20,43.61,0.37,0.86,49.64,-12.15,True,1,7599,-43.61,-142907.79,331392.39,188484.6
1958-05-21,43.55,-0.06,-0.14,49.64,-12.27,True,1,7600,-43.55,-142951.34,330980.0,188028.66
1958-05-22,43.78,0.23,0.53,49.64,-11.8,True,1,7601,-43.78,-142995.12,332771.78,189776.66
1958-05-23,43.87,0.09,0.21,49.64,-11.62,True,1,7602,-43.87,-143038.99,333499.74,190460.75
1958-05-26,43.85,-0.02,-0.05,49.64,-11.66,True,1,7603,-43.85,-143082.84,333391.55,190308.71
1958-05-27,43.79,-0.06,-0.14,49.64,-11.78,True,1,7604,-43.79,-143126.63,332979.16,189852.53
1958-05-28,43.85,0.06,0.14,49.64,-11.66,True,1,7605,-43.85,-143170.48,333479.25,190308.77
1958-05-29,44.09,0.24,0.55,49.64,-11.18,True,1,7606,-44.09,-143214.57,335348.54,192133.97
1958-06-02,44.31,0.22,0.5,49.64,-10.74,True,1,7607,-44.31,-143258.88,337066.17,193807.29
1958-06-03,44.46,0.15,0.34,49.64,-10.44,True,1,7608,-44.46,-143303.34,338251.68,194948.34
1958-06-04,44.5,0.04,0.09,49.64,-10.36,True,1,7609,-44.5,-143347.84,338600.5,195252.66
1958-06-05,44.55,0.05,0.11,49.64,-10.25,True,1,7610,-44.55,-143392.39,339025.5,195633.11
1958-06-06,44.64,0.09,0.2,49.64,-10.07,True,1,7611,-44.64,-143437.03,339755.04,196318.01
1958-06-09,44.57,-0.07,-0.16,49.64,-10.21,True,1,7612,-44.57,-143481.6,339266.84,195785.24
1958-06-10,44.48,-0.09,-0.2,49.64,-10.4,True,1,7613,-44.48,-143526.08,338626.24,195100.16
1958-06-11,44.49,0.01,0.02,49.64,-10.38,True,1,7614,-44.49,-143570.57,338746.86,195176.29
1958-06-12,44.75,0.26,0.58,49.64,-9.85,True,1,7615,-44.75,-143615.32,340771.25,197155.93
1958-06-13,45.02,0.27,0.6,49.64,-9.31,True,1,7616,-45.02,-143660.34,342872.32,199211.98
1958-06-16,45.18,0.16,0.36,49.64,-8.98,True,1,7617,-45.18,-143705.52,344136.06,200430.54
1958-06-17,44.94,-0.24,-0.53,49.64,-9.47,True,1,7618,-44.94,-143750.46,342352.92,198602.46
1958-06-18,45.34,0.4,0.89,49.64,-8.66,True,1,7619,-45.34,-143795.8,345445.46,201649.66
1958-06-19,44.61,-0.73,-1.61,49.64,-10.13,True,1,7620,-44.61,-143840.41,339928.2,196087.79
1958-06-20,44.85,0.24,0.54,49.64,-9.65,True,1,7621,-44.85,-143885.26,341801.85,197916.59
1958-06-23,44.69,-0.16,-0.36,49.64,-9.97,True,1,7622,-44.69,-143929.95,340627.18,196697.23
1958-06-24,44.52,-0.17,-0.38,49.64,-10.31,True,1,7623,-44.52,-143974.47,339375.96,195401.49
1958-06-25,44.63,0.11,0.25,49.64,-10.09,True,1,7624,-44.63,-144019.1,340259.12,196240.02
1958-06-26,44.84,0.21,0.47,49.64,-9.67,True,1,7625,-44.84,-144063.94,341905.0,197841.06
1958-06-27,44.9,0.06,0.13,49.64,-9.55,True,1,7626,-44.9,-144108.84,342407.4,198298.56
1958-06-30,45.24,0.34,0.76,49.64,-8.86,True,1,7627,-45.24,-144154.08,345045.48,200891.4
1958-07-01,45.28,0.04,0.09,49.64,-8.78,True,1,7628,-45.28,-144199.36,345395.84,201196.48
1958-07-02,45.32,0.04,0.09,49.64,-8.7,True,1,7629,-45.32,-144244.68,345746.28,201501.6
1958-07-03,45.47,0.15,0.33,49.64,-8.4,True,1,7630,-45.47,-144290.15,346936.1,202645.95
1958-07-07,45.62,0.15,0.33,49.64,-8.1,True,1,7631,-45.62,-144335.77,348126.22,203790.45
1958-07-08,45.4,-0.22,-0.48,49.64,-8.54,True,1,7632,-45.4,-144381.17,346492.8,202111.63
1958-07-09,45.25,-0.15,-0.33,49.64,-8.84,True,1,7633,-45.25,-144426.42,345393.25,200966.83
1958-07-10,45.42,0.17,0.38,49.64,-8.5,True,1,7634,-45.42,-144471.84,346736.28,202264.44
1958-07-11,45.72,0.3,0.66,49.64,-7.9,True,1,7635,-45.72,-144517.56,349072.2,204554.64
1958-07-14,45.14,-0.58,-1.27,49.64,-9.06,True,1,7636,-45.14,-144562.7,344689.04,200126.34
1958-07-15,45.11,-0.03,-0.07,49.64,-9.13,True,1,7637,-45.11,-144607.81,344505.07,199897.26
1958-07-16,45.25,0.14,0.31,49.64,-8.84,True,1,7638,-45.25,-144653.06,345619.5,200966.44
1958-07-17,45.55,0.3,0.66,49.64,-8.24,True,1,7639,-45.55,-144698.61,347956.45,203257.84
1958-07-18,45.77,0.22,0.48,49.64,-7.8,True,1,7640,-45.77,-144744.38,349682.8,204938.42
1958-07-21,46.33,0.56,1.22,49.64,-6.67,True,1,7641,-46.33,-144790.71,354007.53,209216.82
1958-07-22,46.41,0.08,0.17,49.64,-6.51,True,1,7642,-46.41,-144837.12,354665.22,209828.1
1958-07-23,46.4,-0.01,-0.02,49.64,-6.53,True,1,7643,-46.4,-144883.52,354635.2,209751.68
1958-07-24,46.65,0.25,0.54,49.64,-6.02,True,1,7644,-46.65,-144930.17,356592.6,211662.43
1958-07-25,46.97,0.32,0.69,49.64,-5.38,True,1,7645,-46.97,-144977.14,359085.65,214108.51
1958-07-28,47.15,0.18,0.38,49.64,-5.02,True,1,7646,-47.15,-145024.29,360508.9,215484.61
1958-07-29,46.96,-0.19,-0.4,49.64,-5.4,True,1,7647,-46.96,-145071.25,359103.12,214031.87
1958-07-30,47.09,0.13,0.28,49.64,-5.14,True,1,7648,-47.09,-145118.34,360144.32,215025.98
1958-07-31,47.19,0.1,0.21,49.64,-4.94,True,1,7649,-47.19,-145165.53,360956.31,215790.78
1958-08-01,47.49,0.3,0.64,49.64,-4.33,True,1,7650,-47.49,-145213.02,363298.5,218085.48
1958-08-04,47.94,0.45,0.95,49.64,-3.42,True,1,7651,-47.94,-145260.96,366788.94,221527.98
1958-08-05,47.75,-0.19,-0.4,49.64,-3.81,True,1,7652,-47.75,-145308.71,365383.0,220074.29
1958-08-06,47.46,-0.29,-0.61,49.64,-4.39,True,1,7653,-47.46,-145356.17,363211.38,217855.21
1958-08-07,47.77,0.31,0.65,49.64,-3.77,True,1,7654,-47.77,-145403.94,365631.58,220227.64
1958-08-08,48.05,0.28,0.59,49.64,-3.2,True,1,7655,-48.05,-145451.99,367822.75,222370.76
1958-08-11,48.16,0.11,0.23,49.64,-2.98,True,1,7656,-48.16,-145500.15,368712.96,223212.81
1958-08-12,47.73,-0.43,-0.89,49.64,-3.85,True,1,7657,-47.73,-145547.88,365468.61,219920.73
1958-08-13,47.81,0.08,0.17,49.64,-3.69,True,1,7658,-47.81,-145595.69,366128.98,220533.29
1958-08-14,47.91,0.1,0.21,49.64,-3.48,True,1,7659,-47.91,-145643.6,366942.69,221299.09
1958-08-15,47.5,-0.41,-0.86,49.64,-4.31,True,1,7660,-47.5,-145691.1,363850.0,218158.9
1958-08-18,47.22,-0.28,-0.59,49.64,-4.88,True,1,7661,-47.22,-145738.32,361752.42,216014.1
1958-08-19,47.3,0.08,0.17,49.64,-4.71,True,1,7662,-47.3,-145785.62,362412.6,216626.98
1958-08-20,47.32,0.02,0.04,49.64,-4.67,True,1,7663,-47.32,-145832.94,362613.16,216780.22
1958-08-21,47.63,0.31,0.66,49.64,-4.05,True,1,7664,-47.63,-145880.57,365036.32,219155.75
1958-08-22,47.73,0.1,0.21,49.64,-3.85,True,1,7665,-47.73,-145928.3,365850.45,219922.15
1958-08-25,47.74,0.01,0.02,49.64,-3.83,True,1,7666,-47.74,-145976.04,365974.84,219998.8
1958-08-26,47.9,0.16,0.34,49.64,-3.5,True,1,7667,-47.9,-146023.94,367249.3,221225.36
1958-08-27,47.91,0.01,0.02,49.64,-3.48,True,1,7668,-47.91,-146071.85,367373.88,221302.03
1958-08-28,47.66,-0.25,-0.52,49.64,-3.99,True,1,7669,-47.66,-146119.51,365504.54,219385.03
1958-08-29,47.75,0.09,0.19,49.64,-3.81,True,1,7670,-47.75,-146167.26,366242.5,220075.24
1958-09-02,48.0,0.25,0.52,49.64,-3.3,True,1,7671,-48.0,-146215.26,368208.0,221992.74
1958-09-03,48.18,0.18,0.38,49.64,-2.94,True,1,7672,-48.18,-146263.44,369636.96,223373.52
1958-09-04,48.1,-0.08,-0.17,49.64,-3.1,True,1,7673,-48.1,-146311.54,369071.3,222759.76
1958-09-05,47.97,-0.13,-0.27,49.64,-3.36,True,1,7674,-47.97,-146359.51,368121.78,221762.27
1958-09-08,48.13,0.16,0.33,49.64,-3.04,True,1,7675,-48.13,-146407.64,369397.75,222990.11
1958-09-09,48.46,0.33,0.69,49.64,-2.38,True,1,7676,-48.46,-146456.1,371978.96,225522.86
1958-09-10,48.31,-0.15,-0.31,49.64,-2.68,True,1,7677,-48.31,-146504.41,370875.87,224371.46
1958-09-11,48.64,0.33,0.68,49.64,-2.02,True,1,7678,-48.64,-146553.05,373457.92,226904.87
1958-09-12,48.53,-0.11,-0.23,49.64,-2.24,True,1,7679,-48.53,-146601.58,372661.87,226060.29
1958-09-15,48.96,0.43,0.89,49.64,-1.37,True,1,7680,-48.96,-146650.54,376012.8,229362.26
1958-09-16,49.35,0.39,0.8,49.64,-0.58,True,1,7681,-49.35,-146699.89,379057.35,232357.46
1958-09-17,49.35,0.0,0.0,49.64,-0.58,True,1,7682,-49.35,-146749.24,379106.7,232357.46
1958-09-18,49.38,0.03,0.06,49.64,-0.52,True,1,7683,-49.38,-146798.62,379386.54,232587.92
1958-09-19,49.4,0.02,0.04,49.64,-0.48,True,1,7684,-49.4,-146848.02,379589.6,232741.58
1958-09-22,49.2,-0.2,-0.4,49.64,-0.89,True,1,7685,-49.2,-146897.22,378102.0,231204.78
1958-09-23,49.56,0.36,0.73,49.64,-0.16,True,1,7686,-49.56,-146946.78,380918.16,233971.38
1958-09-24,49.78,0.22,0.44,49.78,0.0,True,1,7687,-49.78,-146996.56,382658.86,235662.3
1958-09-25,49.57,-0.21,-0.42,49.78,-0.42,True,1,7688,-49.57,-147046.13,381094.16,234048.03
1958-09-26,49.66,0.09,0.18,49.78,-0.24,True,1,7689,-49.66,-147095.79,381835.74,234739.95
1958-09-29,49.87,0.21,0.42,49.87,0.0,True,1,7690,-49.87,-147145.66,383500.3,236354.64
1958-09-30,50.06,0.19,0.38,50.06,0.0,True,1,7691,-50.06,-147195.72,385011.46,237815.74
1958-10-01,49.98,-0.08,-0.16,50.06,-0.16,True,1,7692,-49.98,-147245.7,384446.16,237200.46
1958-10-02,50.17,0.19,0.38,50.17,0.0,True,1,7693,-50.17,-147295.87,385957.81,238661.94
1958-10-03,50.37,0.2,0.4,50.37,0.0,True,1,7694,-50.37,-147346.24,387546.78,240200.54
1958-10-06,51.07,0.7,1.39,51.07,0.0,True,1,7695,-51.07,-147397.31,392983.65,245586.34
1958-10-07,51.07,0.0,0.0,51.07,0.0,True,1,7696,-51.07,-147448.38,393034.72,245586.34
1958-10-08,51.06,-0.01,-0.02,51.07,-0.02,True,1,7697,-51.06,-147499.44,393008.82,245509.38
1958-10-09,51.05,-0.01,-0.02,51.07,-0.04,True,1,7698,-51.05,-147550.49,392982.9,245432.41
1958-10-10,51.39,0.34,0.67,51.39,0.0,True,1,7699,-51.39,-147601.88,395651.61,248049.73
1958-10-13,51.62,0.23,0.45,51.62,0.0,True,1,7700,-51.62,-147653.5,397474.0,249820.5
1958-10-14,51.26,-0.36,-0.7,51.62,-0.7,True,1,7701,-51.26,-147704.76,394753.26,247048.5
1958-10-15,50.58,-0.68,-1.33,51.62,-2.02,True,1,7702,-50.58,-147755.34,389567.16,241811.82
1958-10-16,50.94,0.36,0.71,51.62,-1.32,True,1,7703,-50.94,-147806.28,392390.82,244584.54
1958-10-17,51.46,0.52,1.02,51.62,-0.31,True,1,7704,-51.46,-147857.74,396447.84,248590.1
1958-10-20,51.27,-0.19,-0.37,51.62,-0.68,True,1,7705,-51.27,-147909.01,395035.35,247126.34
1958-10-21,51.27,0.0,0.0,51.62,-0.68,True,1,7706,-51.27,-147960.28,395086.62,247126.34
1958-10-22,51.07,-0.2,-0.39,51.62,-1.06,True,1,7707,-51.07,-148011.35,393596.49,245585.14
1958-10-23,50.97,-0.1,-0.2,51.62,-1.26,True,1,7708,-50.97,-148062.32,392876.76,244814.44
1958-10-24,50.81,-0.16,-0.31,51.62,-1.57,True,1,7709,-50.81,-148113.13,391694.29,243581.16
1958-10-27,50.42,-0.39,-0.77,51.62,-2.33,True,1,7710,-50.42,-148163.55,388738.2,240574.65
1958-10-28,50.58,0.16,0.32,51.62,-2.02,True,1,7711,-50.58,-148214.13,390022.38,241808.25
1958-10-29,51.07,0.49,0.97,51.62,-1.06,True,1,7712,-51.07,-148265.2,393851.84,245586.64
1958-10-30,51.27,0.2,0.39,51.62,-0.68,True,1,7713,-51.27,-148316.47,395445.51,247129.04
1958-10-31,51.33,0.06,0.12,51.62,-0.56,True,1,7714,-51.33,-148367.8,395959.62,247591.82
1958-11-03,51.56,0.23,0.45,51.62,-0.12,True,1,7715,-51.56,-148419.36,397785.4,249366.04
1958-11-05,52.03,0.47,0.91,52.03,0.0,True,1,7716,-52.03,-148471.39,401463.48,252992.09
1958-11-06,52.45,0.42,0.81,52.45,0.0,True,1,7717,-52.45,-148523.84,404756.65,256232.81
1958-11-07,52.26,-0.19,-0.36,52.45,-0.36,True,1,7718,-52.26,-148576.1,403342.68,254766.58
1958-11-10,52.57,0.31,0.59,52.57,0.0,True,1,7719,-52.57,-148628.67,405787.83,257159.16
1958-11-11,52.98,0.41,0.78,52.98,0.0,True,1,7720,-52.98,-148681.65,409005.6,260323.95
1958-11-12,53.05,0.07,0.13,53.05,0.0,True,1,7721,-53.05,-148734.7,409599.05,260864.35
1958-11-13,52.83,-0.22,-0.42,53.05,-0.42,True,1,7722,-52.83,-148787.53,407953.26,259165.73
1958-11-14,53.09,0.26,0.49,53.09,0.0,True,1,7723,-53.09,-148840.62,410014.07,261173.45
1958-11-17,53.24,0.15,0.28,53.24,0.0,True,1,7724,-53.24,-148893.86,411225.76,262331.9
1958-11-18,53.13,-0.11,-0.21,53.24,-0.21,True,1,7725,-53.13,-148946.99,410429.25,261482.26
1958-11-19,53.2,0.07,0.13,53.24,-0.08,True,1,7726,-53.2,-149000.19,411023.2,262023.01
1958-11-20,53.21,0.01,0.02,53.24,-0.06,True,1,7727,-53.21,-149053.4,411153.67,262100.27
1958-11-21,52.7,-0.51,-0.96,53.24,-1.01,True,1,7728,-52.7,-149106.1,407265.6,258159.5
1958-11-24,52.03,-0.67,-1.27,53.24,-2.27,True,1,7729,-52.03,-149158.13,402139.87,252981.74
1958-11-25,51.02,-1.01,-1.94,53.24,-4.17,True,1,7730,-51.02,-149209.15,394384.6,245175.45
1958-11-26,51.9,0.88,1.72,53.24,-2.52,True,1,7731,-51.9,-149261.05,401238.9,251977.85
1958-11-28,52.48,0.58,1.12,53.24,-1.43,True,1,7732,-52.48,-149313.53,405775.36,256461.83
1958-12-01,52.69,0.21,0.4,53.24,-1.03,True,1,7733,-52.69,-149366.22,407451.77,258085.55
1958-12-02,52.46,-0.23,-0.44,53.24,-1.46,True,1,7734,-52.46,-149418.68,405725.64,256306.96
1958-12-03,52.53,0.07,0.13,53.24,-1.33,True,1,7735,-52.53,-149471.21,406319.55,256848.34
1958-12-04,52.55,0.02,0.04,53.24,-1.3,True,1,7736,-52.55,-149523.76,406526.8,257003.04
1958-12-05,52.46,-0.09,-0.17,53.24,-1.46,True,1,7737,-52.46,-149576.22,405883.02,256306.8
1958-12-08,52.46,0.0,0.0,53.24,-1.46,True,1,7738,-52.46,-149628.68,405935.48,256306.8
1958-12-09,52.82,0.36,0.69,53.24,-0.79,True,1,7739,-52.82,-149681.5,408773.98,259092.48
1958-12-10,53.46,0.64,1.21,53.46,0.0,True,1,7740,-53.46,-149734.96,413780.4,264045.44
1958-12-11,53.35,-0.11,-0.21,53.46,-0.21,True,1,7741,-53.35,-149788.31,412982.35,263194.04
1958-12-12,53.22,-0.13,-0.24,53.46,-0.45,True,1,7742,-53.22,-149841.53,412029.24,262187.71
1958-12-15,53.37,0.15,0.28,53.46,-0.17,True,1,7743,-53.37,-149894.9,413243.91,263349.01
1958-12-16,53.57,0.2,0.38,53.57,0.0,True,1,7744,-53.57,-149948.47,414846.08,264897.61
1958-12-17,53.92,0.35,0.65,53.92,0.0,True,1,7745,-53.92,-150002.39,417610.4,267608.01
1958-12-18,54.15,0.23,0.43,54.15,0.0,True,1,7746,-54.15,-150056.54,419445.9,269389.36
1958-12-19,54.07,-0.08,-0.15,54.15,-0.15,True,1,7747,-54.07,-150110.61,418880.29,268769.68
1958-12-22,53.71,-0.36,-0.67,54.15,-0.81,True,1,7748,-53.71,-150164.32,416145.08,265980.76
1958-12-23,53.42,-0.29,-0.54,54.15,-1.35,True,1,7749,-53.42,-150217.74,413951.58,263733.84
1958-12-24,54.11,0.69,1.29,54.15,-0.07,True,1,7750,-54.11,-150271.85,419352.5,269080.65
1958-12-29,54.74,0.63,1.16,54.74,0.0,True,1,7751,-54.74,-150326.59,424289.74,273963.15
1958-12-30,54.93,0.19,0.35,54.93,0.0,True,1,7752,-54.93,-150381.52,425817.36,275435.84
1958-12-31,55.21,0.28,0.51,55.21,0.0,True,1,7753,-55.21,-150436.73,428043.13,277606.4
1959-01-02,55.44,0.23,0.42,55.44,0.0,True,1,7754,-55.44,-150492.17,429881.76,279389.59
1959-01-05,55.66,0.22,0.4,55.66,0.0,True,1,7755,-55.66,-150547.83,431643.3,281095.47
1959-01-06,55.59,-0.07,-0.13,55.66,-0.13,True,1,7756,-55.59,-150603.42,431156.04,280552.62
1959-01-07,54.89,-0.7,-1.26,55.66,-1.38,True,1,7757,-54.89,-150658.31,425781.73,275123.42
1959-01-08,55.4,0.51,0.93,55.66,-0.47,True,1,7758,-55.4,-150713.71,429793.2,279079.49
1959-01-09,55.77,0.37,0.67,55.77,0.0,True,1,7759,-55.77,-150769.48,432719.43,281949.95
1959-01-12,55.78,0.01,0.02,55.78,0.0,True,1,7760,-55.78,-150825.26,432852.8,282027.54
1959-01-13,55.47,-0.31,-0.56,55.78,-0.56,True,1,7761,-55.47,-150880.73,430502.67,279621.94
1959-01-14,55.62,0.15,0.27,55.78,-0.29,True,1,7762,-55.62,-150936.35,431722.44,280786.09
1959-01-15,55.83,0.21,0.38,55.83,0.0,True,1,7763,-55.83,-150992.18,433408.29,282416.11
1959-01-16,55.81,-0.02,-0.04,55.83,-0.04,True,1,7764,-55.81,-151047.99,433308.84,282260.85
1959-01-19,55.68,-0.13,-0.23,55.83,-0.27,True,1,7765,-55.68,-151103.67,432355.2,281251.53
1959-01-20,55.72,0.04,0.07,55.83,-0.2,True,1,7766,-55.72,-151159.39,432721.52,281562.13
1959-01-21,56.04,0.32,0.57,56.04,0.0,True,1,7767,-56.04,-151215.43,435262.68,284047.25
1959-01-22,55.97,-0.07,-0.12,56.04,-0.12,True,1,7768,-55.97,-151271.4,434774.96,283503.56
1959-01-23,56.0,0.03,0.05,56.04,-0.07,True,1,7769,-56.0,-151327.4,435064.0,283736.6
1959-01-26,55.77,-0.23,-0.41,56.04,-0.48,True,1,7770,-55.77,-151383.17,433332.9,281949.73
1959-01-27,55.78,0.01,0.02,56.04,-0.46,True,1,7771,-55.78,-151438.95,433466.38,282027.43
1959-01-28,55.16,-0.62,-1.11,56.04,-1.57,True,1,7772,-55.16,-151494.11,428703.52,277209.41
1959-01-29,55.2,0.04,0.07,56.04,-1.5,True,1,7773,-55.2,-151549.31,429069.6,277520.29
1959-01-30,55.45,0.25,0.45,56.04,-1.05,True,1,7774,-55.45,-151604.76,431068.3,279463.54
1959-02-02,55.21,-0.24,-0.43,56.04,-1.48,True,1,7775,-55.21,-151659.97,429257.75,277597.78
1959-02-03,55.28,0.07,0.13,56.04,-1.36,True,1,7776,-55.28,-151715.25,429857.28,278142.03
1959-02-04,55.06,-0.22,-0.4,56.04,-1.75,True,1,7777,-55.06,-151770.31,428201.62,276431.31
1959-02-05,54.81,-0.25,-0.45,56.04,-2.19,True,1,7778,-54.81,-151825.12,426312.18,274487.06
1959-02-06,54.37,-0.44,-0.8,56.04,-2.98,True,1,7779,-54.37,-151879.49,422944.23,271064.74
1959-02-09,53.58,-0.79,-1.45,56.04,-4.39,True,1,7780,-53.58,-151933.07,416852.4,264919.33
1959-02-10,54.32,0.74,1.38,56.04,-3.07,True,1,7781,-54.32,-151987.39,422663.92,270676.53
1959-02-11,54.35,0.03,0.06,56.04,-3.02,True,1,7782,-54.35,-152041.74,422951.7,270909.96
1959-02-12,54.0,-0.35,-0.64,56.04,-3.64,True,1,7783,-54.0,-152095.74,420282.0,268186.26
1959-02-13,54.42,0.42,0.78,56.04,-2.89,True,1,7784,-54.42,-152150.16,423605.28,271455.12
1959-02-16,54.5,0.08,0.15,56.04,-2.75,True,1,7785,-54.5,-152204.66,424282.5,272077.84
1959-02-17,54.29,-0.21,-0.38,56.04,-3.12,True,1,7786,-54.29,-152258.95,422701.94,270442.99
1959-02-18,54.3,0.01,0.02,56.04,-3.1,True,1,7787,-54.3,-152313.25,422834.1,270520.85
1959-02-19,55.5,1.2,2.21,56.04,-0.96,True,1,7788,-55.5,-152368.75,432234.0,279865.25
1959-02-20,55.52,0.02,0.04,56.04,-0.93,True,1,7789,-55.52,-152424.27,432445.28,280021.01
1959-02-24,55.48,-0.04,-0.07,56.04,-1.0,True,1,7790,-55.48,-152479.75,432189.2,279709.45
1959-02-25,55.24,-0.24,-0.43,56.04,-1.43,True,1,7791,-55.24,-152534.99,430374.84,277839.85
1959-02-26,55.34,0.1,0.18,56.04,-1.25,True,1,7792,-55.34,-152590.33,431209.28,278618.95
1959-02-27,55.41,0.07,0.13,56.04,-1.12,True,1,7793,-55.41,-152645.74,431810.13,279164.39
1959-03-02,55.73,0.32,0.58,56.04,-0.55,True,1,7794,-55.73,-152701.47,434359.62,281658.15
1959-03-03,56.25,0.52,0.93,56.25,0.0,True,1,7795,-56.25,-152757.72,438468.75,285711.03
1959-03-04,56.35,0.1,0.18,56.35,0.0,True,1,7796,-56.35,-152814.07,439304.6,286490.53
1959-03-05,56.43,0.08,0.14,56.43,0.0,True,1,7797,-56.43,-152870.5,439984.71,287114.21
1959-03-06,56.21,-0.22,-0.39,56.43,-0.39,True,1,7798,-56.21,-152926.71,438325.58,285398.87
1959-03-09,56.15,-0.06,-0.11,56.43,-0.5,True,1,7799,-56.15,-152982.86,437913.85,284930.99
1959-03-10,56.31,0.16,0.28,56.43,-0.21,True,1,7800,-56.31,-153039.17,439218.0,286178.83
1959-03-11,56.35,0.04,0.07,56.43,-0.14,True,1,7801,-56.35,-153095.52,439586.35,286490.83
1959-03-12,56.6,0.25,0.44,56.6,0.0,True,1,7802,-56.6,-153152.12,441593.2,288441.08
1959-03-13,56.67,0.07,0.12,56.67,0.0,True,1,7803,-56.67,-153208.79,442196.01,288987.22
1959-03-16,56.06,-0.61,-1.08,56.67,-1.08,True,1,7804,-56.06,-153264.85,437492.24,284227.39
1959-03-17,56.52,0.46,0.82,56.67,-0.26,True,1,7805,-56.52,-153321.37,441138.6,287817.23
1959-03-18,56.39,-0.13,-0.23,56.67,-0.49,True,1,7806,-56.39,-153377.76,440180.34,286802.58
1959-03-19,56.34,-0.05,-0.09,56.67,-0.58,True,1,7807,-56.34,-153434.1,439846.38,286412.28
1959-03-20,56.39,0.05,0.09,56.67,-0.49,True,1,7808,-56.39,-153490.49,440293.12,286802.63
1959-03-23,55.87,-0.52,-0.92,56.67,-1.41,True,1,7809,-55.87,-153546.36,436288.83,282742.47
1959-03-24,55.96,0.09,0.16,56.67,-1.25,True,1,7810,-55.96,-153602.32,437047.6,283445.28
1959-03-25,55.88,-0.08,-0.14,56.67,-1.39,True,1,7811,-55.88,-153658.2,436478.68,282820.48
1959-03-26,55.76,-0.12,-0.22,56.67,-1.61,True,1,7812,-55.76,-153713.96,435597.12,281883.16
1959-03-30,55.45,-0.31,-0.56,56.67,-2.15,True,1,7813,-55.45,-153769.41,433230.85,279461.44
1959-03-31,55.44,-0.01,-0.02,56.67,-2.17,True,1,7814,-55.44,-153824.85,433208.16,279383.31
1959-04-01,55.69,0.25,0.45,56.67,-1.73,True,1,7815,-55.69,-153880.54,435217.35,281336.81
1959-04-02,56.0,0.31,0.56,56.67,-1.18,True,1,7816,-56.0,-153936.54,437696.0,283759.46
1959-04-03,56.44,0.44,0.79,56.67,-0.41,True,1,7817,-56.44,-153992.98,441191.48,287198.5
1959-04-06,56.6,0.16,0.28,56.67,-0.12,True,1,7818,-56.6,-154049.58,442498.8,288449.22
1959-04-07,56.48,-0.12,-0.21,56.67,-0.34,True,1,7819,-56.48,-154106.06,441617.12,287511.06
1959-04-08,56.21,-0.27,-0.48,56.67,-0.81,True,1,7820,-56.21,-154162.27,439562.2,285399.93
1959-04-09,56.17,-0.04,-0.07,56.67,-0.88,True,1,7821,-56.17,-154218.44,439305.57,285087.13
1959-04-10,56.22,0.05,0.09,56.67,-0.79,True,1,7822,-56.22,-154274.66,439752.84,285478.18
1959-04-13,56.43,0.21,0.37,56.67,-0.42,True,1,7823,-56.43,-154331.09,441451.89,287120.8
1959-04-14,56.71,0.28,0.5,56.71,0.0,True,1,7824,-56.71,-154387.8,443699.04,289311.24
1959-04-15,56.96,0.25,0.44,56.96,0.0,True,1,7825,-56.96,-154444.76,445712.0,291267.24
1959-04-16,57.43,0.47,0.82,57.43,0.0,True,1,7826,-57.43,-154502.19,449447.18,294944.99
1959-04-17,57.92,0.49,0.85,57.92,0.0,True,1,7827,-57.92,-154560.11,453339.84,298779.73
1959-04-20,58.17,0.25,0.43,58.17,0.0,True,1,7828,-58.17,-154618.28,455354.76,300736.48
1959-04-21,58.11,-0.06,-0.1,58.17,-0.1,True,1,7829,-58.11,-154676.39,454943.19,300266.8
1959-04-22,57.73,-0.38,-0.65,58.17,-0.76,True,1,7830,-57.73,-154734.12,452025.9,297291.78
1959-04-23,57.6,-0.13,-0.22,58.17,-0.98,True,1,7831,-57.6,-154791.72,451065.6,296273.88
1959-04-24,57.96,0.36,0.62,58.17,-0.36,True,1,7832,-57.96,-154849.68,453942.72,299093.04
1959-04-27,58.14,0.18,0.31,58.17,-0.05,True,1,7833,-58.14,-154907.82,455410.62,300502.8
1959-04-28,57.92,-0.22,-0.38,58.17,-0.43,True,1,7834,-57.92,-154965.74,453745.28,298779.54
1959-04-29,57.69,-0.23,-0.4,58.17,-0.82,True,1,7835,-57.69,-155023.43,452001.15,296977.72
1959-04-30,57.59,-0.1,-0.17,58.17,-1.0,True,1,7836,-57.59,-155081.02,451275.24,296194.22
1959-05-01,57.65,0.06,0.1,58.17,-0.89,True,1,7837,-57.65,-155138.67,451803.05,296664.38
1959-05-04,57.65,0.0,0.0,58.17,-0.89,True,1,7838,-57.65,-155196.32,451860.7,296664.38
1959-05-05,57.75,0.1,0.17,58.17,-0.72,True,1,7839,-57.75,-155254.07,452702.25,297448.18
1959-05-06,57.61,-0.14,-0.24,58.17,-0.96,True,1,7840,-57.61,-155311.68,451662.4,296350.72
1959-05-07,56.88,-0.73,-1.27,58.17,-2.22,True,1,7841,-56.88,-155368.56,445996.08,290627.52
1959-05-08,57.32,0.44,0.77,58.17,-1.46,True,1,7842,-57.32,-155425.88,449503.44,294077.56
1959-05-11,57.96,0.64,1.12,58.17,-0.36,True,1,7843,-57.96,-155483.84,454580.28,299096.44
1959-05-12,57.96,0.0,0.0,58.17,-0.36,True,1,7844,-57.96,-155541.8,454638.24,299096.44
1959-05-13,57.97,0.01,0.02,58.17,-0.34,True,1,7845,-57.97,-155599.77,454774.65,299174.88
1959-05-14,58.37,0.4,0.69,58.37,0.0,True,1,7846,-58.37,-155658.14,457971.02,302312.88
1959-05-15,58.16,-0.21,-0.36,58.37,-0.36,True,1,7847,-58.16,-155716.3,456381.52,300665.22
1959-05-18,58.15,-0.01,-0.02,58.37,-0.38,True,1,7848,-58.15,-155774.45,456361.2,300586.75
1959-05-19,58.32,0.17,0.29,58.37,-0.09,True,1,7849,-58.32,-155832.77,457753.68,301920.91
1959-05-20,58.09,-0.23,-0.39,58.37,-0.48,True,1,7850,-58.09,-155890.86,456006.5,300115.64
1959-05-21,58.14,0.05,0.09,58.37,-0.39,True,1,7851,-58.14,-155949.0,456457.14,300508.14
1959-05-22,58.33,0.19,0.33,58.37,-0.07,True,1,7852,-58.33,-156007.33,458007.16,301999.83
1959-05-25,58.18,-0.15,-0.26,58.37,-0.33,True,1,7853,-58.18,-156065.51,456887.54,300822.03
1959-05-26,58.09,-0.09,-0.16,58.37,-0.48,True,1,7854,-58.09,-156123.6,456238.86,300115.26
1959-05-27,58.19,0.1,0.17,58.37,-0.31,True,1,7855,-58.19,-156181.79,457082.45,300900.66
1959-05-28,58.39,0.2,0.34,58.39,0.0,True,1,7856,-58.39,-156240.18,458711.84,302471.66
1959-05-29,58.68,0.29,0.5,58.68,0.0,True,1,7857,-58.68,-156298.86,461048.76,304749.9
1959-06-01,58.63,-0.05,-0.08,58.68,-0.08,True,1,7858,-58.63,-156357.49,460714.54,304357.05
1959-06-02,58.23,-0.4,-0.68,58.68,-0.77,True,1,7859,-58.23,-156415.72,457629.57,301213.85
1959-06-03,58.25,0.02,0.03,58.68,-0.73,True,1,7860,-58.25,-156473.97,457845.0,301371.03
1959-06-04,57.63,-0.62,-1.06,58.68,-1.79,True,1,7861,-57.63,-156531.6,453029.43,296497.83
1959-06-05,57.51,-0.12,-0.21,58.68,-1.99,True,1,7862,-57.51,-156589.11,452143.62,295554.51
1959-06-08,56.76,-0.75,-1.3,58.68,-3.27,True,1,7863,-56.76,-156645.87,446303.88,289658.01
1959-06-09,56.36,-0.4,-0.7,58.68,-3.95,True,1,7864,-56.36,-156702.23,443215.04,286512.81
1959-06-10,57.19,0.83,1.47,58.68,-2.54,True,1,7865,-57.19,-156759.42,449799.35,293039.93
1959-06-11,57.25,0.06,0.1,58.68,-2.44,True,1,7866,-57.25,-156816.67,450328.5,293511.83
1959-06-12,57.29,0.04,0.07,58.68,-2.37,True,1,7867,-57.29,-156873.96,450700.43,293826.47
1959-06-15,56.99,-0.3,-0.52,58.68,-2.88,True,1,7868,-56.99,-156930.95,448397.32,291466.37
1959-06-16,56.56,-0.43,-0.76,58.68,-3.61,True,1,7869,-56.56,-156987.51,445070.64,288083.13
1959-06-17,57.09,0.53,0.94,58.68,-2.71,True,1,7870,-57.09,-157044.6,449298.3,292253.7
1959-06-18,57.05,-0.04,-0.07,58.68,-2.78,True,1,7871,-57.05,-157101.65,449040.55,291938.9
1959-06-19,57.13,0.08,0.14,58.68,-2.64,True,1,7872,-57.13,-157158.78,449727.36,292568.58
1959-06-22,57.13,0.0,0.0,58.68,-2.64,True,1,7873,-57.13,-157215.91,449784.49,292568.58
1959-06-23,57.12,-0.01,-0.02,58.68,-2.66,True,1,7874,-57.12,-157273.03,449762.88,292489.85
1959-06-24,57.41,0.29,0.51,58.68,-2.16,True,1,7875,-57.41,-157330.44,452103.75,294773.31
1959-06-25,57.73,0.32,0.56,58.68,-1.62,True,1,7876,-57.73,-157388.17,454681.48,297293.31
1959-06-26,57.98,0.25,0.43,58.68,-1.19,True,1,7877,-57.98,-157446.15,456708.46,299262.31
1959-06-29,58.37,0.39,0.67,58.68,-0.53,True,1,7878,-58.37,-157504.52,459838.86,302334.34
1959-06-30,58.47,0.1,0.17,58.68,-0.36,True,1,7879,-58.47,-157562.99,460685.13,303122.14
1959-07-01,58.97,0.5,0.86,58.97,0.0,True,1,7880,-58.97,-157621.96,464683.6,307061.64
1959-07-02,59.28,0.31,0.53,59.28,0.0,True,1,7881,-59.28,-157681.24,467185.68,309504.44
1959-07-06,59.65,0.37,0.62,59.65,0.0,True,1,7882,-59.65,-157740.89,470161.3,312420.41
1959-07-07,60.01,0.36,0.6,60.01,0.0,True,1,7883,-60.01,-157800.9,473058.83,315257.93
1959-07-08,60.03,0.02,0.03,60.03,0.0,True,1,7884,-60.03,-157860.93,473276.52,315415.59
1959-07-09,59.97,-0.06,-0.1,60.03,-0.1,True,1,7885,-59.97,-157920.9,472863.45,314942.55
1959-07-10,59.91,-0.06,-0.1,60.03,-0.2,True,1,7886,-59.91,-157980.81,472450.26,314469.45
1959-07-13,59.41,-0.5,-0.84,60.03,-1.03,True,1,7887,-59.41,-158040.22,468566.67,310526.45
1959-07-14,59.55,0.14,0.24,60.03,-0.8,True,1,7888,-59.55,-158099.77,469730.4,311630.63
1959-07-15,59.59,0.04,0.07,60.03,-0.73,True,1,7889,-59.59,-158159.36,470105.51,311946.15
1959-07-16,59.41,-0.18,-0.3,60.03,-1.03,True,1,7890,-59.41,-158218.77,468744.9,310526.13
1959-07-17,59.19,-0.22,-0.37,60.03,-1.4,True,1,7891,-59.19,-158277.96,467068.29,308790.33
1959-07-20,58.91,-0.28,-0.47,60.03,-1.87,True,1,7892,-58.91,-158336.87,464917.72,306580.85
1959-07-21,59.41,0.5,0.85,60.03,-1.03,True,1,7893,-59.41,-158396.28,468923.13,310526.85
1959-07-22,59.61,0.2,0.34,60.03,-0.7,True,1,7894,-59.61,-158455.89,470561.34,312105.45
1959-07-23,59.67,0.06,0.1,60.03,-0.6,True,1,7895,-59.67,-158515.56,471094.65,312579.09
1959-07-24,59.65,-0.02,-0.03,60.03,-0.63,True,1,7896,-59.65,-158575.21,470996.4,312421.19
1959-07-27,60.02,0.37,0.62,60.03,-0.02,True,1,7897,-60.02,-158635.23,473977.94,315342.71
1959-07-28,60.32,0.3,0.5,60.32,0.0,True,1,7898,-60.32,-158695.55,476407.36,317711.81
1959-07-29,60.62,0.3,0.5,60.62,0.0,True,1,7899,-60.62,-158756.17,478837.38,320081.21
1959-07-30,60.5,-0.12,-0.2,60.62,-0.2,True,1,7900,-60.5,-158816.67,477950.0,319133.33
1959-07-31,60.51,0.01,0.02,60.62,-0.18,True,1,7901,-60.51,-158877.18,478089.51,319212.33
1959-08-03,60.71,0.2,0.33,60.71,0.0,True,1,7902,-60.71,-158937.89,479730.42,320792.53
1959-08-04,60.61,-0.1,-0.16,60.71,-0.16,True,1,7903,-60.61,-158998.5,479000.83,320002.33
1959-08-05,60.3,-0.31,-0.51,60.71,-0.68,True,1,7904,-60.3,-159058.8,476611.2,317552.4
1959-08-06,60.24,-0.06,-0.1,60.71,-0.77,True,1,7905,-60.24,-159119.04,476197.2,317078.16
1959-08-07,59.87,-0.37,-0.61,60.71,-1.38,True,1,7906,-59.87,-159178.91,473332.22,314153.31
1959-08-10,58.62,-1.25,-2.09,60.71,-3.44,True,1,7907,-58.62,-159237.53,463508.34,304270.81
1959-08-11,59.39,0.77,1.31,60.71,-2.17,True,1,7908,-59.39,-159296.92,469656.12,310359.2
1959-08-12,59.25,-0.14,-0.24,60.71,-2.4,True,1,7909,-59.25,-159356.17,468608.25,309252.08
1959-08-13,59.15,-0.1,-0.17,60.71,-2.57,True,1,7910,-59.15,-159415.32,467876.5,308461.18
1959-08-14,59.29,0.14,0.24,60.71,-2.34,True,1,7911,-59.29,-159474.61,469043.19,309568.58
1959-08-17,59.17,-0.12,-0.2,60.71,-2.54,True,1,7912,-59.17,-159533.78,468153.04,308619.26
1959-08-18,58.62,-0.55,-0.93,60.71,-3.44,True,1,7913,-58.62,-159592.4,463860.06,304267.66
1959-08-19,58.27,-0.35,-0.6,60.71,-4.02,True,1,7914,-58.27,-159650.67,461148.78,301498.11
1959-08-20,59.14,0.87,1.49,60.71,-2.59,True,1,7915,-59.14,-159709.81,468093.1,308383.29
1959-08-21,59.08,-0.06,-0.1,60.71,-2.68,True,1,7916,-59.08,-159768.89,467677.28,307908.39
1959-08-24,58.87,-0.21,-0.36,60.71,-3.03,True,1,7917,-58.87,-159827.76,466073.79,306246.03
1959-08-25,58.99,0.12,0.2,60.71,-2.83,True,1,7918,-58.99,-159886.75,467082.82,307196.07
1959-08-26,59.07,0.08,0.14,60.71,-2.7,True,1,7919,-59.07,-159945.82,467775.33,307829.51
1959-08-27,59.58,0.51,0.86,60.71,-1.86,True,1,7920,-59.58,-160005.4,471873.6,311868.2
1959-08-28,59.6,0.02,0.03,60.71,-1.83,True,1,7921,-59.6,-160065.0,472091.6,312026.6
1959-08-31,59.6,0.0,0.0,60.71,-1.83,True,1,7922,-59.6,-160124.6,472151.2,312026.6
1959-09-01,58.87,-0.73,-1.23,60.71,-3.03,True,1,7923,-58.87,-160183.47,466427.01,306243.54
1959-09-02,58.92,0.05,0.08,60.71,-2.95,True,1,7924,-58.92,-160242.39,466882.08,306639.69
1959-09-03,58.26,-0.66,-1.12,60.71,-4.04,True,1,7925,-58.26,-160300.65,461710.5,301409.85
1959-09-04,58.54,0.28,0.48,60.71,-3.57,True,1,7926,-58.54,-160359.19,463988.04,303628.85
1959-09-08,57.7,-0.84,-1.44,60.71,-4.96,True,1,7927,-57.7,-160416.89,457387.9,296971.01
1959-09-09,57.29,-0.41,-0.71,60.71,-5.63,True,1,7928,-57.29,-160474.18,454195.12,293720.94
1959-09-10,56.99,-0.3,-0.52,60.71,-6.13,True,1,7929,-56.99,-160531.17,451873.71,291342.54
1959-09-11,57.41,0.42,0.74,60.71,-5.44,True,1,7930,-57.41,-160588.58,455261.3,294672.72
1959-09-14,56.99,-0.42,-0.73,60.71,-6.13,True,1,7931,-56.99,-160645.57,451987.69,291342.12
1959-09-15,56.68,-0.31,-0.54,60.71,-6.64,True,1,7932,-56.68,-160702.25,449585.76,288883.51
1959-09-16,56.72,0.04,0.07,60.71,-6.57,True,1,7933,-56.72,-160758.97,449959.76,289200.79
1959-09-17,56.41,-0.31,-0.55,60.71,-7.08,True,1,7934,-56.41,-160815.38,447556.94,286741.56
1959-09-18,56.19,-0.22,-0.39,60.71,-7.44,True,1,7935,-56.19,-160871.57,445867.65,284996.08
1959-09-21,55.27,-0.92,-1.64,60.71,-8.96,True,1,7936,-55.27,-160926.84,438622.72,277695.88
1959-09-22,55.14,-0.13,-0.24,60.71,-9.18,True,1,7937,-55.14,-160981.98,437646.18,276664.2
1959-09-23,55.82,0.68,1.23,60.71,-8.06,True,1,7938,-55.82,-161037.8,443099.16,282061.36
1959-09-24,56.78,0.96,1.72,60.71,-6.47,True,1,7939,-56.78,-161094.58,450776.42,289681.84
1959-09-25,56.73,-0.05,-0.09,60.71,-6.56,True,1,7940,-56.73,-161151.31,450436.2,289284.89
1959-09-28,57.15,0.42,0.74,60.71,-5.86,True,1,7941,-57.15,-161208.46,453828.15,292619.69
1959-09-29,57.51,0.36,0.63,60.71,-5.27,True,1,7942,-57.51,-161265.97,456744.42,295478.45
1959-09-30,56.88,-0.63,-1.1,60.71,-6.31,True,1,7943,-56.88,-161322.85,451797.84,290474.99
1959-10-01,56.94,0.06,0.1,60.71,-6.21,True,1,7944,-56.94,-161379.79,452331.36,290951.57
1959-10-02,57.2,0.26,0.46,60.71,-5.78,True,1,7945,-57.2,-161436.99,454454.0,293017.01
1959-10-05,57.14,-0.06,-0.1,60.71,-5.88,True,1,7946,-57.14,-161494.13,454034.44,292540.31
1959-10-06,57.09,-0.05,-0.09,60.71,-5.96,True,1,7947,-57.09,-161551.22,453694.23,292143.01
1959-10-07,56.94,-0.15,-0.26,60.71,-6.21,True,1,7948,-56.94,-161608.16,452559.12,290950.96
1959-10-08,56.81,-0.13,-0.23,60.71,-6.42,True,1,7949,-56.81,-161664.97,451582.69,289917.72
1959-10-09,57.0,0.19,0.33,60.71,-6.11,True,1,7950,-57.0,-161721.97,453150.0,291428.03
1959-10-12,57.32,0.32,0.56,60.71,-5.58,True,1,7951,-57.32,-161779.29,455751.32,293972.03
1959-10-13,57.16,-0.16,-0.28,60.71,-5.85,True,1,7952,-57.16,-161836.45,454536.32,292699.87
1959-10-14,56.71,-0.45,-0.79,60.71,-6.59,True,1,7953,-56.71,-161893.16,451014.63,289121.47
1959-10-15,56.87,0.16,0.28,60.71,-6.32,True,1,7954,-56.87,-161950.03,452343.98,290393.95
1959-10-16,57.33,0.46,0.81,60.71,-5.57,True,1,7955,-57.33,-162007.36,456060.15,294052.79
1959-10-19,57.01,-0.32,-0.56,60.71,-6.1,True,1,7956,-57.01,-162064.37,453571.56,291507.19
1959-10-20,56.66,-0.35,-0.61,60.71,-6.67,True,1,7957,-56.66,-162121.03,450843.62,288722.59
1959-10-21,56.55,-0.11,-0.19,60.71,-6.85,True,1,7958,-56.55,-162177.58,450024.9,287847.32
1959-10-22,56.0,-0.55,-0.97,60.71,-7.76,True,1,7959,-56.0,-162233.58,445704.0,283470.42
1959-10-23,56.56,0.56,1.0,60.71,-6.84,True,1,7960,-56.56,-162290.14,450217.6,287927.46
1959-10-26,56.94,0.38,0.67,60.71,-6.21,True,1,7961,-56.94,-162347.08,453299.34,290952.26
1959-10-27,57.42,0.48,0.84,60.71,-5.42,True,1,7962,-57.42,-162404.5,457178.04,294773.54
1959-10-28,57.46,0.04,0.07,60.71,-5.35,True,1,7963,-57.46,-162461.96,457553.98,295092.02
1959-10-29,57.41,-0.05,-0.09,60.71,-5.44,True,1,7964,-57.41,-162519.37,457213.24,294693.87
1959-10-30,57.52,0.11,0.19,60.71,-5.25,True,1,7965,-57.52,-162576.89,458146.8,295569.91
1959-11-02,57.41,-0.11,-0.19,60.71,-5.44,True,1,7966,-57.41,-162634.3,457328.06,294693.76
1959-11-04,57.26,-0.15,-0.26,60.71,-5.68,True,1,7967,-57.26,-162691.56,456190.42,293498.86
1959-11-05,57.32,0.06,0.1,60.71,-5.58,True,1,7968,-57.32,-162748.88,456725.76,293976.88
1959-11-06,57.6,0.28,0.49,60.71,-5.12,True,1,7969,-57.6,-162806.48,459014.4,296207.92
1959-11-09,57.5,-0.1,-0.17,60.71,-5.29,True,1,7970,-57.5,-162863.98,458275.0,295411.02
1959-11-10,57.48,-0.02,-0.04,60.71,-5.32,True,1,7971,-57.48,-162921.46,458173.08,295251.62
1959-11-11,57.49,0.01,0.02,60.71,-5.3,True,1,7972,-57.49,-162978.95,458310.28,295331.33
1959-11-12,57.17,-0.32,-0.56,60.71,-5.83,True,1,7973,-57.17,-163036.12,455816.41,292780.29
1959-11-13,56.85,-0.32,-0.56,60.71,-6.36,True,1,7974,-56.85,-163092.97,453321.9,290228.93
1959-11-16,56.22,-0.63,-1.11,60.71,-7.4,True,1,7975,-56.22,-163149.19,448354.5,285205.31
1959-11-17,56.38,0.16,0.28,60.71,-7.13,True,1,7976,-56.38,-163205.57,449686.88,286481.31
1959-11-18,56.99,0.61,1.08,60.71,-6.13,True,1,7977,-56.99,-163262.56,454609.23,291346.67
1959-11-19,56.94,-0.05,-0.09,60.71,-6.21,True,1,7978,-56.94,-163319.5,454267.32,290947.82
1959-11-20,56.97,0.03,0.05,60.71,-6.16,True,1,7979,-56.97,-163376.47,454563.63,291187.16
1959-11-23,57.08,0.11,0.19,60.71,-5.98,True,1,7980,-57.08,-163433.55,455498.4,292064.85
1959-11-24,57.35,0.27,0.47,60.71,-5.54,True,1,7981,-57.35,-163490.9,457710.35,294219.45
1959-11-25,57.44,0.09,0.16,60.71,-5.39,True,1,7982,-57.44,-163548.34,458486.08,294937.74
1959-11-27,57.7,0.26,0.45,60.71,-4.96,True,1,7983,-57.7,-163606.04,460619.1,297013.06
1959-11-30,58.28,0.58,1.0,60.71,-4.0,True,1,7984,-58.28,-163664.32,465307.52,301643.2
1959-12-01,58.7,0.42,0.72,60.71,-3.31,True,1,7985,-58.7,-163723.02,468719.5,304996.48
1959-12-02,58.6,-0.1,-0.17,60.71,-3.48,True,1,7986,-58.6,-163781.62,467979.6,304197.98
1959-12-03,58.73,0.13,0.22,60.71,-3.26,True,1,7987,-58.73,-163840.35,469076.51,305236.16
1959-12-04,58.85,0.12,0.2,60.71,-3.06,True,1,7988,-58.85,-163899.2,470093.8,306194.6
1959-12-07,58.96,0.11,0.19,60.71,-2.88,True,1,7989,-58.96,-163958.16,471031.44,307073.28
1959-12-08,59.34,0.38,0.64,60.71,-2.26,True,1,7990,-59.34,-164017.5,474126.6,310109.1
1959-12-09,58.97,-0.37,-0.62,60.71,-2.87,True,1,7991,-58.97,-164076.47,471229.27,307152.8
1959-12-10,59.02,0.05,0.08,60.71,-2.78,True,1,7992,-59.02,-164135.49,471687.84,307552.35
1959-12-11,58.88,-0.14,-0.24,60.71,-3.01,True,1,7993,-58.88,-164194.37,470627.84,306433.47
1959-12-14,59.04,0.16,0.27,60.71,-2.75,True,1,7994,-59.04,-164253.41,471965.76,307712.35
1959-12-15,58.9,-0.14,-0.24,60.71,-2.98,True,1,7995,-58.9,-164312.31,470905.5,306593.19
1959-12-16,58.97,0.07,0.12,60.71,-2.87,True,1,7996,-58.97,-164371.28,471524.12,307152.84
1959-12-17,58.86,-0.11,-0.19,60.71,-3.05,True,1,7997,-58.86,-164430.14,470703.42,306273.28
1959-12-18,59.14,0.28,0.48,60.71,-2.59,True,1,7998,-59.14,-164489.28,473001.72,308512.44
1959-12-21,59.21,0.07,0.12,60.71,-2.47,True,1,7999,-59.21,-164548.49,473620.79,309072.3
1959-12-22,59.14,-0.07,-0.12,60.71,-2.59,True,1,8000,-59.14,-164607.63,473120.0,308512.37
1959-12-23,58.96,-0.18,-0.3,60.71,-2.88,True,1,8001,-58.96,-164666.59,471738.96,307072.37
1959-12-24,59.0,0.04,0.07,60.71,-2.82,True,1,8002,-59.0,-164725.59,472118.0,307392.41
1959-12-28,58.98,-0.02,-0.03,60.71,-2.85,True,1,8003,-58.98,-164784.57,472016.94,307232.37
1959-12-29,59.3,0.32,0.54,60.71,-2.32,True,1,8004,-59.3,-164843.87,474637.2,309793.33
1959-12-30,59.77,0.47,0.79,60.71,-1.55,True,1,8005,-59.77,-164903.64,478458.85,313555.21
1959-12-31,59.89,0.12,0.2,60.71,-1.35,True,1,8006,-59.89,-164963.53,479479.34,314515.81
1960-01-04,59.91,0.02,0.03,60.71,-1.32,True,1,8007,-59.91,-165023.44,479699.37,314675.93
1960-01-05,60.39,0.48,0.8,60.71,-0.53,True,1,8008,-60.39,-165083.83,483603.12,318519.29
1960-01-06,60.13,-0.26,-0.43,60.71,-0.96,True,1,8009,-60.13,-165143.96,481581.17,316437.21
1960-01-07,59.69,-0.44,-0.73,60.71,-1.68,True,1,8010,-59.69,-165203.65,478116.9,312913.25
1960-01-08,59.5,-0.19,-0.32,60.71,-1.99,True,1,8011,-59.5,-165263.15,476654.5,311391.35
1960-01-11,58.77,-0.73,-1.23,60.71,-3.2,True,1,8012,-58.77,-165321.92,470865.24,305543.32
1960-01-12,58.41,-0.36,-0.61,60.71,-3.79,True,1,8013,-58.41,-165380.33,468039.33,302659.0
1960-01-13,58.08,-0.33,-0.56,60.71,-4.33,True,1,8014,-58.08,-165438.41,465453.12,300014.71
1960-01-14,58.4,0.32,0.55,60.71,-3.8,True,1,8015,-58.4,-165496.81,468076.0,302579.19
1960-01-15,58.38,-0.02,-0.03,60.71,-3.84,True,1,8016,-58.38,-165555.19,467974.08,302418.89
1960-01-18,57.89,-0.49,-0.84,60.71,-4.64,True,1,8017,-57.89,-165613.08,464104.13,298491.05
1960-01-19,57.27,-0.62,-1.07,60.71,-5.67,True,1,8018,-57.27,-165670.35,459190.86,293520.51
1960-01-20,57.07,-0.2,-0.35,60.71,-6.0,True,1,8019,-57.07,-165727.42,457644.33,291916.91
1960-01-21,57.21,0.14,0.24,60.71,-5.76,True,1,8020,-57.21,-165784.63,458824.2,293039.57
1960-01-22,57.38,0.17,0.3,60.71,-5.48,True,1,8021,-57.38,-165842.01,460244.98,294402.97
1960-01-25,56.78,-0.6,-1.05,60.71,-6.47,True,1,8022,-56.78,-165898.79,455489.16,289590.37
1960-01-26,56.86,0.08,0.14,60.71,-6.34,True,1,8023,-56.86,-165955.65,456187.78,290232.13
1960-01-27,56.72,-0.14,-0.25,60.71,-6.57,True,1,8024,-56.72,-166012.37,455121.28,289108.91
1960-01-28,56.13,-0.59,-1.04,60.71,-7.54,True,1,8025,-56.13,-166068.5,450443.25,284374.75
1960-01-29,55.61,-0.52,-0.93,60.71,-8.4,True,1,8026,-55.61,-166124.11,446325.86,280201.75
1960-02-01,55.96,0.35,0.63,60.71,-7.82,True,1,8027,-55.96,-166180.07,449190.92,283010.85
1960-02-02,56.82,0.86,1.54,60.71,-6.41,True,1,8028,-56.82,-166236.89,456150.96,289914.07
1960-02-03,56.32,-0.5,-0.88,60.71,-7.23,True,1,8029,-56.32,-166293.21,452193.28,285900.07
1960-02-04,56.27,-0.05,-0.09,60.71,-7.31,True,1,8030,-56.27,-166349.48,451848.1,285498.62
1960-02-05,55.98,-0.29,-0.52,60.71,-7.79,True,1,8031,-55.98,-166405.46,449575.38,283169.92
1960-02-08,55.32,-0.66,-1.18,60.71,-8.88,True,1,8032,-55.32,-166460.78,444330.24,277869.46
1960-02-09,55.84,0.52,0.94,60.71,-8.02,True,1,8033,-55.84,-166516.62,448562.72,282046.1
1960-02-10,55.49,-0.35,-0.63,60.71,-8.6,True,1,8034,-55.49,-166572.11,445806.66,279234.55
1960-02-11,55.18,-0.31,-0.56,60.71,-9.11,True,1,8035,-55.18,-166627.29,443371.3,276744.01
1960-02-12,55.46,0.28,0.51,60.71,-8.65,True,1,8036,-55.46,-166682.75,445676.56,278993.81
1960-02-15,55.17,-0.29,-0.52,60.71,-9.12,True,1,8037,-55.17,-166737.92,443401.29,276663.37
1960-02-16,54.73,-0.44,-0.8,60.71,-9.85,True,1,8038,-54.73,-166792.65,439919.74,273127.09
1960-02-17,55.03,0.3,0.55,60.71,-9.36,True,1,8039,-55.03,-166847.68,442386.17,275538.49
1960-02-18,55.8,0.77,1.4,60.71,-8.09,True,1,8040,-55.8,-166903.48,448632.0,281728.52
1960-02-19,56.24,0.44,0.79,60.71,-7.36,True,1,8041,-56.24,-166959.72,452225.84,285266.12
1960-02-23,55.94,-0.3,-0.53,60.71,-7.86,True,1,8042,-55.94,-167015.66,449869.48,282853.82
1960-02-24,55.74,-0.2,-0.36,60.71,-8.19,True,1,8043,-55.74,-167071.4,448316.82,281245.42
1960-02-25,55.93,0.19,0.34,60.71,-7.87,True,1,8044,-55.93,-167127.33,449900.92,282773.59
1960-02-26,56.16,0.23,0.41,60.71,-7.5,True,1,8045,-56.16,-167183.49,451807.2,284623.71
1960-02-29,56.12,-0.04,-0.07,60.71,-7.56,True,1,8046,-56.12,-167239.61,451541.52,284301.91
1960-03-01,56.01,-0.11,-0.2,60.71,-7.74,True,1,8047,-56.01,-167295.62,450712.47,283416.85
1960-03-02,55.62,-0.39,-0.7,60.71,-8.38,True,1,8048,-55.62,-167351.24,447629.76,280278.52
1960-03-03,54.78,-0.84,-1.51,60.71,-9.77,True,1,8049,-54.78,-167406.02,440924.22,273518.2
1960-03-04,54.57,-0.21,-0.38,60.71,-10.11,True,1,8050,-54.57,-167460.59,439288.5,271827.91
1960-03-07,54.02,-0.55,-1.01,60.71,-11.02,True,1,8051,-54.02,-167514.61,434915.02,267400.41
1960-03-08,53.47,-0.55,-1.02,60.71,-11.93,True,1,8052,-53.47,-167568.08,430540.44,262972.36
1960-03-09,54.04,0.57,1.07,60.71,-10.99,True,1,8053,-54.04,-167622.12,435184.12,267562.0
1960-03-10,53.83,-0.21,-0.39,60.71,-11.33,True,1,8054,-53.83,-167675.95,433546.82,265870.87
1960-03-11,54.24,0.41,0.76,60.71,-10.66,True,1,8055,-54.24,-167730.19,436903.2,269173.01
1960-03-14,54.32,0.08,0.15,60.71,-10.52,True,1,8056,-54.32,-167784.51,437601.92,269817.41
1960-03-15,54.74,0.42,0.77,60.71,-9.83,True,1,8057,-54.74,-167839.25,441040.18,273200.93
1960-03-16,55.04,0.3,0.55,60.71,-9.34,True,1,8058,-55.04,-167894.29,443512.32,275618.03
1960-03-17,54.96,-0.08,-0.14,60.71,-9.47,True,1,8059,-54.96,-167949.25,442922.64,274973.39
1960-03-18,55.01,0.05,0.09,60.71,-9.39,True,1,8060,-55.01,-168004.26,443380.6,275376.34
1960-03-21,55.07,0.06,0.11,60.71,-9.29,True,1,8061,-55.07,-168059.33,443919.27,275859.94
1960-03-22,55.29,0.22,0.4,60.71,-8.93,True,1,8062,-55.29,-168114.62,445747.98,277633.36
1960-03-23,55.74,0.45,0.81,60.71,-8.19,True,1,8063,-55.74,-168170.36,449431.62,281261.26
1960-03-24,55.98,0.24,0.43,60.71,-7.79,True,1,8064,-55.98,-168226.34,451422.72,283196.38
1960-03-25,55.98,0.0,0.0,60.71,-7.79,True,1,8065,-55.98,-168282.32,451478.7,283196.38
1960-03-28,55.86,-0.12,-0.21,60.71,-7.99,True,1,8066,-55.86,-168338.18,450566.76,282228.58
1960-03-29,55.78,-0.08,-0.14,60.71,-8.12,True,1,8067,-55.78,-168393.96,449977.26,281583.3
1960-03-30,55.66,-0.12,-0.22,60.71,-8.32,True,1,8068,-55.66,-168449.62,449064.88,280615.26
1960-03-31,55.34,-0.32,-0.57,60.71,-8.85,True,1,8069,-55.34,-168504.96,446538.46,278033.5
1960-04-01,55.43,0.09,0.16,60.71,-8.7,True,1,8070,-55.43,-168560.39,447320.1,278759.71
1960-04-04,55.54,0.11,0.2,60.71,-8.52,True,1,8071,-55.54,-168615.93,448263.34,279647.41
1960-04-05,55.37,-0.17,-0.31,60.71,-8.8,True,1,8072,-55.37,-168671.3,446946.64,278275.34
1960-04-06,56.51,1.14,2.06,60.71,-6.92,True,1,8073,-56.51,-168727.81,456205.23,287477.42
1960-04-07,56.52,0.01,0.02,60.71,-6.9,True,1,8074,-56.52,-168784.33,456342.48,287558.15
1960-04-08,56.39,-0.13,-0.23,60.71,-7.12,True,1,8075,-56.39,-168840.72,455349.25,286508.53
1960-04-11,56.17,-0.22,-0.39,60.71,-7.48,True,1,8076,-56.17,-168896.89,453628.92,284732.03
1960-04-12,56.3,0.13,0.23,60.71,-7.26,True,1,8077,-56.3,-168953.19,454735.1,285781.91
1960-04-13,56.3,0.0,0.0,60.71,-7.26,True,1,8078,-56.3,-169009.49,454791.4,285781.91
1960-04-14,56.43,0.13,0.23,60.71,-7.05,True,1,8079,-56.43,-169065.92,455897.97,286832.05
1960-04-18,56.59,0.16,0.28,60.71,-6.79,True,1,8080,-56.59,-169122.51,457247.2,288124.69
1960-04-19,56.13,-0.46,-0.81,60.71,-7.54,True,1,8081,-56.13,-169178.64,453586.53,284407.89
1960-04-20,55.44,-0.69,-1.23,60.71,-8.68,True,1,8082,-55.44,-169234.08,448066.08,278832.0
1960-04-21,55.59,0.15,0.27,60.71,-8.43,True,1,8083,-55.59,-169289.67,449333.97,280044.3
1960-04-22,55.42,-0.17,-0.31,60.71,-8.71,True,1,8084,-55.42,-169345.09,448015.28,278670.19
1960-04-25,54.86,-0.56,-1.01,60.71,-9.64,True,1,8085,-54.86,-169399.95,443543.1,274143.15
1960-04-26,55.04,0.18,0.33,60.71,-9.34,True,1,8086,-55.04,-169454.99,445053.44,275598.45
1960-04-27,55.04,0.0,0.0,60.71,-9.34,True,1,8087,-55.04,-169510.03,445108.48,275598.45
1960-04-28,54.56,-0.48,-0.87,60.71,-10.13,True,1,8088,-54.56,-169564.59,441281.28,271716.69
1960-04-29,54.37,-0.19,-0.35,60.71,-10.44,True,1,8089,-54.37,-169618.96,439798.93,270179.97
1960-05-02,54.13,-0.24,-0.44,60.71,-10.84,True,1,8090,-54.13,-169673.09,437911.7,268238.61
1960-05-03,54.83,0.7,1.29,60.71,-9.68,True,1,8091,-54.83,-169727.92,443629.53,273901.61
1960-05-04,55.04,0.21,0.38,60.71,-9.34,True,1,8092,-55.04,-169782.96,445383.68,275600.72
1960-05-05,54.86,-0.18,-0.33,60.71,-9.64,True,1,8093,-54.86,-169837.82,443981.98,274144.16
1960-05-06,54.75,-0.11,-0.2,60.71,-9.82,True,1,8094,-54.75,-169892.57,443146.5,273253.93
1960-05-09,54.8,0.05,0.09,60.71,-9.74,True,1,8095,-54.8,-169947.37,443606.0,273658.63
1960-05-10,54.42,-0.38,-0.69,60.71,-10.36,True,1,8096,-54.42,-170001.79,440584.32,270582.53
1960-05-11,54.57,0.15,0.28,60.71,-10.11,True,1,8097,-54.57,-170056.36,441853.29,271796.93
1960-05-12,54.85,0.28,0.51,60.71,-9.65,True,1,8098,-54.85,-170111.21,444175.3,274064.09
1960-05-13,55.3,0.45,0.82,60.71,-8.91,True,1,8099,-55.3,-170166.51,447874.7,277708.19
1960-05-16,55.25,-0.05,-0.09,60.71,-8.99,True,1,8100,-55.25,-170221.76,447525.0,277303.24
1960-05-17,55.46,0.21,0.38,60.71,-8.65,True,1,8101,-55.46,-170277.22,449281.46,279004.24
1960-05-18,55.44,-0.02,-0.04,60.71,-8.68,True,1,8102,-55.44,-170332.66,449174.88,278842.22
1960-05-19,55.68,0.24,0.43,60.71,-8.28,True,1,8103,-55.68,-170388.34,451175.04,280786.7
1960-05-20,55.73,0.05,0.09,60.71,-8.2,True,1,8104,-55.73,-170444.07,451635.92,281191.85
1960-05-23,55.76,0.03,0.05,60.71,-8.15,True,1,8105,-55.76,-170499.83,451934.8,281434.97
1960-05-24,55.7,-0.06,-0.11,60.71,-8.25,True,1,8106,-55.7,-170555.53,451504.2,280948.67
1960-05-25,55.67,-0.03,-0.05,60.71,-8.3,True,1,8107,-55.67,-170611.2,451316.69,280705.49
1960-05-26,55.71,0.04,0.07,60.71,-8.24,True,1,8108,-55.71,-170666.91,451696.68,281029.77
1960-05-27,55.74,0.03,0.05,60.71,-8.19,True,1,8109,-55.74,-170722.65,451995.66,281273.01
1960-05-31,55.83,0.09,0.16,60.71,-8.04,True,1,8110,-55.83,-170778.48,452781.3,282002.82
1960-06-01,55.89,0.06,0.11,60.71,-7.94,True,1,8111,-55.89,-170834.37,453323.79,282489.42
1960-06-02,56.13,0.24,0.43,60.71,-7.54,True,1,8112,-56.13,-170890.5,455326.56,284436.06
1960-06-03,56.23,0.1,0.18,60.71,-7.38,True,1,8113,-56.23,-170946.73,456193.99,285247.26
1960-06-06,56.89,0.66,1.17,60.71,-6.29,True,1,8114,-56.89,-171003.62,461605.46,290601.84
1960-06-07,57.43,0.54,0.95,60.71,-5.4,True,1,8115,-57.43,-171061.05,466044.45,294983.4
1960-06-08,57.89,0.46,0.8,60.71,-4.64,True,1,8116,-57.89,-171118.94,469835.24,298716.3
1960-06-09,58.0,0.11,0.19,60.71,-4.46,True,1,8117,-58.0,-171176.94,470786.0,299609.06
1960-06-10,57.97,-0.03,-0.05,60.71,-4.51,True,1,8118,-57.97,-171234.91,470600.46,299365.55
1960-06-13,57.99,0.02,0.04,60.71,-4.48,True,1,8119,-57.99,-171292.9,470820.81,299527.91
1960-06-14,57.91,-0.08,-0.14,60.71,-4.61,True,1,8120,-57.91,-171350.81,470229.2,298878.39
1960-06-15,57.57,-0.34,-0.59,60.71,-5.17,True,1,8121,-57.57,-171408.38,467525.97,296117.59
1960-06-16,57.5,-0.07,-0.12,60.71,-5.29,True,1,8122,-57.5,-171465.88,467015.0,295549.12
1960-06-17,57.44,-0.06,-0.1,60.71,-5.39,True,1,8123,-57.44,-171523.32,466585.12,295061.8
1960-06-20,57.16,-0.28,-0.49,60.71,-5.85,True,1,8124,-57.16,-171580.48,464367.84,292787.36
1960-06-21,57.11,-0.05,-0.09,60.71,-5.93,True,1,8125,-57.11,-171637.59,464018.75,292381.16
1960-06-22,57.28,0.17,0.3,60.71,-5.65,True,1,8126,-57.28,-171694.87,465457.28,293762.41
1960-06-23,57.59,0.31,0.54,60.71,-5.14,True,1,8127,-57.59,-171752.46,468033.93,296281.47
1960-06-24,57.68,0.09,0.16,60.71,-4.99,True,1,8128,-57.68,-171810.14,468823.04,297012.9
1960-06-27,57.33,-0.35,-0.61,60.71,-5.57,True,1,8129,-57.33,-171867.47,466035.57,294168.1
1960-06-28,56.94,-0.39,-0.68,60.71,-6.21,True,1,8130,-56.94,-171924.41,462922.2,290997.79
1960-06-29,56.94,0.0,0.0,60.71,-6.21,True,1,8131,-56.94,-171981.35,462979.14,290997.79
1960-06-30,56.92,-0.02,-0.04,60.71,-6.24,True,1,8132,-56.92,-172038.27,462873.44,290835.17
1960-07-01,57.06,0.14,0.25,60.71,-6.01,True,1,8133,-57.06,-172095.33,464068.98,291973.65
1960-07-05,57.02,-0.04,-0.07,60.71,-6.08,True,1,8134,-57.02,-172152.35,463800.68,291648.33
1960-07-06,56.94,-0.08,-0.14,60.71,-6.21,True,1,8135,-56.94,-172209.29,463206.9,290997.61
1960-07-07,57.24,0.3,0.53,60.71,-5.72,True,1,8136,-57.24,-172266.53,465704.64,293438.11
1960-07-08,57.38,0.14,0.24,60.71,-5.48,True,1,8137,-57.38,-172323.91,466901.06,294577.15
1960-07-11,56.87,-0.51,-0.89,60.71,-6.32,True,1,8138,-56.87,-172380.78,462808.06,290427.28
1960-07-12,56.25,-0.62,-1.09,60.71,-7.35,True,1,8139,-56.25,-172437.03,457818.75,285381.72
1960-07-13,56.1,-0.15,-0.27,60.71,-7.59,True,1,8140,-56.1,-172493.13,456654.0,284160.87
1960-07-14,56.12,0.02,0.04,60.71,-7.56,True,1,8141,-56.12,-172549.25,456872.92,284323.67
1960-07-15,56.05,-0.07,-0.12,60.71,-7.68,True,1,8142,-56.05,-172605.3,456359.1,283753.8
1960-07-18,55.7,-0.35,-0.62,60.71,-8.25,True,1,8143,-55.7,-172661.0,453565.1,280904.1
1960-07-19,55.7,0.0,0.0,60.71,-8.25,True,1,8144,-55.7,-172716.7,453620.8,280904.1
1960-07-20,55.61,-0.09,-0.16,60.71,-8.4,True,1,8145,-55.61,-172772.31,452943.45,280171.14
1960-07-21,55.1,-0.51,-0.92,60.71,-9.24,True,1,8146,-55.1,-172827.41,448844.6,276017.19
1960-07-22,54.72,-0.38,-0.69,60.71,-9.87,True,1,8147,-54.72,-172882.13,445803.84,272921.71
1960-07-25,54.18,-0.54,-0.99,60.71,-10.76,True,1,8148,-54.18,-172936.31,441458.64,268522.33
1960-07-26,54.51,0.33,0.61,60.71,-10.21,True,1,8149,-54.51,-172990.82,444201.99,271211.17
1960-07-27,54.17,-0.34,-0.62,60.71,-10.77,True,1,8150,-54.17,-173044.99,441485.5,268440.51
1960-07-28,54.57,0.4,0.74,60.71,-10.11,True,1,8151,-54.57,-173099.56,444800.07,271700.51
1960-07-29,55.51,0.94,1.72,60.71,-8.56,True,1,8152,-55.51,-173155.07,452517.52,279362.45
1960-08-01,55.53,0.02,0.04,60.71,-8.53,True,1,8153,-55.53,-173210.6,452736.09,279525.49
1960-08-02,55.04,-0.49,-0.88,60.71,-9.34,True,1,8154,-55.04,-173265.64,448796.16,275530.52
1960-08-03,54.72,-0.32,-0.58,60.71,-9.87,True,1,8155,-54.72,-173320.36,446241.6,272921.24
1960-08-04,54.89,0.17,0.31,60.71,-9.59,True,1,8156,-54.89,-173375.25,447682.84,274307.59
1960-08-05,55.44,0.55,1.0,60.71,-8.68,True,1,8157,-55.44,-173430.69,452224.08,278793.39
1960-08-08,55.52,0.08,0.14,60.71,-8.55,True,1,8158,-55.52,-173486.21,452932.16,279445.95
1960-08-09,55.84,0.32,0.58,60.71,-8.02,True,1,8159,-55.84,-173542.05,455598.56,282056.51
1960-08-10,56.07,0.23,0.41,60.71,-7.64,True,1,8160,-56.07,-173598.12,457531.2,283933.08
1960-08-11,56.28,0.21,0.38,60.71,-7.3,True,1,8161,-56.28,-173654.4,459301.08,285646.68
1960-08-12,56.66,0.38,0.68,60.71,-6.67,True,1,8162,-56.66,-173711.06,462458.92,288747.86
1960-08-15,56.61,-0.05,-0.09,60.71,-6.75,True,1,8163,-56.61,-173767.67,462107.43,288339.76
1960-08-16,56.72,0.11,0.19,60.71,-6.57,True,1,8164,-56.72,-173824.39,463062.08,289237.69
1960-08-17,56.84,0.12,0.21,60.71,-6.38,True,1,8165,-56.84,-173881.23,464098.6,290217.37
1960-08-18,56.81,-0.03,-0.05,60.71,-6.42,True,1,8166,-56.81,-173938.04,463910.46,289972.42
1960-08-19,57.01,0.2,0.35,60.71,-6.1,True,1,8167,-57.01,-173995.05,465600.67,291605.62
1960-08-22,57.19,0.18,0.32,60.71,-5.8,True,1,8168,-57.19,-174052.24,467127.92,293075.68
1960-08-23,57.75,0.56,0.98,60.71,-4.88,True,1,8169,-57.75,-174109.99,471759.75,297649.76
1960-08-24,58.07,0.32,0.55,60.71,-4.35,True,1,8170,-58.07,-174168.06,474431.9,300263.84
1960-08-25,57.79,-0.28,-0.48,60.71,-4.81,True,1,8171,-57.79,-174225.85,472202.09,297976.24
1960-08-26,57.6,-0.19,-0.33,60.71,-5.12,True,1,8172,-57.6,-174283.45,470707.2,296423.75
1960-08-29,57.44,-0.16,-0.28,60.71,-5.39,True,1,8173,-57.44,-174340.89,469457.12,295116.23
1960-08-30,56.84,-0.6,-1.04,60.71,-6.38,True,1,8174,-56.84,-174397.73,464610.16,290212.43
1960-08-31,56.96,0.12,0.21,60.71,-6.18,True,1,8175,-56.96,-174454.69,465648.0,291193.31
1960-09-01,57.09,0.13,0.23,60.71,-5.96,True,1,8176,-57.09,-174511.78,466767.84,292256.06
1960-09-02,57.0,-0.09,-0.16,60.71,-6.11,True,1,8177,-57.0,-174568.78,466089.0,291520.22
1960-09-06,56.49,-0.51,-0.9,60.71,-6.95,True,1,8178,-56.49,-174625.27,461975.22,287349.95
1960-09-07,55.79,-0.7,-1.24,60.71,-8.1,True,1,8179,-55.79,-174681.06,456306.41,281625.35
1960-09-08,55.74,-0.05,-0.09,60.71,-8.19,True,1,8180,-55.74,-174736.8,455953.2,281216.4
1960-09-09,56.11,0.37,0.66,60.71,-7.58,True,1,8181,-56.11,-174792.91,459035.91,284243.0
1960-09-12,55.72,-0.39,-0.7,60.71,-8.22,True,1,8182,-55.72,-174848.63,455901.04,281052.41
1960-09-13,55.83,0.11,0.2,60.71,-8.04,True,1,8183,-55.83,-174904.46,456856.89,281952.43
1960-09-14,55.44,-0.39,-0.7,60.71,-8.68,True,1,8184,-55.44,-174959.9,453720.96,278761.06
1960-09-15,55.22,-0.22,-0.4,60.71,-9.04,True,1,8185,-55.22,-175015.12,451975.7,276960.58
1960-09-16,55.11,-0.11,-0.2,60.71,-9.22,True,1,8186,-55.11,-175070.23,451130.46,276060.23
1960-09-19,53.86,-1.25,-2.27,60.71,-11.28,True,1,8187,-53.86,-175124.09,440951.82,265827.73
1960-09-20,54.01,0.15,0.28,60.71,-11.04,True,1,8188,-54.01,-175178.1,442233.88,267055.78
1960-09-21,54.57,0.56,1.04,60.71,-10.11,True,1,8189,-54.57,-175232.67,446873.73,271641.06
1960-09-22,54.36,-0.21,-0.38,60.71,-10.46,True,1,8190,-54.36,-175287.03,445208.4,269921.37
1960-09-23,53.9,-0.46,-0.85,60.71,-11.22,True,1,8191,-53.9,-175340.93,441494.9,266153.97
1960-09-26,53.06,-0.84,-1.56,60.71,-12.6,True,1,8192,-53.06,-175393.99,434667.52,259273.53
1960-09-27,52.94,-0.12,-0.23,60.71,-12.8,True,1,8193,-52.94,-175446.93,433737.42,258290.49
1960-09-28,52.48,-0.46,-0.87,60.71,-13.56,True,1,8194,-52.48,-175499.41,430021.12,254521.71
1960-09-29,52.62,0.14,0.27,60.71,-13.33,True,1,8195,-52.62,-175552.03,431220.9,255668.87
1960-09-30,53.52,0.9,1.71,60.71,-11.84,True,1,8196,-53.52,-175605.55,438649.92,263044.37
1960-10-03,53.36,-0.16,-0.3,60.71,-12.11,True,1,8197,-53.36,-175658.91,437391.92,261733.01
1960-10-04,52.99,-0.37,-0.69,60.71,-12.72,True,1,8198,-52.99,-175711.9,434412.02,258700.12
1960-10-05,53.39,0.4,0.76,60.71,-12.06,True,1,8199,-53.39,-175765.29,437744.61,261979.32
1960-10-06,53.72,0.33,0.62,60.71,-11.51,True,1,8200,-53.72,-175819.01,440504.0,264684.99
1960-10-07,54.03,0.31,0.58,60.71,-11.0,True,1,8201,-54.03,-175873.04,443100.03,267226.99
1960-10-10,54.14,0.11,0.2,60.71,-10.82,True,1,8202,-54.14,-175927.18,444056.28,268129.1
1960-10-11,54.22,0.08,0.15,60.71,-10.69,True,1,8203,-54.22,-175981.4,444766.66,268785.26
1960-10-12,54.15,-0.07,-0.13,60.71,-10.8,True,1,8204,-54.15,-176035.55,444246.6,268211.05
1960-10-13,54.57,0.42,0.78,60.71,-10.11,True,1,8205,-54.57,-176090.12,447746.85,271656.73
1960-10-14,54.86,0.29,0.53,60.71,-9.64,True,1,8206,-54.86,-176144.98,450181.16,274036.18
1960-10-17,54.63,-0.23,-0.42,60.71,-10.02,True,1,8207,-54.63,-176199.61,448348.41,272148.8
1960-10-18,54.35,-0.28,-0.51,60.71,-10.48,True,1,8208,-54.35,-176253.96,446104.8,269850.84
1960-10-19,54.25,-0.1,-0.18,60.71,-10.64,True,1,8209,-54.25,-176308.21,445338.25,269030.04
1960-10-20,53.86,-0.39,-0.72,60.71,-11.28,True,1,8210,-53.86,-176362.07,442190.6,265828.53
1960-10-21,53.72,-0.14,-0.26,60.71,-11.51,True,1,8211,-53.72,-176415.79,441094.92,264679.13
1960-10-24,52.7,-1.02,-1.9,60.71,-13.19,True,1,8212,-52.7,-176468.49,432772.4,256303.91
1960-10-25,52.2,-0.5,-0.95,60.71,-14.02,True,1,8213,-52.2,-176520.69,428718.6,252197.91
1960-10-26,53.05,0.85,1.63,60.71,-12.62,True,1,8214,-53.05,-176573.74,435752.7,259178.96
1960-10-27,53.62,0.57,1.07,60.71,-11.68,True,1,8215,-53.62,-176627.36,440488.3,263860.94
1960-10-28,53.41,-0.21,-0.39,60.71,-12.02,True,1,8216,-53.41,-176680.77,438816.56,262135.79
1960-10-31,53.39,-0.02,-0.04,60.71,-12.06,True,1,8217,-53.39,-176734.16,438705.63,261971.47
1960-11-01,53.94,0.55,1.03,60.71,-11.15,True,1,8218,-53.94,-176788.1,443278.92,266490.82
1960-11-02,54.22,0.28,0.52,60.71,-10.69,True,1,8219,-54.22,-176842.32,445634.18,268791.86
1960-11-03,54.43,0.21,0.39,60.71,-10.34,True,1,8220,-54.43,-176896.75,447414.6,270517.85
1960-11-04,54.9,0.47,0.86,60.71,-9.57,True,1,8221,-54.9,-176951.65,451332.9,274381.25
1960-11-07,55.11,0.21,0.38,60.71,-9.22,True,1,8222,-55.11,-177006.76,453114.42,276107.66
1960-11-09,55.35,0.24,0.44,60.71,-8.83,True,1,8223,-55.35,-177062.11,455143.05,278080.94
1960-11-10,56.43,1.08,1.95,60.71,-7.05,True,1,8224,-56.43,-177118.54,464080.32,286961.78
1960-11-11,55.87,-0.56,-0.99,60.71,-7.97,True,1,8225,-55.87,-177174.41,459530.75,282356.34
1960-11-14,55.59,-0.28,-0.5,60.71,-8.43,True,1,8226,-55.59,-177230.0,457283.34,280053.34
1960-11-15,55.81,0.22,0.4,60.71,-8.07,True,1,8227,-55.81,-177285.81,459148.87,281863.06
1960-11-16,55.7,-0.11,-0.2,60.71,-8.25,True,1,8228,-55.7,-177341.51,458299.6,280958.09
1960-11-17,55.55,-0.15,-0.27,60.71,-8.5,True,1,8229,-55.55,-177397.06,457120.95,279723.89
1960-11-18,55.82,0.27,0.49,60.71,-8.06,True,1,8230,-55.82,-177452.88,459398.6,281945.72
1960-11-21,55.93,0.11,0.2,60.71,-7.87,True,1,8231,-55.93,-177508.81,460359.83,282851.02
1960-11-22,55.72,-0.21,-0.38,60.71,-8.22,True,1,8232,-55.72,-177564.53,458687.04,281122.51
1960-11-23,55.8,0.08,0.14,60.71,-8.09,True,1,8233,-55.8,-177620.33,459401.4,281781.07
1960-11-25,56.13,0.33,0.59,60.71,-7.54,True,1,8234,-56.13,-177676.46,462174.42,284497.96
1960-11-28,56.03,-0.1,-0.18,60.71,-7.71,True,1,8235,-56.03,-177732.49,461407.05,283674.56
1960-11-29,55.83,-0.2,-0.36,60.71,-8.04,True,1,8236,-55.83,-177788.32,459815.88,282027.56
1960-11-30,55.54,-0.29,-0.52,60.71,-8.52,True,1,8237,-55.54,-177843.86,457482.98,279639.12
1960-12-01,55.3,-0.24,-0.43,60.71,-8.91,True,1,8238,-55.3,-177899.16,455561.4,277662.24
1960-12-02,55.39,0.09,0.16,60.71,-8.76,True,1,8239,-55.39,-177954.55,456358.21,278403.66
1960-12-05,55.31,-0.08,-0.14,60.71,-8.9,True,1,8240,-55.31,-178009.86,455754.4,277744.54
1960-12-06,55.47,0.16,0.29,60.71,-8.63,True,1,8241,-55.47,-178065.33,457128.27,279062.94
1960-12-07,56.02,0.55,0.99,60.71,-7.72,True,1,8242,-56.02,-178121.35,461716.84,283595.49
1960-12-08,56.15,0.13,0.23,60.71,-7.51,True,1,8243,-56.15,-178177.5,462844.45,284666.95
1960-12-09,56.65,0.5,0.89,60.71,-6.69,True,1,8244,-56.65,-178234.15,467022.6,288788.45
1960-12-12,56.85,0.2,0.35,60.71,-6.36,True,1,8245,-56.85,-178291.0,468728.25,290437.25
1960-12-13,56.88,0.03,0.05,60.71,-6.31,True,1,8246,-56.88,-178347.88,469032.48,290684.6
1960-12-14,56.84,-0.04,-0.07,60.71,-6.38,True,1,8247,-56.84,-178404.72,468759.48,290354.76
1960-12-15,56.68,-0.16,-0.28,60.71,-6.64,True,1,8248,-56.68,-178461.4,467496.64,289035.24
1960-12-16,57.2,0.52,0.92,60.71,-5.78,True,1,8249,-57.2,-178518.6,471842.8,293324.2
1960-12-19,57.13,-0.07,-0.12,60.71,-5.9,True,1,8250,-57.13,-178575.73,471322.5,292746.77
1960-12-20,57.09,-0.04,-0.07,60.71,-5.96,True,1,8251,-57.09,-178632.82,471049.59,292416.77
1960-12-21,57.55,0.46,0.81,60.71,-5.2,True,1,8252,-57.55,-178690.37,474902.6,296212.23
1960-12-22,57.39,-0.16,-0.28,60.71,-5.47,True,1,8253,-57.39,-178747.76,473639.67,294891.91
1960-12-23,57.44,0.05,0.09,60.71,-5.39,True,1,8254,-57.44,-178805.2,474109.76,295304.56
1960-12-27,57.52,0.08,0.14,60.71,-5.25,True,1,8255,-57.52,-178862.72,474827.6,295964.88
1960-12-28,57.78,0.26,0.45,60.71,-4.83,True,1,8256,-57.78,-178920.5,477031.68,298111.18
1960-12-29,58.05,0.27,0.47,60.71,-4.38,True,1,8257,-58.05,-178978.55,479318.85,300340.3
1960-12-30,58.11,0.06,0.1,60.71,-4.28,True,1,8258,-58.11,-179036.66,479872.38,300835.72
1961-01-03,57.57,-0.54,-0.93,60.71,-5.17,True,1,8259,-57.57,-179094.23,475470.63,296376.4
1961-01-04,58.36,0.79,1.37,60.71,-3.87,True,1,8260,-58.36,-179152.59,482053.6,302901.01
1961-01-05,58.57,0.21,0.36,60.71,-3.52,True,1,8261,-58.57,-179211.16,483846.77,304635.61
1961-01-06,58.4,-0.17,-0.29,60.71,-3.8,True,1,8262,-58.4,-179269.56,482500.8,303231.24
1961-01-09,58.81,0.41,0.7,60.71,-3.13,True,1,8263,-58.81,-179328.37,485947.03,306618.66
1961-01-10,58.97,0.16,0.27,60.71,-2.87,True,1,8264,-58.97,-179387.34,487328.08,307940.74
1961-01-11,59.14,0.17,0.29,60.71,-2.59,True,1,8265,-59.14,-179446.48,488792.1,309345.62
1961-01-12,59.32,0.18,0.3,60.71,-2.29,True,1,8266,-59.32,-179505.8,490339.12,310833.32
1961-01-13,59.6,0.28,0.47,60.71,-1.83,True,1,8267,-59.6,-179565.4,492713.2,313147.8
1961-01-16,59.58,-0.02,-0.03,60.71,-1.86,True,1,8268,-59.58,-179624.98,492607.44,312982.46
1961-01-17,59.64,0.06,0.1,60.71,-1.76,True,1,8269,-59.64,-179684.62,493163.16,313478.54
1961-01-18,59.68,0.04,0.07,60.71,-1.7,True,1,8270,-59.68,-179744.3,493553.6,313809.3
1961-01-19,59.77,0.09,0.15,60.71,-1.55,True,1,8271,-59.77,-179804.07,494357.67,314553.6
1961-01-20,59.96,0.19,0.32,60.71,-1.24,True,1,8272,-59.96,-179864.03,495989.12,316125.09
1961-01-23,60.29,0.33,0.55,60.71,-0.69,True,1,8273,-60.29,-179924.32,498779.17,318854.85
1961-01-24,60.45,0.16,0.26,60.71,-0.43,True,1,8274,-60.45,-179984.77,500163.3,320178.53
1961-01-25,60.53,0.08,0.13,60.71,-0.3,True,1,8275,-60.53,-180045.3,500885.75,320840.45
1961-01-26,60.62,0.09,0.15,60.71,-0.15,True,1,8276,-60.62,-180105.92,501691.12,321585.2
1961-01-27,61.24,0.62,1.02,61.24,0.0,True,1,8277,-61.24,-180167.16,506883.48,326716.32
1961-01-30,61.97,0.73,1.19,61.97,0.0,True,1,8278,-61.97,-180229.13,512987.66,332758.53
1961-01-31,61.78,-0.19,-0.31,61.97,-0.31,True,1,8279,-61.78,-180290.91,511476.62,331185.71
1961-02-01,61.9,0.12,0.19,61.97,-0.11,True,1,8280,-61.9,-180352.81,512532.0,332179.19
1961-02-02,62.3,0.4,0.65,62.3,0.0,True,1,8281,-62.3,-180415.11,515906.3,335491.19
1961-02-03,62.22,-0.08,-0.13,62.3,-0.13,True,1,8282,-62.22,-180477.33,515306.04,334828.71
1961-02-06,61.76,-0.46,-0.74,62.3,-0.87,True,1,8283,-61.76,-180539.09,511558.08,331018.99
1961-02-07,61.65,-0.11,-0.18,62.3,-1.04,True,1,8284,-61.65,-180600.74,510708.6,330107.86
1961-02-08,62.21,0.56,0.91,62.3,-0.14,True,1,8285,-62.21,-180662.95,515409.85,334746.9
1961-02-09,62.02,-0.19,-0.3,62.3,-0.45,True,1,8286,-62.02,-180724.97,513897.72,333172.75
1961-02-10,61.5,-0.52,-0.84,62.3,-1.28,True,1,8287,-61.5,-180786.47,509650.5,328864.03
1961-02-13,61.14,-0.36,-0.58,62.3,-1.86,True,1,8288,-61.14,-180847.61,506728.32,325880.71
1961-02-14,61.41,0.27,0.44,62.3,-1.43,True,1,8289,-61.41,-180909.02,509027.49,328118.47
1961-02-15,61.92,0.51,0.83,62.3,-0.61,True,1,8290,-61.92,-180970.94,513316.8,332345.86
1961-02-16,62.3,0.38,0.61,62.3,0.0,True,1,8291,-62.3,-181033.24,516529.3,335496.06
1961-02-17,62.1,-0.2,-0.32,62.3,-0.32,True,1,8292,-62.1,-181095.34,514933.2,333837.86
1961-02-20,62.32,0.22,0.35,62.32,0.0,True,1,8293,-62.32,-181157.66,516819.76,335662.1
1961-02-21,62.36,0.04,0.06,62.36,0.0,True,1,8294,-62.36,-181220.02,517213.84,335993.82
1961-02-23,62.59,0.23,0.37,62.59,0.0,True,1,8295,-62.59,-181282.61,519184.05,337901.44
1961-02-24,62.84,0.25,0.4,62.84,0.0,True,1,8296,-62.84,-181345.45,521320.64,339975.19
1961-02-27,63.3,0.46,0.73,63.3,0.0,True,1,8297,-63.3,-181408.75,525200.1,343791.35
1961-02-28,63.44,0.14,0.22,63.44,0.0,True,1,8298,-63.44,-181472.19,526425.12,344952.93
1961-03-01,63.43,-0.01,-0.02,63.44,-0.02,True,1,8299,-63.43,-181535.62,526405.57,344869.95
1961-03-02,63.85,0.42,0.66,63.85,0.0,True,1,8300,-63.85,-181599.47,529955.0,348355.53
1961-03-03,63.95,0.1,0.16,63.95,0.0,True,1,8301,-63.95,-181663.42,530848.95,349185.53
1961-03-06,64.05,0.1,0.16,64.05,0.0,True,1,8302,-64.05,-181727.47,531743.1,350015.63
1961-03-07,63.47,-0.58,-0.91,64.05,-0.91,True,1,8303,-63.47,-181790.94,526991.41,345200.47
1961-03-08,63.44,-0.03,-0.05,64.05,-0.95,True,1,8304,-63.44,-181854.38,526805.76,344951.38
1961-03-09,63.5,0.06,0.1,64.05,-0.86,True,1,8305,-63.5,-181917.88,527367.5,345449.62
1961-03-10,63.48,-0.02,-0.03,64.05,-0.89,True,1,8306,-63.48,-181981.36,527264.88,345283.52
1961-03-13,63.66,0.18,0.28,64.05,-0.61,True,1,8307,-63.66,-182045.02,528823.62,346778.6
1961-03-14,63.38,-0.28,-0.44,64.05,-1.05,True,1,8308,-63.38,-182108.4,526561.04,344452.64
1961-03-15,63.57,0.19,0.3,64.05,-0.75,True,1,8309,-63.57,-182171.97,528203.13,346031.16
1961-03-16,64.21,0.64,1.01,64.21,0.0,True,1,8310,-64.21,-182236.18,533585.1,351348.92
1961-03-17,64.0,-0.21,-0.33,64.21,-0.33,True,1,8311,-64.0,-182300.18,531904.0,349603.82
1961-03-20,64.86,0.86,1.34,64.86,0.0,True,1,8312,-64.86,-182365.04,539116.32,356751.28
1961-03-21,64.74,-0.12,-0.18,64.86,-0.18,True,1,8313,-64.74,-182429.78,538183.62,355753.84
1961-03-22,64.7,-0.04,-0.06,64.86,-0.25,True,1,8314,-64.7,-182494.48,537915.8,355421.32
1961-03-23,64.53,-0.17,-0.26,64.86,-0.51,True,1,8315,-64.53,-182559.01,536566.95,354007.94
1961-03-24,64.42,-0.11,-0.17,64.86,-0.68,True,1,8316,-64.42,-182623.43,535716.72,353093.29
1961-03-27,64.35,-0.07,-0.11,64.86,-0.79,True,1,8317,-64.35,-182687.78,535198.95,352511.17
1961-03-28,64.38,0.03,0.05,64.86,-0.74,True,1,8318,-64.38,-182752.16,535512.84,352760.68
1961-03-29,64.93,0.55,0.85,64.93,0.0,True,1,8319,-64.93,-182817.09,540152.67,357335.58
1961-03-30,65.06,0.13,0.2,65.06,0.0,True,1,8320,-65.06,-182882.15,541299.2,358417.05
1961-04-03,65.6,0.54,0.83,65.6,0.0,True,1,8321,-65.6,-182947.75,545857.6,362909.85
1961-04-04,65.66,0.06,0.09,65.66,0.0,True,1,8322,-65.66,-183013.41,546422.52,363409.11
1961-04-05,65.46,-0.2,-0.3,65.66,-0.3,True,1,8323,-65.46,-183078.87,544823.58,361744.71
1961-04-06,65.61,0.15,0.23,65.66,-0.08,True,1,8324,-65.61,-183144.48,546137.64,362993.16
1961-04-07,65.96,0.35,0.53,65.96,0.0,True,1,8325,-65.96,-183210.44,549117.0,365906.56
1961-04-10,66.53,0.57,0.86,66.53,0.0,True,1,8326,-66.53,-183276.97,553928.78,370651.81
1961-04-11,66.62,0.09,0.14,66.62,0.0,True,1,8327,-66.62,-183343.59,554744.74,371401.15
1961-04-12,66.31,-0.31,-0.46,66.62,-0.46,True,1,8328,-66.31,-183409.9,552229.68,368819.78
1961-04-13,66.26,-0.05,-0.08,66.62,-0.54,True,1,8329,-66.26,-183476.16,551879.54,368403.38
1961-04-14,66.37,0.11,0.17,66.62,-0.38,True,1,8330,-66.37,-183542.53,552862.1,369319.57
1961-04-17,68.68,2.31,3.48,68.68,0.0,True,1,8331,-68.68,-183611.21,572173.08,388561.87
1961-04-18,66.2,-2.48,-3.61,68.68,-3.61,True,1,8332,-66.2,-183677.41,551578.4,367900.99
1961-04-19,65.81,-0.39,-0.59,68.68,-4.18,True,1,8333,-65.81,-183743.22,548394.73,364651.51
1961-04-20,65.82,0.01,0.02,68.68,-4.16,True,1,8334,-65.82,-183809.04,548543.88,364734.84
1961-04-21,65.77,-0.05,-0.08,68.68,-4.24,True,1,8335,-65.77,-183874.81,548192.95,364318.14
1961-04-24,64.4,-1.37,-2.08,68.68,-6.23,True,1,8336,-64.4,-183939.21,536838.4,352899.19
1961-04-25,65.3,0.9,1.4,68.68,-4.92,True,1,8337,-65.3,-184004.51,544406.1,360401.59
1961-04-26,65.55,0.25,0.38,68.68,-4.56,True,1,8338,-65.55,-184070.06,546555.9,362485.84
1961-04-27,65.46,-0.09,-0.14,68.68,-4.69,True,1,8339,-65.46,-184135.52,545870.94,361735.42
1961-04-28,65.31,-0.15,-0.23,68.68,-4.91,True,1,8340,-65.31,-184200.83,544685.4,360484.57
1961-05-01,65.17,-0.14,-0.21,68.68,-5.11,True,1,8341,-65.17,-184266.0,543582.97,359316.97
1961-05-02,65.64,0.47,0.72,68.68,-4.43,True,1,8342,-65.64,-184331.64,547568.88,363237.24
1961-05-03,66.18,0.54,0.82,68.68,-3.64,True,1,8343,-66.18,-184397.82,552139.74,367741.92
1961-05-04,66.44,0.26,0.39,68.68,-3.26,True,1,8344,-66.44,-184464.26,554375.36,369911.1
1961-05-05,66.52,0.08,0.12,68.68,-3.14,True,1,8345,-66.52,-184530.78,555109.4,370578.62
1961-05-08,66.41,-0.11,-0.16,68.68,-3.3,True,1,8346,-66.41,-184597.19,554257.86,369660.67
1961-05-09,66.47,0.06,0.09,68.68,-3.22,True,1,8347,-66.47,-184663.66,554825.09,370161.43
1961-05-10,66.41,-0.06,-0.09,68.68,-3.3,True,1,8348,-66.41,-184730.07,554390.68,369660.61
1961-05-11,66.39,-0.02,-0.03,68.68,-3.33,True,1,8349,-66.39,-184796.46,554290.11,369493.65
1961-05-12,66.5,0.11,0.17,68.68,-3.17,True,1,8350,-66.5,-184862.96,555275.0,370412.04
1961-05-15,66.83,0.33,0.5,68.68,-2.69,True,1,8351,-66.83,-184929.79,558097.33,373167.54
1961-05-16,67.08,0.25,0.37,68.68,-2.33,True,1,8352,-67.08,-184996.87,560252.16,375255.29
1961-05-17,67.39,0.31,0.46,68.68,-1.88,True,1,8353,-67.39,-185064.26,562908.67,377844.41
1961-05-18,66.99,-0.4,-0.59,68.68,-2.46,True,1,8354,-66.99,-185131.25,559634.46,374503.21
1961-05-19,67.27,0.28,0.42,68.68,-2.05,True,1,8355,-67.27,-185198.52,562040.85,376842.33
1961-05-22,66.85,-0.42,-0.62,68.68,-2.66,True,1,8356,-66.85,-185265.37,558598.6,373333.23
1961-05-23,66.68,-0.17,-0.25,68.68,-2.91,True,1,8357,-66.68,-185332.05,557244.76,371912.71
1961-05-24,66.26,-0.42,-0.63,68.68,-3.52,True,1,8358,-66.26,-185398.31,553801.08,368402.77
1961-05-25,66.01,-0.25,-0.38,68.68,-3.89,True,1,8359,-66.01,-185464.32,551777.59,366313.27
1961-05-26,66.43,0.42,0.64,68.68,-3.28,True,1,8360,-66.43,-185530.75,555354.8,369824.05
1961-05-31,66.56,0.13,0.2,68.68,-3.09,True,1,8361,-66.56,-185597.31,556508.16,370910.85
1961-06-01,66.56,0.0,0.0,68.68,-3.09,True,1,8362,-66.56,-185663.87,556574.72,370910.85
1961-06-02,66.73,0.17,0.26,68.68,-2.84,True,1,8363,-66.73,-185730.6,558062.99,372332.39
1961-06-05,67.08,0.35,0.52,68.68,-2.33,True,1,8364,-67.08,-185797.68,561057.12,375259.44
1961-06-06,66.89,-0.19,-0.28,68.68,-2.61,True,1,8365,-66.89,-185864.57,559534.85,373670.28
1961-06-07,65.64,-1.25,-1.87,68.68,-4.43,True,1,8366,-65.64,-185930.21,549144.24,363214.03
1961-06-08,66.67,1.03,1.57,68.68,-2.93,True,1,8367,-66.67,-185996.88,557827.89,371831.01
1961-06-09,66.66,-0.01,-0.02,68.68,-2.94,True,1,8368,-66.66,-186063.54,557810.88,371747.34
1961-06-12,66.15,-0.51,-0.76,68.68,-3.68,True,1,8369,-66.15,-186129.69,553609.35,367479.66
1961-06-13,65.8,-0.35,-0.53,68.68,-4.19,True,1,8370,-65.8,-186195.49,550746.0,364550.51
1961-06-14,65.98,0.18,0.27,68.68,-3.93,True,1,8371,-65.98,-186261.47,552318.58,366057.11
1961-06-15,65.69,-0.29,-0.44,68.68,-4.35,True,1,8372,-65.69,-186327.16,549956.68,363629.52
1961-06-16,65.18,-0.51,-0.78,68.68,-5.1,True,1,8373,-65.18,-186392.34,545752.14,359359.8
1961-06-19,64.58,-0.6,-0.92,68.68,-5.97,True,1,8374,-64.58,-186456.92,540792.92,354336.0
1961-06-20,65.15,0.57,0.88,68.68,-5.14,True,1,8375,-65.15,-186522.07,545631.25,359109.18
1961-06-21,65.14,-0.01,-0.02,68.68,-5.15,True,1,8376,-65.14,-186587.21,545612.64,359025.43
1961-06-22,64.9,-0.24,-0.37,68.68,-5.5,True,1,8377,-64.9,-186652.11,543667.3,357015.19
1961-06-23,65.16,0.26,0.4,68.68,-5.12,True,1,8378,-65.16,-186717.27,545910.48,359193.21
1961-06-26,64.47,-0.69,-1.06,68.68,-6.13,True,1,8379,-64.47,-186781.74,540194.13,353412.39
1961-06-27,64.47,0.0,0.0,68.68,-6.13,True,1,8380,-64.47,-186846.21,540258.6,353412.39
1961-06-28,64.59,0.12,0.19,68.68,-5.96,True,1,8381,-64.59,-186910.8,541328.79,354417.99
1961-06-29,64.52,-0.07,-0.11,68.68,-6.06,True,1,8382,-64.52,-186975.32,540806.64,353831.32
1961-06-30,64.64,0.12,0.19,68.68,-5.88,True,1,8383,-64.64,-187039.96,541877.12,354837.16
1961-07-03,65.21,0.57,0.88,68.68,-5.05,True,1,8384,-65.21,-187105.17,546720.64,359615.47
1961-07-05,65.63,0.42,0.64,68.68,-4.44,True,1,8385,-65.63,-187170.8,550307.55,363136.75
1961-07-06,65.81,0.18,0.27,68.68,-4.18,True,1,8386,-65.81,-187236.61,551882.66,364646.05
1961-07-07,65.77,-0.04,-0.06,68.68,-4.24,True,1,8387,-65.77,-187302.38,551612.99,364310.61
1961-07-10,65.71,-0.06,-0.09,68.68,-4.32,True,1,8388,-65.71,-187368.09,551175.48,363807.39
1961-07-11,65.69,-0.02,-0.03,68.68,-4.35,True,1,8389,-65.69,-187433.78,551073.41,363639.63
1961-07-12,65.32,-0.37,-0.56,68.68,-4.89,True,1,8390,-65.32,-187499.1,548034.8,360535.7
1961-07-13,64.86,-0.46,-0.7,68.68,-5.56,True,1,8391,-64.86,-187563.96,544240.26,356676.3
1961-07-14,65.28,0.42,0.65,68.68,-4.95,True,1,8392,-65.28,-187629.24,547829.76,360200.52
1961-07-17,64.79,-0.49,-0.75,68.68,-5.66,True,1,8393,-64.79,-187694.03,543782.47,356088.44
1961-07-18,64.41,-0.38,-0.59,68.68,-6.22,True,1,8394,-64.41,-187758.44,540657.54,352899.1
1961-07-19,64.7,0.29,0.45,68.68,-5.8,True,1,8395,-64.7,-187823.14,543156.5,355333.36
1961-07-20,64.71,0.01,0.02,68.68,-5.78,True,1,8396,-64.71,-187887.85,543305.16,355417.31
1961-07-21,64.86,0.15,0.23,68.68,-5.56,True,1,8397,-64.86,-187952.71,544629.42,356676.71
1961-07-24,64.87,0.01,0.02,68.68,-5.55,True,1,8398,-64.87,-188017.58,544778.26,356760.68
1961-07-25,65.23,0.36,0.56,68.68,-5.02,True,1,8399,-65.23,-188082.81,547866.77,359783.96
1961-07-26,65.84,0.61,0.94,68.68,-4.14,True,1,8400,-65.84,-188148.65,553056.0,364907.35
1961-07-27,66.61,0.77,1.17,68.68,-3.01,True,1,8401,-66.61,-188215.26,559590.61,371375.35
1961-07-28,66.71,0.1,0.15,68.68,-2.87,True,1,8402,-66.71,-188281.97,560497.42,372215.45
1961-07-31,66.76,0.05,0.08,68.68,-2.8,True,1,8403,-66.76,-188348.73,560984.28,372635.55
1961-08-01,67.37,0.61,0.91,68.68,-1.91,True,1,8404,-67.37,-188416.1,566177.48,377761.38
1961-08-02,66.94,-0.43,-0.64,68.68,-2.53,True,1,8405,-66.94,-188483.04,562630.7,374147.66
1961-08-03,67.29,0.35,0.52,68.68,-2.02,True,1,8406,-67.29,-188550.33,565639.74,377089.41
1961-08-04,67.68,0.39,0.58,68.68,-1.46,True,1,8407,-67.68,-188618.01,568985.76,380367.75
1961-08-07,67.67,-0.01,-0.02,68.68,-1.47,True,1,8408,-67.67,-188685.68,568969.36,380283.68
1961-08-08,67.82,0.15,0.22,68.68,-1.25,True,1,8409,-67.82,-188753.5,570298.38,381544.88
1961-08-09,67.74,-0.08,-0.12,68.68,-1.37,True,1,8410,-67.74,-188821.24,569693.4,380872.16
1961-08-10,67.95,0.21,0.31,68.68,-1.06,True,1,8411,-67.95,-188889.19,571527.45,382638.26
1961-08-11,68.06,0.11,0.16,68.68,-0.9,True,1,8412,-68.06,-188957.25,572520.72,383563.47
1961-08-14,67.72,-0.34,-0.5,68.68,-1.4,True,1,8413,-67.72,-189024.97,569728.36,380703.39
1961-08-15,67.55,-0.17,-0.25,68.68,-1.64,True,1,8414,-67.55,-189092.52,568365.7,379273.18
1961-08-16,67.73,0.18,0.27,68.68,-1.38,True,1,8415,-67.73,-189160.25,569947.95,380787.7
1961-08-17,68.11,0.38,0.56,68.68,-0.83,True,1,8416,-68.11,-189228.36,573213.76,383985.4
1961-08-18,68.29,0.18,0.26,68.68,-0.57,True,1,8417,-68.29,-189296.65,574796.93,385500.28
1961-08-21,68.43,0.14,0.2,68.68,-0.36,True,1,8418,-68.43,-189365.08,576043.74,386678.66
1961-08-22,68.44,0.01,0.02,68.68,-0.35,True,1,8419,-68.44,-189433.52,576196.36,386762.84
1961-08-23,67.98,-0.46,-0.67,68.68,-1.02,True,1,8420,-67.98,-189501.5,572391.6,382890.1
1961-08-24,67.59,-0.39,-0.57,68.68,-1.59,True,1,8421,-67.59,-189569.09,569175.39,379606.3
1961-08-25,67.67,0.08,0.12,68.68,-1.47,True,1,8422,-67.67,-189636.76,569916.74,380279.98
1961-08-28,67.7,0.03,0.04,68.68,-1.43,True,1,8423,-67.7,-189704.46,570237.1,380532.64
1961-08-29,67.55,-0.15,-0.22,68.68,-1.64,True,1,8424,-67.55,-189772.01,569041.2,379269.19
1961-08-30,67.81,0.26,0.38,68.68,-1.27,True,1,8425,-67.81,-189839.82,571299.25,381459.43
1961-08-31,68.07,0.26,0.38,68.68,-0.89,True,1,8426,-68.07,-189907.89,573557.82,383649.93
1961-09-01,68.19,0.12,0.18,68.68,-0.71,True,1,8427,-68.19,-189976.08,574637.13,384661.05
1961-09-05,67.96,-0.23,-0.34,68.68,-1.05,True,1,8428,-67.96,-190044.04,572766.88,382722.84
1961-09-06,68.46,0.5,0.74,68.68,-0.32,True,1,8429,-68.46,-190112.5,577049.34,386936.84
1961-09-07,68.35,-0.11,-0.16,68.68,-0.48,True,1,8430,-68.35,-190180.85,576190.5,386009.65
1961-09-08,67.88,-0.47,-0.69,68.68,-1.16,True,1,8431,-67.88,-190248.73,572296.28,382047.55
1961-09-11,67.28,-0.6,-0.88,68.68,-2.04,True,1,8432,-67.28,-190316.01,567304.96,376988.95
1961-09-12,67.96,0.68,1.01,68.68,-1.05,True,1,8433,-67.96,-190383.97,573106.68,382722.71
1961-09-13,68.01,0.05,0.07,68.68,-0.98,True,1,8434,-68.01,-190451.98,573596.34,383144.36
1961-09-14,67.53,-0.48,-0.71,68.68,-1.67,True,1,8435,-67.53,-190519.51,569615.55,379096.04
1961-09-15,67.65,0.12,0.18,68.68,-1.5,True,1,8436,-67.65,-190587.16,570695.4,380108.24
1961-09-18,67.21,-0.44,-0.65,68.68,-2.14,True,1,8437,-67.21,-190654.37,567050.77,376396.4
1961-09-19,66.08,-1.13,-1.68,68.68,-3.79,True,1,8438,-66.08,-190720.45,557583.04,366862.59
1961-09-20,66.96,0.88,1.33,68.68,-2.5,True,1,8439,-66.96,-190787.41,565075.44,374288.03
1961-09-21,66.99,0.03,0.04,68.68,-2.46,True,1,8440,-66.99,-190854.4,565395.6,374541.2
1961-09-22,66.72,-0.27,-0.4,68.68,-2.85,True,1,8441,-66.72,-190921.12,563183.52,372262.4
1961-09-25,65.77,-0.95,-1.42,68.68,-4.24,True,1,8442,-65.77,-190986.89,555230.34,364243.45
1961-09-26,65.78,0.01,0.02,68.68,-4.22,True,1,8443,-65.78,-191052.67,555380.54,364327.87
1961-09-27,66.47,0.69,1.05,68.68,-3.22,True,1,8444,-66.47,-191119.14,561272.68,370153.54
1961-09-28,66.58,0.11,0.16,68.68,-3.06,True,1,8445,-66.58,-191185.72,562268.1,371082.38
1961-09-29,66.73,0.15,0.22,68.68,-2.84,True,1,8446,-66.73,-191252.45,563601.58,372349.13
1961-10-02,66.77,0.04,0.06,68.68,-2.78,True,1,8447,-66.77,-191319.22,564006.19,372686.97
1961-10-03,66.73,-0.04,-0.06,68.68,-2.84,True,1,8448,-66.73,-191385.95,563735.04,372349.09
1961-10-04,67.18,0.45,0.67,68.68,-2.18,True,1,8449,-67.18,-191453.13,567603.82,376150.69
1961-10-05,67.77,0.59,0.88,68.68,-1.32,True,1,8450,-67.77,-191520.9,572656.5,381135.6
1961-10-06,66.97,-0.8,-1.18,68.68,-2.49,True,1,8451,-66.97,-191587.87,565963.47,374375.6
1961-10-09,67.94,0.97,1.45,68.68,-1.08,True,1,8452,-67.94,-191655.81,574228.88,382573.07
1961-10-10,68.11,0.17,0.25,68.68,-0.83,True,1,8453,-68.11,-191723.92,575733.83,384009.91
1961-10-11,68.17,0.06,0.09,68.68,-0.74,True,1,8454,-68.17,-191792.09,576309.18,384517.09
1961-10-12,68.16,-0.01,-0.02,68.68,-0.76,True,1,8455,-68.16,-191860.25,576292.8,384432.55
1961-10-13,68.04,-0.12,-0.18,68.68,-0.93,True,1,8456,-68.04,-191928.29,575346.24,383417.95
1961-10-16,67.85,-0.19,-0.28,68.68,-1.21,True,1,8457,-67.85,-191996.14,573807.45,381811.31
1961-10-17,67.87,0.02,0.03,68.68,-1.18,True,1,8458,-67.87,-192064.01,574044.46,381980.45
1961-10-18,68.21,0.34,0.5,68.68,-0.68,True,1,8459,-68.21,-192132.22,576988.39,384856.17
1961-10-19,68.45,0.24,0.35,68.68,-0.34,True,1,8460,-68.45,-192200.67,579087.0,386886.33
1961-10-20,68.0,-0.45,-0.66,68.68,-0.99,True,1,8461,-68.0,-192268.67,575348.0,383079.33
1961-10-23,68.06,0.06,0.09,68.68,-0.9,True,1,8462,-68.06,-192336.73,575923.72,383586.99
1961-10-24,67.98,-0.08,-0.12,68.68,-1.02,True,1,8463,-67.98,-192404.71,575314.74,382910.03
1961-10-25,68.34,0.36,0.53,68.68,-0.5,True,1,8464,-68.34,-192473.05,578429.76,385956.71
1961-10-26,68.46,0.12,0.18,68.68,-0.32,True,1,8465,-68.46,-192541.51,579513.9,386972.39
1961-10-27,68.34,-0.12,-0.18,68.68,-0.5,True,1,8466,-68.34,-192609.85,578566.44,385956.59
1961-10-30,68.42,0.08,0.12,68.68,-0.38,True,1,8467,-68.42,-192678.27,579312.14,386633.87
1961-10-31,68.62,0.2,0.29,68.68,-0.09,True,1,8468,-68.62,-192746.89,581074.16,388327.27
1961-11-01,68.73,0.11,0.16,68.73,0.0,True,1,8469,-68.73,-192815.62,582074.37,389258.75
1961-11-02,69.11,0.38,0.55,69.11,0.0,True,1,8470,-69.11,-192884.73,585361.7,392476.97
1961-11-03,69.47,0.36,0.52,69.47,0.0,True,1,8471,-69.47,-192954.2,588480.37,395526.17
1961-11-06,70.01,0.54,0.78,70.01,0.0,True,1,8472,-70.01,-193024.21,593124.72,400100.51
1961-11-08,70.87,0.86,1.23,70.87,0.0,True,1,8473,-70.87,-193095.08,600481.51,407386.43
1961-11-09,70.77,-0.1,-0.14,70.87,-0.14,True,1,8474,-70.77,-193165.85,599704.98,406539.13
1961-11-10,71.07,0.3,0.42,71.07,0.0,True,1,8475,-71.07,-193236.92,602318.25,409081.33
1961-11-13,71.27,0.2,0.28,71.27,0.0,True,1,8476,-71.27,-193308.19,604084.52,410776.33
1961-11-14,71.66,0.39,0.55,71.66,0.0,True,1,8477,-71.66,-193379.85,607461.82,414081.97
1961-11-15,71.67,0.01,0.01,71.67,0.0,True,1,8478,-71.67,-193451.52,607618.26,414166.74
1961-11-16,71.62,-0.05,-0.07,71.67,-0.07,True,1,8479,-71.62,-193523.14,607265.98,413742.84
1961-11-17,71.62,0.0,0.0,71.67,-0.07,True,1,8480,-71.62,-193594.76,607337.6,413742.84
1961-11-20,71.72,0.1,0.14,71.72,0.0,True,1,8481,-71.72,-193666.48,608257.32,414590.84
1961-11-21,71.78,0.06,0.08,71.78,0.0,True,1,8482,-71.78,-193738.26,608837.96,415099.7
1961-11-22,71.7,-0.08,-0.11,71.78,-0.11,True,1,8483,-71.7,-193809.96,608231.1,414421.14
1961-11-24,71.84,0.14,0.2,71.84,0.0,True,1,8484,-71.84,-193881.8,609490.56,415608.76
1961-11-27,71.85,0.01,0.01,71.85,0.0,True,1,8485,-71.85,-193953.65,609647.25,415693.6
1961-11-28,71.75,-0.1,-0.14,71.85,-0.14,True,1,8486,-71.75,-194025.4,608870.5,414845.1
1961-11-29,71.7,-0.05,-0.07,71.85,-0.21,True,1,8487,-71.7,-194097.1,608517.9,414420.8
1961-11-30,71.32,-0.38,-0.53,71.85,-0.74,True,1,8488,-71.32,-194168.42,605364.16,411195.74
1961-12-01,71.78,0.46,0.64,71.85,-0.1,True,1,8489,-71.78,-194240.2,609340.42,415100.22
1961-12-04,72.01,0.23,0.32,72.01,0.0,True,1,8490,-72.01,-194312.21,611364.9,417052.69
1961-12-05,71.93,-0.08,-0.11,72.01,-0.11,True,1,8491,-71.93,-194384.14,610757.63,416373.49
1961-12-06,71.99,0.06,0.08,72.01,-0.03,True,1,8492,-71.99,-194456.13,611339.08,416882.95
1961-12-07,71.7,-0.29,-0.4,72.01,-0.43,True,1,8493,-71.7,-194527.83,608948.1,414420.27
1961-12-08,72.04,0.34,0.47,72.04,0.0,True,1,8494,-72.04,-194599.87,611907.76,417307.89
1961-12-11,72.39,0.35,0.49,72.39,0.0,True,1,8495,-72.39,-194672.26,614953.05,420280.79
1961-12-12,72.64,0.25,0.34,72.64,0.0,True,1,8496,-72.64,-194744.9,617149.44,422404.54
1961-12-13,72.53,-0.11,-0.15,72.64,-0.15,True,1,8497,-72.53,-194817.43,616287.41,421469.98
1961-12-14,71.98,-0.55,-0.76,72.64,-0.91,True,1,8498,-71.98,-194889.41,611686.04,416796.63
1961-12-15,72.01,0.03,0.04,72.64,-0.87,True,1,8499,-72.01,-194961.42,612012.99,417051.57
1961-12-18,71.76,-0.25,-0.35,72.64,-1.21,True,1,8500,-71.76,-195033.18,609960.0,414926.82
1961-12-19,71.26,-0.5,-0.7,72.64,-1.9,True,1,8501,-71.26,-195104.44,605781.26,410676.82
1961-12-20,71.12,-0.14,-0.2,72.64,-2.09,True,1,8502,-71.12,-195175.56,604662.24,409486.68
1961-12-21,70.86,-0.26,-0.37,72.64,-2.45,True,1,8503,-70.86,-195246.42,602522.58,407276.16
1961-12-22,70.91,0.05,0.07,72.64,-2.38,True,1,8504,-70.91,-195317.33,603018.64,407701.31
1961-12-26,71.02,0.11,0.16,72.64,-2.23,True,1,8505,-71.02,-195388.35,604025.1,408636.75
1961-12-27,71.65,0.63,0.89,72.64,-1.36,True,1,8506,-71.65,-195460.0,609454.9,413994.9
1961-12-28,71.69,0.04,0.06,72.64,-1.31,True,1,8507,-71.69,-195531.69,609866.83,414335.14
1961-12-29,71.55,-0.14,-0.2,72.64,-1.5,True,1,8508,-71.55,-195603.24,608747.4,413144.16
1962-01-02,70.96,-0.59,-0.82,72.64,-2.31,True,1,8509,-70.96,-195674.2,603798.64,408124.44
1962-01-03,71.13,0.17,0.24,72.64,-2.08,True,1,8510,-71.13,-195745.33,605316.3,409570.97
1962-01-04,70.64,-0.49,-0.69,72.64,-2.75,True,1,8511,-70.64,-195815.97,601217.04,405401.07
1962-01-05,69.66,-0.98,-1.39,72.64,-4.1,True,1,8512,-69.66,-195885.63,592945.92,397060.29
1962-01-08,69.12,-0.54,-0.78,72.64,-4.85,True,1,8513,-69.12,-195954.75,588418.56,392463.81
1962-01-09,69.15,0.03,0.04,72.64,-4.8,True,1,8514,-69.15,-196023.9,588743.1,392719.2
1962-01-10,68.96,-0.19,-0.28,72.64,-5.07,True,1,8515,-68.96,-196092.86,587194.4,391101.54
1962-01-11,69.37,0.41,0.6,72.64,-4.5,True,1,8516,-69.37,-196162.23,590754.92,394592.69
1962-01-12,69.61,0.24,0.35,72.64,-4.17,True,1,8517,-69.61,-196231.84,592868.37,396636.53
1962-01-15,69.47,-0.14,-0.2,72.64,-4.36,True,1,8518,-69.47,-196301.31,591745.46,395444.15
1962-01-16,69.07,-0.4,-0.58,72.64,-4.92,True,1,8519,-69.07,-196370.38,588407.33,392036.95
1962-01-17,68.32,-0.75,-1.09,72.64,-5.95,True,1,8520,-68.32,-196438.7,582086.4,385647.7
1962-01-18,68.39,0.07,0.1,72.64,-5.85,True,1,8521,-68.39,-196507.09,582751.19,386244.1
1962-01-19,68.75,0.36,0.53,72.64,-5.36,True,1,8522,-68.75,-196575.84,585887.5,389311.66
1962-01-22,68.81,0.06,0.09,72.64,-5.27,True,1,8523,-68.81,-196644.65,586467.63,389822.98
1962-01-23,68.29,-0.52,-0.76,72.64,-5.99,True,1,8524,-68.29,-196712.94,582103.96,385391.02
1962-01-24,68.4,0.11,0.16,72.64,-5.84,True,1,8525,-68.4,-196781.34,583110.0,386328.66
1962-01-25,68.35,-0.05,-0.07,72.64,-5.91,True,1,8526,-68.35,-196849.69,582752.1,385902.41
1962-01-26,68.13,-0.22,-0.32,72.64,-6.21,True,1,8527,-68.13,-196917.82,580944.51,384026.69
1962-01-29,67.9,-0.23,-0.34,72.64,-6.52,True,1,8528,-67.9,-196985.72,579051.2,382065.48
1962-01-30,68.17,0.27,0.4,72.64,-6.15,True,1,8529,-68.17,-197053.89,581421.93,384368.04
1962-01-31,68.84,0.67,0.98,72.64,-5.23,True,1,8530,-68.84,-197122.73,587205.2,390082.47
1962-02-01,69.26,0.42,0.61,72.64,-4.65,True,1,8531,-69.26,-197191.99,590857.06,393665.07
1962-02-02,69.81,0.55,0.79,72.64,-3.9,True,1,8532,-69.81,-197261.8,595618.92,398357.12
1962-02-05,69.88,0.07,0.1,72.64,-3.8,True,1,8533,-69.88,-197331.68,596286.04,398954.36
1962-02-06,69.96,0.08,0.11,72.64,-3.69,True,1,8534,-69.96,-197401.64,597038.64,399637.0
1962-02-07,70.42,0.46,0.66,72.64,-3.06,True,1,8535,-70.42,-197472.06,601034.7,403562.64
1962-02-08,70.58,0.16,0.23,72.64,-2.84,True,1,8536,-70.58,-197542.64,602470.88,404928.24
1962-02-09,70.48,-0.1,-0.14,72.64,-2.97,True,1,8537,-70.48,-197613.12,601687.76,404074.64
1962-02-12,70.46,-0.02,-0.03,72.64,-3.0,True,1,8538,-70.46,-197683.58,601587.48,403903.9
1962-02-13,70.45,-0.01,-0.01,72.64,-3.02,True,1,8539,-70.45,-197754.03,601572.55,403818.52
1962-02-14,70.42,-0.03,-0.04,72.64,-3.06,True,1,8540,-70.42,-197824.45,601386.8,403562.35
1962-02-15,70.74,0.32,0.45,72.64,-2.62,True,1,8541,-70.74,-197895.19,604190.34,406295.15
1962-02-16,70.59,-0.15,-0.21,72.64,-2.82,True,1,8542,-70.59,-197965.78,602979.78,405014.0
1962-02-19,70.41,-0.18,-0.26,72.64,-3.07,True,1,8543,-70.41,-198036.19,601512.63,403476.44
1962-02-20,70.66,0.25,0.36,72.64,-2.73,True,1,8544,-70.66,-198106.85,603719.04,405612.19
1962-02-21,70.32,-0.34,-0.48,72.64,-3.19,True,1,8545,-70.32,-198177.17,600884.4,402707.23
1962-02-23,70.16,-0.16,-0.23,72.64,-3.41,True,1,8546,-70.16,-198247.33,599587.36,401340.03
1962-02-26,69.76,-0.4,-0.57,72.64,-3.96,True,1,8547,-69.76,-198317.09,596238.72,397921.63
1962-02-27,69.89,0.13,0.19,72.64,-3.79,True,1,8548,-69.89,-198386.98,597419.72,399032.74
1962-02-28,69.96,0.07,0.1,72.64,-3.69,True,1,8549,-69.96,-198456.94,598088.04,399631.1
1962-03-01,70.2,0.24,0.34,72.64,-3.36,True,1,8550,-70.2,-198527.14,600210.0,401682.86
1962-03-02,70.16,-0.04,-0.06,72.64,-3.41,True,1,8551,-70.16,-198597.3,599938.16,401340.86
1962-03-05,70.01,-0.15,-0.21,72.64,-3.62,True,1,8552,-70.01,-198667.31,598725.52,400058.21
1962-03-06,69.78,-0.23,-0.33,72.64,-3.94,True,1,8553,-69.78,-198737.09,596828.34,398091.25
1962-03-07,69.69,-0.09,-0.13,72.64,-4.06,True,1,8554,-69.69,-198806.78,596128.26,397321.48
1962-03-08,70.19,0.5,0.72,72.64,-3.37,True,1,8555,-70.19,-198876.97,600475.45,401598.48
1962-03-09,70.42,0.23,0.33,72.64,-3.06,True,1,8556,-70.42,-198947.39,602513.52,403566.13
1962-03-12,70.4,-0.02,-0.03,72.64,-3.08,True,1,8557,-70.4,-199017.79,602412.8,403395.01
1962-03-13,70.6,0.2,0.28,72.64,-2.81,True,1,8558,-70.6,-199088.39,604194.8,405106.41
1962-03-14,70.91,0.31,0.44,72.64,-2.38,True,1,8559,-70.91,-199159.3,606918.69,407759.39
1962-03-15,71.06,0.15,0.21,72.64,-2.17,True,1,8560,-71.06,-199230.36,608273.6,409043.24
1962-03-16,70.94,-0.12,-0.17,72.64,-2.34,True,1,8561,-70.94,-199301.3,607317.34,408016.04
1962-03-19,70.85,-0.09,-0.13,72.64,-2.46,True,1,8562,-70.85,-199372.15,606617.7,407245.55
1962-03-20,70.66,-0.19,-0.27,72.64,-2.73,True,1,8563,-70.66,-199442.81,605061.58,405618.77
1962-03-21,70.51,-0.15,-0.21,72.64,-2.93,True,1,8564,-70.51,-199513.32,603847.64,404334.32
1962-03-22,70.4,-0.11,-0.16,72.64,-3.08,True,1,8565,-70.4,-199583.72,602976.0,403392.28
1962-03-23,70.45,0.05,0.07,72.64,-3.02,True,1,8566,-70.45,-199654.17,603474.7,403820.53
1962-03-26,69.89,-0.56,-0.8,72.64,-3.79,True,1,8567,-69.89,-199724.06,598747.63,399023.57
1962-03-27,69.7,-0.19,-0.27,72.64,-4.05,True,1,8568,-69.7,-199793.76,597189.6,397395.84
1962-03-28,70.04,0.34,0.49,72.64,-3.58,True,1,8569,-70.04,-199863.8,600172.76,400308.96
1962-03-29,70.01,-0.03,-0.04,72.64,-3.62,True,1,8570,-70.01,-199933.81,599985.7,400051.89
1962-03-30,69.55,-0.46,-0.66,72.64,-4.25,True,1,8571,-69.55,-200003.36,596113.05,396109.69
1962-04-02,69.37,-0.18,-0.26,72.64,-4.5,True,1,8572,-69.37,-200072.73,594639.64,394566.91
1962-04-03,68.81,-0.56,-0.81,72.64,-5.27,True,1,8573,-68.81,-200141.54,589908.13,389766.59
1962-04-04,68.49,-0.32,-0.46,72.64,-5.71,True,1,8574,-68.49,-200210.03,587233.26,387023.23
1962-04-05,68.91,0.42,0.61,72.64,-5.14,True,1,8575,-68.91,-200278.94,590903.25,390624.31
1962-04-06,68.84,-0.07,-0.1,72.64,-5.23,True,1,8576,-68.84,-200347.78,590371.84,390024.06
1962-04-09,68.31,-0.53,-0.77,72.64,-5.96,True,1,8577,-68.31,-200416.09,585894.87,385478.78
1962-04-10,68.56,0.25,0.37,72.64,-5.62,True,1,8578,-68.56,-200484.65,588107.68,387623.03
1962-04-11,68.41,-0.15,-0.22,72.64,-5.82,True,1,8579,-68.41,-200553.06,586889.39,386336.33
1962-04-12,67.9,-0.51,-0.75,72.64,-6.52,True,1,8580,-67.9,-200620.96,582582.0,381961.04
1962-04-13,67.9,0.0,0.0,72.64,-6.52,True,1,8581,-67.9,-200688.86,582649.9,381961.04
1962-04-16,67.6,-0.3,-0.44,72.64,-6.94,True,1,8582,-67.6,-200756.46,580143.2,379386.74
1962-04-17,67.9,0.3,0.44,72.64,-6.52,True,1,8583,-67.9,-200824.36,582785.7,381961.34
1962-04-18,68.27,0.37,0.55,72.64,-6.02,True,1,8584,-68.27,-200892.63,586029.68,385137.05
1962-04-19,68.59,0.32,0.47,72.64,-5.58,True,1,8585,-68.59,-200961.22,588845.15,387883.93
1962-04-23,68.53,-0.06,-0.09,72.64,-5.66,True,1,8586,-68.53,-201029.75,588398.58,387368.83
1962-04-24,68.46,-0.07,-0.1,72.64,-5.75,True,1,8587,-68.46,-201098.21,587866.02,386767.81
1962-04-25,67.71,-0.75,-1.1,72.64,-6.79,True,1,8588,-67.71,-201165.92,581493.48,380327.56
1962-04-26,67.05,-0.66,-0.98,72.64,-7.7,True,1,8589,-67.05,-201232.97,575892.45,374659.48
1962-04-27,66.3,-0.75,-1.12,72.64,-8.73,True,1,8590,-66.3,-201299.27,569517.0,368217.73
1962-04-30,65.24,-1.06,-1.6,72.64,-10.19,True,1,8591,-65.24,-201364.51,560476.84,359112.33
1962-05-01,65.7,0.46,0.7,72.64,-9.55,True,1,8592,-65.7,-201430.21,564494.4,363064.19
1962-05-02,65.99,0.29,0.44,72.64,-9.15,True,1,8593,-65.99,-201496.2,567052.07,365555.87
1962-05-03,66.53,0.54,0.82,72.64,-8.41,True,1,8594,-66.53,-201562.73,571758.82,370196.09
1962-05-04,66.24,-0.29,-0.44,72.64,-8.81,True,1,8595,-66.24,-201628.97,569332.8,367703.83
1962-05-07,66.02,-0.22,-0.33,72.64,-9.11,True,1,8596,-66.02,-201694.99,567507.92,365812.93
1962-05-08,65.17,-0.85,-1.29,72.64,-10.28,True,1,8597,-65.17,-201760.16,560266.49,358506.33
1962-05-09,64.26,-0.91,-1.4,72.64,-11.54,True,1,8598,-64.26,-201824.42,552507.48,350683.06
1962-05-10,63.57,-0.69,-1.07,72.64,-12.49,True,1,8599,-63.57,-201887.99,546638.43,344750.44
1962-05-11,62.65,-0.92,-1.45,72.64,-13.75,True,1,8600,-62.65,-201950.64,538790.0,336839.36
1962-05-14,63.1,0.45,0.72,72.64,-13.13,True,1,8601,-63.1,-202013.74,542723.1,340709.36
1962-05-15,64.29,1.19,1.89,72.64,-11.5,True,1,8602,-64.29,-202078.03,553022.58,350944.55
1962-05-16,64.27,-0.02,-0.03,72.64,-11.52,True,1,8603,-64.27,-202142.3,552914.81,350772.51
1962-05-17,63.93,-0.34,-0.53,72.64,-11.99,True,1,8604,-63.93,-202206.23,550053.72,347847.49
1962-05-18,63.82,-0.11,-0.17,72.64,-12.14,True,1,8605,-63.82,-202270.05,549171.1,346901.05
1962-05-21,63.59,-0.23,-0.36,72.64,-12.46,True,1,8606,-63.59,-202333.64,547255.54,344921.9
1962-05-22,62.34,-1.25,-1.97,72.64,-14.18,True,1,8607,-62.34,-202395.98,536560.38,334164.4
1962-05-23,61.11,-1.23,-1.97,72.64,-15.87,True,1,8608,-61.11,-202457.09,526034.88,323577.79
1962-05-24,60.62,-0.49,-0.8,72.64,-16.55,True,1,8609,-60.62,-202517.71,521877.58,319359.87
1962-05-25,59.47,-1.15,-1.9,72.64,-18.13,True,1,8610,-59.47,-202577.18,512036.7,309459.52
1962-05-28,55.5,-3.97,-6.68,72.64,-23.6,True,1,8611,-55.5,-202632.68,477910.5,275277.82
1962-05-29,58.08,2.58,4.65,72.64,-20.04,True,1,8612,-58.08,-202690.76,500184.96,297494.2
1962-05-31,59.63,1.55,2.67,72.64,-17.91,True,1,8613,-59.63,-202750.39,513593.19,310842.8
1962-06-01,59.38,-0.25,-0.42,72.64,-18.25,True,1,8614,-59.38,-202809.77,511499.32,308689.55
1962-06-04,57.27,-2.11,-3.55,72.64,-21.16,True,1,8615,-57.27,-202867.04,493381.05,290514.01
1962-06-05,57.57,0.3,0.52,72.64,-20.75,True,1,8616,-57.57,-202924.61,496023.12,293098.51
1962-06-06,58.39,0.82,1.42,72.64,-19.62,True,1,8617,-58.39,-202983.0,503146.63,300163.63
1962-06-07,58.4,0.01,0.02,72.64,-19.6,True,1,8618,-58.4,-203041.4,503291.2,300249.8
1962-06-08,58.45,0.05,0.09,72.64,-19.54,True,1,8619,-58.45,-203099.85,503780.55,300680.7
1962-06-11,57.82,-0.63,-1.08,72.64,-20.4,True,1,8620,-57.82,-203157.67,498408.4,295250.73
1962-06-12,56.34,-1.48,-2.56,72.64,-22.44,True,1,8621,-56.34,-203214.01,485707.14,282493.13
1962-06-13,55.5,-0.84,-1.49,72.64,-23.6,True,1,8622,-55.5,-203269.51,478521.0,275251.49
1962-06-14,54.33,-1.17,-2.11,72.64,-25.21,True,1,8623,-54.33,-203323.84,468487.59,265163.75
1962-06-15,55.89,1.56,2.87,72.64,-23.06,True,1,8624,-55.89,-203379.73,481995.36,278615.63
1962-06-18,55.74,-0.15,-0.27,72.64,-23.26,True,1,8625,-55.74,-203435.47,480757.5,277322.03
1962-06-19,55.54,-0.2,-0.36,72.64,-23.54,True,1,8626,-55.54,-203491.01,479088.04,275597.03
1962-06-20,54.78,-0.76,-1.37,72.64,-24.59,True,1,8627,-54.78,-203545.79,472587.06,269041.27
1962-06-21,53.59,-1.19,-2.17,72.64,-26.22,True,1,8628,-53.59,-203599.38,462374.52,258775.14
1962-06-22,52.68,-0.91,-1.7,72.64,-27.48,True,1,8629,-52.68,-203652.06,454575.72,250923.66
1962-06-25,52.45,-0.23,-0.44,72.64,-27.8,True,1,8630,-52.45,-203704.51,452643.5,248938.99
1962-06-26,52.32,-0.13,-0.25,72.64,-27.97,True,1,8631,-52.32,-203756.83,451573.92,247817.09
1962-06-27,52.6,0.28,0.54,72.64,-27.59,True,1,8632,-52.6,-203809.43,454043.2,250233.77
1962-06-28,54.41,1.81,3.44,72.64,-25.1,True,1,8633,-54.41,-203863.84,469721.53,265857.69
1962-06-29,54.75,0.34,0.62,72.64,-24.63,True,1,8634,-54.75,-203918.59,472711.5,268792.91
1962-07-02,55.86,1.11,2.03,72.64,-23.1,True,1,8635,-55.86,-203974.45,482351.1,278376.65
1962-07-03,56.49,0.63,1.13,72.64,-22.23,True,1,8636,-56.49,-204030.94,487847.64,283816.7
1962-07-05,56.81,0.32,0.57,72.64,-21.79,True,1,8637,-56.81,-204087.75,490667.97,286580.22
1962-07-06,56.17,-0.64,-1.13,72.64,-22.67,True,1,8638,-56.17,-204143.92,485196.46,281052.54
1962-07-09,56.55,0.38,0.68,72.64,-22.15,True,1,8639,-56.55,-204200.47,488535.45,284334.98
1962-07-10,57.2,0.65,1.15,72.64,-21.26,True,1,8640,-57.2,-204257.67,494208.0,289950.33
1962-07-11,57.73,0.53,0.93,72.64,-20.53,True,1,8641,-57.73,-204315.4,498844.93,294529.53
1962-07-12,58.03,0.3,0.52,72.64,-20.11,True,1,8642,-58.03,-204373.43,501495.26,297121.83
1962-07-13,57.83,-0.2,-0.34,72.64,-20.39,True,1,8643,-57.83,-204431.26,499824.69,295393.43
1962-07-16,57.83,0.0,0.0,72.64,-20.39,True,1,8644,-57.83,-204489.09,499882.52,295393.43
1962-07-17,56.78,-1.05,-1.82,72.64,-21.83,True,1,8645,-56.78,-204545.87,490863.1,286317.23
1962-07-18,56.2,-0.58,-1.02,72.64,-22.63,True,1,8646,-56.2,-204602.07,485905.2,281303.13
1962-07-19,56.42,0.22,0.39,72.64,-22.33,True,1,8647,-56.42,-204658.49,487863.74,283205.25
1962-07-20,56.81,0.39,0.69,72.64,-21.79,True,1,8648,-56.81,-204715.3,491292.88,286577.58
1962-07-23,56.8,-0.01,-0.02,72.64,-21.81,True,1,8649,-56.8,-204772.1,491263.2,286491.1
1962-07-24,56.36,-0.44,-0.78,72.64,-22.41,True,1,8650,-56.36,-204828.46,487514.0,282685.54
1962-07-25,56.46,0.1,0.18,72.64,-22.27,True,1,8651,-56.46,-204884.92,488435.46,283550.54
1962-07-26,56.77,0.31,0.55,72.64,-21.85,True,1,8652,-56.77,-204941.69,491174.04,286232.35
1962-07-27,57.2,0.43,0.76,72.64,-21.26,True,1,8653,-57.2,-204998.89,494951.6,289952.71
1962-07-30,57.83,0.63,1.1,72.64,-20.39,True,1,8654,-57.83,-205056.72,500460.82,295404.1
1962-07-31,58.23,0.4,0.69,72.64,-19.84,True,1,8655,-58.23,-205114.95,503980.65,298865.7
1962-08-01,57.75,-0.48,-0.82,72.64,-20.5,True,1,8656,-57.75,-205172.7,499884.0,294711.3
1962-08-02,57.98,0.23,0.4,72.64,-20.18,True,1,8657,-57.98,-205230.68,501932.86,296702.18
1962-08-03,58.12,0.14,0.24,72.64,-19.99,True,1,8658,-58.12,-205288.8,503202.96,297914.16
1962-08-06,57.75,-0.37,-0.64,72.64,-20.5,True,1,8659,-57.75,-205346.55,500057.25,294710.7
1962-08-07,57.36,-0.39,-0.68,72.64,-21.04,True,1,8660,-57.36,-205403.91,496737.6,291333.69
1962-08-08,57.51,0.15,0.26,72.64,-20.83,True,1,8661,-57.51,-205461.42,498094.11,292632.69
1962-08-09,57.57,0.06,0.1,72.64,-20.75,True,1,8662,-57.57,-205518.99,498671.34,293152.35
1962-08-10,57.55,-0.02,-0.04,72.64,-20.77,True,1,8663,-57.55,-205576.54,498555.65,292979.11
1962-08-13,57.63,0.08,0.14,72.64,-20.66,True,1,8664,-57.63,-205634.17,499306.32,293672.15
1962-08-14,58.25,0.62,1.08,72.64,-19.81,True,1,8665,-58.25,-205692.42,504736.25,299043.83
1962-08-15,58.66,0.41,0.7,72.64,-19.25,True,1,8666,-58.66,-205751.08,508347.56,302596.48
1962-08-16,58.64,-0.02,-0.03,72.64,-19.27,True,1,8667,-58.64,-205809.72,508232.88,302423.16
1962-08-17,59.01,0.37,0.63,72.64,-18.76,True,1,8668,-59.01,-205868.73,511498.68,305629.95
1962-08-20,59.37,0.36,0.61,72.64,-18.27,True,1,8669,-59.37,-205928.1,514678.53,308750.43
1962-08-21,59.12,-0.25,-0.42,72.64,-18.61,True,1,8670,-59.12,-205987.22,512570.4,306583.18
1962-08-22,59.78,0.66,1.12,72.64,-17.7,True,1,8671,-59.78,-206047.0,518352.38,312305.38
1962-08-23,59.7,-0.08,-0.13,72.64,-17.81,True,1,8672,-59.7,-206106.7,517718.4,311611.7
1962-08-24,59.58,-0.12,-0.2,72.64,-17.98,True,1,8673,-59.58,-206166.28,516737.34,310571.06
1962-08-27,59.55,-0.03,-0.05,72.64,-18.02,True,1,8674,-59.55,-206225.83,516536.7,310310.87
1962-08-28,58.79,-0.76,-1.28,72.64,-19.07,True,1,8675,-58.79,-206284.62,510003.25,303718.63
1962-08-29,58.66,-0.13,-0.22,72.64,-19.25,True,1,8676,-58.66,-206343.28,508934.16,302590.88
1962-08-30,58.68,0.02,0.03,72.64,-19.22,True,1,8677,-58.68,-206401.96,509166.36,302764.4
1962-08-31,59.12,0.44,0.75,72.64,-18.61,True,1,8678,-59.12,-206461.08,513043.36,306582.28
1962-09-04,58.56,-0.56,-0.95,72.64,-19.38,True,1,8679,-58.56,-206519.64,508242.24,301722.6
1962-09-05,58.12,-0.44,-0.75,72.64,-19.99,True,1,8680,-58.12,-206577.76,504481.6,297903.84
1962-09-06,58.36,0.24,0.41,72.64,-19.66,True,1,8681,-58.36,-206636.12,506623.16,299987.04
1962-09-07,58.38,0.02,0.03,72.64,-19.63,True,1,8682,-58.38,-206694.5,506855.16,300160.66
1962-09-10,58.45,0.07,0.12,72.64,-19.54,True,1,8683,-58.45,-206752.95,507521.35,300768.4
1962-09-11,58.59,0.14,0.24,72.64,-19.34,True,1,8684,-58.59,-206811.54,508795.56,301984.02
1962-09-12,58.84,0.25,0.43,72.64,-19.0,True,1,8685,-58.84,-206870.38,511025.4,304155.02
1962-09-13,58.7,-0.14,-0.24,72.64,-19.19,True,1,8686,-58.7,-206929.08,509868.2,302939.12
1962-09-14,58.89,0.19,0.32,72.64,-18.93,True,1,8687,-58.89,-206987.97,511577.43,304589.46
1962-09-17,59.08,0.19,0.32,72.64,-18.67,True,1,8688,-59.08,-207047.05,513287.04,306239.99
1962-09-18,59.03,-0.05,-0.08,72.64,-18.74,True,1,8689,-59.03,-207106.08,512911.67,305805.59
1962-09-19,58.95,-0.08,-0.14,72.64,-18.85,True,1,8690,-58.95,-207165.03,512275.5,305110.47
1962-09-20,58.54,-0.41,-0.7,72.64,-19.41,True,1,8691,-58.54,-207223.57,508771.14,301547.57
1962-09-21,57.69,-0.85,-1.45,72.64,-20.58,True,1,8692,-57.69,-207281.26,501441.48,294160.22
1962-09-24,56.63,-1.06,-1.84,72.64,-22.04,True,1,8693,-56.63,-207337.89,492284.59,284946.7
1962-09-25,56.96,0.33,0.58,72.64,-21.59,True,1,8694,-56.96,-207394.85,495210.24,287815.39
1962-09-26,56.15,-0.81,-1.42,72.64,-22.7,True,1,8695,-56.15,-207451.0,488224.25,280773.25
1962-09-27,55.77,-0.38,-0.68,72.64,-23.22,True,1,8696,-55.77,-207506.77,484975.92,277469.15
1962-09-28,56.27,0.5,0.9,72.64,-22.54,True,1,8697,-56.27,-207563.04,489380.19,281817.15
1962-10-01,55.49,-0.78,-1.39,72.64,-23.61,True,1,8698,-55.49,-207618.53,482652.02,275033.49
1962-10-02,56.1,0.61,1.1,72.64,-22.77,True,1,8699,-56.1,-207674.63,488013.9,280339.27
1962-10-03,56.16,0.06,0.11,72.64,-22.69,True,1,8700,-56.16,-207730.79,488592.0,280861.21
1962-10-04,56.7,0.54,0.96,72.64,-21.94,True,1,8701,-56.7,-207787.49,493346.7,285559.21
1962-10-05,57.07,0.37,0.65,72.64,-21.43,True,1,8702,-57.07,-207844.56,496623.14,288778.58
1962-10-08,57.07,0.0,0.0,72.64,-21.43,True,1,8703,-57.07,-207901.63,496680.21,288778.58
1962-10-09,57.2,0.13,0.23,72.64,-21.26,True,1,8704,-57.2,-207958.83,497868.8,289909.97
1962-10-10,57.24,0.04,0.07,72.64,-21.2,True,1,8705,-57.24,-208016.07,498274.2,290258.13
1962-10-11,57.05,-0.19,-0.33,72.64,-21.46,True,1,8706,-57.05,-208073.12,496677.3,288604.18
1962-10-12,56.95,-0.1,-0.18,72.64,-21.6,True,1,8707,-56.95,-208130.07,495863.65,287733.58
1962-10-15,57.27,0.32,0.56,72.64,-21.16,True,1,8708,-57.27,-208187.34,498707.16,290519.82
1962-10-16,57.08,-0.19,-0.33,72.64,-21.42,True,1,8709,-57.08,-208244.42,497109.72,288865.3
1962-10-17,56.89,-0.19,-0.33,72.64,-21.68,True,1,8710,-56.89,-208301.31,495511.9,287210.59
1962-10-18,56.34,-0.55,-0.97,72.64,-22.44,True,1,8711,-56.34,-208357.65,490777.74,282420.09
1962-10-19,55.59,-0.75,-1.33,72.64,-23.47,True,1,8712,-55.59,-208413.24,484300.08,275886.84
1962-10-22,54.96,-0.63,-1.13,72.64,-24.34,True,1,8713,-54.96,-208468.2,478866.48,270398.28
1962-10-23,53.49,-1.47,-2.68,72.64,-26.36,True,1,8714,-53.49,-208521.69,466111.86,257590.17
1962-10-24,55.21,1.72,3.22,72.64,-24.0,True,1,8715,-55.21,-208576.9,481155.15,272578.25
1962-10-25,54.69,-0.52,-0.94,72.64,-24.71,True,1,8716,-54.69,-208631.59,476678.04,268046.45
1962-10-26,54.54,-0.15,-0.27,72.64,-24.92,True,1,8717,-54.54,-208686.13,475425.18,266739.05
1962-10-29,55.72,1.18,2.16,72.64,-23.29,True,1,8718,-55.72,-208741.85,485766.96,277025.11
1962-10-30,56.54,0.82,1.47,72.64,-22.16,True,1,8719,-56.54,-208798.39,492972.26,284173.87
1962-10-31,56.52,-0.02,-0.04,72.64,-22.19,True,1,8720,-56.52,-208854.91,492854.4,283999.49
1962-11-01,57.12,0.6,1.06,72.64,-21.37,True,1,8721,-57.12,-208912.03,498143.52,289231.49
1962-11-02,57.75,0.63,1.1,72.64,-20.5,True,1,8722,-57.75,-208969.78,503695.5,294725.72
1962-11-05,58.35,0.6,1.04,72.64,-19.67,True,1,8723,-58.35,-209028.13,508987.05,299958.92
1962-11-07,58.71,0.36,0.62,72.64,-19.18,True,1,8724,-58.71,-209086.84,512186.04,303099.2
1962-11-08,58.32,-0.39,-0.66,72.64,-19.71,True,1,8725,-58.32,-209145.16,508842.0,299696.84
1962-11-09,58.78,0.46,0.79,72.64,-19.08,True,1,8726,-58.78,-209203.94,512914.28,303710.34
1962-11-12,59.59,0.81,1.38,72.64,-17.96,True,1,8727,-59.59,-209263.53,520041.93,310778.4
1962-11-13,59.46,-0.13,-0.22,72.64,-18.14,True,1,8728,-59.46,-209322.99,518966.88,309643.89
1962-11-14,60.16,0.7,1.18,72.64,-17.18,True,1,8729,-60.16,-209383.15,525136.64,315753.49
1962-11-15,59.97,-0.19,-0.32,72.64,-17.44,True,1,8730,-59.97,-209443.12,523538.1,314094.98
1962-11-16,60.16,0.19,0.32,72.64,-17.18,True,1,8731,-60.16,-209503.28,525256.96,315753.68
1962-11-19,59.82,-0.34,-0.56,72.64,-17.65,True,1,8732,-59.82,-209563.1,522348.24,312785.14
1962-11-20,60.45,0.63,1.05,72.64,-16.78,True,1,8733,-60.45,-209623.55,527909.85,318286.3
1962-11-21,60.81,0.36,0.6,72.64,-16.29,True,1,8734,-60.81,-209684.36,531114.54,321430.18
1962-11-23,61.54,0.73,1.2,72.64,-15.28,True,1,8735,-61.54,-209745.9,537551.9,327806.0
1962-11-26,61.36,-0.18,-0.29,72.64,-15.53,True,1,8736,-61.36,-209807.26,536040.96,326233.7
1962-11-27,61.73,0.37,0.6,72.64,-15.02,True,1,8737,-61.73,-209868.99,539335.01,329466.02
1962-11-28,62.12,0.39,0.63,72.64,-14.48,True,1,8738,-62.12,-209931.11,542804.56,332873.45
1962-11-29,62.41,0.29,0.47,72.64,-14.08,True,1,8739,-62.41,-209993.52,545400.99,335407.47
1962-11-30,62.26,-0.15,-0.24,72.64,-14.29,True,1,8740,-62.26,-210055.78,544152.4,334096.62
1962-12-03,61.94,-0.32,-0.51,72.64,-14.73,True,1,8741,-61.94,-210117.72,541417.54,331299.82
1962-12-04,62.64,0.7,1.13,72.64,-13.77,True,1,8742,-62.64,-210180.36,547598.88,337418.52
1962-12-05,62.39,-0.25,-0.4,72.64,-14.11,True,1,8743,-62.39,-210242.75,545475.77,335233.02
1962-12-06,62.93,0.54,0.87,72.64,-13.37,True,1,8744,-62.93,-210305.68,550259.92,339954.24
1962-12-07,63.06,0.13,0.21,72.64,-13.19,True,1,8745,-63.06,-210368.74,551459.7,341090.96
1962-12-10,62.27,-0.79,-1.25,72.64,-14.28,True,1,8746,-62.27,-210431.01,544613.42,334182.41
1962-12-11,62.32,0.05,0.08,72.64,-14.21,True,1,8747,-62.32,-210493.33,545113.04,334619.71
1962-12-12,62.63,0.31,0.5,72.64,-13.78,True,1,8748,-62.63,-210555.96,547887.24,337331.28
1962-12-13,62.42,-0.21,-0.34,72.64,-14.07,True,1,8749,-62.42,-210618.38,546112.58,335494.2
1962-12-14,62.57,0.15,0.24,72.64,-13.86,True,1,8750,-62.57,-210680.95,547487.5,336806.55
1962-12-17,62.37,-0.2,-0.32,72.64,-14.14,True,1,8751,-62.37,-210743.32,545799.87,335056.55
1962-12-18,62.07,-0.3,-0.48,72.64,-14.55,True,1,8752,-62.07,-210805.39,543236.64,332431.25
1962-12-19,62.58,0.51,0.82,72.64,-13.85,True,1,8753,-62.58,-210867.97,547762.74,336894.77
1962-12-20,62.82,0.24,0.38,72.64,-13.52,True,1,8754,-62.82,-210930.79,549926.28,338995.49
1962-12-21,62.64,-0.18,-0.29,72.64,-13.77,True,1,8755,-62.64,-210993.43,548413.2,337419.77
1962-12-24,62.63,-0.01,-0.02,72.64,-13.78,True,1,8756,-62.63,-211056.06,548388.28,337332.22
1962-12-26,63.02,0.39,0.62,72.64,-13.24,True,1,8757,-63.02,-211119.08,551866.14,340747.06
1962-12-27,62.93,-0.09,-0.14,72.64,-13.37,True,1,8758,-62.93,-211182.01,551140.94,339958.93
1962-12-28,62.96,0.03,0.05,72.64,-13.33,True,1,8759,-62.96,-211244.97,551466.64,340221.67
1962-12-31,63.1,0.14,0.22,72.64,-13.13,True,1,8760,-63.1,-211308.07,552756.0,341447.93
1963-01-02,62.69,-0.41,-0.65,72.64,-13.7,True,1,8761,-62.69,-211370.76,549227.09,337856.33
1963-01-03,63.72,1.03,1.64,72.64,-12.28,True,1,8762,-63.72,-211434.48,558314.64,346880.16
1963-01-04,64.13,0.41,0.64,72.64,-11.72,True,1,8763,-64.13,-211498.61,561971.19,350472.58
1963-01-07,64.12,-0.01,-0.02,72.64,-11.73,True,1,8764,-64.12,-211562.73,561947.68,350384.95
1963-01-08,64.74,0.62,0.97,72.64,-10.88,True,1,8765,-64.74,-211627.47,567446.1,355818.63
1963-01-09,64.59,-0.15,-0.23,72.64,-11.08,True,1,8766,-64.59,-211692.06,566195.94,354503.88
1963-01-10,64.71,0.12,0.19,72.64,-10.92,True,1,8767,-64.71,-211756.77,567312.57,355555.8
1963-01-11,64.85,0.14,0.22,72.64,-10.72,True,1,8768,-64.85,-211821.62,568604.8,356783.18
1963-01-14,65.2,0.35,0.54,72.64,-10.24,True,1,8769,-65.2,-211886.82,571738.8,359851.98
1963-01-15,65.11,-0.09,-0.14,72.64,-10.37,True,1,8770,-65.11,-211951.93,571014.7,359062.77
1963-01-16,64.67,-0.44,-0.68,72.64,-10.97,True,1,8771,-64.67,-212016.6,567220.57,355203.97
1963-01-17,65.13,0.46,0.71,72.64,-10.34,True,1,8772,-65.13,-212081.73,571320.36,359238.63
1963-01-18,65.18,0.05,0.08,72.64,-10.27,True,1,8773,-65.18,-212146.91,571824.14,359677.23
1963-01-21,65.28,0.1,0.15,72.64,-10.13,True,1,8774,-65.28,-212212.19,572766.72,360554.53
1963-01-22,65.44,0.16,0.24,72.64,-9.91,True,1,8775,-65.44,-212277.63,574236.0,361958.37
1963-01-23,65.62,0.18,0.28,72.64,-9.66,True,1,8776,-65.62,-212343.25,575881.12,363537.87
1963-01-24,65.75,0.13,0.2,72.64,-9.48,True,1,8777,-65.75,-212409.0,577087.75,364678.75
1963-01-25,65.92,0.17,0.26,72.64,-9.25,True,1,8778,-65.92,-212474.92,578645.76,366170.84
1963-01-28,66.24,0.32,0.48,72.64,-8.81,True,1,8779,-66.24,-212541.16,581520.96,368979.8
1963-01-29,66.23,-0.01,-0.02,72.64,-8.82,True,1,8780,-66.23,-212607.39,581499.4,368892.01
1963-01-30,65.85,-0.38,-0.57,72.64,-9.35,True,1,8781,-65.85,-212673.24,578228.85,365555.61
1963-01-31,66.2,0.35,0.53,72.64,-8.87,True,1,8782,-66.2,-212739.44,581368.4,368628.96
1963-02-01,66.31,0.11,0.17,72.64,-8.71,True,1,8783,-66.31,-212805.75,582400.73,369594.98
1963-02-04,66.17,-0.14,-0.21,72.64,-8.91,True,1,8784,-66.17,-212871.92,581237.28,368365.36
1963-02-05,66.11,-0.06,-0.09,72.64,-8.99,True,1,8785,-66.11,-212938.03,580776.35,367838.32
1963-02-06,66.4,0.29,0.44,72.64,-8.59,True,1,8786,-66.4,-213004.43,583390.4,370385.97
1963-02-07,66.17,-0.23,-0.35,72.64,-8.91,True,1,8787,-66.17,-213070.6,581435.79,368365.19
1963-02-08,66.17,0.0,0.0,72.64,-8.91,True,1,8788,-66.17,-213136.77,581501.96,368365.19
1963-02-11,65.76,-0.41,-0.62,72.64,-9.47,True,1,8789,-65.76,-213202.53,577964.64,364762.11
1963-02-12,65.83,0.07,0.11,72.64,-9.38,True,1,8790,-65.83,-213268.36,578645.7,365377.34
1963-02-13,66.15,0.32,0.49,72.64,-8.93,True,1,8791,-66.15,-213334.51,581524.65,368190.14
1963-02-14,66.35,0.2,0.3,72.64,-8.66,True,1,8792,-66.35,-213400.86,583349.2,369948.34
1963-02-15,66.41,0.06,0.09,72.64,-8.58,True,1,8793,-66.41,-213467.27,583943.13,370475.86
1963-02-18,66.52,0.11,0.17,72.64,-8.43,True,1,8794,-66.52,-213533.79,584976.88,371443.09
1963-02-19,66.2,-0.32,-0.48,72.64,-8.87,True,1,8795,-66.2,-213599.99,582229.0,368629.01
1963-02-20,65.83,-0.37,-0.56,72.64,-9.38,True,1,8796,-65.83,-213665.82,579040.68,365374.86
1963-02-21,65.92,0.09,0.14,72.64,-9.25,True,1,8797,-65.92,-213731.74,579898.24,366166.5
1963-02-25,65.46,-0.46,-0.7,72.64,-9.88,True,1,8798,-65.46,-213797.2,575917.08,362119.88
1963-02-26,65.47,0.01,0.02,72.64,-9.87,True,1,8799,-65.47,-213862.67,576070.53,362207.86
1963-02-27,65.01,-0.46,-0.7,72.64,-10.5,True,1,8800,-65.01,-213927.68,572088.0,358160.32
1963-02-28,64.29,-0.72,-1.11,72.64,-11.5,True,1,8801,-64.29,-213991.97,565816.29,351824.32
1963-03-01,64.1,-0.19,-0.3,72.64,-11.76,True,1,8802,-64.1,-214056.07,564208.2,350152.13
1963-03-04,64.72,0.62,0.97,72.64,-10.9,True,1,8803,-64.72,-214120.79,569730.16,355609.37
1963-03-05,64.74,0.02,0.03,72.64,-10.88,True,1,8804,-64.74,-214185.53,569970.96,355785.43
1963-03-06,64.85,0.11,0.17,72.64,-10.72,True,1,8805,-64.85,-214250.38,571004.25,356753.87
1963-03-07,65.26,0.41,0.63,72.64,-10.16,True,1,8806,-65.26,-214315.64,574679.56,360363.92
1963-03-08,65.33,0.07,0.11,72.64,-10.06,True,1,8807,-65.33,-214380.97,575361.31,360980.34
1963-03-11,65.51,0.18,0.28,72.64,-9.82,True,1,8808,-65.51,-214446.48,577012.08,362565.6
1963-03-12,65.67,0.16,0.24,72.64,-9.6,True,1,8809,-65.67,-214512.15,578487.03,363974.88
1963-03-13,65.91,0.24,0.36,72.64,-9.26,True,1,8810,-65.91,-214578.06,580667.1,366089.04
1963-03-14,65.6,-0.31,-0.47,72.64,-9.69,True,1,8811,-65.6,-214643.66,578001.6,363357.94
1963-03-15,65.93,0.33,0.5,72.64,-9.24,True,1,8812,-65.93,-214709.59,580975.16,366265.57
1963-03-18,65.61,-0.32,-0.48,72.64,-9.68,True,1,8813,-65.61,-214775.2,578220.93,363445.73
1963-03-19,65.47,-0.14,-0.21,72.64,-9.87,True,1,8814,-65.47,-214840.67,577052.58,362211.91
1963-03-20,65.95,0.48,0.73,72.64,-9.21,True,1,8815,-65.95,-214906.62,581349.25,366442.63
1963-03-21,65.85,-0.1,-0.15,72.64,-9.35,True,1,8816,-65.85,-214972.47,580533.6,365561.13
1963-03-22,66.19,0.34,0.52,72.64,-8.88,True,1,8817,-66.19,-215038.66,583597.23,368558.57
1963-03-25,66.21,0.02,0.03,72.64,-8.85,True,1,8818,-66.21,-215104.87,583839.78,368734.91
1963-03-26,66.4,0.19,0.29,72.64,-8.59,True,1,8819,-66.4,-215171.27,585581.6,370410.33
1963-03-27,66.68,0.28,0.42,72.64,-8.2,True,1,8820,-66.68,-215237.95,588117.6,372879.65
1963-03-28,66.58,-0.1,-0.15,72.64,-8.34,True,1,8821,-66.58,-215304.53,587302.18,371997.65
1963-03-29,66.57,-0.01,-0.02,72.64,-8.36,True,1,8822,-66.57,-215371.1,587280.54,371909.44
1963-04-01,66.85,0.28,0.42,72.64,-7.97,True,1,8823,-66.85,-215437.95,589817.55,374379.6
1963-04-02,66.84,-0.01,-0.02,72.64,-7.98,True,1,8824,-66.84,-215504.79,589796.16,374291.37
1963-04-03,67.36,0.52,0.78,72.64,-7.27,True,1,8825,-67.36,-215572.15,594452.0,378879.85
1963-04-04,67.85,0.49,0.73,72.64,-6.59,True,1,8826,-67.85,-215640.0,598844.1,383204.1
1963-04-05,68.28,0.43,0.63,72.64,-6.0,True,1,8827,-68.28,-215708.28,602707.56,386999.28
1963-04-08,68.52,0.24,0.35,72.64,-5.67,True,1,8828,-68.52,-215776.8,604894.56,389117.76
1963-04-09,68.45,-0.07,-0.1,72.64,-5.77,True,1,8829,-68.45,-215845.25,604345.05,388499.8
1963-04-10,68.29,-0.16,-0.23,72.64,-5.99,True,1,8830,-68.29,-215913.54,603000.7,387087.16
1963-04-11,68.77,0.48,0.7,72.64,-5.33,True,1,8831,-68.77,-215982.31,607307.87,391325.56
1963-04-15,69.09,0.32,0.46,72.64,-4.89,True,1,8832,-69.09,-216051.4,610202.88,394151.48
1963-04-16,69.14,0.05,0.07,72.64,-4.82,True,1,8833,-69.14,-216120.54,610713.62,394593.08
1963-04-17,68.92,-0.22,-0.32,72.64,-5.12,True,1,8834,-68.92,-216189.46,608839.28,392649.82
1963-04-18,68.89,-0.03,-0.04,72.64,-5.16,True,1,8835,-68.89,-216258.35,608643.15,392384.8
1963-04-19,69.23,0.34,0.49,72.64,-4.69,True,1,8836,-69.23,-216327.58,611716.28,395388.7
1963-04-22,69.3,0.07,0.1,72.64,-4.6,True,1,8837,-69.3,-216396.88,612404.1,396007.22
1963-04-23,69.53,0.23,0.33,72.64,-4.28,True,1,8838,-69.53,-216466.41,614506.14,398039.73
1963-04-24,69.72,0.19,0.27,72.64,-4.02,True,1,8839,-69.72,-216536.13,616255.08,399718.95
1963-04-25,69.76,0.04,0.06,72.64,-3.96,True,1,8840,-69.76,-216605.89,616678.4,400072.51
1963-04-26,69.7,-0.06,-0.09,72.64,-4.05,True,1,8841,-69.7,-216675.59,616217.7,399542.11
1963-04-29,69.65,-0.05,-0.07,72.64,-4.12,True,1,8842,-69.65,-216745.24,615845.3,399100.06
1963-04-30,69.8,0.15,0.22,72.64,-3.91,True,1,8843,-69.8,-216815.04,617241.4,400426.36
1963-05-01,69.97,0.17,0.24,72.64,-3.68,True,1,8844,-69.97,-216885.01,618814.68,401929.67
1963-05-02,70.17,0.2,0.29,72.64,-3.4,True,1,8845,-70.17,-216955.18,620653.65,403698.47
1963-05-03,70.03,-0.14,-0.2,72.64,-3.59,True,1,8846,-70.03,-217025.21,619485.38,402460.17
1963-05-06,69.53,-0.5,-0.71,72.64,-4.28,True,1,8847,-69.53,-217094.74,615131.91,398037.17
1963-05-07,69.44,-0.09,-0.13,72.64,-4.4,True,1,8848,-69.44,-217164.18,614405.12,397240.94
1963-05-08,70.01,0.57,0.82,72.64,-3.62,True,1,8849,-70.01,-217234.19,619518.49,402284.3
1963-05-09,70.35,0.34,0.49,72.64,-3.15,True,1,8850,-70.35,-217304.54,622597.5,405292.96
1963-05-10,70.52,0.17,0.24,72.64,-2.92,True,1,8851,-70.52,-217375.06,624172.52,406797.46
1963-05-13,70.48,-0.04,-0.06,72.64,-2.97,True,1,8852,-70.48,-217445.54,623888.96,406443.42
1963-05-14,70.21,-0.27,-0.38,72.64,-3.34,True,1,8853,-70.21,-217515.75,621569.13,404053.38
1963-05-15,70.43,0.22,0.31,72.64,-3.04,True,1,8854,-70.43,-217586.18,623587.22,406001.04
1963-05-16,70.25,-0.18,-0.26,72.64,-3.29,True,1,8855,-70.25,-217656.43,622063.75,404407.32
1963-05-17,70.29,0.04,0.06,72.64,-3.24,True,1,8856,-70.29,-217726.72,622488.24,404761.52
1963-05-20,69.96,-0.33,-0.47,72.64,-3.69,True,1,8857,-69.96,-217796.68,619635.72,401839.04
1963-05-21,70.14,0.18,0.26,72.64,-3.44,True,1,8858,-70.14,-217866.82,621300.12,403433.3
1963-05-22,70.14,0.0,0.0,72.64,-3.44,True,1,8859,-70.14,-217936.96,621370.26,403433.3
1963-05-23,70.1,-0.04,-0.06,72.64,-3.5,True,1,8860,-70.1,-218007.06,621086.0,403078.94
1963-05-24,70.02,-0.08,-0.11,72.64,-3.61,True,1,8861,-70.02,-218077.08,620447.22,402370.14
1963-05-27,69.87,-0.15,-0.21,72.64,-3.81,True,1,8862,-69.87,-218146.95,619187.94,401040.99
1963-05-28,70.01,0.14,0.2,72.64,-3.62,True,1,8863,-70.01,-218216.96,620498.63,402281.67
1963-05-29,70.33,0.32,0.46,72.64,-3.18,True,1,8864,-70.33,-218287.29,623405.12,405117.83
1963-05-31,70.8,0.47,0.67,72.64,-2.53,True,1,8865,-70.8,-218358.09,627642.0,409283.91
1963-06-03,70.69,-0.11,-0.16,72.64,-2.68,True,1,8866,-70.69,-218428.78,626737.54,408308.76
1963-06-04,70.7,0.01,0.01,72.64,-2.67,True,1,8867,-70.7,-218499.48,626896.9,408397.42
1963-06-05,70.53,-0.17,-0.24,72.64,-2.9,True,1,8868,-70.53,-218570.01,625460.04,406890.03
1963-06-06,70.58,0.05,0.07,72.64,-2.84,True,1,8869,-70.58,-218640.59,625974.02,407333.43
1963-06-07,70.41,-0.17,-0.24,72.64,-3.07,True,1,8870,-70.41,-218711.0,624536.7,405825.7
1963-06-10,69.94,-0.47,-0.67,72.64,-3.72,True,1,8871,-69.94,-218780.94,620437.74,401656.8
1963-06-11,70.03,0.09,0.13,72.64,-3.59,True,1,8872,-70.03,-218850.97,621306.16,402455.19
1963-06-12,70.41,0.38,0.54,72.64,-3.07,True,1,8873,-70.41,-218921.38,624747.93,405826.55
1963-06-13,70.23,-0.18,-0.26,72.64,-3.32,True,1,8874,-70.23,-218991.61,623221.02,404229.41
1963-06-14,70.25,0.02,0.03,72.64,-3.29,True,1,8875,-70.25,-219061.86,623468.75,404406.89
1963-06-17,69.95,-0.3,-0.43,72.64,-3.7,True,1,8876,-69.95,-219131.81,620876.2,401744.39
1963-06-18,70.02,0.07,0.1,72.64,-3.61,True,1,8877,-70.02,-219201.83,621567.54,402365.71
1963-06-19,70.09,0.07,0.1,72.64,-3.51,True,1,8878,-70.09,-219271.92,622259.02,402987.1
1963-06-20,70.01,-0.08,-0.11,72.64,-3.62,True,1,8879,-70.01,-219341.93,621618.79,402276.86
1963-06-21,70.25,0.24,0.34,72.64,-3.29,True,1,8880,-70.25,-219412.18,623820.0,404407.82
1963-06-24,70.2,-0.05,-0.07,72.64,-3.36,True,1,8881,-70.2,-219482.38,623446.2,403963.82
1963-06-25,70.04,-0.16,-0.23,72.64,-3.58,True,1,8882,-70.04,-219552.42,622095.28,402542.86
1963-06-26,69.41,-0.63,-0.9,72.64,-4.45,True,1,8883,-69.41,-219621.83,616569.03,396947.2
1963-06-27,69.07,-0.34,-0.49,72.64,-4.92,True,1,8884,-69.07,-219690.9,613617.88,393926.98
1963-06-28,69.37,0.3,0.43,72.64,-4.5,True,1,8885,-69.37,-219760.27,616352.45,396592.18
1963-07-01,68.86,-0.51,-0.74,72.64,-5.2,True,1,8886,-68.86,-219829.13,611889.96,392060.83
1963-07-02,69.46,0.6,0.87,72.64,-4.38,True,1,8887,-69.46,-219898.59,617291.02,397392.43
1963-07-03,69.94,0.48,0.69,72.64,-3.72,True,1,8888,-69.94,-219968.53,621626.72,401658.19
1963-07-05,70.22,0.28,0.4,72.64,-3.33,True,1,8889,-70.22,-220038.75,624185.58,404146.83
1963-07-08,69.74,-0.48,-0.68,72.64,-3.99,True,1,8890,-69.74,-220108.49,619988.6,399880.11
1963-07-09,70.04,0.3,0.43,72.64,-3.58,True,1,8891,-70.04,-220178.53,622725.64,402547.11
1963-07-10,69.89,-0.15,-0.21,72.64,-3.79,True,1,8892,-69.89,-220248.42,621461.88,401213.46
1963-07-11,69.76,-0.13,-0.19,72.64,-3.96,True,1,8893,-69.76,-220318.18,620375.68,400057.5
1963-07-12,69.64,-0.12,-0.17,72.64,-4.13,True,1,8894,-69.64,-220387.82,619378.16,398990.34
1963-07-15,69.2,-0.44,-0.63,72.64,-4.74,True,1,8895,-69.2,-220457.02,615534.0,395076.98
1963-07-16,69.14,-0.06,-0.09,72.64,-4.82,True,1,8896,-69.14,-220526.16,615069.44,394543.28
1963-07-17,68.93,-0.21,-0.3,72.64,-5.11,True,1,8897,-68.93,-220595.09,613270.21,392675.12
1963-07-18,68.49,-0.44,-0.64,72.64,-5.71,True,1,8898,-68.49,-220663.58,609424.02,388760.44
1963-07-19,68.35,-0.14,-0.2,72.64,-5.91,True,1,8899,-68.35,-220731.93,608246.65,387514.72
1963-07-22,67.9,-0.45,-0.66,72.64,-6.52,True,1,8900,-67.9,-220799.83,604310.0,383510.17
1963-07-23,67.91,0.01,0.02,72.64,-6.51,True,1,8901,-67.91,-220867.74,604466.91,383599.17
1963-07-24,68.28,0.37,0.55,72.64,-6.0,True,1,8902,-68.28,-220936.02,607828.56,386892.54
1963-07-25,68.26,-0.02,-0.03,72.64,-6.03,True,1,8903,-68.26,-221004.28,607718.78,386714.5
1963-07-26,68.54,0.28,0.41,72.64,-5.64,True,1,8904,-68.54,-221072.82,610280.16,389207.34
1963-07-29,68.67,0.13,0.19,72.64,-5.46,True,1,8905,-68.67,-221141.49,611506.35,390364.86
1963-07-30,69.24,0.57,0.83,72.64,-4.68,True,1,8906,-69.24,-221210.73,616651.44,395440.71
1963-07-31,69.13,-0.11,-0.16,72.64,-4.83,True,1,8907,-69.13,-221279.86,615740.91,394461.05
1963-08-01,69.07,-0.06,-0.09,72.64,-4.92,True,1,8908,-69.07,-221348.93,615275.56,393926.63
1963-08-02,69.3,0.23,0.33,72.64,-4.6,True,1,8909,-69.3,-221418.23,617393.7,395975.47
1963-08-05,69.71,0.41,0.59,72.64,-4.03,True,1,8910,-69.71,-221487.94,621116.1,399628.16
1963-08-06,70.17,0.46,0.66,72.64,-3.4,True,1,8911,-70.17,-221558.11,625284.87,403726.76
1963-08-07,69.96,-0.21,-0.3,72.64,-3.69,True,1,8912,-69.96,-221628.07,623483.52,401855.45
1963-08-08,70.02,0.06,0.09,72.64,-3.61,True,1,8913,-70.02,-221698.09,624088.26,402390.17
1963-08-09,70.48,0.46,0.66,72.64,-2.97,True,1,8914,-70.48,-221768.57,628258.72,406490.15
1963-08-12,70.59,0.11,0.16,72.64,-2.82,True,1,8915,-70.59,-221839.16,629309.85,407470.69
1963-08-13,70.79,0.2,0.28,72.64,-2.55,True,1,8916,-70.79,-221909.95,631163.64,409253.69
1963-08-14,71.07,0.28,0.4,72.64,-2.16,True,1,8917,-71.07,-221981.02,633731.19,411750.17
1963-08-15,71.38,0.31,0.44,72.64,-1.74,True,1,8918,-71.38,-222052.4,636566.84,414514.44
1963-08-16,71.49,0.11,0.15,72.64,-1.58,True,1,8919,-71.49,-222123.89,637619.31,415495.42
1963-08-19,71.44,-0.05,-0.07,72.64,-1.65,True,1,8920,-71.44,-222195.33,637244.8,415049.47
1963-08-20,71.38,-0.06,-0.08,72.64,-1.74,True,1,8921,-71.38,-222266.71,636780.98,414514.27
1963-08-21,71.29,-0.09,-0.13,72.64,-1.86,True,1,8922,-71.29,-222338.0,636049.38,413711.38
1963-08-22,71.54,0.25,0.35,72.64,-1.51,True,1,8923,-71.54,-222409.54,638351.42,415941.88
1963-08-23,71.76,0.22,0.31,72.64,-1.21,True,1,8924,-71.76,-222481.3,640386.24,417904.94
1963-08-26,71.91,0.15,0.21,72.64,-1.0,True,1,8925,-71.91,-222553.21,641796.75,419243.54
1963-08-27,71.52,-0.39,-0.54,72.64,-1.54,True,1,8926,-71.52,-222624.73,638387.52,415762.79
1963-08-28,72.04,0.52,0.73,72.64,-0.83,True,1,8927,-72.04,-222696.77,643101.08,420404.31
1963-08-29,72.16,0.12,0.17,72.64,-0.66,True,1,8928,-72.16,-222768.93,644244.48,421475.55
1963-08-30,72.5,0.34,0.47,72.64,-0.19,True,1,8929,-72.5,-222841.43,647352.5,424511.07
1963-09-03,72.66,0.16,0.22,72.66,0.0,True,1,8930,-72.66,-222914.09,648853.8,425939.71
1963-09-04,72.64,-0.02,-0.03,72.66,-0.03,True,1,8931,-72.64,-222986.73,648747.84,425761.11
1963-09-05,73.0,0.36,0.5,73.0,0.0,True,1,8932,-73.0,-223059.73,652036.0,428976.27
1963-09-06,72.84,-0.16,-0.22,73.0,-0.22,True,1,8933,-72.84,-223132.57,650679.72,427547.15
1963-09-09,72.58,-0.26,-0.36,73.0,-0.57,True,1,8934,-72.58,-223205.15,648429.72,425224.57
1963-09-10,72.99,0.41,0.56,73.0,-0.01,True,1,8935,-72.99,-223278.14,652165.65,428887.51
1963-09-11,73.2,0.21,0.29,73.2,0.0,True,1,8936,-73.2,-223351.34,654115.2,430763.86
1963-09-12,73.15,-0.05,-0.07,73.2,-0.07,True,1,8937,-73.15,-223424.49,653741.55,430317.06
1963-09-13,73.17,0.02,0.03,73.2,-0.04,True,1,8938,-73.17,-223497.66,653993.46,430495.8
1963-09-16,73.07,-0.1,-0.14,73.2,-0.18,True,1,8939,-73.07,-223570.73,653172.73,429602.0
1963-09-17,73.12,0.05,0.07,73.2,-0.11,True,1,8940,-73.12,-223643.85,653692.8,430048.95
1963-09-18,72.8,-0.32,-0.44,73.2,-0.55,True,1,8941,-72.8,-223716.65,650904.8,427188.15
1963-09-19,73.22,0.42,0.58,73.22,0.0,True,1,8942,-73.22,-223789.87,654733.24,430943.37
1963-09-20,73.3,0.08,0.11,73.3,0.0,True,1,8943,-73.3,-223863.17,655521.9,431658.73
1963-09-23,72.96,-0.34,-0.46,73.3,-0.46,True,1,8944,-72.96,-223936.13,652554.24,428618.11
1963-09-24,73.3,0.34,0.47,73.3,0.0,True,1,8945,-73.3,-224009.43,655668.5,431659.07
1963-09-25,72.89,-0.41,-0.56,73.3,-0.56,True,1,8946,-72.89,-224082.32,652073.94,427991.62
1963-09-26,72.27,-0.62,-0.85,73.3,-1.4,True,1,8947,-72.27,-224154.59,646599.69,422445.1
1963-09-27,72.13,-0.14,-0.19,73.3,-1.6,True,1,8948,-72.13,-224226.72,645419.24,421192.52
1963-09-30,71.7,-0.43,-0.6,73.3,-2.18,True,1,8949,-71.7,-224298.42,641643.3,417344.88
1963-10-01,72.22,0.52,0.72,73.3,-1.47,True,1,8950,-72.22,-224370.64,646369.0,421998.36
1963-10-02,72.3,0.08,0.11,73.3,-1.36,True,1,8951,-72.3,-224442.94,647157.3,422714.36
1963-10-03,72.83,0.53,0.73,73.3,-0.64,True,1,8952,-72.83,-224515.77,651974.16,427458.39
1963-10-04,72.85,0.02,0.03,73.3,-0.61,True,1,8953,-72.85,-224588.62,652226.05,427637.43
1963-10-07,72.7,-0.15,-0.21,73.3,-0.82,True,1,8954,-72.7,-224661.32,650955.8,426294.48
1963-10-08,72.6,-0.1,-0.14,73.3,-0.96,True,1,8955,-72.6,-224733.92,650133.0,425399.08
1963-10-09,71.87,-0.73,-1.01,73.3,-1.95,True,1,8956,-71.87,-224805.79,643667.72,418861.93
1963-10-10,72.2,0.33,0.46,73.3,-1.5,True,1,8957,-72.2,-224877.99,646695.4,421817.41
1963-10-11,72.27,0.07,0.1,73.3,-1.4,True,1,8958,-72.27,-224950.26,647394.66,422444.4
1963-10-14,72.3,0.03,0.04,73.3,-1.36,True,1,8959,-72.3,-225022.56,647735.7,422713.14
1963-10-15,72.4,0.1,0.14,73.3,-1.23,True,1,8960,-72.4,-225094.96,648704.0,423609.04
1963-10-16,72.97,0.57,0.79,73.3,-0.45,True,1,8961,-72.97,-225167.93,653884.17,428716.24
1963-10-17,73.26,0.29,0.4,73.3,-0.06,True,1,8962,-73.26,-225241.19,656556.12,431314.93
1963-10-18,73.32,0.06,0.08,73.32,0.0,True,1,8963,-73.32,-225314.51,657167.16,431852.65
1963-10-21,73.38,0.06,0.08,73.38,0.0,True,1,8964,-73.38,-225387.89,657778.32,432390.43
1963-10-22,72.96,-0.42,-0.57,73.38,-0.57,True,1,8965,-72.96,-225460.85,654086.4,428625.55
1963-10-23,73.0,0.04,0.06,73.38,-0.52,True,1,8966,-73.0,-225533.85,654518.0,428984.15
1963-10-24,73.28,0.28,0.38,73.38,-0.14,True,1,8967,-73.28,-225607.13,657101.76,431494.63
1963-10-25,74.01,0.73,1.0,74.01,0.0,True,1,8968,-74.01,-225681.14,663721.68,438040.54
1963-10-28,74.48,0.47,0.64,74.48,0.0,True,1,8969,-74.48,-225755.62,668011.12,442255.5
1963-10-29,74.46,-0.02,-0.03,74.48,-0.03,True,1,8970,-74.46,-225830.08,667906.2,442076.12
1963-10-30,73.8,-0.66,-0.89,74.48,-0.91,True,1,8971,-73.8,-225903.88,662059.8,436155.92
1963-10-31,74.01,0.21,0.28,74.48,-0.63,True,1,8972,-74.01,-225977.89,664017.72,438039.83
1963-11-01,73.83,-0.18,-0.24,74.48,-0.87,True,1,8973,-73.83,-226051.72,662476.59,436424.87
1963-11-04,73.45,-0.38,-0.52,74.48,-1.38,True,1,8974,-73.45,-226125.17,659140.3,433015.13
1963-11-06,72.81,-0.64,-0.87,74.48,-2.24,True,1,8975,-72.81,-226197.98,653469.75,427271.77
1963-11-07,73.06,0.25,0.34,74.48,-1.91,True,1,8976,-73.06,-226271.04,655786.56,429515.52
1963-11-08,73.36,0.3,0.41,74.48,-1.5,True,1,8977,-73.36,-226344.4,658552.72,432208.32
1963-11-11,73.52,0.16,0.22,74.48,-1.29,True,1,8978,-73.52,-226417.92,660062.56,433644.64
1963-11-12,73.23,-0.29,-0.39,74.48,-1.68,True,1,8979,-73.23,-226491.15,657532.17,431041.02
1963-11-13,73.29,0.06,0.08,74.48,-1.6,True,1,8980,-73.29,-226564.44,658144.2,431579.76
1963-11-14,72.95,-0.34,-0.46,74.48,-2.05,True,1,8981,-72.95,-226637.39,655163.95,428526.56
1963-11-15,72.35,-0.6,-0.82,74.48,-2.86,True,1,8982,-72.35,-226709.74,649847.7,423137.96
1963-11-18,71.83,-0.52,-0.72,74.48,-3.56,True,1,8983,-71.83,-226781.57,645248.89,418467.32
1963-11-19,71.9,0.07,0.1,74.48,-3.46,True,1,8984,-71.9,-226853.47,645949.6,419096.13
1963-11-20,72.56,0.66,0.92,74.48,-2.58,True,1,8985,-72.56,-226926.03,651951.6,425025.57
1963-11-21,71.62,-0.94,-1.3,74.48,-3.84,True,1,8986,-71.62,-226997.65,643577.32,416579.67
1963-11-22,69.61,-2.01,-2.81,74.48,-6.54,True,1,8987,-69.61,-227067.26,625585.07,398517.81
1963-11-26,72.38,2.77,3.98,74.48,-2.82,True,1,8988,-72.38,-227139.64,650551.44,423411.8
1963-11-27,72.25,-0.13,-0.18,74.48,-2.99,True,1,8989,-72.25,-227211.89,649455.25,422243.36
1963-11-29,73.23,0.98,1.36,74.48,-1.68,True,1,8990,-73.23,-227285.12,658337.7,431052.58
1963-12-02,73.66,0.43,0.59,74.48,-1.1,True,1,8991,-73.66,-227358.78,662277.06,434918.28
1963-12-03,73.62,-0.04,-0.05,74.48,-1.16,True,1,8992,-73.62,-227432.4,661991.04,434558.64
1963-12-04,73.8,0.18,0.24,74.48,-0.91,True,1,8993,-73.8,-227506.2,663683.4,436177.2
1963-12-05,74.28,0.48,0.65,74.48,-0.27,True,1,8994,-74.28,-227580.48,668074.32,440493.84
1963-12-06,74.0,-0.28,-0.38,74.48,-0.64,True,1,8995,-74.0,-227654.48,665630.0,437975.52
1963-12-09,73.96,-0.04,-0.05,74.48,-0.7,True,1,8996,-73.96,-227728.44,665344.16,437615.72
1963-12-10,73.99,0.03,0.04,74.48,-0.66,True,1,8997,-73.99,-227802.43,665688.03,437885.6
1963-12-11,73.9,-0.09,-0.12,74.48,-0.78,True,1,8998,-73.9,-227876.33,664952.2,437075.87
1963-12-12,73.91,0.01,0.01,74.48,-0.76,True,1,8999,-73.91,-227950.24,665116.09,437165.85
1963-12-13,74.06,0.15,0.2,74.48,-0.56,True,1,9000,-74.06,-228024.3,666540.0,438515.7
1963-12-16,74.3,0.24,0.32,74.48,-0.24,True,1,9001,-74.3,-228098.6,668774.3,440675.7
1963-12-17,74.74,0.44,0.59,74.74,0.0,True,1,9002,-74.74,-228173.34,672809.48,444636.14
1963-12-18,74.63,-0.11,-0.15,74.74,-0.15,True,1,9003,-74.63,-228247.97,671893.89,443645.92
1963-12-19,74.4,-0.23,-0.31,74.74,-0.46,True,1,9004,-74.4,-228322.37,669897.6,441575.23
1963-12-20,74.28,-0.12,-0.16,74.74,-0.62,True,1,9005,-74.28,-228396.65,668891.4,440494.75
1963-12-23,73.81,-0.47,-0.63,74.74,-1.24,True,1,9006,-73.81,-228470.46,664732.86,436262.4
1963-12-24,73.97,0.16,0.22,74.74,-1.03,True,1,9007,-73.97,-228544.43,666247.79,437703.36
1963-12-26,74.32,0.35,0.47,74.74,-0.56,True,1,9008,-74.32,-228618.75,669474.56,440855.81
1963-12-27,74.44,0.12,0.16,74.74,-0.4,True,1,9009,-74.44,-228693.19,670629.96,441936.77
1963-12-30,74.56,0.12,0.16,74.74,-0.24,True,1,9010,-74.56,-228767.75,671785.6,443017.85
1963-12-31,75.02,0.46,0.62,75.02,0.0,True,1,9011,-75.02,-228842.77,676005.22,447162.45
1964-01-02,75.43,0.41,0.55,75.43,0.0,True,1,9012,-75.43,-228918.2,679775.16,450856.96
1964-01-03,75.5,0.07,0.09,75.5,0.0,True,1,9013,-75.5,-228993.7,680481.5,451487.8
1964-01-06,75.67,0.17,0.22,75.67,0.0,True,1,9014,-75.67,-229069.37,682089.38,453020.01
1964-01-07,75.69,0.02,0.03,75.69,0.0,True,1,9015,-75.69,-229145.06,682345.35,453200.29
1964-01-08,76.0,0.31,0.41,76.0,0.0,True,1,9016,-76.0,-229221.06,685216.0,455994.94
1964-01-09,76.28,0.28,0.37,76.28,0.0,True,1,9017,-76.28,-229297.34,687816.76,458519.42
1964-01-10,76.24,-0.04,-0.05,76.28,-0.05,True,1,9018,-76.24,-229373.58,687532.32,458158.74
1964-01-13,76.22,-0.02,-0.03,76.28,-0.08,True,1,9019,-76.22,-229449.8,687428.18,457978.38
1964-01-14,76.36,0.14,0.18,76.36,0.0,True,1,9020,-76.36,-229526.16,688767.2,459241.04
1964-01-15,76.64,0.28,0.37,76.64,0.0,True,1,9021,-76.64,-229602.8,691369.44,461766.64
1964-01-16,76.55,-0.09,-0.12,76.64,-0.12,True,1,9022,-76.55,-229679.35,690634.1,460954.75
1964-01-17,76.56,0.01,0.01,76.64,-0.1,True,1,9023,-76.56,-229755.91,690800.88,461044.97
1964-01-20,76.41,-0.15,-0.2,76.64,-0.3,True,1,9024,-76.41,-229832.32,689523.84,459691.52
1964-01-21,76.62,0.21,0.28,76.64,-0.03,True,1,9025,-76.62,-229908.94,691495.5,461586.56
1964-01-22,77.03,0.41,0.54,77.03,0.0,True,1,9026,-77.03,-229985.97,695272.78,465286.81
1964-01-23,77.09,0.06,0.08,77.09,0.0,True,1,9027,-77.09,-230063.06,695891.43,465828.37
1964-01-24,77.11,0.02,0.03,77.11,0.0,True,1,9028,-77.11,-230140.17,696149.08,466008.91
1964-01-27,77.08,-0.03,-0.04,77.11,-0.04,True,1,9029,-77.08,-230217.25,695955.32,465738.07
1964-01-28,77.1,0.02,0.03,77.11,-0.01,True,1,9030,-77.1,-230294.35,696213.0,465918.65
1964-01-29,76.63,-0.47,-0.61,77.11,-0.62,True,1,9031,-76.63,-230370.98,692045.53,461674.55
1964-01-30,76.7,0.07,0.09,77.11,-0.53,True,1,9032,-76.7,-230447.68,692754.4,462306.72
1964-01-31,77.04,0.34,0.44,77.11,-0.09,True,1,9033,-77.04,-230524.72,695902.32,465377.6
1964-02-03,76.97,-0.07,-0.09,77.11,-0.18,True,1,9034,-76.97,-230601.69,695346.98,464745.29
1964-02-04,76.88,-0.09,-0.12,77.11,-0.3,True,1,9035,-76.88,-230678.57,694610.8,463932.23
1964-02-05,76.75,-0.13,-0.17,77.11,-0.47,True,1,9036,-76.75,-230755.32,693513.0,462757.68
1964-02-06,76.93,0.18,0.24,77.11,-0.23,True,1,9037,-76.93,-230832.25,695216.41,464384.16
1964-02-07,77.18,0.25,0.32,77.18,0.0,True,1,9038,-77.18,-230909.43,697552.84,466643.41
1964-02-10,77.05,-0.13,-0.17,77.18,-0.17,True,1,9039,-77.05,-230986.48,696454.95,465468.47
1964-02-11,77.33,0.28,0.36,77.33,0.0,True,1,9040,-77.33,-231063.81,699063.2,467999.39
1964-02-12,77.57,0.24,0.31,77.57,0.0,True,1,9041,-77.57,-231141.38,701310.37,470168.99
1964-02-13,77.52,-0.05,-0.06,77.57,-0.06,True,1,9042,-77.52,-231218.9,700935.84,469716.94
1964-02-14,77.48,-0.04,-0.05,77.57,-0.12,True,1,9043,-77.48,-231296.38,700651.64,469355.26
1964-02-17,77.46,-0.02,-0.03,77.57,-0.14,True,1,9044,-77.46,-231373.84,700548.24,469174.4
1964-02-18,77.47,0.01,0.01,77.57,-0.13,True,1,9045,-77.47,-231451.31,700716.15,469264.84
1964-02-19,77.55,0.08,0.1,77.57,-0.03,True,1,9046,-77.55,-231528.86,701517.3,469988.44
1964-02-20,77.62,0.07,0.09,77.62,0.0,True,1,9047,-77.62,-231606.48,702228.14,470621.66
1964-02-24,77.68,0.06,0.08,77.68,0.0,True,1,9048,-77.68,-231684.16,702848.64,471164.48
1964-02-25,77.68,0.0,0.0,77.68,0.0,True,1,9049,-77.68,-231761.84,702926.32,471164.48
1964-02-26,77.87,0.19,0.24,77.87,0.0,True,1,9050,-77.87,-231839.71,704723.5,472883.79
1964-02-27,77.62,-0.25,-0.32,77.87,-0.32,True,1,9051,-77.62,-231917.33,702538.62,470621.29
1964-02-28,77.8,0.18,0.23,77.87,-0.09,True,1,9052,-77.8,-231995.13,704245.6,472250.47
1964-03-02,77.97,0.17,0.22,77.97,0.0,True,1,9053,-77.97,-232073.1,705862.41,473789.31
1964-03-03,78.22,0.25,0.32,78.22,0.0,True,1,9054,-78.22,-232151.32,708203.88,476052.56
1964-03-04,78.07,-0.15,-0.19,78.22,-0.19,True,1,9055,-78.07,-232229.39,706923.85,474694.46
1964-03-05,78.06,-0.01,-0.01,78.22,-0.2,True,1,9056,-78.06,-232307.45,706911.36,474603.91
1964-03-06,78.31,0.25,0.32,78.31,0.0,True,1,9057,-78.31,-232385.76,709253.67,476867.91
1964-03-09,78.33,0.02,0.03,78.33,0.0,True,1,9058,-78.33,-232464.09,709513.14,477049.05
1964-03-10,78.59,0.26,0.33,78.59,0.0,True,1,9059,-78.59,-232542.68,711946.81,479404.13
1964-03-11,78.95,0.36,0.46,78.95,0.0,True,1,9060,-78.95,-232621.63,715287.0,482665.37
1964-03-12,79.08,0.13,0.16,79.08,0.0,True,1,9061,-79.08,-232700.71,716543.88,483843.17
1964-03-13,79.14,0.06,0.08,79.14,0.0,True,1,9062,-79.14,-232779.85,717166.68,484386.83
1964-03-16,79.14,0.0,0.0,79.14,0.0,True,1,9063,-79.14,-232858.99,717245.82,484386.83
1964-03-17,79.32,0.18,0.23,79.32,0.0,True,1,9064,-79.32,-232938.31,718956.48,486018.17
1964-03-18,79.38,0.06,0.08,79.38,0.0,True,1,9065,-79.38,-233017.69,719579.7,486562.01
1964-03-19,79.3,-0.08,-0.1,79.38,-0.1,True,1,9066,-79.3,-233096.99,718933.8,485836.81
1964-03-20,78.92,-0.38,-0.48,79.38,-0.58,True,1,9067,-78.92,-233175.91,715567.64,482391.73
1964-03-23,78.93,0.01,0.01,79.38,-0.57,True,1,9068,-78.93,-233254.84,715737.24,482482.4
1964-03-24,78.79,-0.14,-0.18,79.38,-0.74,True,1,9069,-78.79,-233333.63,714546.51,481212.88
1964-03-25,78.98,0.19,0.24,79.38,-0.5,True,1,9070,-78.98,-233412.61,716348.6,482935.99
1964-03-26,79.19,0.21,0.27,79.38,-0.24,True,1,9071,-79.19,-233491.8,718332.49,484840.69
1964-03-30,79.14,-0.05,-0.06,79.38,-0.3,True,1,9072,-79.14,-233570.94,717958.08,484387.14
1964-03-31,78.98,-0.16,-0.2,79.38,-0.5,True,1,9073,-78.98,-233649.92,716585.54,482935.62
1964-04-01,79.24,0.26,0.33,79.38,-0.18,True,1,9074,-79.24,-233729.16,719023.76,485294.6
1964-04-02,79.7,0.46,0.58,79.7,0.0,True,1,9075,-79.7,-233808.86,723277.5,489468.64
1964-04-03,79.94,0.24,0.3,79.94,0.0,True,1,9076,-79.94,-233888.8,725535.44,491646.64
1964-04-06,80.02,0.08,0.1,80.02,0.0,True,1,9077,-80.02,-233968.82,726341.54,492372.72
1964-04-07,79.74,-0.28,-0.35,80.02,-0.35,True,1,9078,-79.74,-234048.56,723879.72,489831.16
1964-04-08,79.75,0.01,0.01,80.02,-0.34,True,1,9079,-79.75,-234128.31,724050.25,489921.94
1964-04-09,79.7,-0.05,-0.06,80.02,-0.4,True,1,9080,-79.7,-234208.01,723676.0,489467.99
1964-04-10,79.85,0.15,0.19,80.02,-0.21,True,1,9081,-79.85,-234287.86,725117.85,490829.99
1964-04-13,79.77,-0.08,-0.1,80.02,-0.31,True,1,9082,-79.77,-234367.63,724471.14,490103.51
1964-04-14,79.99,0.22,0.28,80.02,-0.04,True,1,9083,-79.99,-234447.62,726549.17,492101.55
1964-04-15,80.09,0.1,0.12,80.09,0.0,True,1,9084,-80.09,-234527.71,727537.56,493009.85
1964-04-16,80.2,0.11,0.14,80.2,0.0,True,1,9085,-80.2,-234607.91,728617.0,494009.09
1964-04-17,80.55,0.35,0.44,80.55,0.0,True,1,9086,-80.55,-234688.46,731877.3,497188.84
1964-04-20,80.5,-0.05,-0.06,80.55,-0.06,True,1,9087,-80.5,-234768.96,731503.5,496734.54
1964-04-21,80.54,0.04,0.05,80.55,-0.01,True,1,9088,-80.54,-234849.5,731947.52,497098.02
1964-04-22,80.49,-0.05,-0.06,80.55,-0.07,True,1,9089,-80.49,-234929.99,731573.61,496643.62
1964-04-23,80.38,-0.11,-0.14,80.55,-0.21,True,1,9090,-80.38,-235010.37,730654.2,495643.83
1964-04-24,79.75,-0.63,-0.78,80.55,-0.99,True,1,9091,-79.75,-235090.12,725007.25,489917.13
1964-04-27,79.35,-0.4,-0.5,80.55,-1.49,True,1,9092,-79.35,-235169.47,721450.2,486280.73
1964-04-28,79.9,0.55,0.69,80.55,-0.81,True,1,9093,-79.9,-235249.37,726530.7,491281.33
1964-04-29,79.7,-0.2,-0.25,80.55,-1.06,True,1,9094,-79.7,-235329.07,724791.8,489462.73
1964-04-30,79.46,-0.24,-0.3,80.55,-1.35,True,1,9095,-79.46,-235408.53,722688.7,487280.17
1964-05-01,80.17,0.71,0.89,80.55,-0.47,True,1,9096,-80.17,-235488.7,729226.32,493737.62
1964-05-04,80.47,0.3,0.37,80.55,-0.1,True,1,9097,-80.47,-235569.17,732035.59,496466.42
1964-05-05,80.88,0.41,0.51,80.88,0.0,True,1,9098,-80.88,-235650.05,735846.24,500196.19
1964-05-06,81.06,0.18,0.22,81.06,0.0,True,1,9099,-81.06,-235731.11,737564.94,501833.83
1964-05-07,81.15,0.09,0.11,81.15,0.0,True,1,9100,-81.15,-235812.26,738465.0,502652.74
1964-05-08,81.0,-0.15,-0.18,81.15,-0.18,True,1,9101,-81.0,-235893.26,737181.0,501287.74
1964-05-11,80.9,-0.1,-0.12,81.15,-0.31,True,1,9102,-80.9,-235974.16,736351.8,500377.64
1964-05-12,81.16,0.26,0.32,81.16,0.0,True,1,9103,-81.16,-236055.32,738799.48,502744.16
1964-05-13,80.97,-0.19,-0.23,81.16,-0.23,True,1,9104,-80.97,-236136.29,737150.88,501014.59
1964-05-14,80.86,-0.11,-0.14,81.16,-0.37,True,1,9105,-80.86,-236217.15,736230.3,500013.15
1964-05-15,81.1,0.24,0.3,81.16,-0.07,True,1,9106,-81.1,-236298.25,738496.6,502198.35
1964-05-18,80.72,-0.38,-0.47,81.16,-0.54,True,1,9107,-80.72,-236378.97,735117.04,498738.07
1964-05-19,80.3,-0.42,-0.52,81.16,-1.06,True,1,9108,-80.3,-236459.27,731372.4,494913.13
1964-05-20,80.66,0.36,0.45,81.16,-0.62,True,1,9109,-80.66,-236539.93,734731.94,498192.01
1964-05-21,80.94,0.28,0.35,81.16,-0.27,True,1,9110,-80.94,-236620.87,737363.4,500742.53
1964-05-22,80.73,-0.21,-0.26,81.16,-0.53,True,1,9111,-80.73,-236701.6,735531.03,498829.43
1964-05-25,80.56,-0.17,-0.21,81.16,-0.74,True,1,9112,-80.56,-236782.16,734062.72,497280.56
1964-05-26,80.39,-0.17,-0.21,81.16,-0.95,True,1,9113,-80.39,-236862.55,732594.07,495731.52
1964-05-27,80.26,-0.13,-0.16,81.16,-1.11,True,1,9114,-80.26,-236942.81,731489.64,494546.83
1964-05-28,80.37,0.11,0.14,81.16,-0.97,True,1,9115,-80.37,-237023.18,732572.55,495549.37
1964-06-01,80.11,-0.26,-0.32,81.16,-1.29,True,1,9116,-80.11,-237103.29,730282.76,493179.47
1964-06-02,79.7,-0.41,-0.51,81.16,-1.8,True,1,9117,-79.7,-237182.99,726624.9,489441.91
1964-06-03,79.49,-0.21,-0.26,81.16,-2.06,True,1,9118,-79.49,-237262.48,724789.82,487527.34
1964-06-04,78.67,-0.82,-1.03,81.16,-3.07,True,1,9119,-78.67,-237341.15,717391.73,480050.58
1964-06-05,79.02,0.35,0.44,81.16,-2.64,True,1,9120,-79.02,-237420.17,720662.4,483242.23
1964-06-08,78.64,-0.38,-0.48,81.16,-3.1,True,1,9121,-78.64,-237498.81,717275.44,479776.63
1964-06-09,79.14,0.5,0.64,81.16,-2.49,True,1,9122,-79.14,-237577.95,721915.08,484337.13
1964-06-10,79.44,0.3,0.38,81.16,-2.12,True,1,9123,-79.44,-237657.39,724731.12,487073.73
1964-06-11,79.73,0.29,0.36,81.16,-1.76,True,1,9124,-79.73,-237737.12,727456.52,489719.4
1964-06-12,79.6,-0.13,-0.16,81.16,-1.92,True,1,9125,-79.6,-237816.72,726350.0,488533.28
1964-06-15,79.97,0.37,0.46,81.16,-1.47,True,1,9126,-79.97,-237896.69,729806.22,491909.53
1964-06-16,80.4,0.43,0.54,81.16,-0.94,True,1,9127,-80.4,-237977.09,733810.8,495833.71
1964-06-17,80.81,0.41,0.51,81.16,-0.43,True,1,9128,-80.81,-238057.9,737633.68,499575.78
1964-06-18,80.79,-0.02,-0.02,81.16,-0.46,True,1,9129,-80.79,-238138.69,737531.91,499393.22
1964-06-19,80.89,0.1,0.12,81.16,-0.33,True,1,9130,-80.89,-238219.58,738525.7,500306.12
1964-06-22,81.11,0.22,0.27,81.16,-0.06,True,1,9131,-81.11,-238300.69,740615.41,502314.72
1964-06-23,80.77,-0.34,-0.42,81.16,-0.48,True,1,9132,-80.77,-238381.46,737591.64,499210.18
1964-06-24,81.06,0.29,0.36,81.16,-0.12,True,1,9133,-81.06,-238462.52,740320.98,501858.46
1964-06-25,81.21,0.15,0.18,81.21,0.0,True,1,9134,-81.21,-238543.73,741772.14,503228.41
1964-06-26,81.46,0.25,0.31,81.46,0.0,True,1,9135,-81.46,-238625.19,744137.1,505511.91
1964-06-29,81.64,0.18,0.22,81.64,0.0,True,1,9136,-81.64,-238706.83,745863.04,507156.21
1964-06-30,81.69,0.05,0.06,81.69,0.0,True,1,9137,-81.69,-238788.52,746401.53,507613.01
1964-07-01,82.27,0.58,0.71,82.27,0.0,True,1,9138,-82.27,-238870.79,751783.26,512912.47
1964-07-02,82.6,0.33,0.4,82.6,0.0,True,1,9139,-82.6,-238953.39,754881.4,515928.01
1964-07-06,82.98,0.38,0.46,82.98,0.0,True,1,9140,-82.98,-239036.37,758437.2,519400.83
1964-07-07,83.12,0.14,0.17,83.12,0.0,True,1,9141,-83.12,-239119.49,759799.92,520680.43
1964-07-08,83.12,0.0,0.0,83.12,0.0,True,1,9142,-83.12,-239202.61,759883.04,520680.43
1964-07-09,83.22,0.1,0.12,83.22,0.0,True,1,9143,-83.22,-239285.83,760880.46,521594.63
1964-07-10,83.36,0.14,0.17,83.36,0.0,True,1,9144,-83.36,-239369.19,762243.84,522874.65
1964-07-13,83.31,-0.05,-0.06,83.36,-0.06,True,1,9145,-83.31,-239452.5,761869.95,522417.45
1964-07-14,83.06,-0.25,-0.3,83.36,-0.36,True,1,9146,-83.06,-239535.56,759666.76,520131.2
1964-07-15,83.34,0.28,0.34,83.36,-0.02,True,1,9147,-83.34,-239618.9,762310.98,522692.08
1964-07-16,83.64,0.3,0.36,83.64,0.0,True,1,9148,-83.64,-239702.54,765138.72,525436.18
1964-07-17,84.01,0.37,0.44,84.01,0.0,True,1,9149,-84.01,-239786.55,768607.49,528820.94
1964-07-20,83.74,-0.27,-0.32,84.01,-0.32,True,1,9150,-83.74,-239870.29,766221.0,526350.71
1964-07-21,83.54,-0.2,-0.24,84.01,-0.56,True,1,9151,-83.54,-239953.83,764474.54,524520.71
1964-07-22,83.52,-0.02,-0.02,84.01,-0.58,True,1,9152,-83.52,-240037.35,764375.04,524337.69
1964-07-23,83.48,-0.04,-0.05,84.01,-0.63,True,1,9153,-83.48,-240120.83,764092.44,523971.61
1964-07-24,83.46,-0.02,-0.02,84.01,-0.66,True,1,9154,-83.46,-240204.29,763992.84,523788.55
1964-07-27,83.08,-0.38,-0.46,84.01,-1.11,True,1,9155,-83.08,-240287.37,760597.4,520310.03
1964-07-28,82.85,-0.23,-0.28,84.01,-1.38,True,1,9156,-82.85,-240370.22,758574.6,518204.38
1964-07-29,82.92,0.07,0.08,84.01,-1.3,True,1,9157,-82.92,-240453.14,759298.44,518845.3
1964-07-30,83.09,0.17,0.2,84.01,-1.1,True,1,9158,-83.09,-240536.23,760938.22,520401.99
1964-07-31,83.18,0.09,0.11,84.01,-0.99,True,1,9159,-83.18,-240619.41,761845.62,521226.21
1964-08-03,83.0,-0.18,-0.22,84.01,-1.2,True,1,9160,-83.0,-240702.41,760280.0,519577.59
1964-08-04,81.96,-1.04,-1.25,84.01,-2.44,True,1,9161,-81.96,-240784.37,750835.56,510051.19
1964-08-05,82.09,0.13,0.16,84.01,-2.28,True,1,9162,-82.09,-240866.46,752108.58,511242.12
1964-08-06,81.34,-0.75,-0.91,84.01,-3.18,True,1,9163,-81.34,-240947.8,745318.42,504370.62
1964-08-07,81.86,0.52,0.64,84.01,-2.56,True,1,9164,-81.86,-241029.66,750165.04,509135.38
1964-08-10,81.78,-0.08,-0.1,84.01,-2.65,True,1,9165,-81.78,-241111.44,749513.7,508402.26
1964-08-11,81.76,-0.02,-0.02,84.01,-2.68,True,1,9166,-81.76,-241193.2,749412.16,508218.96
1964-08-12,82.17,0.41,0.5,84.01,-2.19,True,1,9167,-82.17,-241275.37,753252.39,511977.02
1964-08-13,82.41,0.24,0.29,84.01,-1.9,True,1,9168,-82.41,-241357.78,755534.88,514177.1
1964-08-14,82.35,-0.06,-0.07,84.01,-1.98,True,1,9169,-82.35,-241440.13,755067.15,513627.02
1964-08-17,82.36,0.01,0.01,84.01,-1.96,True,1,9170,-82.36,-241522.49,755241.2,513718.71
1964-08-18,82.4,0.04,0.05,84.01,-1.92,True,1,9171,-82.4,-241604.89,755690.4,514085.51
1964-08-19,82.32,-0.08,-0.1,84.01,-2.01,True,1,9172,-82.32,-241687.21,755039.04,513351.83
1964-08-20,81.94,-0.38,-0.46,84.01,-2.46,True,1,9173,-81.94,-241769.15,751635.62,509866.47
1964-08-21,82.07,0.13,0.16,84.01,-2.31,True,1,9174,-82.07,-241851.22,752910.18,511058.96
1964-08-24,81.91,-0.16,-0.2,84.01,-2.5,True,1,9175,-81.91,-241933.13,751524.25,509591.12
1964-08-25,81.44,-0.47,-0.57,84.01,-3.06,True,1,9176,-81.44,-242014.57,747293.44,505278.87
1964-08-26,81.32,-0.12,-0.15,84.01,-3.2,True,1,9177,-81.32,-242095.89,746273.64,504177.75
1964-08-27,81.7,0.38,0.47,84.01,-2.75,True,1,9178,-81.7,-242177.59,749842.6,507665.01
1964-08-28,81.99,0.29,0.36,84.01,-2.4,True,1,9179,-81.99,-242259.58,752586.21,510326.63
1964-08-31,81.83,-0.16,-0.2,84.01,-2.6,True,1,9180,-81.83,-242341.41,751199.4,508857.99
1964-09-01,82.18,0.35,0.43,84.01,-2.18,True,1,9181,-82.18,-242423.59,754494.58,512070.99
1964-09-02,82.31,0.13,0.16,84.01,-2.02,True,1,9182,-82.31,-242505.9,755770.42,513264.52
1964-09-03,82.56,0.25,0.3,84.01,-1.73,True,1,9183,-82.56,-242588.46,758148.48,515560.02
1964-09-04,82.76,0.2,0.24,84.01,-1.49,True,1,9184,-82.76,-242671.22,760067.84,517396.62
1964-09-08,82.87,0.11,0.13,84.01,-1.36,True,1,9185,-82.87,-242754.09,761160.95,518406.86
1964-09-09,83.05,0.18,0.22,84.01,-1.14,True,1,9186,-83.05,-242837.14,762897.3,520060.16
1964-09-10,83.1,0.05,0.06,84.01,-1.08,True,1,9187,-83.1,-242920.24,763439.7,520519.46
1964-09-11,83.45,0.35,0.42,84.01,-0.67,True,1,9188,-83.45,-243003.69,766738.6,523734.91
1964-09-14,83.22,-0.23,-0.28,84.01,-0.94,True,1,9189,-83.22,-243086.91,764708.58,521621.67
1964-09-15,83.0,-0.22,-0.26,84.01,-1.2,True,1,9190,-83.0,-243169.91,762770.0,519600.09
1964-09-16,83.24,0.24,0.29,84.01,-0.92,True,1,9191,-83.24,-243253.15,765058.84,521805.69
1964-09-17,83.79,0.55,0.66,84.01,-0.26,True,1,9192,-83.79,-243336.94,770197.68,526860.74
1964-09-18,83.48,-0.31,-0.37,84.01,-0.63,True,1,9193,-83.48,-243420.42,767431.64,524011.22
1964-09-21,83.86,0.38,0.46,84.01,-0.18,True,1,9194,-83.86,-243504.28,771008.84,527504.56
1964-09-22,83.89,0.03,0.04,84.01,-0.14,True,1,9195,-83.89,-243588.17,771368.55,527780.38
1964-09-23,83.91,0.02,0.02,84.01,-0.12,True,1,9196,-83.91,-243672.08,771636.36,527964.28
1964-09-24,84.0,0.09,0.11,84.01,-0.01,True,1,9197,-84.0,-243756.08,772548.0,528791.92
1964-09-25,84.21,0.21,0.25,84.21,0.0,True,1,9198,-84.21,-243840.29,774563.58,530723.29
1964-09-28,84.28,0.07,0.08,84.28,0.0,True,1,9199,-84.28,-243924.57,775291.72,531367.15
1964-09-29,84.24,-0.04,-0.05,84.28,-0.05,True,1,9200,-84.24,-244008.81,775008.0,530999.19
1964-09-30,84.18,-0.06,-0.07,84.28,-0.12,True,1,9201,-84.18,-244092.99,774540.18,530447.19
1964-10-01,84.08,-0.1,-0.12,84.28,-0.24,True,1,9202,-84.08,-244177.07,773704.16,529527.09
1964-10-02,84.36,0.28,0.33,84.36,0.0,True,1,9203,-84.36,-244261.43,776365.08,532103.65
1964-10-05,84.74,0.38,0.45,84.74,0.0,True,1,9204,-84.74,-244346.17,779946.96,535600.79
1964-10-06,84.79,0.05,0.06,84.79,0.0,True,1,9205,-84.79,-244430.96,780491.95,536060.99
1964-10-07,84.8,0.01,0.01,84.8,0.0,True,1,9206,-84.8,-244515.76,780668.8,536153.04
1964-10-08,85.04,0.24,0.28,85.04,0.0,True,1,9207,-85.04,-244600.8,782963.28,538362.48
1964-10-09,85.22,0.18,0.21,85.22,0.0,True,1,9208,-85.22,-244686.02,784705.76,540019.74
1964-10-12,85.24,0.02,0.02,85.24,0.0,True,1,9209,-85.24,-244771.26,784975.16,540203.9
1964-10-13,84.96,-0.28,-0.33,85.24,-0.33,True,1,9210,-84.96,-244856.22,782481.6,537625.38
1964-10-14,84.79,-0.17,-0.2,85.24,-0.53,True,1,9211,-84.79,-244941.01,781000.69,536059.68
1964-10-15,84.25,-0.54,-0.64,85.24,-1.16,True,1,9212,-84.25,-245025.26,776111.0,531085.74
1964-10-16,84.83,0.58,0.69,85.24,-0.48,True,1,9213,-84.83,-245110.09,781538.79,536428.7
1964-10-19,84.93,0.1,0.12,85.24,-0.36,True,1,9214,-84.93,-245195.02,782545.02,537350.0
1964-10-20,85.18,0.25,0.29,85.24,-0.07,True,1,9215,-85.18,-245280.2,784933.7,539653.5
1964-10-21,85.1,-0.08,-0.09,85.24,-0.16,True,1,9216,-85.1,-245365.3,784281.6,538916.3
1964-10-22,84.94,-0.16,-0.19,85.24,-0.35,True,1,9217,-84.94,-245450.24,782891.98,537441.74
1964-10-23,85.14,0.2,0.24,85.24,-0.12,True,1,9218,-85.14,-245535.38,784820.52,539285.14
1964-10-26,85.0,-0.14,-0.16,85.24,-0.28,True,1,9219,-85.0,-245620.38,783615.0,537994.62
1964-10-27,85.0,0.0,0.0,85.24,-0.28,True,1,9220,-85.0,-245705.38,783700.0,537994.62
1964-10-28,84.69,-0.31,-0.36,85.24,-0.64,True,1,9221,-84.69,-245790.07,780926.49,535136.42
1964-10-29,84.73,0.04,0.05,85.24,-0.6,True,1,9222,-84.73,-245874.8,781380.06,535505.26
1964-10-30,84.86,0.13,0.15,85.24,-0.45,True,1,9223,-84.86,-245959.66,782663.78,536704.12
1964-11-02,85.18,0.32,0.38,85.24,-0.07,True,1,9224,-85.18,-246044.84,785700.32,539655.48
1964-11-04,85.14,-0.04,-0.05,85.24,-0.12,True,1,9225,-85.14,-246129.98,785416.5,539286.52
1964-11-05,85.16,0.02,0.02,85.24,-0.09,True,1,9226,-85.16,-246215.14,785686.16,539471.02
1964-11-06,85.23,0.07,0.08,85.24,-0.01,True,1,9227,-85.23,-246300.37,786417.21,540116.84
1964-11-09,85.19,-0.04,-0.05,85.24,-0.06,True,1,9228,-85.19,-246385.56,786133.32,539747.76
1964-11-10,84.84,-0.35,-0.41,85.24,-0.47,True,1,9229,-84.84,-246470.4,782988.36,536517.96
1964-11-11,85.08,0.24,0.28,85.24,-0.19,True,1,9230,-85.08,-246555.48,785288.4,538732.92
1964-11-12,85.19,0.11,0.13,85.24,-0.06,True,1,9231,-85.19,-246640.67,786388.89,539748.22
1964-11-13,85.21,0.02,0.02,85.24,-0.04,True,1,9232,-85.21,-246725.88,786658.72,539932.84
1964-11-16,85.65,0.44,0.52,85.65,0.0,True,1,9233,-85.65,-246811.53,790806.45,543994.92
1964-11-17,86.03,0.38,0.44,86.03,0.0,True,1,9234,-86.03,-246897.56,794401.02,547503.46
1964-11-18,86.22,0.19,0.22,86.22,0.0,True,1,9235,-86.22,-246983.78,796241.7,549257.92
1964-11-19,86.18,-0.04,-0.05,86.22,-0.05,True,1,9236,-86.18,-247069.96,795958.48,548888.52
1964-11-20,86.28,0.1,0.12,86.28,0.0,True,1,9237,-86.28,-247156.24,796968.36,549812.12
1964-11-23,86.0,-0.28,-0.32,86.28,-0.32,True,1,9238,-86.0,-247242.24,794468.0,547225.76
1964-11-24,85.73,-0.27,-0.31,86.28,-0.64,True,1,9239,-85.73,-247327.97,792059.47,544731.5
1964-11-25,85.44,-0.29,-0.34,86.28,-0.97,True,1,9240,-85.44,-247413.41,789465.6,542052.19
1964-11-27,85.16,-0.28,-0.33,86.28,-1.3,True,1,9241,-85.16,-247498.57,786963.56,539464.99
1964-11-30,84.42,-0.74,-0.87,86.28,-2.16,True,1,9242,-84.42,-247582.99,780209.64,532626.65
1964-12-01,83.55,-0.87,-1.03,86.28,-3.16,True,1,9243,-83.55,-247666.54,772252.65,524586.11
1964-12-02,83.79,0.24,0.29,86.28,-2.89,True,1,9244,-83.79,-247750.33,774554.76,526804.43
1964-12-03,84.18,0.39,0.46,86.28,-2.43,True,1,9245,-84.18,-247834.51,778244.1,530409.59
1964-12-04,84.35,0.17,0.2,86.28,-2.24,True,1,9246,-84.35,-247918.86,779900.1,531981.24
1964-12-07,84.33,-0.02,-0.02,86.28,-2.26,True,1,9247,-84.33,-248003.19,779799.51,531796.32
1964-12-08,84.0,-0.33,-0.39,86.28,-2.64,True,1,9248,-84.0,-248087.19,776832.0,528744.81
1964-12-09,83.46,-0.54,-0.64,86.28,-3.27,True,1,9249,-83.46,-248170.65,771921.54,523750.89
1964-12-10,83.45,-0.01,-0.01,86.28,-3.28,True,1,9250,-83.45,-248254.1,771912.5,523658.4
1964-12-11,83.66,0.21,0.25,86.28,-3.04,True,1,9251,-83.66,-248337.76,773938.66,525600.9
1964-12-14,83.45,-0.21,-0.25,86.28,-3.28,True,1,9252,-83.45,-248421.21,772079.4,523658.19
1964-12-15,83.22,-0.23,-0.28,86.28,-3.55,True,1,9253,-83.22,-248504.43,770034.66,521530.23
1964-12-16,83.55,0.33,0.4,86.28,-3.16,True,1,9254,-83.55,-248587.98,773171.7,524583.72
1964-12-17,83.9,0.35,0.42,86.28,-2.76,True,1,9255,-83.9,-248671.88,776494.5,527822.62
1964-12-18,84.29,0.39,0.46,86.28,-2.31,True,1,9256,-84.29,-248756.17,780188.24,531432.07
1964-12-21,84.38,0.09,0.11,86.28,-2.2,True,1,9257,-84.38,-248840.55,781105.66,532265.11
1964-12-22,84.33,-0.05,-0.06,86.28,-2.26,True,1,9258,-84.33,-248924.88,780727.14,531802.26
1964-12-23,84.15,-0.18,-0.21,86.28,-2.47,True,1,9259,-84.15,-249009.03,779144.85,530135.82
1964-12-24,84.15,0.0,0.0,86.28,-2.47,True,1,9260,-84.15,-249093.18,779229.0,530135.82
1964-12-28,84.07,-0.08,-0.1,86.28,-2.56,True,1,9261,-84.07,-249177.25,778572.27,529395.02
1964-12-29,83.81,-0.26,-0.31,86.28,-2.86,True,1,9262,-83.81,-249261.06,776248.22,526987.16
1964-12-30,84.3,0.49,0.58,86.28,-2.3,True,1,9263,-84.3,-249345.36,780870.9,531525.54
1964-12-31,84.75,0.45,0.53,86.28,-1.77,True,1,9264,-84.75,-249430.11,785124.0,535693.89
1965-01-04,84.23,-0.52,-0.61,86.28,-2.38,True,1,9265,-84.23,-249514.34,780390.95,530876.61
1965-01-05,84.63,0.4,0.48,86.28,-1.91,True,1,9266,-84.63,-249598.97,784181.58,534582.61
1965-01-06,84.89,0.26,0.31,86.28,-1.61,True,1,9267,-84.89,-249683.86,786675.63,536991.77
1965-01-07,85.26,0.37,0.44,86.28,-1.18,True,1,9268,-85.26,-249769.12,790189.68,540420.56
1965-01-08,85.37,0.11,0.13,86.28,-1.06,True,1,9269,-85.37,-249854.49,791294.53,541440.04
1965-01-11,85.4,0.03,0.04,86.28,-1.02,True,1,9270,-85.4,-249939.89,791658.0,541718.11
1965-01-12,85.61,0.21,0.25,86.28,-0.78,True,1,9271,-85.61,-250025.5,793690.31,543664.81
1965-01-13,85.84,0.23,0.27,86.28,-0.51,True,1,9272,-85.84,-250111.34,795908.48,545797.14
1965-01-14,85.84,0.0,0.0,86.28,-0.51,True,1,9273,-85.84,-250197.18,795994.32,545797.14
1965-01-15,86.21,0.37,0.43,86.28,-0.08,True,1,9274,-86.21,-250283.39,799511.54,549228.15
1965-01-18,86.49,0.28,0.32,86.49,0.0,True,1,9275,-86.49,-250369.88,802194.75,551824.87
1965-01-19,86.63,0.14,0.16,86.63,0.0,True,1,9276,-86.63,-250456.51,803579.88,553123.37
1965-01-20,86.6,-0.03,-0.04,86.63,-0.04,True,1,9277,-86.6,-250543.11,803388.2,552845.09
1965-01-21,86.52,-0.08,-0.09,86.63,-0.13,True,1,9278,-86.52,-250629.63,802732.56,552102.93
1965-01-22,86.74,0.22,0.25,86.74,0.0,True,1,9279,-86.74,-250716.37,804860.46,554144.09
1965-01-25,86.86,0.12,0.14,86.86,0.0,True,1,9280,-86.86,-250803.23,806060.8,555257.57
1965-01-26,86.94,0.08,0.09,86.94,0.0,True,1,9281,-86.94,-250890.17,806890.14,555999.97
1965-01-27,87.23,0.29,0.33,87.23,0.0,True,1,9282,-87.23,-250977.4,809668.86,558691.46
1965-01-28,87.48,0.25,0.29,87.48,0.0,True,1,9283,-87.48,-251064.88,812076.84,561011.96
1965-01-29,87.56,0.08,0.09,87.56,0.0,True,1,9284,-87.56,-251152.44,812907.04,561754.6
1965-02-01,87.58,0.02,0.02,87.58,0.0,True,1,9285,-87.58,-251240.02,813180.3,561940.28
1965-02-02,87.55,-0.03,-0.03,87.58,-0.03,True,1,9286,-87.55,-251327.57,812989.3,561661.73
1965-02-03,87.63,0.08,0.09,87.63,0.0,True,1,9287,-87.63,-251415.2,813819.81,562404.61
1965-02-04,87.57,-0.06,-0.07,87.63,-0.07,True,1,9288,-87.57,-251502.77,813350.16,561847.39
1965-02-05,87.29,-0.28,-0.32,87.63,-0.39,True,1,9289,-87.29,-251590.06,810836.81,559246.75
1965-02-08,86.95,-0.34,-0.39,87.63,-0.78,True,1,9290,-86.95,-251677.01,807765.5,556088.49
1965-02-09,87.24,0.29,0.33,87.63,-0.44,True,1,9291,-87.24,-251764.25,810546.84,558782.59
1965-02-10,86.46,-0.78,-0.89,87.63,-1.34,True,1,9292,-86.46,-251850.71,803386.32,551535.61
1965-02-11,85.54,-0.92,-1.06,87.63,-2.38,True,1,9293,-85.54,-251936.25,794923.22,542986.97
1965-02-12,86.17,0.63,0.74,87.63,-1.67,True,1,9294,-86.17,-252022.42,800863.98,548841.56
1965-02-15,86.07,-0.1,-0.12,87.63,-1.78,True,1,9295,-86.07,-252108.49,800020.65,547912.16
1965-02-16,85.67,-0.4,-0.46,87.63,-2.24,True,1,9296,-85.67,-252194.16,796388.32,544194.16
1965-02-17,85.77,0.1,0.12,87.63,-2.12,True,1,9297,-85.77,-252279.93,797403.69,545123.76
1965-02-18,86.05,0.28,0.33,87.63,-1.8,True,1,9298,-86.05,-252365.98,800092.9,547726.92
1965-02-19,86.21,0.16,0.19,87.63,-1.62,True,1,9299,-86.21,-252452.19,801666.79,549214.6
1965-02-23,86.64,0.43,0.5,87.63,-1.13,True,1,9300,-86.64,-252538.83,805752.0,553213.17
1965-02-24,87.17,0.53,0.61,87.63,-0.52,True,1,9301,-87.17,-252626.0,810768.17,558142.17
1965-02-25,87.2,0.03,0.03,87.63,-0.49,True,1,9302,-87.2,-252713.2,811134.4,558421.2
1965-02-26,87.43,0.23,0.26,87.63,-0.23,True,1,9303,-87.43,-252800.63,813361.29,560560.66
1965-03-01,87.25,-0.18,-0.21,87.63,-0.43,True,1,9304,-87.25,-252887.88,811774.0,558886.12
1965-03-02,87.4,0.15,0.17,87.63,-0.26,True,1,9305,-87.4,-252975.28,813257.0,560281.72
1965-03-03,87.26,-0.14,-0.16,87.63,-0.42,True,1,9306,-87.26,-253062.54,812041.56,558979.02
1965-03-04,86.98,-0.28,-0.32,87.63,-0.74,True,1,9307,-86.98,-253149.52,809522.86,556373.34
1965-03-05,86.8,-0.18,-0.21,87.63,-0.95,True,1,9308,-86.8,-253236.32,807934.4,554698.08
1965-03-08,86.83,0.03,0.04,87.63,-0.91,True,1,9309,-86.83,-253323.15,808300.47,554977.32
1965-03-09,86.69,-0.14,-0.16,87.63,-1.07,True,1,9310,-86.69,-253409.84,807083.9,553674.06
1965-03-10,86.54,-0.15,-0.17,87.63,-1.24,True,1,9311,-86.54,-253496.38,805773.94,552277.56
1965-03-11,86.9,0.36,0.42,87.63,-0.83,True,1,9312,-86.9,-253583.28,809212.8,555629.52
1965-03-12,87.21,0.31,0.36,87.63,-0.48,True,1,9313,-87.21,-253670.49,812186.73,558516.24
1965-03-15,87.24,0.03,0.03,87.63,-0.44,True,1,9314,-87.24,-253757.73,812553.36,558795.63
1965-03-16,87.13,-0.11,-0.13,87.63,-0.57,True,1,9315,-87.13,-253844.86,811615.95,557771.09
1965-03-17,87.02,-0.11,-0.13,87.63,-0.7,True,1,9316,-87.02,-253931.88,810678.32,556746.44
1965-03-18,86.81,-0.21,-0.24,87.63,-0.94,True,1,9317,-86.81,-254018.69,808808.77,554790.08
1965-03-19,86.84,0.03,0.04,87.63,-0.9,True,1,9318,-86.84,-254105.53,809175.12,555069.59
1965-03-22,86.83,-0.01,-0.01,87.63,-0.91,True,1,9319,-86.83,-254192.36,809168.77,554976.41
1965-03-23,86.93,0.1,0.12,87.63,-0.8,True,1,9320,-86.93,-254279.29,810187.6,555908.31
1965-03-24,87.09,0.16,0.18,87.63,-0.62,True,1,9321,-87.09,-254366.38,811765.89,557399.51
1965-03-25,86.84,-0.25,-0.29,87.63,-0.9,True,1,9322,-86.84,-254453.22,809522.48,555069.26
1965-03-26,86.2,-0.64,-0.74,87.63,-1.63,True,1,9323,-86.2,-254539.42,803642.6,549103.18
1965-03-29,86.03,-0.17,-0.2,87.63,-1.83,True,1,9324,-86.03,-254625.45,802143.72,547518.27
1965-03-30,86.2,0.17,0.2,87.63,-1.63,True,1,9325,-86.2,-254711.65,803815.0,549103.35
1965-03-31,86.16,-0.04,-0.05,87.63,-1.68,True,1,9326,-86.16,-254797.81,803528.16,548730.35
1965-04-01,86.32,0.16,0.19,87.63,-1.5,True,1,9327,-86.32,-254884.13,805106.64,550222.51
1965-04-02,86.53,0.21,0.24,87.63,-1.25,True,1,9328,-86.53,-254970.66,807151.84,552181.18
1965-04-05,86.53,0.0,0.0,87.63,-1.25,True,1,9329,-86.53,-255057.19,807238.37,552181.18
1965-04-06,86.5,-0.03,-0.04,87.63,-1.29,True,1,9330,-86.5,-255143.69,807045.0,551901.31
1965-04-07,86.55,0.05,0.06,87.63,-1.23,True,1,9331,-86.55,-255230.24,807598.05,552367.81
1965-04-08,87.04,0.49,0.57,87.63,-0.67,True,1,9332,-87.04,-255317.28,812257.28,556940.0
1965-04-09,87.56,0.52,0.6,87.63,-0.08,True,1,9333,-87.56,-255404.84,817197.48,561792.64
1965-04-12,87.94,0.38,0.43,87.94,0.0,True,1,9334,-87.94,-255492.78,820831.96,565339.18
1965-04-13,88.04,0.1,0.11,88.04,0.0,True,1,9335,-88.04,-255580.82,821853.4,566272.58
1965-04-14,88.24,0.2,0.23,88.24,0.0,True,1,9336,-88.24,-255669.06,823808.64,568139.58
1965-04-15,88.15,-0.09,-0.1,88.24,-0.1,True,1,9337,-88.15,-255757.21,823056.55,567299.34
1965-04-19,88.51,0.36,0.41,88.51,0.0,True,1,9338,-88.51,-255845.72,826506.38,570660.66
1965-04-20,88.46,-0.05,-0.06,88.51,-0.06,True,1,9339,-88.46,-255934.18,826127.94,570193.76
1965-04-21,88.3,-0.16,-0.18,88.51,-0.24,True,1,9340,-88.3,-256022.48,824722.0,568699.52
1965-04-22,88.78,0.48,0.54,88.78,0.0,True,1,9341,-88.78,-256111.26,829293.98,573182.72
1965-04-23,88.88,0.1,0.11,88.88,0.0,True,1,9342,-88.88,-256200.14,830316.96,574116.82
1965-04-26,88.89,0.01,0.01,88.89,0.0,True,1,9343,-88.89,-256289.03,830499.27,574210.24
1965-04-27,89.04,0.15,0.17,89.04,0.0,True,1,9344,-89.04,-256378.07,831989.76,575611.69
1965-04-28,89.0,-0.04,-0.04,89.04,-0.04,True,1,9345,-89.0,-256467.07,831705.0,575237.93
1965-04-29,88.93,-0.07,-0.08,89.04,-0.12,True,1,9346,-88.93,-256556.0,831139.78,574583.78
1965-04-30,89.11,0.18,0.2,89.11,0.0,True,1,9347,-89.11,-256645.11,832911.17,576266.06
1965-05-03,89.23,0.12,0.14,89.23,0.0,True,1,9348,-89.23,-256734.34,834122.04,577387.7
1965-05-04,89.51,0.28,0.31,89.51,0.0,True,1,9349,-89.51,-256823.85,836828.99,580005.14
1965-05-05,89.71,0.2,0.22,89.71,0.0,True,1,9350,-89.71,-256913.56,838788.5,581874.94
1965-05-06,89.92,0.21,0.23,89.92,0.0,True,1,9351,-89.92,-257003.48,840841.92,583838.44
1965-05-07,89.85,-0.07,-0.08,89.92,-0.08,True,1,9352,-89.85,-257093.33,840277.2,583183.87
1965-05-10,89.66,-0.19,-0.21,89.92,-0.29,True,1,9353,-89.66,-257182.99,838589.98,581406.99
1965-05-11,89.55,-0.11,-0.12,89.92,-0.41,True,1,9354,-89.55,-257272.54,837650.7,580378.16
1965-05-12,89.94,0.39,0.44,89.94,0.0,True,1,9355,-89.94,-257362.48,841388.7,584026.22
1965-05-13,90.27,0.33,0.37,90.27,0.0,True,1,9356,-90.27,-257452.75,844566.12,587113.37
1965-05-14,90.1,-0.17,-0.19,90.27,-0.19,True,1,9357,-90.1,-257542.85,843065.7,585522.85
1965-05-17,89.54,-0.56,-0.62,90.27,-0.81,True,1,9358,-89.54,-257632.39,837915.32,580282.93
1965-05-18,89.46,-0.08,-0.09,90.27,-0.9,True,1,9359,-89.46,-257721.85,837256.14,579534.29
1965-05-19,89.67,0.21,0.24,90.27,-0.66,True,1,9360,-89.67,-257811.52,839311.2,581499.68
1965-05-20,89.18,-0.49,-0.55,90.27,-1.21,True,1,9361,-89.18,-257900.7,834813.98,576913.28
1965-05-21,88.75,-0.43,-0.48,90.27,-1.68,True,1,9362,-88.75,-257989.45,830877.5,572888.05
1965-05-24,88.09,-0.66,-0.74,90.27,-2.42,True,1,9363,-88.09,-258077.54,824786.67,566709.13
1965-05-25,88.6,0.51,0.58,90.27,-1.85,True,1,9364,-88.6,-258166.14,829650.4,571484.26
1965-05-26,88.3,-0.3,-0.34,90.27,-2.18,True,1,9365,-88.3,-258254.44,826929.5,568675.06
1965-05-27,87.84,-0.46,-0.52,90.27,-2.69,True,1,9366,-87.84,-258342.28,822709.44,564367.16
1965-05-28,88.42,0.58,0.66,90.27,-2.05,True,1,9367,-88.42,-258430.7,828230.14,569799.44
1965-06-01,88.72,0.3,0.34,90.27,-1.72,True,1,9368,-88.72,-258519.42,831128.96,572609.54
1965-06-02,87.09,-1.63,-1.84,90.27,-3.52,True,1,9369,-87.09,-258606.51,815946.21,557339.7
1965-06-03,86.9,-0.19,-0.22,90.27,-3.73,True,1,9370,-86.9,-258693.41,814253.0,555559.59
1965-06-04,87.11,0.21,0.24,90.27,-3.5,True,1,9371,-87.11,-258780.52,816307.81,557527.29
1965-06-07,86.88,-0.23,-0.26,90.27,-3.76,True,1,9372,-86.88,-258867.4,814239.36,555371.96
1965-06-08,85.93,-0.95,-1.09,90.27,-4.81,True,1,9373,-85.93,-258953.33,805421.89,546468.56
1965-06-09,85.04,-0.89,-1.04,90.27,-5.79,True,1,9374,-85.04,-259038.37,797164.96,538126.59
1965-06-10,84.73,-0.31,-0.36,90.27,-6.14,True,1,9375,-84.73,-259123.1,794343.75,535220.65
1965-06-11,85.12,0.39,0.46,90.27,-5.7,True,1,9376,-85.12,-259208.22,798085.12,538876.9
1965-06-14,84.01,-1.11,-1.3,90.27,-6.94,True,1,9377,-84.01,-259292.23,787761.77,528469.54
1965-06-15,84.49,0.48,0.57,90.27,-6.4,True,1,9378,-84.49,-259376.72,792347.22,532970.5
1965-06-16,85.2,0.71,0.84,90.27,-5.62,True,1,9379,-85.2,-259461.92,799090.8,539628.88
1965-06-17,85.74,0.54,0.63,90.27,-5.02,True,1,9380,-85.74,-259547.66,804241.2,544693.54
1965-06-18,85.34,-0.4,-0.47,90.27,-5.46,True,1,9381,-85.34,-259633.0,800574.54,540941.54
1965-06-21,85.05,-0.29,-0.34,90.27,-5.78,True,1,9382,-85.05,-259718.05,797939.1,538221.05
1965-06-22,85.21,0.16,0.19,90.27,-5.6,True,1,9383,-85.21,-259803.26,799525.43,539722.17
1965-06-23,84.67,-0.54,-0.63,90.27,-6.2,True,1,9384,-84.67,-259887.93,794543.28,534655.35
1965-06-24,83.56,-1.11,-1.31,90.27,-7.43,True,1,9385,-83.56,-259971.49,784210.6,524239.11
1965-06-25,83.06,-0.5,-0.6,90.27,-7.99,True,1,9386,-83.06,-260054.55,779601.16,519546.61
1965-06-28,81.6,-1.46,-1.76,90.27,-9.6,True,1,9387,-81.6,-260136.15,765979.2,505843.05
1965-06-29,82.41,0.81,0.99,90.27,-8.71,True,1,9388,-82.41,-260218.56,773665.08,513446.52
1965-06-30,84.12,1.71,2.08,90.27,-6.81,True,1,9389,-84.12,-260302.68,789802.68,529500.0
1965-07-01,84.48,0.36,0.43,90.27,-6.41,True,1,9390,-84.48,-260387.16,793267.2,532880.04
1965-07-02,85.16,0.68,0.8,90.27,-5.66,True,1,9391,-85.16,-260472.32,799737.56,539265.24
1965-07-06,84.99,-0.17,-0.2,90.27,-5.85,True,1,9392,-84.99,-260557.31,798226.08,537668.77
1965-07-07,84.67,-0.32,-0.38,90.27,-6.2,True,1,9393,-84.67,-260641.98,795305.31,534663.33
1965-07-08,85.39,0.72,0.85,90.27,-5.41,True,1,9394,-85.39,-260727.37,802153.66,541426.29
1965-07-09,85.71,0.32,0.38,90.27,-5.05,True,1,9395,-85.71,-260813.08,805245.45,544432.37
1965-07-12,85.69,-0.02,-0.02,90.27,-5.07,True,1,9396,-85.69,-260898.77,805143.24,544244.47
1965-07-13,85.59,-0.1,-0.12,90.27,-5.18,True,1,9397,-85.59,-260984.36,804289.23,543304.87
1965-07-14,85.87,0.28,0.33,90.27,-4.87,True,1,9398,-85.87,-261070.23,807006.26,545936.03
1965-07-15,85.72,-0.15,-0.18,90.27,-5.04,True,1,9399,-85.72,-261155.95,805682.28,544526.33
1965-07-16,85.69,-0.03,-0.04,90.27,-5.07,True,1,9400,-85.69,-261241.64,805486.0,544244.36
1965-07-19,85.63,-0.06,-0.07,90.27,-5.14,True,1,9401,-85.63,-261327.27,805007.63,543680.36
1965-07-20,84.55,-1.08,-1.26,90.27,-6.34,True,1,9402,-84.55,-261411.82,794939.1,533527.28
1965-07-21,84.07,-0.48,-0.57,90.27,-6.87,True,1,9403,-84.07,-261495.89,790510.21,529014.32
1965-07-22,83.85,-0.22,-0.26,90.27,-7.11,True,1,9404,-83.85,-261579.74,788525.4,526945.66
1965-07-23,84.07,0.22,0.26,90.27,-6.87,True,1,9405,-84.07,-261663.81,790678.35,529014.54
1965-07-26,84.05,-0.02,-0.02,90.27,-6.89,True,1,9406,-84.05,-261747.86,790574.3,528826.44
1965-07-27,83.87,-0.18,-0.21,90.27,-7.09,True,1,9407,-83.87,-261831.73,788965.09,527133.36
1965-07-28,84.03,0.16,0.19,90.27,-6.91,True,1,9408,-84.03,-261915.76,790554.24,528638.48
1965-07-29,84.68,0.65,0.77,90.27,-6.19,True,1,9409,-84.68,-262000.44,796754.12,534753.68
1965-07-30,85.25,0.57,0.67,90.27,-5.56,True,1,9410,-85.25,-262085.69,802202.5,540116.81
1965-08-02,85.42,0.17,0.2,90.27,-5.37,True,1,9411,-85.42,-262171.11,803887.62,541716.51
1965-08-03,85.46,0.04,0.05,90.27,-5.33,True,1,9412,-85.46,-262256.57,804349.52,542092.95
1965-08-04,85.79,0.33,0.39,90.27,-4.96,True,1,9413,-85.79,-262342.36,807541.27,545198.91
1965-08-05,85.79,0.0,0.0,90.27,-4.96,True,1,9414,-85.79,-262428.15,807627.06,545198.91
1965-08-06,86.07,0.28,0.33,90.27,-4.65,True,1,9415,-86.07,-262514.22,810349.05,547834.83
1965-08-09,85.86,-0.21,-0.24,90.27,-4.88,True,1,9416,-85.86,-262600.08,808457.76,545857.68
1965-08-10,85.87,0.01,0.01,90.27,-4.87,True,1,9417,-85.87,-262685.95,808637.79,545951.84
1965-08-11,86.13,0.26,0.3,90.27,-4.59,True,1,9418,-86.13,-262772.08,811172.34,548400.26
1965-08-12,86.38,0.25,0.29,90.27,-4.31,True,1,9419,-86.38,-262858.46,813613.22,550754.76
1965-08-13,86.77,0.39,0.45,90.27,-3.88,True,1,9420,-86.77,-262945.23,817373.4,554428.17
1965-08-16,86.87,0.1,0.12,90.27,-3.77,True,1,9421,-86.87,-263032.1,818402.27,555370.17
1965-08-17,87.04,0.17,0.2,90.27,-3.58,True,1,9422,-87.04,-263119.14,820090.88,556971.74
1965-08-18,86.99,-0.05,-0.06,90.27,-3.63,True,1,9423,-86.99,-263206.13,819706.77,556500.64
1965-08-19,86.79,-0.2,-0.23,90.27,-3.86,True,1,9424,-86.79,-263292.92,817908.96,554616.04
1965-08-20,86.69,-0.1,-0.12,90.27,-3.97,True,1,9425,-86.69,-263379.61,817053.25,553673.64
1965-08-23,86.56,-0.13,-0.15,90.27,-4.11,True,1,9426,-86.56,-263466.17,815914.56,552448.39
1965-08-24,86.71,0.15,0.17,90.27,-3.94,True,1,9427,-86.71,-263552.88,817415.17,553862.29
1965-08-25,86.81,0.1,0.12,90.27,-3.83,True,1,9428,-86.81,-263639.69,818444.68,554804.99
1965-08-26,87.14,0.33,0.38,90.27,-3.47,True,1,9429,-87.14,-263726.83,821643.06,557916.23
1965-08-27,87.2,0.06,0.07,90.27,-3.4,True,1,9430,-87.2,-263814.03,822296.0,558481.97
1965-08-30,87.21,0.01,0.01,90.27,-3.39,True,1,9431,-87.21,-263901.24,822477.51,558576.27
1965-08-31,87.17,-0.04,-0.05,90.27,-3.43,True,1,9432,-87.17,-263988.41,822187.44,558199.03
1965-09-01,87.17,0.0,0.0,90.27,-3.43,True,1,9433,-87.17,-264075.58,822274.61,558199.03
1965-09-02,87.65,0.48,0.55,90.27,-2.9,True,1,9434,-87.65,-264163.23,826890.1,562726.87
1965-09-03,88.06,0.41,0.47,90.27,-2.45,True,1,9435,-88.06,-264251.29,830846.1,566594.81
1965-09-07,88.36,0.3,0.34,90.27,-2.12,True,1,9436,-88.36,-264339.65,833764.96,569425.31
1965-09-08,88.66,0.3,0.34,90.27,-1.78,True,1,9437,-88.66,-264428.31,836684.42,572256.11
1965-09-09,88.89,0.23,0.26,90.27,-1.53,True,1,9438,-88.89,-264517.2,838943.82,574426.62
1965-09-10,89.12,0.23,0.26,90.27,-1.27,True,1,9439,-89.12,-264606.32,841203.68,576597.36
1965-09-13,89.38,0.26,0.29,90.27,-0.99,True,1,9440,-89.38,-264695.7,843747.2,579051.5
1965-09-14,89.03,-0.35,-0.39,90.27,-1.37,True,1,9441,-89.03,-264784.73,840532.23,575747.5
1965-09-15,89.52,0.49,0.55,90.27,-0.83,True,1,9442,-89.52,-264874.25,845247.84,580373.59
1965-09-16,90.02,0.5,0.56,90.27,-0.28,True,1,9443,-90.02,-264964.27,850058.86,585094.59
1965-09-17,90.05,0.03,0.03,90.27,-0.24,True,1,9444,-90.05,-265054.32,850432.2,585377.88
1965-09-20,90.08,0.03,0.03,90.27,-0.21,True,1,9445,-90.08,-265144.4,850805.6,585661.2
1965-09-21,89.81,-0.27,-0.3,90.27,-0.51,True,1,9446,-89.81,-265234.21,848345.26,583111.05
1965-09-22,90.22,0.41,0.46,90.27,-0.06,True,1,9447,-90.22,-265324.43,852308.34,586983.91
1965-09-23,89.86,-0.36,-0.4,90.27,-0.45,True,1,9448,-89.86,-265414.29,848997.28,583582.99
1965-09-24,90.02,0.16,0.18,90.27,-0.28,True,1,9449,-90.02,-265504.31,850598.98,585094.67
1965-09-27,90.65,0.63,0.7,90.65,0.0,True,1,9450,-90.65,-265594.96,856642.5,591047.54
1965-09-28,90.43,-0.22,-0.24,90.65,-0.24,True,1,9451,-90.43,-265685.39,854653.93,588968.54
1965-09-29,90.02,-0.41,-0.45,90.65,-0.7,True,1,9452,-90.02,-265775.41,850869.04,585093.63
1965-09-30,89.96,-0.06,-0.07,90.65,-0.76,True,1,9453,-89.96,-265865.37,850391.88,584526.51
1965-10-01,89.9,-0.06,-0.07,90.65,-0.83,True,1,9454,-89.9,-265955.27,849914.6,583959.33
1965-10-04,90.08,0.18,0.2,90.65,-0.63,True,1,9455,-90.08,-266045.35,851706.4,585661.05
1965-10-05,90.63,0.55,0.61,90.65,-0.02,True,1,9456,-90.63,-266135.98,856997.28,590861.3
1965-10-06,90.54,-0.09,-0.1,90.65,-0.12,True,1,9457,-90.54,-266226.52,856236.78,590010.26
1965-10-07,90.47,-0.07,-0.08,90.65,-0.2,True,1,9458,-90.47,-266316.99,855665.26,589348.27
1965-10-08,90.85,0.38,0.42,90.85,0.0,True,1,9459,-90.85,-266407.84,859350.15,592942.31
1965-10-11,91.37,0.52,0.57,91.37,0.0,True,1,9460,-91.37,-266499.21,864360.2,597860.99
1965-10-12,91.35,-0.02,-0.02,91.37,-0.02,True,1,9461,-91.35,-266590.56,864262.35,597671.79
1965-10-13,91.34,-0.01,-0.01,91.37,-0.03,True,1,9462,-91.34,-266681.9,864259.08,597577.18
1965-10-14,91.19,-0.15,-0.16,91.37,-0.2,True,1,9463,-91.19,-266773.09,862930.97,596157.88
1965-10-15,91.38,0.19,0.21,91.38,0.0,True,1,9464,-91.38,-266864.47,864820.32,597955.85
1965-10-18,91.68,0.3,0.33,91.68,0.0,True,1,9465,-91.68,-266956.15,867751.2,600795.05
1965-10-19,91.8,0.12,0.13,91.8,0.0,True,1,9466,-91.8,-267047.95,868978.8,601930.85
1965-10-20,91.78,-0.02,-0.02,91.8,-0.02,True,1,9467,-91.78,-267139.73,868881.26,601741.53
1965-10-21,91.94,0.16,0.17,91.94,0.0,True,1,9468,-91.94,-267231.67,870487.92,603256.25
1965-10-22,91.98,0.04,0.04,91.98,0.0,True,1,9469,-91.98,-267323.65,870958.62,603634.97
1965-10-25,91.67,-0.31,-0.34,91.98,-0.34,True,1,9470,-91.67,-267415.32,868114.9,600699.58
1965-10-26,92.2,0.53,0.58,92.2,0.0,True,1,9471,-92.2,-267507.52,873226.2,605718.68
1965-10-27,92.51,0.31,0.34,92.51,0.0,True,1,9472,-92.51,-267600.03,876254.72,608654.69
1965-10-28,92.21,-0.3,-0.32,92.51,-0.32,True,1,9473,-92.21,-267692.24,873505.33,605813.09
1965-10-29,92.42,0.21,0.23,92.51,-0.1,True,1,9474,-92.42,-267784.66,875587.08,607802.42
1965-11-01,92.23,-0.19,-0.21,92.51,-0.3,True,1,9475,-92.23,-267876.89,873879.25,606002.36
1965-11-03,92.31,0.08,0.09,92.51,-0.22,True,1,9476,-92.31,-267969.2,874729.56,606760.36
1965-11-04,92.46,0.15,0.16,92.51,-0.05,True,1,9477,-92.46,-268061.66,876243.42,608181.76
1965-11-05,92.37,-0.09,-0.1,92.51,-0.15,True,1,9478,-92.37,-268154.03,875482.86,607328.83
1965-11-08,92.23,-0.14,-0.15,92.51,-0.3,True,1,9479,-92.23,-268246.26,874248.17,606001.91
1965-11-09,91.93,-0.3,-0.32,92.51,-0.63,True,1,9480,-91.93,-268338.19,871496.4,603158.21
1965-11-10,91.83,-0.1,-0.11,92.51,-0.74,True,1,9481,-91.83,-268430.02,870640.23,602210.21
1965-11-11,92.11,0.28,0.3,92.51,-0.43,True,1,9482,-92.11,-268522.13,873387.02,604864.89
1965-11-12,92.55,0.44,0.48,92.55,0.0,True,1,9483,-92.55,-268614.68,877651.65,609036.97
1965-11-15,92.63,0.08,0.09,92.63,0.0,True,1,9484,-92.63,-268707.31,878502.92,609795.61
1965-11-16,92.41,-0.22,-0.24,92.63,-0.24,True,1,9485,-92.41,-268799.72,876508.85,607709.13
1965-11-17,92.6,0.19,0.21,92.63,-0.03,True,1,9486,-92.6,-268892.32,878403.6,609511.28
1965-11-18,92.22,-0.38,-0.41,92.63,-0.44,True,1,9487,-92.22,-268984.54,874891.14,605906.6
1965-11-19,92.24,0.02,0.02,92.63,-0.42,True,1,9488,-92.24,-269076.78,875173.12,606096.34
1965-11-22,91.64,-0.6,-0.65,92.63,-1.07,True,1,9489,-91.64,-269168.42,869571.96,600403.54
1965-11-23,91.78,0.14,0.15,92.63,-0.92,True,1,9490,-91.78,-269260.2,870992.2,601732.0
1965-11-24,91.94,0.16,0.17,92.63,-0.74,True,1,9491,-91.94,-269352.14,872602.54,603250.4
1965-11-26,92.03,0.09,0.1,92.63,-0.65,True,1,9492,-92.03,-269444.17,873548.76,604104.59
1965-11-29,91.8,-0.23,-0.25,92.63,-0.9,True,1,9493,-91.8,-269535.97,871457.4,601921.43
1965-11-30,91.61,-0.19,-0.21,92.63,-1.1,True,1,9494,-91.61,-269627.58,869745.34,600117.76
1965-12-01,91.5,-0.11,-0.12,92.63,-1.22,True,1,9495,-91.5,-269719.08,868792.5,599073.42
1965-12-02,91.21,-0.29,-0.32,92.63,-1.53,True,1,9496,-91.21,-269810.29,866130.16,596319.87
1965-12-03,91.27,0.06,0.07,92.63,-1.47,True,1,9497,-91.27,-269901.56,866791.19,596889.63
1965-12-06,90.59,-0.68,-0.74,92.63,-2.2,True,1,9498,-90.59,-269992.15,860423.82,590431.67
1965-12-07,91.39,0.8,0.88,92.63,-1.34,True,1,9499,-91.39,-270083.54,868113.61,598030.07
1965-12-08,91.28,-0.11,-0.12,92.63,-1.46,True,1,9500,-91.28,-270174.82,867160.0,596985.18
1965-12-09,91.56,0.28,0.31,92.63,-1.16,True,1,9501,-91.56,-270266.38,869911.56,599645.18
1965-12-10,91.8,0.24,0.26,92.63,-0.9,True,1,9502,-91.8,-270358.18,872283.6,601925.42
1965-12-13,91.83,0.03,0.03,92.63,-0.86,True,1,9503,-91.83,-270450.01,872660.49,602210.48
1965-12-14,91.88,0.05,0.05,92.63,-0.81,True,1,9504,-91.88,-270541.89,873227.52,602685.63
1965-12-15,92.02,0.14,0.15,92.63,-0.66,True,1,9505,-92.02,-270633.91,874650.1,604016.19
1965-12-16,92.12,0.1,0.11,92.63,-0.55,True,1,9506,-92.12,-270726.03,875692.72,604966.69
1965-12-17,92.08,-0.04,-0.04,92.63,-0.59,True,1,9507,-92.08,-270818.11,875404.56,604586.45
1965-12-20,91.65,-0.43,-0.47,92.63,-1.06,True,1,9508,-91.65,-270909.76,871408.2,600498.44
1965-12-21,92.01,0.36,0.39,92.63,-0.67,True,1,9509,-92.01,-271001.77,874923.09,603921.32
1965-12-22,92.29,0.28,0.3,92.63,-0.37,True,1,9510,-92.29,-271094.06,877677.9,606583.84
1965-12-23,92.19,-0.1,-0.11,92.63,-0.48,True,1,9511,-92.19,-271186.25,876819.09,605632.84
1965-12-27,91.52,-0.67,-0.73,92.63,-1.2,True,1,9512,-91.52,-271277.77,870538.24,599260.47
1965-12-28,91.53,0.01,0.01,92.63,-1.19,True,1,9513,-91.53,-271369.3,870724.89,599355.59
1965-12-29,91.81,0.28,0.31,92.63,-0.88,True,1,9514,-91.81,-271461.11,873480.34,602019.23
1965-12-30,92.2,0.39,0.42,92.63,-0.46,True,1,9515,-92.2,-271553.31,877283.0,605729.69
1965-12-31,92.43,0.23,0.25,92.63,-0.22,True,1,9516,-92.43,-271645.74,879563.88,607918.14
1966-01-03,92.18,-0.25,-0.27,92.63,-0.49,True,1,9517,-92.18,-271737.92,877277.06,605539.14
1966-01-04,92.26,0.08,0.09,92.63,-0.4,True,1,9518,-92.26,-271830.18,878130.68,606300.5
1966-01-05,92.85,0.59,0.64,92.85,0.0,True,1,9519,-92.85,-271923.03,883839.15,611916.12
1966-01-06,93.06,0.21,0.23,93.06,0.0,True,1,9520,-93.06,-272016.09,885931.2,613915.11
1966-01-07,93.14,0.08,0.09,93.14,0.0,True,1,9521,-93.14,-272109.23,886785.94,614676.71
1966-01-10,93.33,0.19,0.2,93.33,0.0,True,1,9522,-93.33,-272202.56,888688.26,616485.7
1966-01-11,93.41,0.08,0.09,93.41,0.0,True,1,9523,-93.41,-272295.97,889543.43,617247.46
1966-01-12,93.19,-0.22,-0.24,93.41,-0.24,True,1,9524,-93.19,-272389.16,887541.56,615152.4
1966-01-13,93.36,0.17,0.18,93.41,-0.05,True,1,9525,-93.36,-272482.52,889254.0,616771.48
1966-01-14,93.5,0.14,0.15,93.5,0.0,True,1,9526,-93.5,-272576.02,890681.0,618104.98
1966-01-17,93.77,0.27,0.29,93.77,0.0,True,1,9527,-93.77,-272669.79,893346.79,620677.0
1966-01-18,93.95,0.18,0.19,93.95,0.0,True,1,9528,-93.95,-272763.74,895155.6,622391.86
1966-01-19,93.69,-0.26,-0.28,93.95,-0.28,True,1,9529,-93.69,-272857.43,892772.01,619914.58
1966-01-20,93.36,-0.33,-0.35,93.95,-0.63,True,1,9530,-93.36,-272950.79,889720.8,616770.01
1966-01-21,93.47,0.11,0.12,93.95,-0.51,True,1,9531,-93.47,-273044.26,890862.57,617818.31
1966-01-24,93.71,0.24,0.26,93.95,-0.26,True,1,9532,-93.71,-273137.97,893243.72,620105.75
1966-01-25,93.85,0.14,0.15,93.95,-0.11,True,1,9533,-93.85,-273231.82,894672.05,621440.23
1966-01-26,93.7,-0.15,-0.16,93.95,-0.27,True,1,9534,-93.7,-273325.52,893335.8,620010.28
1966-01-27,93.67,-0.03,-0.03,93.95,-0.3,True,1,9535,-93.67,-273419.19,893143.45,619724.26
1966-01-28,93.31,-0.36,-0.38,93.95,-0.68,True,1,9536,-93.31,-273512.5,889804.16,616291.66
1966-01-31,92.88,-0.43,-0.46,93.95,-1.14,True,1,9537,-92.88,-273605.38,885796.56,612191.18
1966-02-01,92.16,-0.72,-0.78,93.95,-1.9,True,1,9538,-92.16,-273697.54,879022.08,605324.54
1966-02-02,92.53,0.37,0.4,93.95,-1.51,True,1,9539,-92.53,-273790.07,882643.67,608853.6
1966-02-03,92.65,0.12,0.13,93.95,-1.38,True,1,9540,-92.65,-273882.72,883881.0,609998.28
1966-02-04,93.26,0.61,0.66,93.95,-0.73,True,1,9541,-93.26,-273975.98,889793.66,615817.68
1966-02-07,93.59,0.33,0.35,93.95,-0.38,True,1,9542,-93.59,-274069.57,893035.78,618966.21
1966-02-08,93.55,-0.04,-0.04,93.95,-0.43,True,1,9543,-93.55,-274163.12,892747.65,618584.53
1966-02-09,94.06,0.51,0.55,94.06,0.0,True,1,9544,-94.06,-274257.18,897708.64,623451.46
1966-02-10,93.83,-0.23,-0.24,94.06,-0.24,True,1,9545,-93.83,-274351.01,895607.35,621256.34
1966-02-11,93.81,-0.02,-0.02,94.06,-0.27,True,1,9546,-93.81,-274444.82,895510.26,621065.44
1966-02-14,93.53,-0.28,-0.3,94.06,-0.56,True,1,9547,-93.53,-274538.35,892930.91,618392.56
1966-02-15,93.17,-0.36,-0.38,94.06,-0.95,True,1,9548,-93.17,-274631.52,889587.16,614955.64
1966-02-16,93.16,-0.01,-0.01,94.06,-0.96,True,1,9549,-93.16,-274724.68,889584.84,614860.16
1966-02-17,92.66,-0.5,-0.54,94.06,-1.49,True,1,9550,-92.66,-274817.34,884903.0,610085.66
1966-02-18,92.41,-0.25,-0.27,94.06,-1.75,True,1,9551,-92.41,-274909.75,882607.91,607698.16
1966-02-21,91.87,-0.54,-0.58,94.06,-2.33,True,1,9552,-91.87,-275001.62,877542.24,602540.62
1966-02-23,91.48,-0.39,-0.42,94.06,-2.74,True,1,9553,-91.48,-275093.1,873908.44,598815.34
1966-02-24,90.89,-0.59,-0.64,94.06,-3.37,True,1,9554,-90.89,-275183.99,868363.06,593179.07
1966-02-25,91.14,0.25,0.28,94.06,-3.1,True,1,9555,-91.14,-275275.13,870842.7,595567.57
1966-02-28,91.22,0.08,0.09,94.06,-3.02,True,1,9556,-91.22,-275366.35,871698.32,596331.97
1966-03-01,90.06,-1.16,-1.27,94.06,-4.25,True,1,9557,-90.06,-275456.41,860703.42,585247.01
1966-03-02,89.15,-0.91,-1.01,94.06,-5.22,True,1,9558,-89.15,-275545.56,852095.7,576550.14
1966-03-03,89.47,0.32,0.36,94.06,-4.88,True,1,9559,-89.47,-275635.03,855243.73,579608.7
1966-03-04,89.24,-0.23,-0.26,94.06,-5.12,True,1,9560,-89.24,-275724.27,853134.4,577410.13
1966-03-07,88.04,-1.2,-1.34,94.06,-6.4,True,1,9561,-88.04,-275812.31,841750.44,565938.13
1966-03-08,88.18,0.14,0.16,94.06,-6.25,True,1,9562,-88.18,-275900.49,843177.16,567276.67
1966-03-09,88.96,0.78,0.88,94.06,-5.42,True,1,9563,-88.96,-275989.45,850724.48,574735.03
1966-03-10,88.96,0.0,0.0,94.06,-5.42,True,1,9564,-88.96,-276078.41,850813.44,574735.03
1966-03-11,88.85,-0.11,-0.12,94.06,-5.54,True,1,9565,-88.85,-276167.26,849850.25,573682.99
1966-03-14,87.85,-1.0,-1.12,94.06,-6.6,True,1,9566,-87.85,-276255.11,840373.1,564117.99
1966-03-15,87.35,-0.5,-0.57,94.06,-7.13,True,1,9567,-87.35,-276342.46,835677.45,559334.99
1966-03-16,87.86,0.51,0.58,94.06,-6.59,True,1,9568,-87.86,-276430.32,840644.48,564214.16
1966-03-17,88.17,0.31,0.35,94.06,-6.26,True,1,9569,-88.17,-276518.49,843698.73,567180.24
1966-03-18,88.53,0.36,0.41,94.06,-5.88,True,1,9570,-88.53,-276607.02,847232.1,570625.08
1966-03-21,89.2,0.67,0.76,94.06,-5.17,True,1,9571,-89.2,-276696.22,853733.2,577036.98
1966-03-22,89.46,0.26,0.29,94.06,-4.89,True,1,9572,-89.46,-276785.68,856311.12,579525.44
1966-03-23,89.13,-0.33,-0.37,94.06,-5.24,True,1,9573,-89.13,-276874.81,853241.49,576366.68
1966-03-24,89.29,0.16,0.18,94.06,-5.07,True,1,9574,-89.29,-276964.1,854862.46,577898.36
1966-03-25,89.54,0.25,0.28,94.06,-4.8,True,1,9575,-89.54,-277053.64,857345.5,580291.86
1966-03-28,89.62,0.08,0.09,94.06,-4.72,True,1,9576,-89.62,-277143.26,858201.12,581057.86
1966-03-29,89.27,-0.35,-0.39,94.06,-5.09,True,1,9577,-89.27,-277232.53,854938.79,577706.26
1966-03-30,88.78,-0.49,-0.55,94.06,-5.61,True,1,9578,-88.78,-277321.31,850334.84,573013.53
1966-03-31,89.23,0.45,0.51,94.06,-5.14,True,1,9579,-89.23,-277410.54,854734.17,577323.63
1966-04-01,89.94,0.71,0.8,94.06,-4.38,True,1,9580,-89.94,-277500.48,861625.2,584124.72
1966-04-04,90.76,0.82,0.91,94.06,-3.51,True,1,9581,-90.76,-277591.24,869571.56,591980.32
1966-04-05,91.31,0.55,0.61,94.06,-2.92,True,1,9582,-91.31,-277682.55,874932.42,597249.87
1966-04-06,91.56,0.25,0.27,94.06,-2.66,True,1,9583,-91.56,-277774.11,877419.48,599645.37
1966-04-07,91.76,0.2,0.22,94.06,-2.44,True,1,9584,-91.76,-277865.87,879427.84,601561.97
1966-04-11,91.79,0.03,0.03,94.06,-2.41,True,1,9585,-91.79,-277957.66,879807.15,601849.49
1966-04-12,91.45,-0.34,-0.37,94.06,-2.78,True,1,9586,-91.45,-278049.11,876639.7,598590.59
1966-04-13,91.54,0.09,0.1,94.06,-2.68,True,1,9587,-91.54,-278140.65,877593.98,599453.33
1966-04-14,91.87,0.33,0.36,94.06,-2.33,True,1,9588,-91.87,-278232.52,880849.56,602617.04
1966-04-15,91.99,0.12,0.13,94.06,-2.2,True,1,9589,-91.99,-278324.51,882092.11,603767.6
1966-04-18,91.58,-0.41,-0.45,94.06,-2.64,True,1,9590,-91.58,-278416.09,878252.2,599836.11
1966-04-19,91.57,-0.01,-0.01,94.06,-2.65,True,1,9591,-91.57,-278507.66,878247.87,599740.21
1966-04-20,92.08,0.51,0.56,94.06,-2.1,True,1,9592,-92.08,-278599.74,883231.36,604631.62
1966-04-21,92.42,0.34,0.37,94.06,-1.74,True,1,9593,-92.42,-278692.16,886585.06,607892.9
1966-04-22,92.27,-0.15,-0.16,94.06,-1.9,True,1,9594,-92.27,-278784.43,885238.38,606453.95
1966-04-25,92.08,-0.19,-0.21,94.06,-2.1,True,1,9595,-92.08,-278876.51,883507.6,604631.09
1966-04-26,91.99,-0.09,-0.1,94.06,-2.2,True,1,9596,-91.99,-278968.5,882736.04,603767.54
1966-04-27,91.76,-0.23,-0.25,94.06,-2.44,True,1,9597,-91.76,-279060.26,880620.72,601560.46
1966-04-28,91.13,-0.63,-0.69,94.06,-3.12,True,1,9598,-91.13,-279151.39,874665.74,595514.35
1966-04-29,91.06,-0.07,-0.08,94.06,-3.19,True,1,9599,-91.06,-279242.45,874084.94,594842.49
1966-05-02,90.9,-0.16,-0.18,94.06,-3.36,True,1,9600,-90.9,-279333.35,872640.0,593306.65
1966-05-03,89.85,-1.05,-1.16,94.06,-4.48,True,1,9601,-89.85,-279423.2,862649.85,583226.65
1966-05-04,89.39,-0.46,-0.51,94.06,-4.96,True,1,9602,-89.39,-279512.59,858322.78,578810.19
1966-05-05,87.93,-1.46,-1.63,94.06,-6.52,True,1,9603,-87.93,-279600.52,844391.79,564791.27
1966-05-06,87.84,-0.09,-0.1,94.06,-6.61,True,1,9604,-87.84,-279688.36,843615.36,563927.0
1966-05-09,86.32,-1.52,-1.73,94.06,-8.23,True,1,9605,-86.32,-279774.68,829103.6,549328.92
1966-05-10,87.08,0.76,0.88,94.06,-7.42,True,1,9606,-87.08,-279861.76,836490.48,556628.72
1966-05-11,87.23,0.15,0.17,94.06,-7.26,True,1,9607,-87.23,-279948.99,838018.61,558069.62
1966-05-12,86.23,-1.0,-1.15,94.06,-8.32,True,1,9608,-86.23,-280035.22,828497.84,548462.62
1966-05-13,85.47,-0.76,-0.88,94.06,-9.13,True,1,9609,-85.47,-280120.69,821281.23,541160.54
1966-05-16,84.41,-1.06,-1.24,94.06,-10.26,True,1,9610,-84.41,-280205.1,811180.1,530975.0
1966-05-17,83.63,-0.78,-0.92,94.06,-11.09,True,1,9611,-83.63,-280288.73,803767.93,523479.2
1966-05-18,85.12,1.49,1.78,94.06,-9.51,True,1,9612,-85.12,-280373.85,818173.44,537799.59
1966-05-19,85.02,-0.1,-0.12,94.06,-9.61,True,1,9613,-85.02,-280458.87,817297.26,536838.39
1966-05-20,85.43,0.41,0.48,94.06,-9.18,True,1,9614,-85.43,-280544.3,821324.02,540779.72
1966-05-23,86.2,0.77,0.9,94.06,-8.36,True,1,9615,-86.2,-280630.5,828813.0,548182.5
1966-05-24,86.77,0.57,0.66,94.06,-7.75,True,1,9616,-86.77,-280717.27,834380.32,553663.05
1966-05-25,87.07,0.3,0.35,94.06,-7.43,True,1,9617,-87.07,-280804.34,837352.19,556547.85
1966-05-26,87.07,0.0,0.0,94.06,-7.43,True,1,9618,-87.07,-280891.41,837439.26,556547.85
1966-05-27,87.33,0.26,0.3,94.06,-7.16,True,1,9619,-87.33,-280978.74,840027.27,559048.53
1966-05-31,86.13,-1.2,-1.37,94.06,-8.43,True,1,9620,-86.13,-281064.87,828570.6,547505.73
1966-06-01,86.1,-0.03,-0.04,94.06,-8.46,True,1,9621,-86.1,-281150.97,828368.1,547217.13
1966-06-02,85.96,-0.14,-0.16,94.06,-8.61,True,1,9622,-85.96,-281236.93,827107.12,545870.19
1966-06-03,86.06,0.1,0.12,94.06,-8.51,True,1,9623,-86.06,-281322.99,828155.38,546832.39
1966-06-06,85.42,-0.64,-0.74,94.06,-9.19,True,1,9624,-85.42,-281408.41,822082.08,540673.67
1966-06-07,84.83,-0.59,-0.69,94.06,-9.81,True,1,9625,-84.83,-281493.24,816488.75,534995.51
1966-06-08,84.93,0.1,0.12,94.06,-9.71,True,1,9626,-84.93,-281578.17,817536.18,535958.01
1966-06-09,85.5,0.57,0.67,94.06,-9.1,True,1,9627,-85.5,-281663.67,823108.5,541444.83
1966-06-10,86.44,0.94,1.1,94.06,-8.1,True,1,9628,-86.44,-281750.11,832244.32,550494.21
1966-06-13,86.83,0.39,0.45,94.06,-7.69,True,1,9629,-86.83,-281836.94,836086.07,554249.13
1966-06-14,87.07,0.24,0.28,94.06,-7.43,True,1,9630,-87.07,-281924.01,838484.1,556560.09
1966-06-15,86.73,-0.34,-0.39,94.06,-7.79,True,1,9631,-86.73,-282010.74,835296.63,553285.89
1966-06-16,86.47,-0.26,-0.3,94.06,-8.07,True,1,9632,-86.47,-282097.21,832879.04,550781.83
1966-06-17,86.51,0.04,0.05,94.06,-8.03,True,1,9633,-86.51,-282183.72,833350.83,551167.11
1966-06-20,86.48,-0.03,-0.04,94.06,-8.06,True,1,9634,-86.48,-282270.2,833148.32,550878.12
1966-06-21,86.71,0.23,0.27,94.06,-7.81,True,1,9635,-86.71,-282356.91,835450.85,553093.94
1966-06-22,86.85,0.14,0.16,94.06,-7.66,True,1,9636,-86.85,-282443.76,836886.6,554442.84
1966-06-23,86.5,-0.35,-0.4,94.06,-8.04,True,1,9637,-86.5,-282530.26,833600.5,551070.24
1966-06-24,86.58,0.08,0.09,94.06,-7.95,True,1,9638,-86.58,-282616.84,834458.04,551841.2
1966-06-27,86.08,-0.5,-0.58,94.06,-8.48,True,1,9639,-86.08,-282702.92,829725.12,547022.2
1966-06-28,85.67,-0.41,-0.48,94.06,-8.92,True,1,9640,-85.67,-282788.59,825858.8,543070.21
1966-06-29,84.86,-0.81,-0.94,94.06,-9.78,True,1,9641,-84.86,-282873.45,818135.26,535261.81
1966-06-30,84.74,-0.12,-0.14,94.06,-9.91,True,1,9642,-84.74,-282958.19,817063.08,534104.89
1966-07-01,85.61,0.87,1.03,94.06,-8.98,True,1,9643,-85.61,-283043.8,825537.23,542493.43
1966-07-05,85.82,0.21,0.24,94.06,-8.76,True,1,9644,-85.82,-283129.62,827648.08,544518.46
1966-07-06,87.06,1.24,1.44,94.06,-7.44,True,1,9645,-87.06,-283216.68,839693.7,556477.02
1966-07-07,87.38,0.32,0.37,94.06,-7.1,True,1,9646,-87.38,-283304.06,842867.48,559563.42
1966-07-08,87.61,0.23,0.26,94.06,-6.86,True,1,9647,-87.61,-283391.67,845173.67,561782.0
1966-07-11,87.45,-0.16,-0.18,94.06,-7.03,True,1,9648,-87.45,-283479.12,843717.6,560238.48
1966-07-12,86.88,-0.57,-0.65,94.06,-7.63,True,1,9649,-86.88,-283566.0,838305.12,554739.12
1966-07-13,86.3,-0.58,-0.67,94.06,-8.25,True,1,9650,-86.3,-283652.3,832795.0,549142.7
1966-07-14,86.82,0.52,0.6,94.06,-7.7,True,1,9651,-86.82,-283739.12,837899.82,554160.7
1966-07-15,87.08,0.26,0.3,94.06,-7.42,True,1,9652,-87.08,-283826.2,840496.16,556669.96
1966-07-18,86.99,-0.09,-0.1,94.06,-7.52,True,1,9653,-86.99,-283913.19,839714.47,555801.28
1966-07-19,86.33,-0.66,-0.76,94.06,-8.22,True,1,9654,-86.33,-283999.52,833429.82,549430.3
1966-07-20,85.51,-0.82,-0.95,94.06,-9.09,True,1,9655,-85.51,-284085.03,825599.05,541514.02
1966-07-21,85.52,0.01,0.01,94.06,-9.08,True,1,9656,-85.52,-284170.55,825781.12,541610.57
1966-07-22,85.41,-0.11,-0.13,94.06,-9.2,True,1,9657,-85.41,-284255.96,824804.37,540548.41
1966-07-25,83.83,-1.58,-1.85,94.06,-10.88,True,1,9658,-83.83,-284339.79,809630.14,525290.35
1966-07-26,83.7,-0.13,-0.16,94.06,-11.01,True,1,9659,-83.7,-284423.49,808458.3,524034.81
1966-07-27,84.1,0.4,0.48,94.06,-10.59,True,1,9660,-84.1,-284507.59,812406.0,527898.41
1966-07-28,83.77,-0.33,-0.39,94.06,-10.94,True,1,9661,-83.77,-284591.36,809301.97,524710.61
1966-07-29,83.6,-0.17,-0.2,94.06,-11.12,True,1,9662,-83.6,-284674.96,807743.2,523068.24
1966-08-01,82.31,-1.29,-1.54,94.06,-12.49,True,1,9663,-82.31,-284757.27,795361.53,510604.26
1966-08-02,82.33,0.02,0.02,94.06,-12.47,True,1,9664,-82.33,-284839.6,795637.12,510797.52
1966-08-03,83.15,0.82,1.0,94.06,-11.6,True,1,9665,-83.15,-284922.75,803644.75,518722.0
1966-08-04,83.93,0.78,0.94,94.06,-10.77,True,1,9666,-83.93,-285006.68,811267.38,526260.7
1966-08-05,84.0,0.07,0.08,94.06,-10.7,True,1,9667,-84.0,-285090.68,812028.0,526937.32
1966-08-08,83.75,-0.25,-0.3,94.06,-10.96,True,1,9668,-83.75,-285174.43,809695.0,524520.57
1966-08-09,83.49,-0.26,-0.31,94.06,-11.24,True,1,9669,-83.49,-285257.92,807264.81,522006.89
1966-08-10,83.11,-0.38,-0.46,94.06,-11.64,True,1,9670,-83.11,-285341.03,803673.7,518332.67
1966-08-11,83.02,-0.09,-0.11,94.06,-11.74,True,1,9671,-83.02,-285424.05,802886.42,517462.37
1966-08-12,83.17,0.15,0.18,94.06,-11.58,True,1,9672,-83.17,-285507.22,804420.24,518913.02
1966-08-15,82.74,-0.43,-0.52,94.06,-12.04,True,1,9673,-82.74,-285589.96,800344.02,514754.06
1966-08-16,81.63,-1.11,-1.34,94.06,-13.22,True,1,9674,-81.63,-285671.59,789688.62,504017.03
1966-08-17,81.18,-0.45,-0.55,94.06,-13.69,True,1,9675,-81.18,-285752.77,785416.5,499663.73
1966-08-18,80.16,-1.02,-1.26,94.06,-14.78,True,1,9676,-80.16,-285832.93,775628.16,489795.23
1966-08-19,79.62,-0.54,-0.67,94.06,-15.35,True,1,9677,-79.62,-285912.55,770482.74,484570.19
1966-08-22,78.24,-1.38,-1.73,94.06,-16.82,True,1,9678,-78.24,-285990.79,757206.72,471215.93
1966-08-23,78.11,-0.13,-0.17,94.06,-16.96,True,1,9679,-78.11,-286068.9,756026.69,469957.79
1966-08-24,79.07,0.96,1.23,94.06,-15.94,True,1,9680,-79.07,-286147.97,765397.6,479249.63
1966-08-25,78.06,-1.01,-1.28,94.06,-17.01,True,1,9681,-78.06,-286226.03,755698.86,469472.83
1966-08-26,76.41,-1.65,-2.11,94.06,-18.76,True,1,9682,-76.41,-286302.44,739801.62,453499.18
1966-08-29,74.53,-1.88,-2.46,94.06,-20.76,True,1,9683,-74.53,-286376.97,721673.99,435297.02
1966-08-30,75.86,1.33,1.78,94.06,-19.35,True,1,9684,-75.86,-286452.83,734628.24,448175.41
1966-08-31,77.1,1.24,1.64,94.06,-18.03,True,1,9685,-77.1,-286529.93,746713.5,460183.57
1966-09-01,77.7,0.6,0.78,94.06,-17.39,True,1,9686,-77.7,-286607.63,752602.2,465994.57
1966-09-02,77.42,-0.28,-0.36,94.06,-17.69,True,1,9687,-77.42,-286685.05,749967.54,463282.49
1966-09-06,76.96,-0.46,-0.59,94.06,-18.18,True,1,9688,-76.96,-286762.01,745588.48,458826.47
1966-09-07,76.37,-0.59,-0.77,94.06,-18.81,True,1,9689,-76.37,-286838.38,739948.93,453110.55
1966-09-08,76.05,-0.32,-0.42,94.06,-19.15,True,1,9690,-76.05,-286914.43,736924.5,450010.07
1966-09-09,76.29,0.24,0.32,94.06,-18.89,True,1,9691,-76.29,-286990.72,739326.39,452335.67
1966-09-12,77.91,1.62,2.12,94.06,-17.17,True,1,9692,-77.91,-287068.63,755103.72,468035.09
1966-09-13,78.32,0.41,0.53,94.06,-16.73,True,1,9693,-78.32,-287146.95,759155.76,472008.81
1966-09-14,79.13,0.81,1.03,94.06,-15.87,True,1,9694,-79.13,-287226.08,767086.22,479860.14
1966-09-15,80.08,0.95,1.2,94.06,-14.86,True,1,9695,-80.08,-287306.16,776375.6,489069.44
1966-09-16,79.99,-0.09,-0.11,94.06,-14.96,True,1,9696,-79.99,-287386.15,775583.04,488196.89
1966-09-19,79.59,-0.4,-0.5,94.06,-15.38,True,1,9697,-79.59,-287465.74,771784.23,484318.49
1966-09-20,79.04,-0.55,-0.69,94.06,-15.97,True,1,9698,-79.04,-287544.78,766529.92,478985.14
1966-09-21,77.71,-1.33,-1.68,94.06,-17.38,True,1,9699,-77.71,-287622.49,753709.29,466086.8
1966-09-22,77.94,0.23,0.3,94.06,-17.14,True,1,9700,-77.94,-287700.43,756018.0,468317.57
1966-09-23,77.67,-0.27,-0.35,94.06,-17.42,True,1,9701,-77.67,-287778.1,753476.67,465698.57
1966-09-26,77.86,0.19,0.24,94.06,-17.22,True,1,9702,-77.86,-287855.96,755397.72,467541.76
1966-09-27,78.1,0.24,0.31,94.06,-16.97,True,1,9703,-78.1,-287934.06,757804.3,469870.24
1966-09-28,77.11,-0.99,-1.27,94.06,-18.02,True,1,9704,-77.11,-288011.17,748275.44,460264.27
1966-09-29,76.31,-0.8,-1.04,94.06,-18.87,True,1,9705,-76.31,-288087.48,740588.55,452501.07
1966-09-30,76.56,0.25,0.33,94.06,-18.6,True,1,9706,-76.56,-288164.04,743091.36,454927.32
1966-10-03,74.9,-1.66,-2.17,94.06,-20.37,True,1,9707,-74.9,-288238.94,727054.3,438815.36
1966-10-04,75.1,0.2,0.27,94.06,-20.16,True,1,9708,-75.1,-288314.04,729070.8,440756.76
1966-10-05,74.69,-0.41,-0.55,94.06,-20.59,True,1,9709,-74.69,-288388.73,725165.21,436776.48
1966-10-06,74.05,-0.64,-0.86,94.06,-21.27,True,1,9710,-74.05,-288462.78,719025.5,430562.72
1966-10-07,73.2,-0.85,-1.15,94.06,-22.18,True,1,9711,-73.2,-288535.98,710845.2,422309.22
1966-10-10,74.53,1.33,1.82,94.06,-20.76,True,1,9712,-74.53,-288610.51,723835.36,435224.85
1966-10-11,74.91,0.38,0.51,94.06,-20.36,True,1,9713,-74.91,-288685.42,727600.83,438915.41
1966-10-12,77.04,2.13,2.84,94.06,-18.1,True,1,9714,-77.04,-288762.46,748366.56,459604.1
1966-10-13,76.89,-0.15,-0.2,94.06,-18.25,True,1,9715,-76.89,-288839.35,746986.35,458147.0
1966-10-14,76.6,-0.29,-0.38,94.06,-18.56,True,1,9716,-76.6,-288915.95,744245.6,455329.65
1966-10-17,77.47,0.87,1.14,94.06,-17.64,True,1,9717,-77.47,-288993.42,752775.99,463782.57
1966-10-18,78.68,1.21,1.56,94.06,-16.35,True,1,9718,-78.68,-289072.1,764612.24,475540.14
1966-10-19,78.05,-0.63,-0.8,94.06,-17.02,True,1,9719,-78.05,-289150.15,758567.95,469417.8
1966-10-20,77.84,-0.21,-0.27,94.06,-17.24,True,1,9720,-77.84,-289227.99,756604.8,467376.81
1966-10-21,78.19,0.35,0.45,94.06,-16.87,True,1,9721,-78.19,-289306.18,760084.99,470778.81
1966-10-24,78.42,0.23,0.29,94.06,-16.63,True,1,9722,-78.42,-289384.6,762399.24,473014.64
1966-10-25,78.9,0.48,0.61,94.06,-16.12,True,1,9723,-78.9,-289463.5,767144.7,477681.2
1966-10-26,79.58,0.68,0.86,94.06,-15.39,True,1,9724,-79.58,-289543.08,773835.92,484292.84
1966-10-27,80.23,0.65,0.82,94.06,-14.7,True,1,9725,-80.23,-289623.31,780236.75,490613.44
1966-10-28,80.24,0.01,0.01,94.06,-14.69,True,1,9726,-80.24,-289703.55,780414.24,490710.69
1966-10-31,80.2,-0.04,-0.05,94.06,-14.74,True,1,9727,-80.2,-289783.75,780105.4,490321.65
1966-11-01,80.81,0.61,0.76,94.06,-14.09,True,1,9728,-80.81,-289864.56,786119.68,496255.12
1966-11-02,80.88,0.07,0.09,94.06,-14.01,True,1,9729,-80.88,-289945.44,786881.52,496936.08
1966-11-03,80.56,-0.32,-0.4,94.06,-14.35,True,1,9730,-80.56,-290026.0,783848.8,493822.8
1966-11-04,80.81,0.25,0.31,94.06,-14.09,True,1,9731,-80.81,-290106.81,786362.11,496255.3
1966-11-07,80.73,-0.08,-0.1,94.06,-14.17,True,1,9732,-80.73,-290187.54,785664.36,495476.82
1966-11-09,81.38,0.65,0.8,94.06,-13.48,True,1,9733,-81.38,-290268.92,792071.54,501802.62
1966-11-10,81.89,0.51,0.63,94.06,-12.94,True,1,9734,-81.89,-290350.81,797117.26,506766.45
1966-11-11,81.94,0.05,0.06,94.06,-12.88,True,1,9735,-81.94,-290432.75,797685.9,507253.15
1966-11-14,81.37,-0.57,-0.7,94.06,-13.49,True,1,9736,-81.37,-290514.12,792218.32,501704.2
1966-11-15,81.69,0.32,0.39,94.06,-13.15,True,1,9737,-81.69,-290595.81,795415.53,504819.72
1966-11-16,82.37,0.68,0.83,94.06,-12.43,True,1,9738,-82.37,-290678.18,802119.06,511440.88
1966-11-17,81.8,-0.57,-0.69,94.06,-13.03,True,1,9739,-81.8,-290759.98,796650.2,505890.22
1966-11-18,81.26,-0.54,-0.66,94.06,-13.61,True,1,9740,-81.26,-290841.24,791472.4,500631.16
1966-11-21,80.09,-1.17,-1.44,94.06,-14.85,True,1,9741,-80.09,-290921.33,780156.69,489235.36
1966-11-22,79.67,-0.42,-0.52,94.06,-15.3,True,1,9742,-79.67,-291001.0,776145.14,485144.14
1966-11-23,80.21,0.54,0.68,94.06,-14.72,True,1,9743,-80.21,-291081.21,781486.03,490404.82
1966-11-25,80.85,0.64,0.8,94.06,-14.04,True,1,9744,-80.85,-291162.06,787802.4,496640.34
1966-11-28,80.71,-0.14,-0.17,94.06,-14.19,True,1,9745,-80.71,-291242.77,786518.95,495276.18
1966-11-29,80.42,-0.29,-0.36,94.06,-14.5,True,1,9746,-80.42,-291323.19,783773.32,492450.13
1966-11-30,80.45,0.03,0.04,94.06,-14.47,True,1,9747,-80.45,-291403.64,784146.15,492742.51
1966-12-01,80.08,-0.37,-0.46,94.06,-14.86,True,1,9748,-80.08,-291483.72,780619.84,489136.12
1966-12-02,80.13,0.05,0.06,94.06,-14.81,True,1,9749,-80.13,-291563.85,781187.37,489623.52
1966-12-05,80.24,0.11,0.14,94.06,-14.69,True,1,9750,-80.24,-291644.09,782340.0,490695.91
1966-12-06,80.84,0.6,0.75,94.06,-14.06,True,1,9751,-80.84,-291724.93,788270.84,496545.91
1966-12-07,81.72,0.88,1.09,94.06,-13.12,True,1,9752,-81.72,-291806.65,796933.44,505126.79
1966-12-08,82.05,0.33,0.4,94.06,-12.77,True,1,9753,-82.05,-291888.7,800233.65,508344.95
1966-12-09,82.14,0.09,0.11,94.06,-12.67,True,1,9754,-82.14,-291970.84,801193.56,509222.72
1966-12-12,83.0,0.86,1.05,94.06,-11.76,True,1,9755,-83.0,-292053.84,809665.0,517611.16
1966-12-13,82.73,-0.27,-0.32,94.06,-12.04,True,1,9756,-82.73,-292136.57,807113.88,514977.31
1966-12-14,82.64,-0.09,-0.11,94.06,-12.14,True,1,9757,-82.64,-292219.21,806318.48,514099.27
1966-12-15,81.64,-1.0,-1.21,94.06,-13.2,True,1,9758,-81.64,-292300.85,796643.12,504342.27
1966-12-16,81.58,-0.06,-0.07,94.06,-13.27,True,1,9759,-81.58,-292382.43,796139.22,503756.79
1966-12-19,81.27,-0.31,-0.38,94.06,-13.6,True,1,9760,-81.27,-292463.7,793195.2,500731.5
1966-12-20,80.96,-0.31,-0.38,94.06,-13.93,True,1,9761,-80.96,-292544.66,790250.56,497705.9
1966-12-21,81.38,0.42,0.52,94.06,-13.48,True,1,9762,-81.38,-292626.04,794431.56,501805.52
1966-12-22,81.69,0.31,0.38,94.06,-13.15,True,1,9763,-81.69,-292707.73,797539.47,504831.74
1966-12-23,81.47,-0.22,-0.27,94.06,-13.38,True,1,9764,-81.47,-292789.2,795473.08,502683.88
1966-12-27,81.0,-0.47,-0.58,94.06,-13.88,True,1,9765,-81.0,-292870.2,790965.0,498094.8
1966-12-28,80.61,-0.39,-0.48,94.06,-14.3,True,1,9766,-80.61,-292950.81,787237.26,494286.45
1966-12-29,80.37,-0.24,-0.3,94.06,-14.56,True,1,9767,-80.37,-293031.18,784973.79,491942.61
1966-12-30,80.33,-0.04,-0.05,94.06,-14.6,True,1,9768,-80.33,-293111.51,784663.44,491551.93
1967-01-03,80.38,0.05,0.06,94.06,-14.54,True,1,9769,-80.38,-293191.89,785232.22,492040.33
1967-01-04,80.55,0.17,0.21,94.06,-14.36,True,1,9770,-80.55,-293272.44,786973.5,493701.06
1967-01-05,81.6,1.05,1.3,94.06,-13.25,True,1,9771,-81.6,-293354.04,797313.6,503959.56
1967-01-06,82.18,0.58,0.71,94.06,-12.63,True,1,9772,-82.18,-293436.22,803062.96,509626.74
1967-01-09,82.81,0.63,0.77,94.06,-11.96,True,1,9773,-82.81,-293519.03,809302.13,515783.1
1967-01-10,82.81,0.0,0.0,94.06,-11.96,True,1,9774,-82.81,-293601.84,809384.94,515783.1
1967-01-11,83.47,0.66,0.8,94.06,-11.26,True,1,9775,-83.47,-293685.31,815919.25,522233.94
1967-01-12,83.91,0.44,0.53,94.06,-10.79,True,1,9776,-83.91,-293769.22,820304.16,526534.94
1967-01-13,84.53,0.62,0.74,94.06,-10.13,True,1,9777,-84.53,-293853.75,826449.81,532596.06
1967-01-16,84.31,-0.22,-0.26,94.06,-10.37,True,1,9778,-84.31,-293938.06,824383.18,530445.12
1967-01-17,85.24,0.93,1.1,94.06,-9.38,True,1,9779,-85.24,-294023.3,833561.96,539538.66
1967-01-18,85.79,0.55,0.64,94.06,-8.79,True,1,9780,-85.79,-294109.09,839026.2,544917.11
1967-01-19,85.82,0.03,0.04,94.06,-8.76,True,1,9781,-85.82,-294194.91,839405.42,545210.51
1967-01-20,86.07,0.25,0.29,94.06,-8.49,True,1,9782,-86.07,-294280.98,841936.74,547655.76
1967-01-23,86.39,0.32,0.37,94.06,-8.15,True,1,9783,-86.39,-294367.37,845153.37,550786.0
1967-01-24,86.51,0.12,0.14,94.06,-8.03,True,1,9784,-86.51,-294453.88,846413.84,551959.96
1967-01-25,85.85,-0.66,-0.76,94.06,-8.73,True,1,9785,-85.85,-294539.73,840042.25,545502.52
1967-01-26,85.81,-0.04,-0.05,94.06,-8.77,True,1,9786,-85.81,-294625.54,839736.66,545111.12
1967-01-27,86.16,0.35,0.41,94.06,-8.4,True,1,9787,-86.16,-294711.7,843247.92,548536.22
1967-01-30,86.66,0.5,0.58,94.06,-7.87,True,1,9788,-86.66,-294798.36,848228.08,553429.72
1967-01-31,86.61,-0.05,-0.06,94.06,-7.92,True,1,9789,-86.61,-294884.97,847825.29,552940.32
1967-02-01,86.43,-0.18,-0.21,94.06,-8.11,True,1,9790,-86.43,-294971.4,846149.7,551178.3
1967-02-02,86.73,0.3,0.35,94.06,-7.79,True,1,9791,-86.73,-295058.13,849173.43,554115.3
1967-02-03,87.36,0.63,0.73,94.06,-7.12,True,1,9792,-87.36,-295145.49,855429.12,560283.63
1967-02-06,87.18,-0.18,-0.21,94.06,-7.31,True,1,9793,-87.18,-295232.67,853753.74,558521.07
1967-02-07,86.95,-0.23,-0.26,94.06,-7.56,True,1,9794,-86.95,-295319.62,851588.3,556268.68
1967-02-08,87.72,0.77,0.89,94.06,-6.74,True,1,9795,-87.72,-295407.34,859217.4,563810.06
1967-02-09,87.36,-0.36,-0.41,94.06,-7.12,True,1,9796,-87.36,-295494.7,855778.56,560283.86
1967-02-10,87.63,0.27,0.31,94.06,-6.84,True,1,9797,-87.63,-295582.33,858511.11,562928.78
1967-02-13,87.58,-0.05,-0.06,94.06,-6.89,True,1,9798,-87.58,-295669.91,858108.84,562438.93
1967-02-14,88.17,0.59,0.67,94.06,-6.26,True,1,9799,-88.17,-295758.08,863977.83,568219.75
1967-02-15,88.27,0.1,0.11,94.06,-6.16,True,1,9800,-88.27,-295846.35,865046.0,569199.65
1967-02-16,87.86,-0.41,-0.46,94.06,-6.59,True,1,9801,-87.86,-295934.21,861115.86,565181.65
1967-02-17,87.89,0.03,0.03,94.06,-6.56,True,1,9802,-87.89,-296022.1,861497.78,565475.68
1967-02-20,87.4,-0.49,-0.56,94.06,-7.08,True,1,9803,-87.4,-296109.5,856782.2,560672.7
1967-02-21,87.34,-0.06,-0.07,94.06,-7.14,True,1,9804,-87.34,-296196.84,856281.36,560084.52
1967-02-23,87.45,0.11,0.13,94.06,-7.03,True,1,9805,-87.45,-296284.29,857447.25,561162.96
1967-02-24,87.41,-0.04,-0.05,94.06,-7.07,True,1,9806,-87.41,-296371.7,857142.46,560770.76
1967-02-27,86.46,-0.95,-1.09,94.06,-8.08,True,1,9807,-86.46,-296458.16,847913.22,551455.06
1967-02-28,86.78,0.32,0.37,94.06,-7.74,True,1,9808,-86.78,-296544.94,851138.24,554593.3
1967-03-01,87.68,0.9,1.04,94.06,-6.78,True,1,9809,-87.68,-296632.62,860053.12,563420.5
1967-03-02,88.16,0.48,0.55,94.06,-6.27,True,1,9810,-88.16,-296720.78,864849.6,568128.82
1967-03-03,88.29,0.13,0.15,94.06,-6.13,True,1,9811,-88.29,-296809.07,866213.19,569404.12
1967-03-06,88.1,-0.19,-0.22,94.06,-6.34,True,1,9812,-88.1,-296897.17,864437.2,567540.03
1967-03-07,88.16,0.06,0.07,94.06,-6.27,True,1,9813,-88.16,-296985.33,865114.08,568128.75
1967-03-08,88.27,0.11,0.12,94.06,-6.16,True,1,9814,-88.27,-297073.6,866281.78,569208.18
1967-03-09,88.53,0.26,0.3,94.06,-5.88,True,1,9815,-88.53,-297162.13,868921.95,571759.82
1967-03-10,88.89,0.36,0.41,94.06,-5.5,True,1,9816,-88.89,-297251.02,872544.24,575293.22
1967-03-13,88.43,-0.46,-0.52,94.06,-5.99,True,1,9817,-88.43,-297339.45,868117.31,570777.86
1967-03-14,88.35,-0.08,-0.09,94.06,-6.07,True,1,9818,-88.35,-297427.8,867420.3,569992.5
1967-03-15,89.19,0.84,0.95,94.06,-5.18,True,1,9819,-89.19,-297516.99,875756.61,578239.62
1967-03-16,90.09,0.9,1.01,94.06,-4.22,True,1,9820,-90.09,-297607.08,884683.8,587076.72
1967-03-17,90.25,0.16,0.18,94.06,-4.05,True,1,9821,-90.25,-297697.33,886345.25,588647.92
1967-03-20,90.2,-0.05,-0.06,94.06,-4.1,True,1,9822,-90.2,-297787.53,885944.4,588156.87
1967-03-21,90.0,-0.2,-0.22,94.06,-4.32,True,1,9823,-90.0,-297877.53,884070.0,586192.47
1967-03-22,90.25,0.25,0.28,94.06,-4.05,True,1,9824,-90.25,-297967.78,886616.0,588648.22
1967-03-23,90.94,0.69,0.76,94.06,-3.32,True,1,9825,-90.94,-298058.72,893485.5,595426.78
1967-03-27,90.87,-0.07,-0.08,94.06,-3.39,True,1,9826,-90.87,-298149.59,892888.62,594739.03
1967-03-28,90.91,0.04,0.04,94.06,-3.35,True,1,9827,-90.91,-298240.5,893372.57,595132.07
1967-03-29,90.73,-0.18,-0.2,94.06,-3.54,True,1,9828,-90.73,-298331.23,891694.44,593363.21
1967-03-30,90.7,-0.03,-0.03,94.06,-3.57,True,1,9829,-90.7,-298421.93,891490.3,593068.37
1967-03-31,90.2,-0.5,-0.55,94.06,-4.1,True,1,9830,-90.2,-298512.13,886666.0,588153.87
1967-04-03,89.24,-0.96,-1.06,94.06,-5.12,True,1,9831,-89.24,-298601.37,877318.44,578717.07
1967-04-04,89.22,-0.02,-0.02,94.06,-5.15,True,1,9832,-89.22,-298690.59,877211.04,578520.45
1967-04-05,89.79,0.57,0.64,94.06,-4.54,True,1,9833,-89.79,-298780.38,882905.07,584124.69
1967-04-06,89.94,0.15,0.17,94.06,-4.38,True,1,9834,-89.94,-298870.32,884469.96,585599.64
1967-04-07,89.36,-0.58,-0.64,94.06,-5.0,True,1,9835,-89.36,-298959.68,878855.6,579895.92
1967-04-10,88.24,-1.12,-1.25,94.06,-6.19,True,1,9836,-88.24,-299047.92,867928.64,568880.72
1967-04-11,88.88,0.64,0.72,94.06,-5.51,True,1,9837,-88.88,-299136.8,874312.56,575175.76
1967-04-12,88.78,-0.1,-0.11,94.06,-5.61,True,1,9838,-88.78,-299225.58,873417.64,574192.06
1967-04-13,89.46,0.68,0.77,94.06,-4.89,True,1,9839,-89.46,-299315.04,880196.94,580881.9
1967-04-14,90.43,0.97,1.08,94.06,-3.86,True,1,9840,-90.43,-299405.47,889831.2,590425.73
1967-04-17,91.07,0.64,0.71,94.06,-3.18,True,1,9841,-91.07,-299496.54,896219.87,596723.33
1967-04-18,91.86,0.79,0.87,94.06,-2.34,True,1,9842,-91.86,-299588.4,904086.12,604497.72
1967-04-19,91.94,0.08,0.09,94.06,-2.25,True,1,9843,-91.94,-299680.34,904965.42,605285.08
1967-04-20,92.11,0.17,0.18,94.06,-2.07,True,1,9844,-92.11,-299772.45,906730.84,606958.39
1967-04-21,92.3,0.19,0.21,94.06,-1.87,True,1,9845,-92.3,-299864.75,908693.5,608828.75
1967-04-24,92.62,0.32,0.35,94.06,-1.53,True,1,9846,-92.62,-299957.37,911936.52,611979.15
1967-04-25,93.11,0.49,0.53,94.06,-1.01,True,1,9847,-93.11,-300050.48,916854.17,616803.69
1967-04-26,93.02,-0.09,-0.1,94.06,-1.11,True,1,9848,-93.02,-300143.5,916060.96,615917.46
1967-04-27,93.81,0.79,0.85,94.06,-0.27,True,1,9849,-93.81,-300237.31,923934.69,623697.38
1967-04-28,94.01,0.2,0.21,94.06,-0.05,True,1,9850,-94.01,-300331.32,925998.5,625667.18
1967-05-01,93.84,-0.17,-0.18,94.06,-0.23,True,1,9851,-93.84,-300425.16,924417.84,623992.68
1967-05-02,93.67,-0.17,-0.18,94.06,-0.42,True,1,9852,-93.67,-300518.83,922836.84,622318.01
1967-05-03,93.91,0.24,0.26,94.06,-0.16,True,1,9853,-93.91,-300612.74,925295.23,624682.49
1967-05-04,94.32,0.41,0.44,94.32,0.0,True,1,9854,-94.32,-300707.06,929429.28,628722.22
1967-05-05,94.44,0.12,0.13,94.44,0.0,True,1,9855,-94.44,-300801.5,930706.2,629904.7
1967-05-08,94.58,0.14,0.15,94.58,0.0,True,1,9856,-94.58,-300896.08,932180.48,631284.4
1967-05-09,93.6,-0.98,-1.04,94.58,-1.04,True,1,9857,-93.6,-300989.68,922615.2,621625.52
1967-05-10,93.35,-0.25,-0.27,94.58,-1.3,True,1,9858,-93.35,-301083.03,920244.3,619161.27
1967-05-11,93.75,0.4,0.43,94.58,-0.88,True,1,9859,-93.75,-301176.78,924281.25,623104.47
1967-05-12,93.48,-0.27,-0.29,94.58,-1.16,True,1,9860,-93.48,-301270.26,921712.8,620442.54
1967-05-15,92.71,-0.77,-0.82,94.58,-1.98,True,1,9861,-92.71,-301362.97,914213.31,612850.34
1967-05-16,93.14,0.43,0.46,94.58,-1.52,True,1,9862,-93.14,-301456.11,918546.68,617090.57
1967-05-17,92.78,-0.36,-0.39,94.58,-1.9,True,1,9863,-92.78,-301548.89,915089.14,613540.25
1967-05-18,92.53,-0.25,-0.27,94.58,-2.17,True,1,9864,-92.53,-301641.42,912715.92,611074.5
1967-05-19,92.07,-0.46,-0.5,94.58,-2.65,True,1,9865,-92.07,-301733.49,908270.55,606537.06
1967-05-22,91.67,-0.4,-0.43,94.58,-3.08,True,1,9866,-91.67,-301825.16,904416.22,602591.06
1967-05-23,91.23,-0.44,-0.48,94.58,-3.54,True,1,9867,-91.23,-301916.39,900166.41,598250.02
1967-05-24,90.18,-1.05,-1.15,94.58,-4.65,True,1,9868,-90.18,-302006.57,889896.24,587889.67
1967-05-25,91.19,1.01,1.12,94.58,-3.58,True,1,9869,-91.19,-302097.76,899954.11,597856.35
1967-05-26,90.98,-0.21,-0.23,94.58,-3.81,True,1,9870,-90.98,-302188.74,897972.6,595783.86
1967-05-29,90.49,-0.49,-0.54,94.58,-4.32,True,1,9871,-90.49,-302279.23,893226.79,590947.56
1967-05-31,89.08,-1.41,-1.56,94.58,-5.82,True,1,9872,-89.08,-302368.31,879397.76,577029.45
1967-06-01,90.23,1.15,1.29,94.58,-4.6,True,1,9873,-90.23,-302458.54,890840.79,588382.25
1967-06-02,89.79,-0.44,-0.49,94.58,-5.06,True,1,9874,-89.79,-302548.33,886586.46,584038.13
1967-06-05,88.43,-1.36,-1.52,94.58,-6.5,True,1,9875,-88.43,-302636.76,873246.25,570609.49
1967-06-06,90.23,1.8,2.04,94.58,-4.6,True,1,9876,-90.23,-302726.99,891111.48,588384.49
1967-06-07,90.91,0.68,0.75,94.58,-3.88,True,1,9877,-90.91,-302817.9,897918.07,595100.17
1967-06-08,91.4,0.49,0.54,94.58,-3.36,True,1,9878,-91.4,-302909.3,902849.2,599939.9
1967-06-09,91.56,0.16,0.18,94.58,-3.19,True,1,9879,-91.56,-303000.86,904521.24,601520.38
1967-06-12,92.04,0.48,0.52,94.58,-2.69,True,1,9880,-92.04,-303092.9,909355.2,606262.3
1967-06-13,92.62,0.58,0.63,94.58,-2.07,True,1,9881,-92.62,-303185.52,915178.22,611992.7
1967-06-14,92.4,-0.22,-0.24,94.58,-2.31,True,1,9882,-92.4,-303277.92,913096.8,609818.88
1967-06-15,92.49,0.09,0.1,94.58,-2.21,True,1,9883,-92.49,-303370.41,914078.67,610708.26
1967-06-16,92.54,0.05,0.05,94.58,-2.16,True,1,9884,-92.54,-303462.95,914665.36,611202.41
1967-06-19,92.51,-0.03,-0.03,94.58,-2.19,True,1,9885,-92.51,-303555.46,914461.35,610905.89
1967-06-20,92.48,-0.03,-0.03,94.58,-2.22,True,1,9886,-92.48,-303647.94,914257.28,610609.34
1967-06-21,92.2,-0.28,-0.3,94.58,-2.52,True,1,9887,-92.2,-303740.14,911581.4,607841.26
1967-06-22,91.97,-0.23,-0.25,94.58,-2.76,True,1,9888,-91.97,-303832.11,909399.36,605567.25
1967-06-23,92.0,0.03,0.03,94.58,-2.73,True,1,9889,-92.0,-303924.11,909788.0,605863.89
1967-06-26,91.64,-0.36,-0.39,94.58,-3.11,True,1,9890,-91.64,-304015.75,906319.6,602303.85
1967-06-27,91.3,-0.34,-0.37,94.58,-3.47,True,1,9891,-91.3,-304107.05,903048.3,598941.25
1967-06-28,91.31,0.01,0.01,94.58,-3.46,True,1,9892,-91.31,-304198.36,903238.52,599040.16
1967-06-29,90.85,-0.46,-0.5,94.58,-3.94,True,1,9893,-90.85,-304289.21,898779.05,594489.84
1967-06-30,90.64,-0.21,-0.23,94.58,-4.17,True,1,9894,-90.64,-304379.85,896792.16,592412.31
1967-07-03,90.91,0.27,0.3,94.58,-3.88,True,1,9895,-90.91,-304470.76,899554.45,595083.69
1967-07-05,91.36,0.45,0.5,94.58,-3.4,True,1,9896,-91.36,-304562.12,904098.56,599536.44
1967-07-06,91.32,-0.04,-0.04,94.58,-3.45,True,1,9897,-91.32,-304653.44,903794.04,599140.6
1967-07-07,91.69,0.37,0.4,94.58,-3.06,True,1,9898,-91.69,-304745.13,907547.62,602802.49
1967-07-10,92.05,0.36,0.39,94.58,-2.68,True,1,9899,-92.05,-304837.18,911202.95,606365.77
1967-07-11,92.48,0.43,0.47,94.58,-2.22,True,1,9900,-92.48,-304929.66,915552.0,610622.34
1967-07-12,92.4,-0.08,-0.09,94.58,-2.31,True,1,9901,-92.4,-305022.06,914852.4,609830.34
1967-07-13,92.42,0.02,0.02,94.58,-2.28,True,1,9902,-92.42,-305114.48,915142.84,610028.36
1967-07-14,92.74,0.32,0.35,94.58,-1.94,True,1,9903,-92.74,-305207.22,918404.22,613197.0
1967-07-17,92.75,0.01,0.01,94.58,-1.94,True,1,9904,-92.75,-305299.97,918596.0,613296.03
1967-07-18,93.5,0.75,0.81,94.58,-1.14,True,1,9905,-93.5,-305393.47,926117.5,620724.03
1967-07-19,93.65,0.15,0.16,94.58,-0.98,True,1,9906,-93.65,-305487.12,927696.9,622209.78
1967-07-20,93.85,0.2,0.21,94.58,-0.77,True,1,9907,-93.85,-305580.97,929771.95,624190.98
1967-07-21,94.04,0.19,0.2,94.58,-0.57,True,1,9908,-94.04,-305675.01,931748.32,626073.31
1967-07-24,93.73,-0.31,-0.33,94.58,-0.9,True,1,9909,-93.73,-305768.74,928770.57,623001.83
1967-07-25,93.24,-0.49,-0.52,94.58,-1.42,True,1,9910,-93.24,-305861.98,924008.4,618146.42
1967-07-26,94.06,0.82,0.88,94.58,-0.55,True,1,9911,-94.06,-305956.04,932228.66,626272.62
1967-07-27,94.35,0.29,0.31,94.58,-0.24,True,1,9912,-94.35,-306050.39,935197.2,629146.81
1967-07-28,94.49,0.14,0.15,94.58,-0.1,True,1,9913,-94.49,-306144.88,936679.37,630534.49
1967-07-31,94.75,0.26,0.28,94.75,0.0,True,1,9914,-94.75,-306239.63,939351.5,633111.87
1967-08-01,95.37,0.62,0.65,95.37,0.0,True,1,9915,-95.37,-306335.0,945593.55,639258.55
1967-08-02,95.78,0.41,0.43,95.78,0.0,True,1,9916,-95.78,-306430.78,949754.48,643323.7
1967-08-03,95.66,-0.12,-0.12,95.78,-0.12,True,1,9917,-95.66,-306526.44,948660.22,642133.78
1967-08-04,95.83,0.17,0.18,95.83,0.0,True,1,9918,-95.83,-306622.27,950441.94,643819.67
1967-08-07,95.58,-0.25,-0.26,95.83,-0.26,True,1,9919,-95.58,-306717.85,948058.02,641340.17
1967-08-08,95.69,0.11,0.12,95.83,-0.15,True,1,9920,-95.69,-306813.54,949244.8,642431.26
1967-08-09,95.78,0.09,0.09,95.83,-0.05,True,1,9921,-95.78,-306909.32,950233.38,643324.06
1967-08-10,95.53,-0.25,-0.26,95.83,-0.31,True,1,9922,-95.53,-307004.85,947848.66,640843.81
1967-08-11,95.15,-0.38,-0.4,95.83,-0.71,True,1,9923,-95.15,-307100.0,944173.45,637073.45
1967-08-14,94.64,-0.51,-0.54,95.83,-1.24,True,1,9924,-94.64,-307194.64,939207.36,632012.72
1967-08-15,94.77,0.13,0.14,95.83,-1.11,True,1,9925,-94.77,-307289.41,940592.25,633302.84
1967-08-16,94.55,-0.22,-0.23,95.83,-1.34,True,1,9926,-94.55,-307383.96,938503.3,631119.34
1967-08-17,94.63,0.08,0.08,95.83,-1.25,True,1,9927,-94.63,-307478.59,939392.01,631913.42
1967-08-18,94.78,0.15,0.16,95.83,-1.1,True,1,9928,-94.78,-307573.37,940975.84,633402.47
1967-08-21,94.25,-0.53,-0.56,95.83,-1.65,True,1,9929,-94.25,-307667.62,935808.25,628140.63
1967-08-22,93.74,-0.51,-0.54,95.83,-2.18,True,1,9930,-93.74,-307761.36,930838.2,623076.84
1967-08-23,93.61,-0.13,-0.14,95.83,-2.32,True,1,9931,-93.61,-307854.97,929640.91,621785.94
1967-08-24,93.09,-0.52,-0.56,95.83,-2.86,True,1,9932,-93.09,-307948.06,924569.88,616621.82
1967-08-25,92.7,-0.39,-0.42,95.83,-3.27,True,1,9933,-92.7,-308040.76,920789.1,612748.34
1967-08-28,92.64,-0.06,-0.06,95.83,-3.33,True,1,9934,-92.64,-308133.4,920285.76,612152.36
1967-08-29,92.88,0.24,0.26,95.83,-3.08,True,1,9935,-92.88,-308226.28,922762.8,614536.52
1967-08-30,93.07,0.19,0.2,95.83,-2.88,True,1,9936,-93.07,-308319.35,924743.52,616424.17
1967-08-31,93.64,0.57,0.61,95.83,-2.28,True,1,9937,-93.64,-308412.99,930500.68,622087.69
1967-09-01,93.68,0.04,0.04,95.83,-2.24,True,1,9938,-93.68,-308506.67,930991.84,622485.17
1967-09-05,94.21,0.53,0.57,95.83,-1.69,True,1,9939,-94.21,-308600.88,936353.19,627752.31
1967-09-06,94.39,0.18,0.19,95.83,-1.5,True,1,9940,-94.39,-308695.27,938236.6,629541.33
1967-09-07,94.33,-0.06,-0.06,95.83,-1.56,True,1,9941,-94.33,-308789.6,937734.53,628944.93
1967-09-08,94.36,0.03,0.03,95.83,-1.53,True,1,9942,-94.36,-308883.96,938127.12,629243.16
1967-09-11,94.54,0.18,0.19,95.83,-1.35,True,1,9943,-94.54,-308978.5,940011.22,631032.72
1967-09-12,94.99,0.45,0.48,95.83,-0.88,True,1,9944,-94.99,-309073.49,944580.56,635507.07
1967-09-13,95.99,1.0,1.05,95.99,0.0,True,1,9945,-95.99,-309169.48,954620.55,645451.07
1967-09-14,96.2,0.21,0.22,96.2,0.0,True,1,9946,-96.2,-309265.68,956805.2,647539.52
1967-09-15,96.27,0.07,0.07,96.27,0.0,True,1,9947,-96.27,-309361.95,957597.69,648235.74
1967-09-18,96.53,0.26,0.27,96.53,0.0,True,1,9948,-96.53,-309458.48,960280.44,650821.96
1967-09-19,96.17,-0.36,-0.37,96.53,-0.37,True,1,9949,-96.17,-309554.65,956795.33,647240.68
1967-09-20,96.13,-0.04,-0.04,96.53,-0.41,True,1,9950,-96.13,-309650.78,956493.5,646842.72
1967-09-21,96.75,0.62,0.64,96.75,0.0,True,1,9951,-96.75,-309747.53,962759.25,653011.72
1967-09-22,97.0,0.25,0.26,97.0,0.0,True,1,9952,-97.0,-309844.53,965344.0,655499.47
1967-09-25,97.59,0.59,0.61,97.59,0.0,True,1,9953,-97.59,-309942.12,971313.27,661371.15
1967-09-26,96.76,-0.83,-0.85,97.59,-0.85,True,1,9954,-96.76,-310038.88,963149.04,653110.16
1967-09-27,96.79,0.03,0.03,97.59,-0.82,True,1,9955,-96.79,-310135.67,963544.45,653408.78
1967-09-28,96.79,0.0,0.0,97.59,-0.82,True,1,9956,-96.79,-310232.46,963641.24,653408.78
1967-09-29,96.71,-0.08,-0.08,97.59,-0.9,True,1,9957,-96.71,-310329.17,962941.47,652612.3
1967-10-02,96.32,-0.39,-0.4,97.59,-1.3,True,1,9958,-96.32,-310425.49,959154.56,648729.07
1967-10-03,96.65,0.33,0.34,97.59,-0.96,True,1,9959,-96.65,-310522.14,962537.35,652015.21
1967-10-04,96.43,-0.22,-0.23,97.59,-1.19,True,1,9960,-96.43,-310618.57,960442.8,649824.23
1967-10-05,96.67,0.24,0.25,97.59,-0.94,True,1,9961,-96.67,-310715.24,962929.87,652214.63
1967-10-06,97.26,0.59,0.61,97.59,-0.34,True,1,9962,-97.26,-310812.5,968904.12,658091.62
1967-10-09,97.51,0.25,0.26,97.59,-0.08,True,1,9963,-97.51,-310910.01,971492.13,660582.12
1967-10-10,96.84,-0.67,-0.69,97.59,-0.77,True,1,9964,-96.84,-311006.85,964913.76,653906.91
1967-10-11,96.37,-0.47,-0.48,97.59,-1.25,True,1,9965,-96.37,-311103.22,960327.05,649223.83
1967-10-12,95.75,-0.62,-0.64,97.59,-1.88,True,1,9966,-95.75,-311198.97,954244.5,643045.53
1967-10-13,96.0,0.25,0.26,97.59,-1.63,True,1,9967,-96.0,-311294.97,956832.0,645537.03
1967-10-16,95.25,-0.75,-0.78,97.59,-2.4,True,1,9968,-95.25,-311390.22,949452.0,638061.78
1967-10-17,95.0,-0.25,-0.26,97.59,-2.65,True,1,9969,-95.0,-311485.22,947055.0,635569.78
1967-10-18,95.25,0.25,0.26,97.59,-2.4,True,1,9970,-95.25,-311580.47,949642.5,638062.03
1967-10-19,95.43,0.18,0.19,97.59,-2.21,True,1,9971,-95.43,-311675.9,951532.53,639856.63
1967-10-20,95.38,-0.05,-0.05,97.59,-2.26,True,1,9972,-95.38,-311771.28,951129.36,639358.08
1967-10-23,94.96,-0.42,-0.44,97.59,-2.7,True,1,9973,-94.96,-311866.24,947036.08,635169.84
1967-10-24,94.42,-0.54,-0.57,97.59,-3.25,True,1,9974,-94.42,-311960.66,941745.08,629784.42
1967-10-25,94.52,0.1,0.11,97.59,-3.15,True,1,9975,-94.52,-312055.18,942837.0,630781.82
1967-10-26,94.94,0.42,0.44,97.59,-2.72,True,1,9976,-94.94,-312150.12,947121.44,634971.32
1967-10-27,94.96,0.02,0.02,97.59,-2.7,True,1,9977,-94.96,-312245.08,947415.92,635170.84
1967-10-30,94.79,-0.17,-0.18,97.59,-2.87,True,1,9978,-94.79,-312339.87,945814.62,633474.75
1967-10-31,93.3,-1.49,-1.57,97.59,-4.4,True,1,9979,-93.3,-312433.17,931040.7,618607.53
1967-11-01,92.71,-0.59,-0.63,97.59,-5.0,True,1,9980,-92.71,-312525.88,925245.8,612719.92
1967-11-02,92.34,-0.37,-0.4,97.59,-5.38,True,1,9981,-92.34,-312618.22,921645.54,609027.32
1967-11-03,91.78,-0.56,-0.61,97.59,-5.95,True,1,9982,-91.78,-312710.0,916147.96,603437.96
1967-11-06,91.48,-0.3,-0.33,97.59,-6.26,True,1,9983,-91.48,-312801.48,913244.84,600443.36
1967-11-08,91.14,-0.34,-0.37,97.59,-6.61,True,1,9984,-91.14,-312892.62,909941.76,597049.14
1967-11-09,91.59,0.45,0.49,97.59,-6.15,True,1,9985,-91.59,-312984.21,914526.15,601541.94
1967-11-10,92.21,0.62,0.68,97.59,-5.51,True,1,9986,-92.21,-313076.42,920809.06,607732.64
1967-11-13,91.97,-0.24,-0.26,97.59,-5.76,True,1,9987,-91.97,-313168.39,918504.39,605336.0
1967-11-14,91.39,-0.58,-0.63,97.59,-6.35,True,1,9988,-91.39,-313259.78,912803.32,599543.54
1967-11-15,91.76,0.37,0.4,97.59,-5.97,True,1,9989,-91.76,-313351.54,916590.64,603239.1
1967-11-16,92.6,0.84,0.92,97.59,-5.11,True,1,9990,-92.6,-313444.14,925074.0,611629.86
1967-11-17,92.82,0.22,0.24,97.59,-4.89,True,1,9991,-92.82,-313536.96,927364.62,613827.66
1967-11-20,91.65,-1.17,-1.26,97.59,-6.09,True,1,9992,-91.65,-313628.61,915766.8,602138.19
1967-11-21,93.1,1.45,1.58,97.59,-4.6,True,1,9993,-93.1,-313721.71,930348.3,616626.59
1967-11-22,93.65,0.55,0.59,97.59,-4.04,True,1,9994,-93.65,-313815.36,935938.1,622122.74
1967-11-24,93.9,0.25,0.27,97.59,-3.78,True,1,9995,-93.9,-313909.26,938530.5,624621.24
1967-11-27,94.17,0.27,0.29,97.59,-3.5,True,1,9996,-94.17,-314003.43,941323.32,627319.89
1967-11-28,94.49,0.32,0.34,97.59,-3.18,True,1,9997,-94.49,-314097.92,944616.53,630518.61
1967-11-29,94.47,-0.02,-0.02,97.59,-3.2,True,1,9998,-94.47,-314192.39,944511.06,630318.67
1967-11-30,94.0,-0.47,-0.5,97.59,-3.68,True,1,9999,-94.0,-314286.39,939906.0,625619.61
1967-12-01,94.5,0.5,0.53,97.59,-3.17,True,1,10000,-94.5,-314380.89,945000.0,630619.11
1967-12-04,95.1,0.6,0.64,97.59,-2.55,True,1,10001,-95.1,-314475.99,951095.1,636619.11
1967-12-05,95.23,0.13,0.14,97.59,-2.42,True,1,10002,-95.23,-314571.22,952490.46,637919.24
1967-12-06,95.64,0.41,0.43,97.59,-2.0,True,1,10003,-95.64,-314666.86,956686.92,642020.06
1967-12-07,95.53,-0.11,-0.12,97.59,-2.11,True,1,10004,-95.53,-314762.39,955682.12,640919.73
1967-12-08,95.42,-0.11,-0.12,97.59,-2.22,True,1,10005,-95.42,-314857.81,954677.1,639819.29
1967-12-11,95.12,-0.3,-0.31,97.59,-2.53,True,1,10006,-95.12,-314952.93,951770.72,636817.79
1967-12-12,95.01,-0.11,-0.12,97.59,-2.64,True,1,10007,-95.01,-315047.94,950765.07,635717.13
1967-12-13,95.34,0.33,0.35,97.59,-2.31,True,1,10008,-95.34,-315143.28,954162.72,639019.44
1967-12-14,95.47,0.13,0.14,97.59,-2.17,True,1,10009,-95.47,-315238.75,955559.23,640320.48
1967-12-15,95.03,-0.44,-0.46,97.59,-2.62,True,1,10010,-95.03,-315333.78,951250.3,635916.52
1967-12-18,94.77,-0.26,-0.27,97.59,-2.89,True,1,10011,-94.77,-315428.55,948742.47,633313.92
1967-12-19,94.63,-0.14,-0.15,97.59,-3.03,True,1,10012,-94.63,-315523.18,947435.56,631912.38
1967-12-20,95.15,0.52,0.55,97.59,-2.5,True,1,10013,-95.15,-315618.33,952736.95,637118.62
1967-12-21,95.38,0.23,0.24,97.59,-2.26,True,1,10014,-95.38,-315713.71,955135.32,639421.61
1967-12-22,95.2,-0.18,-0.19,97.59,-2.45,True,1,10015,-95.2,-315808.91,953428.0,637619.09
1967-12-26,95.26,0.06,0.06,97.59,-2.39,True,1,10016,-95.26,-315904.17,954124.16,638219.99
1967-12-27,95.91,0.65,0.68,97.59,-1.72,True,1,10017,-95.91,-316000.08,960730.47,644730.39
1967-12-28,95.89,-0.02,-0.02,97.59,-1.74,True,1,10018,-95.89,-316095.97,960626.02,644530.05
1967-12-29,96.47,0.58,0.6,97.59,-1.15,True,1,10019,-96.47,-316192.44,966532.93,650340.49
1968-01-02,96.11,-0.36,-0.37,97.59,-1.52,True,1,10020,-96.11,-316288.55,963022.2,646733.65
1968-01-03,95.67,-0.44,-0.46,97.59,-1.97,True,1,10021,-95.67,-316384.22,958709.07,642324.85
1968-01-04,95.36,-0.31,-0.32,97.59,-2.28,True,1,10022,-95.36,-316479.58,955697.92,639218.34
1968-01-05,95.94,0.58,0.61,97.59,-1.69,True,1,10023,-95.94,-316575.52,961606.62,645031.1
1968-01-08,96.62,0.68,0.71,97.59,-0.99,True,1,10024,-96.62,-316672.14,968518.88,651846.74
1968-01-09,96.5,-0.12,-0.12,97.59,-1.12,True,1,10025,-96.5,-316768.64,967412.5,650643.86
1968-01-10,96.52,0.02,0.02,97.59,-1.1,True,1,10026,-96.52,-316865.16,967709.52,650844.36
1968-01-11,96.62,0.1,0.1,97.59,-0.99,True,1,10027,-96.62,-316961.78,968808.74,651846.96
1968-01-12,96.72,0.1,0.1,97.59,-0.89,True,1,10028,-96.72,-317058.5,969908.16,652849.66
1968-01-15,96.42,-0.3,-0.31,97.59,-1.2,True,1,10029,-96.42,-317154.92,966996.18,649841.26
1968-01-16,95.82,-0.6,-0.62,97.59,-1.81,True,1,10030,-95.82,-317250.74,961074.6,643823.86
1968-01-17,95.64,-0.18,-0.19,97.59,-2.0,True,1,10031,-95.64,-317346.38,959364.84,642018.46
1968-01-18,95.56,-0.08,-0.08,97.59,-2.08,True,1,10032,-95.56,-317441.94,958657.92,641215.98
1968-01-19,95.24,-0.32,-0.34,97.59,-2.41,True,1,10033,-95.24,-317537.18,955542.92,638005.74
1968-01-22,94.03,-1.21,-1.27,97.59,-3.65,True,1,10034,-94.03,-317631.21,943497.02,625865.81
1968-01-23,93.66,-0.37,-0.39,97.59,-4.03,True,1,10035,-93.66,-317724.87,939878.1,622153.23
1968-01-24,93.17,-0.49,-0.52,97.59,-4.53,True,1,10036,-93.17,-317818.04,935054.12,617236.08
1968-01-25,93.3,0.13,0.14,97.59,-4.4,True,1,10037,-93.3,-317911.34,936452.1,618540.76
1968-01-26,93.45,0.15,0.16,97.59,-4.24,True,1,10038,-93.45,-318004.79,938051.1,620046.31
1968-01-29,93.35,-0.1,-0.11,97.59,-4.34,True,1,10039,-93.35,-318098.14,937140.65,619042.51
1968-01-30,92.89,-0.46,-0.49,97.59,-4.82,True,1,10040,-92.89,-318191.03,932615.6,614424.57
1968-01-31,92.24,-0.65,-0.7,97.59,-5.48,True,1,10041,-92.24,-318283.27,926181.84,607898.57
1968-02-01,92.56,0.32,0.35,97.59,-5.15,True,1,10042,-92.56,-318375.83,929487.52,611111.69
1968-02-02,92.27,-0.29,-0.31,97.59,-5.45,True,1,10043,-92.27,-318468.1,926667.61,608199.51
1968-02-05,91.87,-0.4,-0.43,97.59,-5.86,True,1,10044,-91.87,-318559.97,922742.28,604182.31
1968-02-06,91.9,0.03,0.03,97.59,-5.83,True,1,10045,-91.9,-318651.87,923135.5,604483.63
1968-02-07,92.06,0.16,0.17,97.59,-5.67,True,1,10046,-92.06,-318743.93,924834.76,606090.83
1968-02-08,90.9,-1.16,-1.26,97.59,-6.86,True,1,10047,-90.9,-318834.83,913272.3,594437.47
1968-02-09,89.86,-1.04,-1.14,97.59,-7.92,True,1,10048,-89.86,-318924.69,902913.28,583988.59
1968-02-13,89.07,-0.79,-0.88,97.59,-8.73,True,1,10049,-89.07,-319013.76,895064.43,576050.67
1968-02-14,90.14,1.07,1.2,97.59,-7.63,True,1,10050,-90.14,-319103.9,905907.0,586803.1
1968-02-15,90.3,0.16,0.18,97.59,-7.47,True,1,10051,-90.3,-319194.2,907605.3,588411.1
1968-02-16,89.96,-0.34,-0.38,97.59,-7.82,True,1,10052,-89.96,-319284.16,904277.92,584993.76
1968-02-19,90.31,0.35,0.39,97.59,-7.46,True,1,10053,-90.31,-319374.47,907886.43,588511.96
1968-02-20,91.24,0.93,1.03,97.59,-6.51,True,1,10054,-91.24,-319465.71,917326.96,597861.25
1968-02-21,91.24,0.0,0.0,97.59,-6.51,True,1,10055,-91.24,-319556.95,917418.2,597861.25
1968-02-23,90.89,-0.35,-0.38,97.59,-6.86,True,1,10056,-90.89,-319647.84,913989.84,594342.0
1968-02-26,90.18,-0.71,-0.78,97.59,-7.59,True,1,10057,-90.18,-319738.02,906940.26,587202.24
1968-02-27,90.53,0.35,0.39,97.59,-7.23,True,1,10058,-90.53,-319828.55,910550.74,590722.19
1968-02-28,90.08,-0.45,-0.5,97.59,-7.7,True,1,10059,-90.08,-319918.63,906114.72,586196.09
1968-02-29,89.36,-0.72,-0.8,97.59,-8.43,True,1,10060,-89.36,-320007.99,898961.6,578953.61
1968-03-01,89.11,-0.25,-0.28,97.59,-8.69,True,1,10061,-89.11,-320097.1,896535.71,576438.61
1968-03-04,87.92,-1.19,-1.34,97.59,-9.91,True,1,10062,-87.92,-320185.02,884651.04,564466.02
1968-03-05,87.72,-0.2,-0.23,97.59,-10.11,True,1,10063,-87.72,-320272.74,882726.36,562453.62
1968-03-06,89.26,1.54,1.76,97.59,-8.54,True,1,10064,-89.26,-320362.0,898312.64,577950.64
1968-03-07,89.1,-0.16,-0.18,97.59,-8.7,True,1,10065,-89.1,-320451.1,896791.5,576340.4
1968-03-08,89.03,-0.07,-0.08,97.59,-8.77,True,1,10066,-89.03,-320540.13,896175.98,575635.85
1968-03-11,90.13,1.1,1.24,97.59,-7.64,True,1,10067,-90.13,-320630.26,907338.71,586708.45
1968-03-12,90.23,0.1,0.11,97.59,-7.54,True,1,10068,-90.23,-320720.49,908435.64,587715.15
1968-03-13,90.03,-0.2,-0.22,97.59,-7.75,True,1,10069,-90.03,-320810.52,906512.07,585701.55
1968-03-14,88.32,-1.71,-1.9,97.59,-9.5,True,1,10070,-88.32,-320898.84,889382.4,568483.56
1968-03-15,89.1,0.78,0.88,97.59,-8.7,True,1,10071,-89.1,-320987.94,897326.1,576338.16
1968-03-18,89.59,0.49,0.55,97.59,-8.2,True,1,10072,-89.59,-321077.53,902350.48,581272.95
1968-03-19,88.99,-0.6,-0.67,97.59,-8.81,True,1,10073,-88.99,-321166.52,896396.27,575229.75
1968-03-20,88.98,-0.01,-0.01,97.59,-8.82,True,1,10074,-88.98,-321255.5,896384.52,575129.02
1968-03-21,88.33,-0.65,-0.73,97.59,-9.49,True,1,10075,-88.33,-321343.83,889924.75,568580.92
1968-03-22,88.42,0.09,0.1,97.59,-9.4,True,1,10076,-88.42,-321432.25,890919.92,569487.67
1968-03-25,88.33,-0.09,-0.1,97.59,-9.49,True,1,10077,-88.33,-321520.58,890101.41,568580.83
1968-03-26,88.93,0.6,0.68,97.59,-8.87,True,1,10078,-88.93,-321609.51,896236.54,574627.03
1968-03-27,89.66,0.73,0.82,97.59,-8.13,True,1,10079,-89.66,-321699.17,903683.14,581983.97
1968-03-28,89.57,-0.09,-0.1,97.59,-8.22,True,1,10080,-89.57,-321788.74,902865.6,581076.86
1968-03-29,90.2,0.63,0.7,97.59,-7.57,True,1,10081,-90.2,-321878.94,909306.2,587427.26
1968-04-01,92.48,2.28,2.53,97.59,-5.24,True,1,10082,-92.48,-321971.42,932383.36,610411.94
1968-04-02,92.64,0.16,0.17,97.59,-5.07,True,1,10083,-92.64,-322064.06,934089.12,612025.06
1968-04-03,93.47,0.83,0.9,97.59,-4.22,True,1,10084,-93.47,-322157.53,942551.48,620393.95
1968-04-04,93.84,0.37,0.4,97.59,-3.84,True,1,10085,-93.84,-322251.37,946376.4,624125.03
1968-04-05,93.29,-0.55,-0.59,97.59,-4.41,True,1,10086,-93.29,-322344.66,940922.94,618578.28
1968-04-08,94.95,1.66,1.78,97.59,-2.7,True,1,10087,-94.95,-322439.61,957760.65,635321.04
1968-04-10,95.67,0.72,0.76,97.59,-1.97,True,1,10088,-95.67,-322535.28,965118.96,642583.68
1968-04-11,96.53,0.86,0.9,97.59,-1.09,True,1,10089,-96.53,-322631.81,973891.17,651259.36
1968-04-15,96.59,0.06,0.06,97.59,-1.02,True,1,10090,-96.59,-322728.4,974593.1,651864.7
1968-04-16,96.62,0.03,0.03,97.59,-0.99,True,1,10091,-96.62,-322825.02,974992.42,652167.4
1968-04-17,96.81,0.19,0.2,97.59,-0.8,True,1,10092,-96.81,-322921.83,977006.52,654084.69
1968-04-18,97.08,0.27,0.28,97.59,-0.52,True,1,10093,-97.08,-323018.91,979828.44,656809.53
1968-04-19,95.85,-1.23,-1.27,97.59,-1.78,True,1,10094,-95.85,-323114.76,967509.9,644395.14
1968-04-22,95.32,-0.53,-0.55,97.59,-2.33,True,1,10095,-95.32,-323210.08,962255.4,639045.32
1968-04-23,96.62,1.3,1.36,97.59,-0.99,True,1,10096,-96.62,-323306.7,975475.52,652168.82
1968-04-24,96.92,0.3,0.31,97.59,-0.69,True,1,10097,-96.92,-323403.62,978601.24,655197.62
1968-04-25,96.62,-0.3,-0.31,97.59,-0.99,True,1,10098,-96.62,-323500.24,975668.76,652168.52
1968-04-26,97.21,0.59,0.61,97.59,-0.39,True,1,10099,-97.21,-323597.45,981723.79,658126.34
1968-04-29,97.97,0.76,0.78,97.97,0.0,True,1,10100,-97.97,-323695.42,989497.0,665801.58
1968-04-30,97.46,-0.51,-0.52,97.97,-0.52,True,1,10101,-97.46,-323792.88,984443.46,660650.58
1968-05-01,97.97,0.51,0.52,97.97,0.0,True,1,10102,-97.97,-323890.85,989692.94,665802.09
1968-05-02,98.59,0.62,0.63,98.59,0.0,True,1,10103,-98.59,-323989.44,996054.77,672065.33
1968-05-03,98.66,0.07,0.07,98.66,0.0,True,1,10104,-98.66,-324088.1,996860.64,672772.54
1968-05-06,98.35,-0.31,-0.31,98.66,-0.31,True,1,10105,-98.35,-324186.45,993826.75,669640.3
1968-05-07,98.9,0.55,0.56,98.9,0.0,True,1,10106,-98.9,-324285.35,999483.4,675198.05
1968-05-08,98.91,0.01,0.01,98.91,0.0,True,1,10107,-98.91,-324384.26,999683.37,675299.11
1968-05-09,98.39,-0.52,-0.53,98.91,-0.53,True,1,10108,-98.39,-324482.65,994526.12,670043.47
1968-05-10,98.5,0.11,0.11,98.91,-0.42,True,1,10109,-98.5,-324581.15,995736.5,671155.35
1968-05-13,98.19,-0.31,-0.32,98.91,-0.73,True,1,10110,-98.19,-324679.34,992700.9,668021.56
1968-05-14,98.12,-0.07,-0.07,98.91,-0.8,True,1,10111,-98.12,-324777.46,992091.32,667313.86
1968-05-15,98.07,-0.05,-0.05,98.91,-0.85,True,1,10112,-98.07,-324875.53,991683.84,666808.31
1968-05-16,97.6,-0.47,-0.48,98.91,-1.32,True,1,10113,-97.6,-324973.13,987028.8,662055.67
1968-05-17,96.9,-0.7,-0.72,98.91,-2.03,True,1,10114,-96.9,-325070.03,980046.6,654976.57
1968-05-20,96.45,-0.45,-0.46,98.91,-2.49,True,1,10115,-96.45,-325166.48,975591.75,650425.27
1968-05-21,96.93,0.48,0.5,98.91,-2.0,True,1,10116,-96.93,-325263.41,980543.88,655280.47
1968-05-22,97.18,0.25,0.26,98.91,-1.75,True,1,10117,-97.18,-325360.59,983170.06,657809.47
1968-05-23,96.97,-0.21,-0.22,98.91,-1.96,True,1,10118,-96.97,-325457.56,981142.46,655684.9
1968-05-24,97.15,0.18,0.19,98.91,-1.78,True,1,10119,-97.15,-325554.71,983060.85,657506.14
1968-05-27,96.99,-0.16,-0.16,98.91,-1.94,True,1,10120,-96.99,-325651.7,981538.8,655887.1
1968-05-28,97.62,0.63,0.65,98.91,-1.3,True,1,10121,-97.62,-325749.32,988012.02,662262.7
1968-05-29,97.92,0.3,0.31,98.91,-1.0,True,1,10122,-97.92,-325847.24,991146.24,665299.0
1968-05-31,98.68,0.76,0.78,98.91,-0.23,True,1,10123,-98.68,-325945.92,998937.64,672991.72
1968-06-03,99.99,1.31,1.33,99.99,0.0,True,1,10124,-99.99,-326045.91,1012298.76,686252.85
1968-06-04,100.38,0.39,0.39,100.38,0.0,True,1,10125,-100.38,-326146.29,1016347.5,690201.21
1968-06-05,99.89,-0.49,-0.49,100.38,-0.49,True,1,10126,-99.89,-326246.18,1011486.14,685239.96
1968-06-06,100.65,0.76,0.76,100.65,0.0,True,1,10127,-100.65,-326346.83,1019282.55,692935.72
1968-06-07,101.27,0.62,0.62,101.27,0.0,True,1,10128,-101.27,-326448.1,1025662.56,699214.46
1968-06-10,101.41,0.14,0.14,101.41,0.0,True,1,10129,-101.41,-326549.51,1027181.89,700632.38
1968-06-11,101.66,0.25,0.25,101.66,0.0,True,1,10130,-101.66,-326651.17,1029815.8,703164.63
1968-06-13,101.25,-0.41,-0.4,101.66,-0.4,True,1,10131,-101.25,-326752.42,1025763.75,699011.33
1968-06-14,101.13,-0.12,-0.12,101.66,-0.52,True,1,10132,-101.13,-326853.55,1024649.16,697795.61
1968-06-17,100.13,-1.0,-0.99,101.66,-1.5,True,1,10133,-100.13,-326953.68,1014617.29,687663.61
1968-06-18,99.99,-0.14,-0.14,101.66,-1.64,True,1,10134,-99.99,-327053.67,1013298.66,686244.99
1968-06-20,101.51,1.52,1.52,101.66,-0.15,True,1,10135,-101.51,-327155.18,1028803.85,701648.67
1968-06-21,100.66,-0.85,-0.84,101.66,-0.98,True,1,10136,-100.66,-327255.84,1020289.76,693033.92
1968-06-24,100.39,-0.27,-0.27,101.66,-1.25,True,1,10137,-100.39,-327356.23,1017653.43,690297.2
1968-06-25,100.08,-0.31,-0.31,101.66,-1.55,True,1,10138,-100.08,-327456.31,1014611.04,687154.73
1968-06-27,99.98,-0.1,-0.1,101.66,-1.65,True,1,10139,-99.98,-327556.29,1013697.22,686140.93
1968-06-28,99.58,-0.4,-0.4,101.66,-2.05,True,1,10140,-99.58,-327655.87,1009741.2,682085.33
1968-07-01,99.4,-0.18,-0.18,101.66,-2.22,True,1,10141,-99.4,-327755.27,1008015.4,680260.13
1968-07-02,99.74,0.34,0.34,101.66,-1.89,True,1,10142,-99.74,-327855.01,1011563.08,683708.07
1968-07-03,100.91,1.17,1.17,101.66,-0.74,True,1,10143,-100.91,-327955.92,1023530.13,695574.21
1968-07-08,101.94,1.03,1.02,101.94,0.0,True,1,10144,-101.94,-328057.86,1034079.36,706021.5
1968-07-09,102.23,0.29,0.28,102.23,0.0,True,1,10145,-102.23,-328160.09,1037123.35,708963.26
1968-07-11,102.39,0.16,0.16,102.39,0.0,True,1,10146,-102.39,-328262.48,1038848.94,710586.46
1968-07-12,102.34,-0.05,-0.05,102.39,-0.05,True,1,10147,-102.34,-328364.82,1038443.98,710079.16
1968-07-15,102.26,-0.08,-0.08,102.39,-0.13,True,1,10148,-102.26,-328467.08,1037734.48,709267.4
1968-07-16,101.7,-0.56,-0.55,102.39,-0.67,True,1,10149,-101.7,-328568.78,1032153.3,703584.52
1968-07-18,101.44,-0.26,-0.26,102.39,-0.93,True,1,10150,-101.44,-328670.22,1029616.0,700945.78
1968-07-19,100.46,-0.98,-0.97,102.39,-1.88,True,1,10151,-100.46,-328770.68,1019769.46,690998.78
1968-07-22,99.33,-1.13,-1.12,102.39,-2.99,True,1,10152,-99.33,-328870.01,1008398.16,679528.15
1968-07-23,99.21,-0.12,-0.12,102.39,-3.11,True,1,10153,-99.21,-328969.22,1007279.13,678309.91
1968-07-25,97.94,-1.27,-1.28,102.39,-4.35,True,1,10154,-97.94,-329067.16,994482.76,665415.6
1968-07-26,98.34,0.4,0.41,102.39,-3.96,True,1,10155,-98.34,-329165.5,998642.7,669477.2
1968-07-29,97.65,-0.69,-0.7,102.39,-4.63,True,1,10156,-97.65,-329263.15,991733.4,662470.25
1968-07-30,97.74,0.09,0.09,102.39,-4.54,True,1,10157,-97.74,-329360.89,992745.18,663384.29
1968-08-01,97.28,-0.46,-0.47,102.39,-4.99,True,1,10158,-97.28,-329458.17,988170.24,658712.07
1968-08-02,96.63,-0.65,-0.67,102.39,-5.63,True,1,10159,-96.63,-329554.8,981664.17,652109.37
1968-08-05,96.85,0.22,0.23,102.39,-5.41,True,1,10160,-96.85,-329651.65,983996.0,654344.35
1968-08-06,97.25,0.4,0.41,102.39,-5.02,True,1,10161,-97.25,-329748.9,988157.25,658408.35
1968-08-08,97.04,-0.21,-0.22,102.39,-5.22,True,1,10162,-97.04,-329845.94,986120.48,656274.54
1968-08-09,97.01,-0.03,-0.03,102.39,-5.25,True,1,10163,-97.01,-329942.95,985912.63,655969.68
1968-08-12,98.01,1.0,1.03,102.39,-4.28,True,1,10164,-98.01,-330040.96,996173.64,666132.68
1968-08-13,98.53,0.52,0.53,102.39,-3.77,True,1,10165,-98.53,-330139.49,1001557.45,671417.96
1968-08-15,98.07,-0.46,-0.47,102.39,-4.22,True,1,10166,-98.07,-330237.56,996979.62,666742.06
1968-08-16,98.68,0.61,0.62,102.39,-3.62,True,1,10167,-98.68,-330336.24,1003279.56,672943.32
1968-08-19,99.0,0.32,0.32,102.39,-3.31,True,1,10168,-99.0,-330435.24,1006632.0,676196.76
1968-08-20,98.96,-0.04,-0.04,102.39,-3.35,True,1,10169,-98.96,-330534.2,1006324.24,675790.04
1968-08-22,98.7,-0.26,-0.26,102.39,-3.6,True,1,10170,-98.7,-330632.9,1003779.0,673146.1
1968-08-23,98.69,-0.01,-0.01,102.39,-3.61,True,1,10171,-98.69,-330731.59,1003775.99,673044.4
1968-08-26,98.94,0.25,0.25,102.39,-3.37,True,1,10172,-98.94,-330830.53,1006417.68,675587.15
1968-08-27,98.81,-0.13,-0.13,102.39,-3.5,True,1,10173,-98.81,-330929.34,1005194.13,674264.79
1968-08-29,98.74,-0.07,-0.07,102.39,-3.56,True,1,10174,-98.74,-331028.08,1004580.76,673552.68
1968-08-30,98.86,0.12,0.12,102.39,-3.45,True,1,10175,-98.86,-331126.94,1005900.5,674773.56
1968-09-03,99.32,0.46,0.46,102.39,-3.0,True,1,10176,-99.32,-331226.26,1010680.32,679454.06
1968-09-04,100.02,0.7,0.7,102.39,-2.32,True,1,10177,-100.02,-331326.28,1017903.54,686577.26
1968-09-05,100.74,0.72,0.72,102.39,-1.61,True,1,10178,-100.74,-331427.02,1025331.72,693904.7
1968-09-06,101.2,0.46,0.46,102.39,-1.16,True,1,10179,-101.2,-331528.22,1030114.8,698586.58
1968-09-09,101.23,0.03,0.03,102.39,-1.13,True,1,10180,-101.23,-331629.45,1030521.4,698891.95
1968-09-10,100.73,-0.5,-0.49,102.39,-1.62,True,1,10181,-100.73,-331730.18,1025532.13,693801.95
1968-09-12,100.52,-0.21,-0.21,102.39,-1.83,True,1,10182,-100.52,-331830.7,1023494.64,691663.94
1968-09-13,100.86,0.34,0.34,102.39,-1.49,True,1,10183,-100.86,-331931.56,1027057.38,695125.82
1968-09-16,101.24,0.38,0.38,102.39,-1.12,True,1,10184,-101.24,-332032.8,1031028.16,698995.36
1968-09-17,101.5,0.26,0.26,102.39,-0.87,True,1,10185,-101.5,-332134.3,1033777.5,701643.2
1968-09-19,101.59,0.09,0.09,102.39,-0.78,True,1,10186,-101.59,-332235.89,1034795.74,702559.85
1968-09-20,101.66,0.07,0.07,102.39,-0.71,True,1,10187,-101.66,-332337.55,1035610.42,703272.87
1968-09-23,102.24,0.58,0.57,102.39,-0.15,True,1,10188,-102.24,-332439.79,1041621.12,709181.33
1968-09-24,102.59,0.35,0.34,102.59,0.0,True,1,10189,-102.59,-332542.38,1045289.51,712747.13
1968-09-26,102.36,-0.23,-0.22,102.59,-0.22,True,1,10190,-102.36,-332644.74,1043048.4,710403.66
1968-09-27,102.31,-0.05,-0.05,102.59,-0.27,True,1,10191,-102.31,-332747.05,1042641.21,709894.16
1968-09-30,102.67,0.36,0.35,102.67,0.0,True,1,10192,-102.67,-332849.72,1046412.64,713562.92
1968-10-01,102.86,0.19,0.18,102.86,0.0,True,1,10193,-102.86,-332952.58,1048451.98,715499.4
1968-10-03,103.22,0.36,0.35,103.22,0.0,True,1,10194,-103.22,-333055.8,1052224.68,719168.88
1968-10-04,103.71,0.49,0.48,103.71,0.0,True,1,10195,-103.71,-333159.51,1057323.45,724163.94
1968-10-07,103.7,-0.01,-0.01,103.71,-0.01,True,1,10196,-103.7,-333263.21,1057325.2,724061.99
1968-10-08,103.74,0.04,0.04,103.74,0.0,True,1,10197,-103.74,-333366.95,1057836.78,724469.83
1968-10-10,103.29,-0.45,-0.43,103.74,-0.43,True,1,10198,-103.29,-333470.24,1053351.42,719881.18
1968-10-11,103.18,-0.11,-0.11,103.74,-0.54,True,1,10199,-103.18,-333573.42,1052332.82,718759.4
1968-10-14,103.32,0.14,0.14,103.74,-0.4,True,1,10200,-103.32,-333676.74,1053864.0,720187.26
1968-10-15,103.53,0.21,0.2,103.74,-0.2,True,1,10201,-103.53,-333780.27,1056109.53,722329.26
1968-10-17,104.01,0.48,0.46,104.01,0.0,True,1,10202,-104.01,-333884.28,1061110.02,727225.74
1968-10-18,104.82,0.81,0.78,104.82,0.0,True,1,10203,-104.82,-333989.1,1069478.46,735489.36
1968-10-21,104.99,0.17,0.16,104.99,0.0,True,1,10204,-104.99,-334094.09,1071317.96,737223.87
1968-10-22,104.57,-0.42,-0.4,104.99,-0.4,True,1,10205,-104.57,-334198.66,1067136.85,732938.19
1968-10-24,103.84,-0.73,-0.7,104.99,-1.1,True,1,10206,-103.84,-334302.5,1059791.04,725488.54
1968-10-25,104.2,0.36,0.35,104.99,-0.75,True,1,10207,-104.2,-334406.7,1063569.4,729162.7
1968-10-28,103.9,-0.3,-0.29,104.99,-1.04,True,1,10208,-103.9,-334510.6,1060611.2,726100.6
1968-10-29,103.3,-0.6,-0.58,104.99,-1.61,True,1,10209,-103.3,-334613.9,1054589.7,719975.8
1968-10-31,103.41,0.11,0.11,104.99,-1.5,True,1,10210,-103.41,-334717.31,1055816.1,721098.79
1968-11-01,103.06,-0.35,-0.34,104.99,-1.84,True,1,10211,-103.06,-334820.37,1052345.66,717525.29
1968-11-04,103.1,0.04,0.04,104.99,-1.8,True,1,10212,-103.1,-334923.47,1052857.2,717933.73
1968-11-06,103.27,0.17,0.16,104.99,-1.64,True,1,10213,-103.27,-335026.74,1054696.51,719669.77
1968-11-07,103.5,0.23,0.22,104.99,-1.42,True,1,10214,-103.5,-335130.24,1057149.0,722018.76
1968-11-08,103.95,0.45,0.44,104.99,-0.99,True,1,10215,-103.95,-335234.19,1061849.25,726615.06
1968-11-12,104.62,0.67,0.64,104.99,-0.35,True,1,10216,-104.62,-335338.81,1068797.92,733459.11
1968-11-13,105.13,0.51,0.49,105.13,0.0,True,1,10217,-105.13,-335443.94,1074113.21,738669.27
1968-11-14,105.2,0.07,0.07,105.2,0.0,True,1,10218,-105.2,-335549.14,1074933.6,739384.46
1968-11-15,105.78,0.58,0.55,105.78,0.0,True,1,10219,-105.78,-335654.92,1080965.82,745310.9
1968-11-18,105.92,0.14,0.13,105.92,0.0,True,1,10220,-105.92,-335760.84,1082502.4,746741.56
1968-11-19,106.14,0.22,0.21,106.14,0.0,True,1,10221,-106.14,-335866.98,1084856.94,748989.96
1968-11-21,105.97,-0.17,-0.16,106.14,-0.16,True,1,10222,-105.97,-335972.95,1083225.34,747252.39
1968-11-22,106.3,0.33,0.31,106.3,0.0,True,1,10223,-106.3,-336079.25,1086704.9,750625.65
1968-11-25,106.48,0.18,0.17,106.48,0.0,True,1,10224,-106.48,-336185.73,1088651.52,752465.79
1968-11-26,107.26,0.78,0.73,107.26,0.0,True,1,10225,-107.26,-336292.99,1096733.5,760440.51
1968-11-27,107.76,0.5,0.47,107.76,0.0,True,1,10226,-107.76,-336400.75,1101953.76,765553.01
1968-11-29,108.37,0.61,0.57,108.37,0.0,True,1,10227,-108.37,-336509.12,1108299.99,771790.87
1968-12-02,108.12,-0.25,-0.23,108.37,-0.23,True,1,10228,-108.12,-336617.24,1105851.36,769234.12
1968-12-03,108.02,-0.1,-0.09,108.37,-0.32,True,1,10229,-108.02,-336725.26,1104936.58,768211.32
1968-12-05,107.67,-0.35,-0.32,108.37,-0.65,True,1,10230,-107.67,-336832.93,1101464.1,764631.17
1968-12-06,107.93,0.26,0.24,108.37,-0.41,True,1,10231,-107.93,-336940.86,1104231.83,767290.97
1968-12-09,107.66,-0.27,-0.25,108.37,-0.66,True,1,10232,-107.66,-337048.52,1101577.12,764528.6
1968-12-10,107.39,-0.27,-0.25,108.37,-0.9,True,1,10233,-107.39,-337155.91,1098921.87,761765.96
1968-12-12,107.32,-0.07,-0.06,108.37,-0.97,True,1,10234,-107.32,-337263.23,1098312.88,761049.65
1968-12-13,107.58,0.26,0.24,108.37,-0.73,True,1,10235,-107.58,-337370.81,1101081.3,763710.49
1968-12-16,107.1,-0.48,-0.45,108.37,-1.17,True,1,10236,-107.1,-337477.91,1096275.6,758797.69
1968-12-17,106.66,-0.44,-0.41,108.37,-1.58,True,1,10237,-106.66,-337584.57,1091878.42,754293.85
1968-12-19,106.97,0.31,0.29,108.37,-1.29,True,1,10238,-106.97,-337691.54,1095158.86,757467.32
1968-12-20,106.34,-0.63,-0.59,108.37,-1.87,True,1,10239,-106.34,-337797.88,1088815.26,751017.38
1968-12-23,105.21,-1.13,-1.06,108.37,-2.92,True,1,10240,-105.21,-337903.09,1077350.4,739447.31
1968-12-24,105.04,-0.17,-0.16,108.37,-3.07,True,1,10241,-105.04,-338008.13,1075714.64,737706.51
1968-12-26,105.15,0.11,0.1,108.37,-2.97,True,1,10242,-105.15,-338113.28,1076946.3,738833.02
1968-12-27,104.74,-0.41,-0.39,108.37,-3.35,True,1,10243,-104.74,-338218.02,1072851.82,734633.8
1968-12-30,103.8,-0.94,-0.9,108.37,-4.22,True,1,10244,-103.8,-338321.82,1063327.2,725005.38
1968-12-31,103.86,0.06,0.06,108.37,-4.16,True,1,10245,-103.86,-338425.68,1064045.7,725620.02
1969-01-02,103.93,0.07,0.07,108.37,-4.1,True,1,10246,-103.93,-338529.61,1064866.78,726337.17
1969-01-03,103.99,0.06,0.06,108.37,-4.04,True,1,10247,-103.99,-338633.6,1065585.53,726951.93
1969-01-06,102.47,-1.52,-1.46,108.37,-5.44,True,1,10248,-102.47,-338736.07,1050112.56,711376.49
1969-01-07,101.22,-1.25,-1.22,108.37,-6.6,True,1,10249,-101.22,-338837.29,1037403.78,698566.49
1969-01-08,100.8,-0.42,-0.42,108.37,-6.98,True,1,10250,-100.8,-338938.09,1033200.0,694261.91
1969-01-09,101.22,0.42,0.42,108.37,-6.6,True,1,10251,-101.22,-339039.31,1037606.22,698566.91
1969-01-10,100.93,-0.29,-0.29,108.37,-6.86,True,1,10252,-100.93,-339140.24,1034734.36,695594.12
1969-01-13,100.44,-0.49,-0.48,108.37,-7.32,True,1,10253,-100.44,-339240.68,1029811.32,690570.64
1969-01-14,101.13,0.69,0.69,108.37,-6.68,True,1,10254,-101.13,-339341.81,1036987.02,697645.21
1969-01-15,101.62,0.49,0.48,108.37,-6.23,True,1,10255,-101.62,-339443.43,1042113.1,702669.67
1969-01-16,102.18,0.56,0.55,108.37,-5.71,True,1,10256,-102.18,-339545.61,1047958.08,708412.47
1969-01-17,102.03,-0.15,-0.15,108.37,-5.85,True,1,10257,-102.03,-339647.64,1046521.71,706874.07
1969-01-20,101.69,-0.34,-0.33,108.37,-6.16,True,1,10258,-101.69,-339749.33,1043136.02,703386.69
1969-01-21,101.63,-0.06,-0.06,108.37,-6.22,True,1,10259,-101.63,-339850.96,1042622.17,702771.21
1969-01-22,101.98,0.35,0.34,108.37,-5.9,True,1,10260,-101.98,-339952.94,1046314.8,706361.86
1969-01-23,102.43,0.45,0.44,108.37,-5.48,True,1,10261,-102.43,-340055.37,1051034.23,710978.86
1969-01-24,102.38,-0.05,-0.05,108.37,-5.53,True,1,10262,-102.38,-340157.75,1050623.56,710465.81
1969-01-27,102.4,0.02,0.02,108.37,-5.51,True,1,10263,-102.4,-340260.15,1050931.2,710671.05
1969-01-28,102.41,0.01,0.01,108.37,-5.5,True,1,10264,-102.41,-340362.56,1051136.24,710773.68
1969-01-29,102.51,0.1,0.1,108.37,-5.41,True,1,10265,-102.51,-340465.07,1052265.15,711800.08
1969-01-30,102.55,0.04,0.04,108.37,-5.37,True,1,10266,-102.55,-340567.62,1052778.3,712210.68
1969-01-31,103.01,0.46,0.45,108.37,-4.95,True,1,10267,-103.01,-340670.63,1057603.67,716933.04
1969-02-03,102.89,-0.12,-0.12,108.37,-5.06,True,1,10268,-102.89,-340773.52,1056474.52,715701.0
1969-02-04,102.92,0.03,0.03,108.37,-5.03,True,1,10269,-102.92,-340876.44,1056885.48,716009.04
1969-02-05,103.2,0.28,0.27,108.37,-4.77,True,1,10270,-103.2,-340979.64,1059864.0,718884.36
1969-02-06,103.54,0.34,0.33,108.37,-4.46,True,1,10271,-103.54,-341083.18,1063459.34,722376.16
1969-02-07,103.53,-0.01,-0.01,108.37,-4.47,True,1,10272,-103.53,-341186.71,1063460.16,722273.45
1969-02-11,103.65,0.12,0.12,108.37,-4.36,True,1,10273,-103.65,-341290.36,1064796.45,723506.09
1969-02-12,103.63,-0.02,-0.02,108.37,-4.37,True,1,10274,-103.63,-341393.99,1064694.62,723300.63
1969-02-13,103.71,0.08,0.08,108.37,-4.3,True,1,10275,-103.71,-341497.7,1065620.25,724122.55
1969-02-14,103.61,-0.1,-0.1,108.37,-4.39,True,1,10276,-103.61,-341601.31,1064696.36,723095.05
1969-02-17,102.44,-1.17,-1.13,108.37,-5.47,True,1,10277,-102.44,-341703.75,1052775.88,711072.13
1969-02-18,101.4,-1.04,-1.01,108.37,-6.43,True,1,10278,-101.4,-341805.15,1042189.2,700384.05
1969-02-19,100.65,-0.75,-0.74,108.37,-7.12,True,1,10279,-100.65,-341905.8,1034581.35,692675.55
1969-02-20,99.79,-0.86,-0.85,108.37,-7.92,True,1,10280,-99.79,-342005.59,1025841.2,683835.61
1969-02-24,98.6,-1.19,-1.19,108.37,-9.02,True,1,10281,-98.6,-342104.19,1013706.6,671602.41
1969-02-25,97.98,-0.62,-0.63,108.37,-9.59,True,1,10282,-97.98,-342202.17,1007430.36,665228.19
1969-02-26,98.45,0.47,0.48,108.37,-9.15,True,1,10283,-98.45,-342300.62,1012361.35,670060.73
1969-02-27,98.14,-0.31,-0.32,108.37,-9.44,True,1,10284,-98.14,-342398.76,1009271.76,666873.0
1969-02-28,98.13,-0.01,-0.01,108.37,-9.45,True,1,10285,-98.13,-342496.89,1009267.05,666770.16
1969-03-03,98.38,0.25,0.26,108.37,-9.22,True,1,10286,-98.38,-342595.27,1011936.68,669341.41
1969-03-04,99.32,0.94,0.96,108.37,-8.35,True,1,10287,-99.32,-342694.59,1021704.84,679010.25
1969-03-05,99.71,0.39,0.39,108.37,-7.99,True,1,10288,-99.71,-342794.3,1025816.48,683022.18
1969-03-06,98.7,-1.01,-1.01,108.37,-8.92,True,1,10289,-98.7,-342893.0,1015524.3,672631.3
1969-03-07,98.65,-0.05,-0.05,108.37,-8.97,True,1,10290,-98.65,-342991.65,1015108.5,672116.85
1969-03-10,98.99,0.34,0.34,108.37,-8.66,True,1,10291,-98.99,-343090.64,1018706.09,675615.45
1969-03-11,99.32,0.33,0.33,108.37,-8.35,True,1,10292,-99.32,-343189.96,1022201.44,679011.48
1969-03-12,99.05,-0.27,-0.27,108.37,-8.6,True,1,10293,-99.05,-343289.01,1019521.65,676232.64
1969-03-13,98.39,-0.66,-0.67,108.37,-9.21,True,1,10294,-98.39,-343387.4,1012826.66,669439.26
1969-03-14,98.0,-0.39,-0.4,108.37,-9.57,True,1,10295,-98.0,-343485.4,1008910.0,665424.6
1969-03-17,98.25,0.25,0.26,108.37,-9.34,True,1,10296,-98.25,-343583.65,1011582.0,667998.35
1969-03-18,98.49,0.24,0.24,108.37,-9.12,True,1,10297,-98.49,-343682.14,1014151.53,670469.39
1969-03-19,99.21,0.72,0.73,108.37,-8.45,True,1,10298,-99.21,-343781.35,1021664.58,677883.23
1969-03-20,99.84,0.63,0.64,108.37,-7.87,True,1,10299,-99.84,-343881.19,1028252.16,684370.97
1969-03-21,99.63,-0.21,-0.21,108.37,-8.06,True,1,10300,-99.63,-343980.82,1026189.0,682208.18
1969-03-24,99.5,-0.13,-0.13,108.37,-8.18,True,1,10301,-99.5,-344080.32,1024949.5,680869.18
1969-03-25,99.66,0.16,0.16,108.37,-8.04,True,1,10302,-99.66,-344179.98,1026697.32,682517.34
1969-03-26,100.39,0.73,0.73,108.37,-7.36,True,1,10303,-100.39,-344280.37,1034318.17,690037.8
1969-03-27,101.1,0.71,0.71,108.37,-6.71,True,1,10304,-101.1,-344381.47,1041734.4,697352.93
1969-03-28,101.51,0.41,0.41,108.37,-6.33,True,1,10305,-101.51,-344482.98,1046060.55,701577.57
1969-04-01,101.42,-0.09,-0.09,108.37,-6.41,True,1,10306,-101.42,-344584.4,1045234.52,700650.12
1969-04-02,100.78,-0.64,-0.63,108.37,-7.0,True,1,10307,-100.78,-344685.18,1038739.46,694054.28
1969-04-03,100.68,-0.1,-0.1,108.37,-7.1,True,1,10308,-100.68,-344785.86,1037809.44,693023.58
1969-04-07,99.89,-0.79,-0.78,108.37,-7.82,True,1,10309,-99.89,-344885.75,1029766.01,684880.26
1969-04-08,100.14,0.25,0.25,108.37,-7.59,True,1,10310,-100.14,-344985.89,1032443.4,687457.51
1969-04-09,101.02,0.88,0.88,108.37,-6.78,True,1,10311,-101.02,-345086.91,1041617.22,696530.31
1969-04-10,101.55,0.53,0.52,108.37,-6.29,True,1,10312,-101.55,-345188.46,1047183.6,701995.14
1969-04-11,101.65,0.1,0.1,108.37,-6.2,True,1,10313,-101.65,-345290.11,1048316.45,703026.34
1969-04-14,101.57,-0.08,-0.08,108.37,-6.28,True,1,10314,-101.57,-345391.68,1047592.98,702201.3
1969-04-15,101.53,-0.04,-0.04,108.37,-6.31,True,1,10315,-101.53,-345493.21,1047281.95,701788.74
1969-04-16,100.63,-0.9,-0.89,108.37,-7.14,True,1,10316,-100.63,-345593.84,1038099.08,692505.24
1969-04-17,100.78,0.15,0.15,108.37,-7.0,True,1,10317,-100.78,-345694.62,1039747.26,694052.64
1969-04-18,101.24,0.46,0.46,108.37,-6.58,True,1,10318,-101.24,-345795.86,1044594.32,698798.46
1969-04-21,100.56,-0.68,-0.67,108.37,-7.21,True,1,10319,-100.56,-345896.42,1037678.64,691782.22
1969-04-22,100.78,0.22,0.22,108.37,-7.0,True,1,10320,-100.78,-345997.2,1040049.6,694052.4
1969-04-23,100.8,0.02,0.02,108.37,-6.98,True,1,10321,-100.8,-346098.0,1040356.8,694258.8
1969-04-24,101.27,0.47,0.47,108.37,-6.55,True,1,10322,-101.27,-346199.27,1045308.94,699109.67
1969-04-25,101.72,0.45,0.44,108.37,-6.14,True,1,10323,-101.72,-346300.99,1050055.56,703754.57
1969-04-28,102.03,0.31,0.3,108.37,-5.85,True,1,10324,-102.03,-346403.02,1053357.72,706954.7
1969-04-29,102.79,0.76,0.74,108.37,-5.15,True,1,10325,-102.79,-346505.81,1061306.75,714800.94
1969-04-30,103.69,0.9,0.88,108.37,-4.32,True,1,10326,-103.69,-346609.5,1070702.94,724093.44
1969-05-01,103.51,-0.18,-0.17,108.37,-4.49,True,1,10327,-103.51,-346713.01,1068947.77,722234.76
1969-05-02,104.0,0.49,0.47,108.37,-4.03,True,1,10328,-104.0,-346817.01,1074112.0,727294.99
1969-05-05,104.37,0.37,0.36,108.37,-3.69,True,1,10329,-104.37,-346921.38,1078037.73,731116.35
1969-05-06,104.86,0.49,0.47,108.37,-3.24,True,1,10330,-104.86,-347026.24,1083203.8,736177.56
1969-05-07,104.67,-0.19,-0.18,108.37,-3.41,True,1,10331,-104.67,-347130.91,1081345.77,734214.86
1969-05-08,105.1,0.43,0.41,108.37,-3.02,True,1,10332,-105.1,-347236.01,1085893.2,738657.19
1969-05-09,105.05,-0.05,-0.05,108.37,-3.06,True,1,10333,-105.05,-347341.06,1085481.65,738140.59
1969-05-12,104.89,-0.16,-0.15,108.37,-3.21,True,1,10334,-104.89,-347445.95,1083933.26,736487.31
1969-05-13,105.34,0.45,0.43,108.37,-2.8,True,1,10335,-105.34,-347551.29,1088688.9,741137.61
1969-05-14,106.16,0.82,0.78,108.37,-2.04,True,1,10336,-106.16,-347657.45,1097269.76,749612.31
1969-05-15,105.85,-0.31,-0.29,108.37,-2.33,True,1,10337,-105.85,-347763.3,1094171.45,746408.15
1969-05-16,105.94,0.09,0.08,108.37,-2.24,True,1,10338,-105.94,-347869.24,1095207.72,747338.48
1969-05-19,104.97,-0.97,-0.92,108.37,-3.14,True,1,10339,-104.97,-347974.21,1085284.83,737310.62
1969-05-20,104.04,-0.93,-0.89,108.37,-4.0,True,1,10340,-104.04,-348078.25,1075773.6,727695.35
1969-05-21,104.47,0.43,0.41,108.37,-3.6,True,1,10341,-104.47,-348182.72,1080324.27,732141.55
1969-05-22,104.6,0.13,0.12,108.37,-3.48,True,1,10342,-104.6,-348287.32,1081773.2,733485.88
1969-05-23,104.59,-0.01,-0.01,108.37,-3.49,True,1,10343,-104.59,-348391.91,1081774.37,733382.46
1969-05-26,104.36,-0.23,-0.22,108.37,-3.7,True,1,10344,-104.36,-348496.27,1079499.84,731003.57
1969-05-27,103.57,-0.79,-0.76,108.37,-4.43,True,1,10345,-103.57,-348599.84,1071431.65,722831.81
1969-05-28,103.26,-0.31,-0.3,108.37,-4.72,True,1,10346,-103.26,-348703.1,1068327.96,719624.86
1969-05-29,103.46,0.2,0.19,108.37,-4.53,True,1,10347,-103.46,-348806.56,1070500.62,721694.06
1969-06-02,102.94,-0.52,-0.5,108.37,-5.01,True,1,10348,-102.94,-348909.5,1065223.12,716313.62
1969-06-03,102.63,-0.31,-0.3,108.37,-5.3,True,1,10349,-102.63,-349012.13,1062117.87,713105.74
1969-06-04,102.59,-0.04,-0.04,108.37,-5.33,True,1,10350,-102.59,-349114.72,1061806.5,712691.78
1969-06-05,102.76,0.17,0.17,108.37,-5.18,True,1,10351,-102.76,-349217.48,1063668.76,714451.28
1969-06-06,102.12,-0.64,-0.62,108.37,-5.77,True,1,10352,-102.12,-349319.6,1057146.24,707826.64
1969-06-09,101.2,-0.92,-0.9,108.37,-6.62,True,1,10353,-101.2,-349420.8,1047723.6,698302.8
1969-06-10,100.42,-0.78,-0.77,108.37,-7.34,True,1,10354,-100.42,-349521.22,1039748.68,690227.46
1969-06-11,99.05,-1.37,-1.36,108.37,-8.6,True,1,10355,-99.05,-349620.27,1025662.75,676042.48
1969-06-12,98.26,-0.79,-0.8,108.37,-9.33,True,1,10356,-98.26,-349718.53,1017580.56,667862.03
1969-06-13,98.65,0.39,0.4,108.37,-8.97,True,1,10357,-98.65,-349817.18,1021718.05,671900.87
1969-06-16,98.32,-0.33,-0.34,108.37,-9.27,True,1,10358,-98.32,-349915.5,1018398.56,668483.06
1969-06-17,97.95,-0.37,-0.38,108.37,-9.62,True,1,10359,-97.95,-350013.45,1014664.05,664650.6
1969-06-18,97.81,-0.14,-0.14,108.37,-9.74,True,1,10360,-97.81,-350111.26,1013311.6,663200.34
1969-06-19,97.24,-0.57,-0.58,108.37,-10.27,True,1,10361,-97.24,-350208.5,1007503.64,657295.14
1969-06-20,96.67,-0.57,-0.59,108.37,-10.8,True,1,10362,-96.67,-350305.17,1001694.54,651389.37
1969-06-23,96.23,-0.44,-0.46,108.37,-11.2,True,1,10363,-96.23,-350401.4,997231.49,646830.09
1969-06-24,97.32,1.09,1.13,108.37,-10.2,True,1,10364,-97.32,-350498.72,1008624.48,658125.76
1969-06-25,97.01,-0.31,-0.32,108.37,-10.48,True,1,10365,-97.01,-350595.73,1005508.65,654912.92
1969-06-26,97.25,0.24,0.25,108.37,-10.26,True,1,10366,-97.25,-350692.98,1008093.5,657400.52
1969-06-27,97.33,0.08,0.08,108.37,-10.19,True,1,10367,-97.33,-350790.31,1009020.11,658229.8
1969-06-30,97.71,0.38,0.39,108.37,-9.84,True,1,10368,-97.71,-350888.02,1013057.28,662169.26
1969-07-01,98.08,0.37,0.38,108.37,-9.49,True,1,10369,-98.08,-350986.1,1016991.52,666005.42
1969-07-02,98.94,0.86,0.88,108.37,-8.7,True,1,10370,-98.94,-351085.04,1026007.8,674922.76
1969-07-03,99.61,0.67,0.68,108.37,-8.08,True,1,10371,-99.61,-351184.65,1033055.31,681870.66
1969-07-07,99.03,-0.58,-0.58,108.37,-8.62,True,1,10372,-99.03,-351283.68,1027139.16,675855.48
1969-07-08,97.63,-1.4,-1.41,108.37,-9.91,True,1,10373,-97.63,-351381.31,1012715.99,661334.68
1969-07-09,96.88,-0.75,-0.77,108.37,-10.6,True,1,10374,-96.88,-351478.19,1005033.12,653554.93
1969-07-10,95.38,-1.5,-1.55,108.37,-11.99,True,1,10375,-95.38,-351573.57,989567.5,637993.93
1969-07-11,95.77,0.39,0.41,108.37,-11.63,True,1,10376,-95.77,-351669.34,993709.52,642040.18
1969-07-14,94.55,-1.22,-1.27,108.37,-12.75,True,1,10377,-94.55,-351763.89,981145.35,629381.46
1969-07-15,94.24,-0.31,-0.33,108.37,-13.04,True,1,10378,-94.24,-351858.13,978022.72,626164.59
1969-07-16,95.18,0.94,1.0,108.37,-12.17,True,1,10379,-95.18,-351953.31,987873.22,635919.91
1969-07-17,95.76,0.58,0.61,108.37,-11.64,True,1,10380,-95.76,-352049.07,993988.8,641939.73
1969-07-18,94.95,-0.81,-0.85,108.37,-12.38,True,1,10381,-94.95,-352144.02,985675.95,633531.93
1969-07-22,93.52,-1.43,-1.51,108.37,-13.7,True,1,10382,-93.52,-352237.54,970924.64,618687.1
1969-07-23,93.12,-0.4,-0.43,108.37,-14.07,True,1,10383,-93.12,-352330.66,966864.96,614534.3
1969-07-24,92.8,-0.32,-0.34,108.37,-14.37,True,1,10384,-92.8,-352423.46,963635.2,611211.74
1969-07-25,92.06,-0.74,-0.8,108.37,-15.05,True,1,10385,-92.06,-352515.52,956043.1,603527.58
1969-07-28,90.21,-1.85,-2.01,108.37,-16.76,True,1,10386,-90.21,-352605.73,936921.06,584315.33
1969-07-29,89.48,-0.73,-0.81,108.37,-17.43,True,1,10387,-89.48,-352695.21,929428.76,576733.55
1969-07-30,89.93,0.45,0.5,108.37,-17.02,True,1,10388,-89.93,-352785.14,934192.84,581407.7
1969-07-31,91.83,1.9,2.11,108.37,-15.26,True,1,10389,-91.83,-352876.97,954021.87,601144.9
1969-08-01,93.47,1.64,1.79,108.37,-13.75,True,1,10390,-93.47,-352970.44,971153.3,618182.86
1969-08-04,92.99,-0.48,-0.51,108.37,-14.19,True,1,10391,-92.99,-353063.43,966259.09,613195.66
1969-08-05,93.41,0.42,0.45,108.37,-13.8,True,1,10392,-93.41,-353156.84,970716.72,617559.88
1969-08-06,93.92,0.51,0.55,108.37,-13.33,True,1,10393,-93.92,-353250.76,976110.56,622859.8
1969-08-07,93.99,0.07,0.08,108.37,-13.27,True,1,10394,-93.99,-353344.75,976932.06,623587.31
1969-08-08,93.94,-0.05,-0.05,108.37,-13.32,True,1,10395,-93.94,-353438.69,976506.3,623067.61
1969-08-11,93.36,-0.58,-0.62,108.37,-13.85,True,1,10396,-93.36,-353532.05,970570.56,617038.51
1969-08-12,92.63,-0.73,-0.78,108.37,-14.52,True,1,10397,-92.63,-353624.68,963074.11,609449.43
1969-08-13,92.7,0.07,0.08,108.37,-14.46,True,1,10398,-92.7,-353717.38,963894.6,610177.22
1969-08-14,93.34,0.64,0.69,108.37,-13.87,True,1,10399,-93.34,-353810.72,970642.66,616831.94
1969-08-15,94.0,0.66,0.71,108.37,-13.26,True,1,10400,-94.0,-353904.72,977600.0,623695.28
1969-08-18,94.57,0.57,0.61,108.37,-12.73,True,1,10401,-94.57,-353999.29,983622.57,629623.28
1969-08-19,95.07,0.5,0.53,108.37,-12.27,True,1,10402,-95.07,-354094.36,988918.14,634823.78
1969-08-20,95.07,0.0,0.0,108.37,-12.27,True,1,10403,-95.07,-354189.43,989013.21,634823.78
1969-08-21,95.35,0.28,0.3,108.37,-12.01,True,1,10404,-95.35,-354284.78,992021.4,637736.62
1969-08-22,95.92,0.57,0.6,108.37,-11.49,True,1,10405,-95.92,-354380.7,998047.6,643666.9
1969-08-25,94.93,-0.99,-1.03,108.37,-12.4,True,1,10406,-94.93,-354475.63,987841.58,633365.95
1969-08-26,94.3,-0.63,-0.66,108.37,-12.98,True,1,10407,-94.3,-354569.93,981380.1,626810.17
1969-08-27,94.49,0.19,0.2,108.37,-12.81,True,1,10408,-94.49,-354664.42,983451.92,628787.5
1969-08-28,94.89,0.4,0.42,108.37,-12.44,True,1,10409,-94.89,-354759.31,987710.01,632950.7
1969-08-29,95.51,0.62,0.65,108.37,-11.87,True,1,10410,-95.51,-354854.82,994259.1,639404.28
1969-09-02,95.54,0.03,0.03,108.37,-11.84,True,1,10411,-95.54,-354950.36,994666.94,639716.58
1969-09-03,94.98,-0.56,-0.59,108.37,-12.36,True,1,10412,-94.98,-355045.34,988931.76,633886.42
1969-09-04,94.2,-0.78,-0.82,108.37,-13.08,True,1,10413,-94.2,-355139.54,980904.6,625765.06
1969-09-05,93.64,-0.56,-0.59,108.37,-13.59,True,1,10414,-93.64,-355233.18,975166.96,619933.78
1969-09-08,92.7,-0.94,-1.0,108.37,-14.46,True,1,10415,-92.7,-355325.88,965470.5,610144.62
1969-09-09,93.38,0.68,0.73,108.37,-13.83,True,1,10416,-93.38,-355419.26,972646.08,617226.82
1969-09-10,94.95,1.57,1.68,108.37,-12.38,True,1,10417,-94.95,-355514.21,989094.15,633579.94
1969-09-11,94.22,-0.73,-0.77,108.37,-13.06,True,1,10418,-94.22,-355608.43,981583.96,625975.53
1969-09-12,94.13,-0.09,-0.1,108.37,-13.14,True,1,10419,-94.13,-355702.56,980740.47,625037.91
1969-09-15,94.87,0.74,0.79,108.37,-12.46,True,1,10420,-94.87,-355797.43,988545.4,632747.97
1969-09-16,94.95,0.08,0.08,108.37,-12.38,True,1,10421,-94.95,-355892.38,989473.95,633581.57
1969-09-17,94.76,-0.19,-0.2,108.37,-12.56,True,1,10422,-94.76,-355987.14,987588.72,631601.58
1969-09-18,94.9,0.14,0.15,108.37,-12.43,True,1,10423,-94.9,-356082.04,989142.7,633060.66
1969-09-19,95.19,0.29,0.31,108.37,-12.16,True,1,10424,-95.19,-356177.23,992260.56,636083.33
1969-09-22,95.63,0.44,0.46,108.37,-11.76,True,1,10425,-95.63,-356272.86,996942.75,640669.89
1969-09-23,95.63,0.0,0.0,108.37,-11.76,True,1,10426,-95.63,-356368.49,997038.38,640669.89
1969-09-24,95.5,-0.13,-0.14,108.37,-11.88,True,1,10427,-95.5,-356463.99,995778.5,639314.51
1969-09-25,94.77,-0.73,-0.76,108.37,-12.55,True,1,10428,-94.77,-356558.76,988261.56,631702.8
1969-09-26,94.16,-0.61,-0.64,108.37,-13.11,True,1,10429,-94.16,-356652.92,981994.64,625341.72
1969-09-29,93.41,-0.75,-0.8,108.37,-13.8,True,1,10430,-93.41,-356746.33,974266.3,617519.97
1969-09-30,93.12,-0.29,-0.31,108.37,-14.07,True,1,10431,-93.12,-356839.45,971334.72,614495.27
1969-10-01,92.52,-0.6,-0.64,108.37,-14.63,True,1,10432,-92.52,-356931.97,965168.64,608236.67
1969-10-02,93.24,0.72,0.78,108.37,-13.96,True,1,10433,-93.24,-357025.21,972772.92,615747.71
1969-10-03,93.19,-0.05,-0.05,108.37,-14.01,True,1,10434,-93.19,-357118.4,972344.46,615226.06
1969-10-06,93.38,0.19,0.2,108.37,-13.83,True,1,10435,-93.38,-357211.78,974420.3,617208.52
1969-10-07,93.09,-0.29,-0.31,108.37,-14.1,True,1,10436,-93.09,-357304.87,971487.24,614182.37
1969-10-08,92.67,-0.42,-0.45,108.37,-14.49,True,1,10437,-92.67,-357397.54,967196.79,609799.25
1969-10-09,93.03,0.36,0.39,108.37,-14.16,True,1,10438,-93.03,-357490.57,971047.14,613556.57
1969-10-10,93.56,0.53,0.57,108.37,-13.67,True,1,10439,-93.56,-357584.13,976672.84,619088.71
1969-10-13,94.55,0.99,1.06,108.37,-12.75,True,1,10440,-94.55,-357678.68,987102.0,629423.32
1969-10-14,95.7,1.15,1.22,108.37,-11.69,True,1,10441,-95.7,-357774.38,999203.7,641429.32
1969-10-15,95.72,0.02,0.02,108.37,-11.67,True,1,10442,-95.72,-357870.1,999508.24,641638.14
1969-10-16,96.37,0.65,0.68,108.37,-11.07,True,1,10443,-96.37,-357966.47,1006391.91,648425.44
1969-10-17,96.26,-0.11,-0.11,108.37,-11.18,True,1,10444,-96.26,-358062.73,1005339.44,647276.71
1969-10-20,96.46,0.2,0.21,108.37,-10.99,True,1,10445,-96.46,-358159.19,1007524.7,649365.51
1969-10-21,97.2,0.74,0.77,108.37,-10.31,True,1,10446,-97.2,-358256.39,1015351.2,657094.81
1969-10-22,97.83,0.63,0.65,108.37,-9.73,True,1,10447,-97.83,-358354.22,1022030.01,663675.79
1969-10-23,97.46,-0.37,-0.38,108.37,-10.07,True,1,10448,-97.46,-358451.68,1018262.08,659810.4
1969-10-24,98.12,0.66,0.68,108.37,-9.46,True,1,10449,-98.12,-358549.8,1025255.88,666706.08
1969-10-27,97.97,-0.15,-0.15,108.37,-9.6,True,1,10450,-97.97,-358647.77,1023786.5,665138.73
1969-10-28,97.66,-0.31,-0.32,108.37,-9.88,True,1,10451,-97.66,-358745.43,1020644.66,661899.23
1969-10-29,96.81,-0.85,-0.87,108.37,-10.67,True,1,10452,-96.81,-358842.24,1011858.12,653015.88
1969-10-30,96.93,0.12,0.12,108.37,-10.56,True,1,10453,-96.93,-358939.17,1013209.29,654270.12
1969-10-31,97.12,0.19,0.2,108.37,-10.38,True,1,10454,-97.12,-359036.29,1015292.48,656256.19
1969-11-03,97.15,0.03,0.03,108.37,-10.35,True,1,10455,-97.15,-359133.44,1015703.25,656569.81
1969-11-04,97.21,0.06,0.06,108.37,-10.3,True,1,10456,-97.21,-359230.65,1016427.76,657197.11
1969-11-05,97.64,0.43,0.44,108.37,-9.9,True,1,10457,-97.64,-359328.29,1021021.48,661693.19
1969-11-06,97.67,0.03,0.03,108.37,-9.87,True,1,10458,-97.67,-359425.96,1021432.86,662006.9
1969-11-07,98.26,0.59,0.6,108.37,-9.33,True,1,10459,-98.26,-359524.22,1027701.34,668177.12
1969-11-10,98.33,0.07,0.07,108.37,-9.26,True,1,10460,-98.33,-359622.55,1028531.8,668909.25
1969-11-11,98.07,-0.26,-0.26,108.37,-9.5,True,1,10461,-98.07,-359720.62,1025910.27,666189.65
1969-11-12,97.89,-0.18,-0.18,108.37,-9.67,True,1,10462,-97.89,-359818.51,1024125.18,664306.67
1969-11-13,97.42,-0.47,-0.48,108.37,-10.1,True,1,10463,-97.42,-359915.93,1019305.46,659389.53
1969-11-14,97.07,-0.35,-0.36,108.37,-10.43,True,1,10464,-97.07,-360013.0,1015740.48,655727.48
1969-11-17,96.41,-0.66,-0.68,108.37,-11.04,True,1,10465,-96.41,-360109.41,1008930.65,648821.24
1969-11-18,96.39,-0.02,-0.02,108.37,-11.06,True,1,10466,-96.39,-360205.8,1008817.74,648611.94
1969-11-19,95.9,-0.49,-0.51,108.37,-11.51,True,1,10467,-95.9,-360301.7,1003785.3,643483.6
1969-11-20,94.91,-0.99,-1.03,108.37,-12.42,True,1,10468,-94.91,-360396.61,993517.88,633121.27
1969-11-21,94.32,-0.59,-0.62,108.37,-12.96,True,1,10469,-94.32,-360490.93,987436.08,626945.15
1969-11-24,93.24,-1.08,-1.14,108.37,-13.96,True,1,10470,-93.24,-360584.17,976222.8,615638.63
1969-11-25,92.94,-0.3,-0.32,108.37,-14.24,True,1,10471,-92.94,-360677.11,973174.74,612497.63
1969-11-26,93.27,0.33,0.36,108.37,-13.93,True,1,10472,-93.27,-360770.38,976723.44,615953.06
1969-11-28,93.81,0.54,0.58,108.37,-13.44,True,1,10473,-93.81,-360864.19,982472.13,621607.94
1969-12-01,93.22,-0.59,-0.63,108.37,-13.98,True,1,10474,-93.22,-360957.41,976386.28,615428.87
1969-12-02,92.65,-0.57,-0.61,108.37,-14.51,True,1,10475,-92.65,-361050.06,970508.75,609458.69
1969-12-03,91.65,-1.0,-1.08,108.37,-15.43,True,1,10476,-91.65,-361141.71,960125.4,598983.69
1969-12-04,91.95,0.3,0.33,108.37,-15.15,True,1,10477,-91.95,-361233.66,963360.15,602126.49
1969-12-05,91.73,-0.22,-0.24,108.37,-15.36,True,1,10478,-91.73,-361325.39,961146.94,599821.55
1969-12-08,90.84,-0.89,-0.97,108.37,-16.18,True,1,10479,-90.84,-361416.23,951912.36,590496.13
1969-12-09,90.55,-0.29,-0.32,108.37,-16.44,True,1,10480,-90.55,-361506.78,948964.0,587457.22
1969-12-10,90.48,-0.07,-0.08,108.37,-16.51,True,1,10481,-90.48,-361597.26,948320.88,586723.62
1969-12-11,90.52,0.04,0.04,108.37,-16.47,True,1,10482,-90.52,-361687.78,948830.64,587142.86
1969-12-12,90.81,0.29,0.32,108.37,-16.2,True,1,10483,-90.81,-361778.59,951961.23,590182.64
1969-12-15,90.54,-0.27,-0.3,108.37,-16.45,True,1,10484,-90.54,-361869.13,949221.36,587352.23
1969-12-16,89.72,-0.82,-0.91,108.37,-17.21,True,1,10485,-89.72,-361958.85,940714.2,578755.35
1969-12-17,89.2,-0.52,-0.58,108.37,-17.69,True,1,10486,-89.2,-362048.05,935351.2,573303.15
1969-12-18,90.61,1.41,1.58,108.37,-16.39,True,1,10487,-90.61,-362138.66,950227.07,588088.41
1969-12-19,91.38,0.77,0.85,108.37,-15.68,True,1,10488,-91.38,-362230.04,958393.44,596163.4
1969-12-22,90.58,-0.8,-0.88,108.37,-16.42,True,1,10489,-90.58,-362320.62,950093.62,587773.0
1969-12-23,90.23,-0.35,-0.39,108.37,-16.74,True,1,10490,-90.23,-362410.85,946512.7,584101.85
1969-12-24,91.18,0.95,1.05,108.37,-15.86,True,1,10491,-91.18,-362502.03,956569.38,594067.35
1969-12-26,91.89,0.71,0.78,108.37,-15.21,True,1,10492,-91.89,-362593.92,964109.88,601515.96
1969-12-29,91.25,-0.64,-0.7,108.37,-15.8,True,1,10493,-91.25,-362685.17,957486.25,594801.08
1969-12-30,91.6,0.35,0.38,108.37,-15.48,True,1,10494,-91.6,-362776.77,961250.4,598473.63
1969-12-31,92.06,0.46,0.5,108.37,-15.05,True,1,10495,-92.06,-362868.83,966169.7,603300.87
1970-01-02,93.0,0.94,1.02,108.37,-14.18,True,1,10496,-93.0,-362961.83,976128.0,613166.17
1970-01-05,93.46,0.46,0.5,108.37,-13.76,True,1,10497,-93.46,-363055.29,981049.62,617994.33
1970-01-06,92.82,-0.64,-0.68,108.37,-14.35,True,1,10498,-92.82,-363148.11,974424.36,611276.25
1970-01-07,92.63,-0.19,-0.2,108.37,-14.52,True,1,10499,-92.63,-363240.74,972522.37,609281.63
1970-01-08,92.68,0.05,0.05,108.37,-14.48,True,1,10500,-92.68,-363333.42,973140.0,609806.58
1970-01-09,92.4,-0.28,-0.3,108.37,-14.74,True,1,10501,-92.4,-363425.82,970292.4,606866.58
1970-01-12,91.7,-0.7,-0.76,108.37,-15.38,True,1,10502,-91.7,-363517.52,963033.4,599515.88
1970-01-13,91.92,0.22,0.24,108.37,-15.18,True,1,10503,-91.92,-363609.44,965435.76,601826.32
1970-01-14,91.65,-0.27,-0.29,108.37,-15.43,True,1,10504,-91.65,-363701.09,962691.6,598990.51
1970-01-15,91.68,0.03,0.03,108.37,-15.4,True,1,10505,-91.68,-363792.77,963098.4,599305.63
1970-01-16,90.92,-0.76,-0.83,108.37,-16.1,True,1,10506,-90.92,-363883.69,955205.52,591321.83
1970-01-19,89.65,-1.27,-1.4,108.37,-17.27,True,1,10507,-89.65,-363973.34,941952.55,577979.21
1970-01-20,89.83,0.18,0.2,108.37,-17.11,True,1,10508,-89.83,-364063.17,943933.64,579870.47
1970-01-21,89.95,0.12,0.13,108.37,-17.0,True,1,10509,-89.95,-364153.12,945284.55,581131.43
1970-01-22,90.04,0.09,0.1,108.37,-16.91,True,1,10510,-90.04,-364243.16,946320.4,582077.24
1970-01-23,89.37,-0.67,-0.74,108.37,-17.53,True,1,10511,-89.37,-364332.53,939368.07,575035.54
1970-01-26,88.17,-1.2,-1.34,108.37,-18.64,True,1,10512,-88.17,-364420.7,926843.04,562422.34
1970-01-27,87.62,-0.55,-0.62,108.37,-19.15,True,1,10513,-87.62,-364508.32,921149.06,556640.74
1970-01-28,86.79,-0.83,-0.95,108.37,-19.91,True,1,10514,-86.79,-364595.11,912510.06,547914.95
1970-01-29,85.69,-1.1,-1.27,108.37,-20.93,True,1,10515,-85.69,-364680.8,901030.35,536349.55
1970-01-30,85.02,-0.67,-0.78,108.37,-21.55,True,1,10516,-85.02,-364765.82,894070.32,529304.5
1970-02-02,85.75,0.73,0.86,108.37,-20.87,True,1,10517,-85.75,-364851.57,901832.75,536981.18
1970-02-03,86.77,1.02,1.19,108.37,-19.93,True,1,10518,-86.77,-364938.34,912646.86,547708.52
1970-02-04,86.24,-0.53,-0.61,108.37,-20.42,True,1,10519,-86.24,-365024.58,907158.56,542133.98
1970-02-05,85.9,-0.34,-0.39,108.37,-20.74,True,1,10520,-85.9,-365110.48,903668.0,538557.52
1970-02-06,86.33,0.43,0.5,108.37,-20.34,True,1,10521,-86.33,-365196.81,908277.93,543081.12
1970-02-09,87.01,0.68,0.79,108.37,-19.71,True,1,10522,-87.01,-365283.82,915519.22,550235.4
1970-02-10,86.1,-0.91,-1.05,108.37,-20.55,True,1,10523,-86.1,-365369.92,906030.3,540660.38
1970-02-11,86.94,0.84,0.98,108.37,-19.77,True,1,10524,-86.94,-365456.86,914956.56,549499.7
1970-02-12,86.73,-0.21,-0.24,108.37,-19.97,True,1,10525,-86.73,-365543.59,912833.25,547289.66
1970-02-13,86.54,-0.19,-0.22,108.37,-20.14,True,1,10526,-86.54,-365630.13,910920.04,545289.91
1970-02-16,86.47,-0.07,-0.08,108.37,-20.21,True,1,10527,-86.47,-365716.6,910269.69,544553.09
1970-02-17,86.37,-0.1,-0.12,108.37,-20.3,True,1,10528,-86.37,-365802.97,909303.36,543500.39
1970-02-18,87.44,1.07,1.24,108.37,-19.31,True,1,10529,-87.44,-365890.41,920655.76,554765.35
1970-02-19,87.76,0.32,0.37,108.37,-19.02,True,1,10530,-87.76,-365978.17,924112.8,558134.63
1970-02-20,88.03,0.27,0.31,108.37,-18.77,True,1,10531,-88.03,-366066.2,927043.93,560977.73
1970-02-24,87.99,-0.04,-0.04,108.37,-18.81,True,1,10532,-87.99,-366154.19,926710.68,560556.49
1970-02-25,89.35,1.36,1.55,108.37,-17.55,True,1,10533,-89.35,-366243.54,941123.55,574880.01
1970-02-26,88.9,-0.45,-0.5,108.37,-17.97,True,1,10534,-88.9,-366332.44,936472.6,570140.16
1970-02-27,89.5,0.6,0.68,108.37,-17.41,True,1,10535,-89.5,-366421.94,942882.5,576460.56
1970-03-02,89.71,0.21,0.24,108.37,-17.22,True,1,10536,-89.71,-366511.65,945184.56,578672.91
1970-03-03,90.23,0.52,0.58,108.37,-16.74,True,1,10537,-90.23,-366601.88,950753.51,584151.63
1970-03-04,90.04,-0.19,-0.21,108.37,-16.91,True,1,10538,-90.04,-366691.92,948841.52,582149.6
1970-03-05,90.0,-0.04,-0.04,108.37,-16.95,True,1,10539,-90.0,-366781.92,948510.0,581728.08
1970-03-06,89.44,-0.56,-0.62,108.37,-17.47,True,1,10540,-89.44,-366871.36,942697.6,575826.24
1970-03-09,88.51,-0.93,-1.04,108.37,-18.33,True,1,10541,-88.51,-366959.87,932983.91,566024.04
1970-03-10,88.75,0.24,0.27,108.37,-18.1,True,1,10542,-88.75,-367048.62,935602.5,568553.88
1970-03-11,88.69,-0.06,-0.07,108.37,-18.16,True,1,10543,-88.69,-367137.31,935058.67,567921.36
1970-03-12,88.33,-0.36,-0.41,108.37,-18.49,True,1,10544,-88.33,-367225.64,931351.52,564125.88
1970-03-13,87.86,-0.47,-0.53,108.37,-18.93,True,1,10545,-87.86,-367313.5,926483.7,559170.2
1970-03-16,86.91,-0.95,-1.08,108.37,-19.8,True,1,10546,-86.91,-367400.41,916552.86,549152.45
1970-03-17,87.29,0.38,0.44,108.37,-19.45,True,1,10547,-87.29,-367487.7,920647.63,553159.93
1970-03-18,87.54,0.25,0.29,108.37,-19.22,True,1,10548,-87.54,-367575.24,923371.92,555796.68
1970-03-19,87.42,-0.12,-0.14,108.37,-19.33,True,1,10549,-87.42,-367662.66,922193.58,554530.92
1970-03-20,87.06,-0.36,-0.41,108.37,-19.66,True,1,10550,-87.06,-367749.72,918483.0,550733.28
1970-03-23,86.99,-0.07,-0.08,108.37,-19.73,True,1,10551,-86.99,-367836.71,917831.49,549994.78
1970-03-24,87.98,0.99,1.14,108.37,-18.82,True,1,10552,-87.98,-367924.69,928364.96,560440.27
1970-03-25,89.77,1.79,2.04,108.37,-17.16,True,1,10553,-89.77,-368014.46,947342.81,579328.35
1970-03-26,89.92,0.15,0.17,108.37,-17.02,True,1,10554,-89.92,-368104.38,949015.68,580911.3
1970-03-30,89.63,-0.29,-0.32,108.37,-17.29,True,1,10555,-89.63,-368194.01,946044.65,577850.64
1970-03-31,89.63,0.0,0.0,108.37,-17.29,True,1,10556,-89.63,-368283.64,946134.28,577850.64
1970-04-01,90.07,0.44,0.49,108.37,-16.89,True,1,10557,-90.07,-368373.71,950868.99,582495.28
1970-04-02,89.79,-0.28,-0.31,108.37,-17.14,True,1,10558,-89.79,-368463.5,948002.82,579539.32
1970-04-03,89.39,-0.4,-0.44,108.37,-17.51,True,1,10559,-89.39,-368552.89,943869.01,575316.12
1970-04-06,88.76,-0.63,-0.7,108.37,-18.1,True,1,10560,-88.76,-368641.65,937305.6,568663.95
1970-04-07,88.52,-0.24,-0.27,108.37,-18.32,True,1,10561,-88.52,-368730.17,934859.72,566129.55
1970-04-08,88.49,-0.03,-0.03,108.37,-18.34,True,1,10562,-88.49,-368818.66,934631.38,565812.72
1970-04-09,88.53,0.04,0.04,108.37,-18.31,True,1,10563,-88.53,-368907.19,935142.39,566235.2
1970-04-10,88.24,-0.29,-0.33,108.37,-18.58,True,1,10564,-88.24,-368995.43,932167.36,563171.93
1970-04-13,87.64,-0.6,-0.68,108.37,-19.13,True,1,10565,-87.64,-369083.07,925916.6,556833.53
1970-04-14,86.89,-0.75,-0.86,108.37,-19.82,True,1,10566,-86.89,-369169.96,918079.74,548909.78
1970-04-15,86.73,-0.16,-0.18,108.37,-19.97,True,1,10567,-86.73,-369256.69,916475.91,547219.22
1970-04-16,85.88,-0.85,-0.98,108.37,-20.75,True,1,10568,-85.88,-369342.57,907579.84,538237.27
1970-04-17,85.67,-0.21,-0.24,108.37,-20.95,True,1,10569,-85.67,-369428.24,905446.23,536017.99
1970-04-20,85.83,0.16,0.19,108.37,-20.8,True,1,10570,-85.83,-369514.07,907223.1,537709.03
1970-04-21,85.38,-0.45,-0.52,108.37,-21.21,True,1,10571,-85.38,-369599.45,902551.98,532952.53
1970-04-22,84.27,-1.11,-1.3,108.37,-22.24,True,1,10572,-84.27,-369683.72,890902.44,521218.72
1970-04-23,83.04,-1.23,-1.46,108.37,-23.37,True,1,10573,-83.04,-369766.76,877981.92,508215.16
1970-04-24,82.77,-0.27,-0.32,108.37,-23.62,True,1,10574,-82.77,-369849.53,875209.98,505360.45
1970-04-27,81.46,-1.31,-1.58,108.37,-24.83,True,1,10575,-81.46,-369930.99,861439.5,491508.51
1970-04-28,80.27,-1.19,-1.46,108.37,-25.93,True,1,10576,-80.27,-370011.26,848935.52,478924.26
1970-04-29,81.81,1.54,1.92,108.37,-24.51,True,1,10577,-81.81,-370093.07,865304.37,495211.3
1970-04-30,81.52,-0.29,-0.35,108.37,-24.78,True,1,10578,-81.52,-370174.59,862318.56,492143.97
1970-05-01,81.44,-0.08,-0.1,108.37,-24.85,True,1,10579,-81.44,-370256.03,861553.76,491297.73
1970-05-04,79.37,-2.07,-2.54,108.37,-26.76,True,1,10580,-79.37,-370335.4,839734.6,469399.2
1970-05-05,78.6,-0.77,-0.97,108.37,-27.47,True,1,10581,-78.6,-370414.0,831666.6,461252.6
1970-05-06,79.47,0.87,1.11,108.37,-26.67,True,1,10582,-79.47,-370493.47,840951.54,470458.07
1970-05-07,79.83,0.36,0.45,108.37,-26.34,True,1,10583,-79.83,-370573.3,844840.89,474267.59
1970-05-08,79.44,-0.39,-0.49,108.37,-26.7,True,1,10584,-79.44,-370652.74,840792.96,470140.22
1970-05-11,78.6,-0.84,-1.06,108.37,-27.47,True,1,10585,-78.6,-370731.34,831981.0,461249.66
1970-05-12,77.85,-0.75,-0.95,108.37,-28.16,True,1,10586,-77.85,-370809.19,824120.1,453310.91
1970-05-13,76.53,-1.32,-1.7,108.37,-29.38,True,1,10587,-76.53,-370885.72,810223.11,439337.39
1970-05-14,75.44,-1.09,-1.42,108.37,-30.39,True,1,10588,-75.44,-370961.16,798758.72,427797.56
1970-05-15,76.9,1.46,1.94,108.37,-29.04,True,1,10589,-76.9,-371038.06,814294.1,443256.04
1970-05-18,76.96,0.06,0.08,108.37,-28.98,True,1,10590,-76.96,-371115.02,815006.4,443891.38
1970-05-19,75.46,-1.5,-1.95,108.37,-30.37,True,1,10591,-75.46,-371190.48,799196.86,428006.38
1970-05-20,73.52,-1.94,-2.57,108.37,-32.16,True,1,10592,-73.52,-371264.0,778723.84,407459.84
1970-05-21,72.16,-1.36,-1.85,108.37,-33.41,True,1,10593,-72.16,-371336.16,764390.88,393054.72
1970-05-22,72.25,0.09,0.12,108.37,-33.33,True,1,10594,-72.25,-371408.41,765416.5,394008.09
1970-05-25,70.25,-2.0,-2.77,108.37,-35.18,True,1,10595,-70.25,-371478.66,744298.75,372820.09
1970-05-26,69.29,-0.96,-1.37,108.37,-36.06,True,1,10596,-69.29,-371547.95,734196.84,362648.89
1970-05-27,72.77,3.48,5.02,108.37,-32.85,True,1,10597,-72.77,-371620.72,771143.69,399522.97
1970-05-28,74.61,1.84,2.53,108.37,-31.15,True,1,10598,-74.61,-371695.33,790716.78,419021.45
1970-05-29,76.55,1.94,2.6,108.37,-29.36,True,1,10599,-76.55,-371771.88,811353.45,439581.57
1970-06-01,77.84,1.29,1.68,108.37,-28.17,True,1,10600,-77.84,-371849.72,825104.0,453254.28
1970-06-02,77.84,0.0,0.0,108.37,-28.17,True,1,10601,-77.84,-371927.56,825181.84,453254.28
1970-06-03,78.52,0.68,0.87,108.37,-27.54,True,1,10602,-78.52,-372006.08,832469.04,460462.96
1970-06-04,77.36,-1.16,-1.48,108.37,-28.62,True,1,10603,-77.36,-372083.44,820248.08,448164.64
1970-06-05,76.17,-1.19,-1.54,108.37,-29.71,True,1,10604,-76.17,-372159.61,807706.68,435547.07
1970-06-08,76.29,0.12,0.16,108.37,-29.6,True,1,10605,-76.29,-372235.9,809055.45,436819.55
1970-06-09,76.25,-0.04,-0.05,108.37,-29.64,True,1,10606,-76.25,-372312.15,808707.5,436395.35
1970-06-10,75.48,-0.77,-1.01,108.37,-30.35,True,1,10607,-75.48,-372387.63,800616.36,428228.73
1970-06-11,74.45,-1.03,-1.36,108.37,-31.3,True,1,10608,-74.45,-372462.08,789765.6,417303.52
1970-06-12,73.88,-0.57,-0.77,108.37,-31.83,True,1,10609,-73.88,-372535.96,783792.92,411256.96
1970-06-15,74.58,0.7,0.95,108.37,-31.18,True,1,10610,-74.58,-372610.54,791293.8,418683.26
1970-06-16,76.15,1.57,2.1,108.37,-29.73,True,1,10611,-76.15,-372686.69,808027.65,435340.96
1970-06-17,76.0,-0.15,-0.2,108.37,-29.87,True,1,10612,-76.0,-372762.69,806512.0,433749.31
1970-06-18,76.51,0.51,0.67,108.37,-29.4,True,1,10613,-76.51,-372839.2,812000.63,439161.43
1970-06-19,77.05,0.54,0.71,108.37,-28.9,True,1,10614,-77.05,-372916.25,817808.7,444892.45
1970-06-22,76.64,-0.41,-0.53,108.37,-29.28,True,1,10615,-76.64,-372992.89,813533.6,440540.71
1970-06-23,74.76,-1.88,-2.45,108.37,-31.01,True,1,10616,-74.76,-373067.65,793652.16,420584.51
1970-06-24,73.97,-0.79,-1.06,108.37,-31.74,True,1,10617,-73.97,-373141.62,785339.49,412197.87
1970-06-25,74.02,0.05,0.07,108.37,-31.7,True,1,10618,-74.02,-373215.64,785944.36,412728.72
1970-06-26,73.47,-0.55,-0.74,108.37,-32.2,True,1,10619,-73.47,-373289.11,780177.93,406888.82
1970-06-29,72.89,-0.58,-0.79,108.37,-32.74,True,1,10620,-72.89,-373362.0,774091.8,400729.8
1970-06-30,72.72,-0.17,-0.23,108.37,-32.9,True,1,10621,-72.72,-373434.72,772359.12,398924.4
1970-07-01,72.94,0.22,0.3,108.37,-32.69,True,1,10622,-72.94,-373507.66,774768.68,401261.02
1970-07-02,72.92,-0.02,-0.03,108.37,-32.71,True,1,10623,-72.92,-373580.58,774629.16,401048.58
1970-07-06,71.78,-1.14,-1.56,108.37,-33.76,True,1,10624,-71.78,-373652.36,762590.72,388938.36
1970-07-07,71.23,-0.55,-0.77,108.37,-34.27,True,1,10625,-71.23,-373723.59,756818.75,383095.16
1970-07-08,73.0,1.77,2.48,108.37,-32.64,True,1,10626,-73.0,-373796.59,775698.0,401901.41
1970-07-09,74.06,1.06,1.45,108.37,-31.66,True,1,10627,-74.06,-373870.65,787035.62,413164.97
1970-07-10,74.45,0.39,0.53,108.37,-31.3,True,1,10628,-74.45,-373945.1,791254.6,417309.5
1970-07-13,74.55,0.1,0.13,108.37,-31.21,True,1,10629,-74.55,-374019.65,792391.95,418372.3
1970-07-14,74.42,-0.13,-0.17,108.37,-31.33,True,1,10630,-74.42,-374094.07,791084.6,416990.53
1970-07-15,75.23,0.81,1.09,108.37,-30.58,True,1,10631,-75.23,-374169.3,799770.13,425600.83
1970-07-16,76.34,1.11,1.48,108.37,-29.56,True,1,10632,-76.34,-374245.64,811646.88,437401.24
1970-07-17,77.69,1.35,1.77,108.37,-28.31,True,1,10633,-77.69,-374323.33,826077.77,451754.44
1970-07-20,77.79,0.1,0.13,108.37,-28.22,True,1,10634,-77.79,-374401.12,827218.86,452817.74
1970-07-21,76.98,-0.81,-1.04,108.37,-28.97,True,1,10635,-76.98,-374478.1,818682.3,444204.2
1970-07-22,77.03,0.05,0.06,108.37,-28.92,True,1,10636,-77.03,-374555.13,819291.08,444735.95
1970-07-23,78.0,0.97,1.26,108.37,-28.02,True,1,10637,-78.0,-374633.13,829686.0,455052.87
1970-07-24,77.82,-0.18,-0.23,108.37,-28.19,True,1,10638,-77.82,-374710.95,827849.16,453138.21
1970-07-27,77.65,-0.17,-0.22,108.37,-28.35,True,1,10639,-77.65,-374788.6,826118.35,451329.75
1970-07-28,77.77,0.12,0.16,108.37,-28.24,True,1,10640,-77.77,-374866.37,827472.8,452606.43
1970-07-29,78.04,0.27,0.35,108.37,-27.99,True,1,10641,-78.04,-374944.41,830423.64,455479.23
1970-07-30,78.07,0.03,0.04,108.37,-27.96,True,1,10642,-78.07,-375022.48,830820.94,455798.46
1970-07-31,78.05,-0.02,-0.03,108.37,-27.98,True,1,10643,-78.05,-375100.53,830686.15,455585.62
1970-08-03,77.02,-1.03,-1.32,108.37,-28.93,True,1,10644,-77.02,-375177.55,819800.88,444623.33
1970-08-04,77.19,0.17,0.22,108.37,-28.77,True,1,10645,-77.19,-375254.74,821687.55,446432.81
1970-08-05,77.18,-0.01,-0.01,108.37,-28.78,True,1,10646,-77.18,-375331.92,821658.28,446326.36
1970-08-06,77.08,-0.1,-0.13,108.37,-28.87,True,1,10647,-77.08,-375409.0,820670.76,445261.76
1970-08-07,77.28,0.2,0.26,108.37,-28.69,True,1,10648,-77.28,-375486.28,822877.44,447391.16
1970-08-10,76.2,-1.08,-1.4,108.37,-29.68,True,1,10649,-76.2,-375562.48,811453.8,435891.32
1970-08-11,75.82,-0.38,-0.5,108.37,-30.04,True,1,10650,-75.82,-375638.3,807483.0,431844.7
1970-08-12,75.42,-0.4,-0.53,108.37,-30.4,True,1,10651,-75.42,-375713.72,803298.42,427584.7
1970-08-13,74.76,-0.66,-0.88,108.37,-31.01,True,1,10652,-74.76,-375788.48,796343.52,420555.04
1970-08-14,75.18,0.42,0.56,108.37,-30.63,True,1,10653,-75.18,-375863.66,800892.54,425028.88
1970-08-17,75.33,0.15,0.2,108.37,-30.49,True,1,10654,-75.33,-375938.99,802565.82,426626.83
1970-08-18,76.2,0.87,1.16,108.37,-29.68,True,1,10655,-76.2,-376015.19,811911.0,435895.81
1970-08-19,76.96,0.76,1.0,108.37,-28.98,True,1,10656,-76.96,-376092.15,820085.76,443993.61
1970-08-20,77.84,0.88,1.14,108.37,-28.17,True,1,10657,-77.84,-376169.99,829540.88,453370.89
1970-08-21,79.24,1.4,1.8,108.37,-26.88,True,1,10658,-79.24,-376249.23,844539.92,468290.69
1970-08-24,80.99,1.75,2.21,108.37,-25.26,True,1,10659,-80.99,-376330.22,863272.41,486942.19
1970-08-25,81.12,0.13,0.16,108.37,-25.14,True,1,10660,-81.12,-376411.34,864739.2,488327.86
1970-08-26,81.21,0.09,0.11,108.37,-25.06,True,1,10661,-81.21,-376492.55,865779.81,489287.26
1970-08-27,81.08,-0.13,-0.16,108.37,-25.18,True,1,10662,-81.08,-376573.63,864474.96,487901.33
1970-08-28,81.86,0.78,0.96,108.37,-24.46,True,1,10663,-81.86,-376655.49,872873.18,496217.69
1970-08-31,81.52,-0.34,-0.42,108.37,-24.78,True,1,10664,-81.52,-376737.01,869329.28,492592.27
1970-09-01,80.95,-0.57,-0.7,108.37,-25.3,True,1,10665,-80.95,-376817.96,863331.75,486513.79
1970-09-02,80.96,0.01,0.01,108.37,-25.29,True,1,10666,-80.96,-376898.92,863519.36,486620.44
1970-09-03,82.09,1.13,1.4,108.37,-24.25,True,1,10667,-82.09,-376981.01,875654.03,498673.02
1970-09-04,82.83,0.74,0.9,108.37,-23.57,True,1,10668,-82.83,-377063.84,883630.44,506566.6
1970-09-08,83.04,0.21,0.25,108.37,-23.37,True,1,10669,-83.04,-377146.88,885953.76,508806.88
1970-09-09,82.79,-0.25,-0.3,108.37,-23.6,True,1,10670,-82.79,-377229.67,883369.3,506139.63
1970-09-10,82.3,-0.49,-0.59,108.37,-24.06,True,1,10671,-82.3,-377311.97,878223.3,500911.33
1970-09-11,82.52,0.22,0.27,108.37,-23.85,True,1,10672,-82.52,-377394.49,880653.44,503258.95
1970-09-14,82.07,-0.45,-0.55,108.37,-24.27,True,1,10673,-82.07,-377476.56,875933.11,498456.55
1970-09-15,81.36,-0.71,-0.86,108.37,-24.92,True,1,10674,-81.36,-377557.92,868436.64,490878.72
1970-09-16,81.79,0.43,0.53,108.37,-24.53,True,1,10675,-81.79,-377639.71,873108.25,495468.54
1970-09-17,82.29,0.5,0.61,108.37,-24.07,True,1,10676,-82.29,-377722.0,878528.04,500806.04
1970-09-18,82.62,0.33,0.4,108.37,-23.76,True,1,10677,-82.62,-377804.62,882133.74,504329.12
1970-09-21,81.91,-0.71,-0.86,108.37,-24.42,True,1,10678,-81.91,-377886.53,874634.98,496748.45
1970-09-22,81.86,-0.05,-0.06,108.37,-24.46,True,1,10679,-81.86,-377968.39,874182.94,496214.55
1970-09-23,81.91,0.05,0.06,108.37,-24.42,True,1,10680,-81.91,-378050.3,874798.8,496748.5
1970-09-24,81.66,-0.25,-0.3,108.37,-24.65,True,1,10681,-81.66,-378131.96,872210.46,494078.5
1970-09-25,82.83,1.17,1.43,108.37,-23.57,True,1,10682,-82.83,-378214.79,884790.06,506575.27
1970-09-28,83.91,1.08,1.3,108.37,-22.57,True,1,10683,-83.91,-378298.7,896410.53,518111.83
1970-09-29,83.86,-0.05,-0.06,108.37,-22.62,True,1,10684,-83.86,-378382.56,895960.24,517577.68
1970-09-30,84.3,0.44,0.52,108.37,-22.21,True,1,10685,-84.3,-378466.86,900745.5,522278.64
1970-10-01,84.32,0.02,0.02,108.37,-22.19,True,1,10686,-84.32,-378551.18,901043.52,522492.34
1970-10-02,85.16,0.84,1.0,108.37,-21.42,True,1,10687,-85.16,-378636.34,910104.92,531468.58
1970-10-05,86.47,1.31,1.54,108.37,-20.21,True,1,10688,-86.47,-378722.81,924191.36,545468.55
1970-10-06,86.85,0.38,0.44,108.37,-19.86,True,1,10689,-86.85,-378809.66,928339.65,549529.99
1970-10-07,86.89,0.04,0.05,108.37,-19.82,True,1,10690,-86.89,-378896.55,928854.1,549957.55
1970-10-08,85.95,-0.94,-1.08,108.37,-20.69,True,1,10691,-85.95,-378982.5,918891.45,539908.95
1970-10-09,85.08,-0.87,-1.01,108.37,-21.49,True,1,10692,-85.08,-379067.58,909675.36,530607.78
1970-10-12,84.17,-0.91,-1.07,108.37,-22.33,True,1,10693,-84.17,-379151.75,900029.81,520878.06
1970-10-13,84.06,-0.11,-0.13,108.37,-22.43,True,1,10694,-84.06,-379235.81,898937.64,519701.83
1970-10-14,84.19,0.13,0.16,108.37,-22.31,True,1,10695,-84.19,-379320.0,900412.05,521092.05
1970-10-15,84.65,0.46,0.55,108.37,-21.89,True,1,10696,-84.65,-379404.65,905416.4,526011.75
1970-10-16,84.28,-0.37,-0.44,108.37,-22.23,True,1,10697,-84.28,-379488.93,901543.16,522054.23
1970-10-19,83.15,-1.13,-1.34,108.37,-23.27,True,1,10698,-83.15,-379572.08,889538.7,509966.62
1970-10-20,83.64,0.49,0.59,108.37,-22.82,True,1,10699,-83.64,-379655.72,894864.36,515208.64
1970-10-21,83.66,0.02,0.02,108.37,-22.8,True,1,10700,-83.66,-379739.38,895162.0,515422.62
1970-10-22,83.38,-0.28,-0.34,108.37,-23.06,True,1,10701,-83.38,-379822.76,892249.38,512426.62
1970-10-23,83.77,0.39,0.47,108.37,-22.7,True,1,10702,-83.77,-379906.53,896506.54,516600.01
1970-10-26,83.31,-0.46,-0.55,108.37,-23.12,True,1,10703,-83.31,-379989.84,891666.93,511677.09
1970-10-27,83.12,-0.19,-0.23,108.37,-23.3,True,1,10704,-83.12,-380072.96,889716.48,509643.52
1970-10-28,83.43,0.31,0.37,108.37,-23.01,True,1,10705,-83.43,-380156.39,893118.15,512961.76
1970-10-29,83.36,-0.07,-0.08,108.37,-23.08,True,1,10706,-83.36,-380239.75,892452.16,512212.41
1970-10-30,83.25,-0.11,-0.13,108.37,-23.18,True,1,10707,-83.25,-380323.0,891357.75,511034.75
1970-11-02,83.51,0.26,0.31,108.37,-22.94,True,1,10708,-83.51,-380406.51,894225.08,513818.57
1970-11-03,84.22,0.71,0.85,108.37,-22.28,True,1,10709,-84.22,-380490.73,901911.98,521421.25
1970-11-04,84.39,0.17,0.2,108.37,-22.13,True,1,10710,-84.39,-380575.12,903816.9,523241.78
1970-11-05,84.1,-0.29,-0.34,108.37,-22.4,True,1,10711,-84.1,-380659.22,900795.1,520135.88
1970-11-06,84.22,0.12,0.14,108.37,-22.28,True,1,10712,-84.22,-380743.44,902164.64,521421.2
1970-11-09,84.67,0.45,0.53,108.37,-21.87,True,1,10713,-84.67,-380828.11,907069.71,526241.6
1970-11-10,84.79,0.12,0.14,108.37,-21.76,True,1,10714,-84.79,-380912.9,908440.06,527527.16
1970-11-11,85.03,0.24,0.28,108.37,-21.54,True,1,10715,-85.03,-380997.93,911096.45,530098.52
1970-11-12,84.15,-0.88,-1.03,108.37,-22.35,True,1,10716,-84.15,-381082.08,901751.4,520669.32
1970-11-13,83.37,-0.78,-0.93,108.37,-23.07,True,1,10717,-83.37,-381165.45,893476.29,512310.84
1970-11-16,83.24,-0.13,-0.16,108.37,-23.19,True,1,10718,-83.24,-381248.69,892166.32,510917.63
1970-11-17,83.47,0.23,0.28,108.37,-22.98,True,1,10719,-83.47,-381332.16,894714.93,513382.77
1970-11-18,82.79,-0.68,-0.82,108.37,-23.6,True,1,10720,-82.79,-381414.95,887508.8,506093.85
1970-11-19,82.91,0.12,0.14,108.37,-23.49,True,1,10721,-82.91,-381497.86,888878.11,507380.25
1970-11-20,83.72,0.81,0.98,108.37,-22.75,True,1,10722,-83.72,-381581.58,897645.84,516064.26
1970-11-23,84.24,0.52,0.62,108.37,-22.27,True,1,10723,-84.24,-381665.82,903305.52,521639.7
1970-11-24,84.78,0.54,0.64,108.37,-21.77,True,1,10724,-84.78,-381750.6,909180.72,527430.12
1970-11-25,85.09,0.31,0.37,108.37,-21.48,True,1,10725,-85.09,-381835.69,912590.25,530754.56
1970-11-27,85.93,0.84,0.99,108.37,-20.71,True,1,10726,-85.93,-381921.62,921685.18,539763.56
1970-11-30,87.2,1.27,1.48,108.37,-19.54,True,1,10727,-87.2,-382008.82,935394.4,553385.58
1970-12-01,87.47,0.27,0.31,108.37,-19.29,True,1,10728,-87.47,-382096.29,938378.16,556281.87
1970-12-02,88.48,1.01,1.16,108.37,-18.35,True,1,10729,-88.48,-382184.77,949301.92,567117.15
1970-12-03,88.9,0.42,0.48,108.37,-17.97,True,1,10730,-88.9,-382273.67,953897.0,571623.33
1970-12-04,89.46,0.56,0.63,108.37,-17.45,True,1,10731,-89.46,-382363.13,959995.26,577632.13
1970-12-07,89.94,0.48,0.54,108.37,-17.01,True,1,10732,-89.94,-382453.07,965236.08,582783.01
1970-12-08,89.47,-0.47,-0.52,108.37,-17.44,True,1,10733,-89.47,-382542.54,960281.51,577738.97
1970-12-09,89.54,0.07,0.08,108.37,-17.38,True,1,10734,-89.54,-382632.08,961122.36,578490.28
1970-12-10,89.92,0.38,0.42,108.37,-17.02,True,1,10735,-89.92,-382722.0,965291.2,582569.2
1970-12-11,90.26,0.34,0.38,108.37,-16.71,True,1,10736,-90.26,-382812.26,969031.36,586219.1
1970-12-14,89.8,-0.46,-0.51,108.37,-17.14,True,1,10737,-89.8,-382902.06,964182.6,581280.54
1970-12-15,89.66,-0.14,-0.16,108.37,-17.26,True,1,10738,-89.66,-382991.72,962769.08,579777.36
1970-12-16,89.72,0.06,0.07,108.37,-17.21,True,1,10739,-89.72,-383081.44,963503.08,580421.64
1970-12-17,90.04,0.32,0.36,108.37,-16.91,True,1,10740,-90.04,-383171.48,967029.6,583858.12
1970-12-18,90.22,0.18,0.2,108.37,-16.75,True,1,10741,-90.22,-383261.7,969053.02,585791.32
1970-12-21,89.94,-0.28,-0.31,108.37,-17.01,True,1,10742,-89.94,-383351.64,966135.48,582783.84
1970-12-22,90.04,0.1,0.11,108.37,-16.91,True,1,10743,-90.04,-383441.68,967299.72,583858.04
1970-12-23,90.1,0.06,0.07,108.37,-16.86,True,1,10744,-90.1,-383531.78,968034.4,584502.62
1970-12-24,90.61,0.51,0.57,108.37,-16.39,True,1,10745,-90.61,-383622.39,973604.45,589982.06
1970-12-28,91.09,0.48,0.53,108.37,-15.94,True,1,10746,-91.09,-383713.48,978853.14,595139.66
1970-12-29,92.08,0.99,1.09,108.37,-15.03,True,1,10747,-92.08,-383805.56,989583.76,605778.2
1970-12-30,92.27,0.19,0.21,108.37,-14.86,True,1,10748,-92.27,-383897.83,991717.96,607820.13
1970-12-31,92.15,-0.12,-0.13,108.37,-14.97,True,1,10749,-92.15,-383989.98,990520.35,606530.37
1971-01-04,91.15,-1.0,-1.08,108.37,-15.89,True,1,10750,-91.15,-384081.13,979862.5,595781.37
1971-01-05,91.8,0.65,0.71,108.37,-15.29,True,1,10751,-91.8,-384172.93,986941.8,602768.87
1971-01-06,92.35,0.55,0.6,108.37,-14.78,True,1,10752,-92.35,-384265.28,992947.2,608681.92
1971-01-07,92.38,0.03,0.03,108.37,-14.76,True,1,10753,-92.38,-384357.66,993362.14,609004.48
1971-01-08,92.19,-0.19,-0.21,108.37,-14.93,True,1,10754,-92.19,-384449.85,991411.26,606961.41
1971-01-11,91.98,-0.21,-0.23,108.37,-15.12,True,1,10755,-91.98,-384541.83,989244.9,604703.07
1971-01-12,92.72,0.74,0.8,108.37,-14.44,True,1,10756,-92.72,-384634.55,997296.32,612661.77
1971-01-13,92.56,-0.16,-0.17,108.37,-14.59,True,1,10757,-92.56,-384727.11,995667.92,610940.81
1971-01-14,92.8,0.24,0.26,108.37,-14.37,True,1,10758,-92.8,-384819.91,998342.4,613522.49
1971-01-15,93.03,0.23,0.25,108.37,-14.16,True,1,10759,-93.03,-384912.94,1000909.77,615996.83
1971-01-18,93.41,0.38,0.41,108.37,-13.8,True,1,10760,-93.41,-385006.35,1005091.6,620085.25
1971-01-19,93.76,0.35,0.38,108.37,-13.48,True,1,10761,-93.76,-385100.11,1008951.36,623851.25
1971-01-20,93.78,0.02,0.02,108.37,-13.46,True,1,10762,-93.78,-385193.89,1009260.36,624066.47
1971-01-21,94.19,0.41,0.44,108.37,-13.08,True,1,10763,-94.19,-385288.08,1013766.97,628478.89
1971-01-22,94.88,0.69,0.73,108.37,-12.45,True,1,10764,-94.88,-385382.96,1021288.32,635905.36
1971-01-25,95.28,0.4,0.42,108.37,-12.08,True,1,10765,-95.28,-385478.24,1025689.2,640210.96
1971-01-26,95.59,0.31,0.32,108.37,-11.79,True,1,10766,-95.59,-385573.83,1029121.94,643548.11
1971-01-27,94.89,-0.7,-0.73,108.37,-12.44,True,1,10767,-94.89,-385668.72,1021680.63,636011.91
1971-01-28,95.21,0.32,0.34,108.37,-12.14,True,1,10768,-95.21,-385763.93,1025221.28,639457.35
1971-01-29,95.88,0.67,0.7,108.37,-11.52,True,1,10769,-95.88,-385859.81,1032531.72,646671.91
1971-02-01,96.42,0.54,0.56,108.37,-11.03,True,1,10770,-96.42,-385956.23,1038443.4,652487.17
1971-02-02,96.43,0.01,0.01,108.37,-11.02,True,1,10771,-96.43,-386052.66,1038647.53,652594.87
1971-02-03,96.63,0.2,0.21,108.37,-10.83,True,1,10772,-96.63,-386149.29,1040898.36,654749.07
1971-02-04,96.62,-0.01,-0.01,108.37,-10.84,True,1,10773,-96.62,-386245.91,1040887.26,654641.35
1971-02-05,96.93,0.31,0.32,108.37,-10.56,True,1,10774,-96.93,-386342.84,1044323.82,657980.98
1971-02-08,97.45,0.52,0.54,108.37,-10.08,True,1,10775,-97.45,-386440.29,1050023.75,663583.46
1971-02-09,97.51,0.06,0.06,108.37,-10.02,True,1,10776,-97.51,-386537.8,1050767.76,664229.96
1971-02-10,97.39,-0.12,-0.12,108.37,-10.13,True,1,10777,-97.39,-386635.19,1049572.03,662936.84
1971-02-11,97.91,0.52,0.53,108.37,-9.65,True,1,10778,-97.91,-386733.1,1055273.98,668540.88
1971-02-12,98.43,0.52,0.53,108.37,-9.17,True,1,10779,-98.43,-386831.53,1060976.97,674145.44
1971-02-16,98.66,0.23,0.23,108.37,-8.96,True,1,10780,-98.66,-386930.19,1063554.8,676624.61
1971-02-17,98.2,-0.46,-0.47,108.37,-9.38,True,1,10781,-98.2,-387028.39,1058694.2,671665.81
1971-02-18,97.56,-0.64,-0.65,108.37,-9.98,True,1,10782,-97.56,-387125.95,1051891.92,664765.97
1971-02-19,96.74,-0.82,-0.84,108.37,-10.73,True,1,10783,-96.74,-387222.69,1043147.42,655924.73
1971-02-22,95.72,-1.02,-1.05,108.37,-11.67,True,1,10784,-95.72,-387318.41,1032244.48,644926.07
1971-02-23,96.09,0.37,0.39,108.37,-11.33,True,1,10785,-96.09,-387414.5,1036330.65,648916.15
1971-02-24,96.73,0.64,0.67,108.37,-10.74,True,1,10786,-96.73,-387511.23,1043329.78,655818.55
1971-02-25,96.96,0.23,0.24,108.37,-10.53,True,1,10787,-96.96,-387608.19,1045907.52,658299.33
1971-02-26,96.75,-0.21,-0.22,108.37,-10.72,True,1,10788,-96.75,-387704.94,1043739.0,656034.06
1971-03-01,97.0,0.25,0.26,108.37,-10.49,True,1,10789,-97.0,-387801.94,1046533.0,658731.06
1971-03-02,96.98,-0.02,-0.02,108.37,-10.51,True,1,10790,-96.98,-387898.92,1046414.2,658515.28
1971-03-03,96.95,-0.03,-0.03,108.37,-10.54,True,1,10791,-96.95,-387995.87,1046187.45,658191.58
1971-03-04,97.92,0.97,1.0,108.37,-9.64,True,1,10792,-97.92,-388093.79,1056752.64,668658.85
1971-03-05,98.96,1.04,1.06,108.37,-8.68,True,1,10793,-98.96,-388192.75,1068075.28,679882.53
1971-03-08,99.38,0.42,0.42,108.37,-8.3,True,1,10794,-99.38,-388292.13,1072707.72,684415.59
1971-03-09,99.46,0.08,0.08,108.37,-8.22,True,1,10795,-99.46,-388391.59,1073670.7,685279.11
1971-03-10,99.3,-0.16,-0.16,108.37,-8.37,True,1,10796,-99.3,-388490.89,1072042.8,683551.91
1971-03-11,99.39,0.09,0.09,108.37,-8.29,True,1,10797,-99.39,-388590.28,1073113.83,684523.55
1971-03-12,99.57,0.18,0.18,108.37,-8.12,True,1,10798,-99.57,-388689.85,1075156.86,686467.01
1971-03-15,100.71,1.14,1.14,108.37,-7.07,True,1,10799,-100.71,-388790.56,1087567.29,698776.73
1971-03-16,101.21,0.5,0.5,108.37,-6.61,True,1,10800,-101.21,-388891.77,1093068.0,704176.23
1971-03-17,101.12,-0.09,-0.09,108.37,-6.69,True,1,10801,-101.12,-388992.89,1092197.12,703204.23
1971-03-18,101.19,0.07,0.07,108.37,-6.62,True,1,10802,-101.19,-389094.08,1093054.38,703960.3
1971-03-19,101.01,-0.18,-0.18,108.37,-6.79,True,1,10803,-101.01,-389195.09,1091211.03,702015.94
1971-03-22,100.62,-0.39,-0.39,108.37,-7.15,True,1,10804,-100.62,-389295.71,1087098.48,697802.77
1971-03-23,100.28,-0.34,-0.34,108.37,-7.46,True,1,10805,-100.28,-389395.99,1083525.4,694129.41
1971-03-24,99.62,-0.66,-0.66,108.37,-8.07,True,1,10806,-99.62,-389495.61,1076493.72,686998.11
1971-03-25,99.61,-0.01,-0.01,108.37,-8.08,True,1,10807,-99.61,-389595.22,1076485.27,686890.05
1971-03-26,99.95,0.34,0.34,108.37,-7.77,True,1,10808,-99.95,-389695.17,1080259.6,690564.43
1971-03-29,100.03,0.08,0.08,108.37,-7.7,True,1,10809,-100.03,-389795.2,1081224.27,691429.07
1971-03-30,100.26,0.23,0.23,108.37,-7.48,True,1,10810,-100.26,-389895.46,1083810.6,693915.14
1971-03-31,100.31,0.05,0.05,108.37,-7.44,True,1,10811,-100.31,-389995.77,1084451.41,694455.64
1971-04-01,100.39,0.08,0.08,108.37,-7.36,True,1,10812,-100.39,-390096.16,1085416.68,695320.52
1971-04-02,100.56,0.17,0.17,108.37,-7.21,True,1,10813,-100.56,-390196.72,1087355.28,697158.56
1971-04-05,100.79,0.23,0.23,108.37,-7.0,True,1,10814,-100.79,-390297.51,1089943.06,699645.55
1971-04-06,101.51,0.72,0.71,108.37,-6.33,True,1,10815,-101.51,-390399.02,1097830.65,707431.63
1971-04-07,101.98,0.47,0.46,108.37,-5.9,True,1,10816,-101.98,-390501.0,1103015.68,712514.68
1971-04-08,102.1,0.12,0.12,108.37,-5.79,True,1,10817,-102.1,-390603.1,1104415.7,713812.6
1971-04-12,102.88,0.78,0.76,108.37,-5.07,True,1,10818,-102.88,-390705.98,1112955.84,722249.86
1971-04-13,102.98,0.1,0.1,108.37,-4.97,True,1,10819,-102.98,-390808.96,1114140.62,723331.66
1971-04-14,103.37,0.39,0.38,108.37,-4.61,True,1,10820,-103.37,-390912.33,1118463.4,727551.07
1971-04-15,103.52,0.15,0.14,108.37,-4.47,True,1,10821,-103.52,-391015.85,1120189.92,729174.07
1971-04-16,103.49,-0.03,-0.03,108.37,-4.5,True,1,10822,-103.49,-391119.34,1119968.78,728849.44
1971-04-19,104.01,0.52,0.5,108.37,-4.02,True,1,10823,-104.01,-391223.35,1125700.23,734476.88
1971-04-20,103.61,-0.4,-0.38,108.37,-4.39,True,1,10824,-103.61,-391326.96,1121474.64,730147.68
1971-04-21,103.36,-0.25,-0.24,108.37,-4.62,True,1,10825,-103.36,-391430.32,1118872.0,727441.68
1971-04-22,103.56,0.2,0.19,108.37,-4.44,True,1,10826,-103.56,-391533.88,1121140.56,729606.68
1971-04-23,104.05,0.49,0.47,108.37,-3.99,True,1,10827,-104.05,-391637.93,1126549.35,734911.42
1971-04-26,103.94,-0.11,-0.11,108.37,-4.09,True,1,10828,-103.94,-391741.87,1125462.32,733720.45
1971-04-27,104.59,0.65,0.62,108.37,-3.49,True,1,10829,-104.59,-391846.46,1132605.11,740758.65
1971-04-28,104.77,0.18,0.17,108.37,-3.32,True,1,10830,-104.77,-391951.23,1134659.1,742707.87
1971-04-29,104.63,-0.14,-0.13,108.37,-3.45,True,1,10831,-104.63,-392055.86,1133247.53,741191.67
1971-04-30,103.95,-0.68,-0.65,108.37,-4.08,True,1,10832,-103.95,-392159.81,1125986.4,733826.59
1971-05-03,103.29,-0.66,-0.64,108.37,-4.69,True,1,10833,-103.29,-392263.1,1118940.57,726677.47
1971-05-04,103.79,0.5,0.48,108.37,-4.23,True,1,10834,-103.79,-392366.89,1124460.86,732093.97
1971-05-05,103.78,-0.01,-0.01,108.37,-4.24,True,1,10835,-103.78,-392470.67,1124456.3,731985.63
1971-05-06,103.23,-0.55,-0.53,108.37,-4.74,True,1,10836,-103.23,-392573.9,1118600.28,726026.38
1971-05-07,102.87,-0.36,-0.35,108.37,-5.08,True,1,10837,-102.87,-392676.77,1114802.19,722125.42
1971-05-10,102.36,-0.51,-0.5,108.37,-5.55,True,1,10838,-102.36,-392779.13,1109377.68,716598.55
1971-05-11,102.62,0.26,0.25,108.37,-5.31,True,1,10839,-102.62,-392881.75,1112298.18,719416.43
1971-05-12,102.9,0.28,0.27,108.37,-5.05,True,1,10840,-102.9,-392984.65,1115436.0,722451.35
1971-05-13,102.69,-0.21,-0.2,108.37,-5.24,True,1,10841,-102.69,-393087.34,1113262.29,720174.95
1971-05-14,102.21,-0.48,-0.47,108.37,-5.68,True,1,10842,-102.21,-393189.55,1108160.82,714971.27
1971-05-17,100.69,-1.52,-1.49,108.37,-7.09,True,1,10843,-100.69,-393290.24,1091781.67,698491.43
1971-05-18,100.83,0.14,0.14,108.37,-6.96,True,1,10844,-100.83,-393391.07,1093400.52,700009.45
1971-05-19,101.07,0.24,0.24,108.37,-6.74,True,1,10845,-101.07,-393492.14,1096104.15,702612.01
1971-05-20,101.31,0.24,0.24,108.37,-6.52,True,1,10846,-101.31,-393593.45,1098808.26,705214.81
1971-05-21,100.99,-0.32,-0.32,108.37,-6.81,True,1,10847,-100.99,-393694.44,1095438.53,701744.09
1971-05-24,100.13,-0.86,-0.85,108.37,-7.6,True,1,10848,-100.13,-393794.57,1086210.24,692415.67
1971-05-25,99.47,-0.66,-0.66,108.37,-8.21,True,1,10849,-99.47,-393894.04,1079150.03,685255.99
1971-05-26,99.59,0.12,0.12,108.37,-8.1,True,1,10850,-99.59,-393993.63,1080551.5,686557.87
1971-05-27,99.4,-0.19,-0.19,108.37,-8.28,True,1,10851,-99.4,-394093.03,1078589.4,684496.37
1971-05-28,99.63,0.23,0.23,108.37,-8.06,True,1,10852,-99.63,-394192.66,1081184.76,686992.1
1971-06-01,100.2,0.57,0.57,108.37,-7.54,True,1,10853,-100.2,-394292.86,1087470.6,693177.74
1971-06-02,100.96,0.76,0.76,108.37,-6.84,True,1,10854,-100.96,-394393.82,1095819.84,701426.02
1971-06-03,101.01,0.05,0.05,108.37,-6.79,True,1,10855,-101.01,-394494.83,1096463.55,701968.72
1971-06-04,101.3,0.29,0.29,108.37,-6.52,True,1,10856,-101.3,-394596.13,1099712.8,705116.67
1971-06-07,101.09,-0.21,-0.21,108.37,-6.72,True,1,10857,-101.09,-394697.22,1097534.13,702836.91
1971-06-08,100.32,-0.77,-0.76,108.37,-7.43,True,1,10858,-100.32,-394797.54,1089274.56,694477.02
1971-06-09,100.29,-0.03,-0.03,108.37,-7.46,True,1,10859,-100.29,-394897.83,1089049.11,694151.28
1971-06-10,100.64,0.35,0.35,108.37,-7.13,True,1,10860,-100.64,-394998.47,1092950.4,697951.93
1971-06-11,101.07,0.43,0.43,108.37,-6.74,True,1,10861,-101.07,-395099.54,1097721.27,702621.73
1971-06-14,100.22,-0.85,-0.84,108.37,-7.52,True,1,10862,-100.22,-395199.76,1088589.64,693389.88
1971-06-15,100.32,0.1,0.1,108.37,-7.43,True,1,10863,-100.32,-395300.08,1089776.16,694476.08
1971-06-16,100.52,0.2,0.2,108.37,-7.24,True,1,10864,-100.52,-395400.6,1092049.28,696648.68
1971-06-17,100.5,-0.02,-0.02,108.37,-7.26,True,1,10865,-100.5,-395501.1,1091932.5,696431.4
1971-06-18,98.97,-1.53,-1.52,108.37,-8.67,True,1,10866,-98.97,-395600.07,1075408.02,679807.95
1971-06-21,97.87,-1.1,-1.11,108.37,-9.69,True,1,10867,-97.87,-395697.94,1063553.29,667855.35
1971-06-22,97.59,-0.28,-0.29,108.37,-9.95,True,1,10868,-97.59,-395795.53,1060608.12,664812.59
1971-06-23,98.41,0.82,0.84,108.37,-9.19,True,1,10869,-98.41,-395893.94,1069618.29,673724.35
1971-06-24,98.13,-0.28,-0.28,108.37,-9.45,True,1,10870,-98.13,-395992.07,1066673.1,670681.03
1971-06-25,97.99,-0.14,-0.14,108.37,-9.58,True,1,10871,-97.99,-396090.06,1065249.29,669159.23
1971-06-28,97.74,-0.25,-0.26,108.37,-9.81,True,1,10872,-97.74,-396187.8,1062629.28,666441.48
1971-06-29,98.82,1.08,1.1,108.37,-8.81,True,1,10873,-98.82,-396286.62,1074469.86,678183.24
1971-06-30,98.7,-0.12,-0.12,108.37,-8.92,True,1,10874,-98.7,-396385.32,1073263.8,676878.48
1971-07-01,99.78,1.08,1.09,108.37,-7.93,True,1,10875,-99.78,-396485.1,1085107.5,688622.4
1971-07-02,99.78,0.0,0.0,108.37,-7.93,True,1,10876,-99.78,-396584.88,1085207.28,688622.4
1971-07-06,99.76,-0.02,-0.02,108.37,-7.94,True,1,10877,-99.76,-396684.64,1085089.52,688404.88
1971-07-07,100.04,0.28,0.28,108.37,-7.69,True,1,10878,-100.04,-396784.68,1088235.12,691450.44
1971-07-08,100.34,0.3,0.3,108.37,-7.41,True,1,10879,-100.34,-396885.02,1091598.86,694713.84
1971-07-09,100.69,0.35,0.35,108.37,-7.09,True,1,10880,-100.69,-396985.71,1095507.2,698521.49
1971-07-12,100.82,0.13,0.13,108.37,-6.97,True,1,10881,-100.82,-397086.53,1097022.42,699935.89
1971-07-13,99.5,-1.32,-1.31,108.37,-8.18,True,1,10882,-99.5,-397186.03,1082759.0,685572.97
1971-07-14,99.22,-0.28,-0.28,108.37,-8.44,True,1,10883,-99.22,-397285.25,1079811.26,682526.01
1971-07-15,99.28,0.06,0.06,108.37,-8.39,True,1,10884,-99.28,-397384.53,1080563.52,683178.99
1971-07-16,99.11,-0.17,-0.17,108.37,-8.54,True,1,10885,-99.11,-397483.64,1078812.35,681328.71
1971-07-19,98.93,-0.18,-0.18,108.37,-8.71,True,1,10886,-98.93,-397582.57,1076951.98,679369.41
1971-07-20,99.32,0.39,0.39,108.37,-8.35,True,1,10887,-99.32,-397681.89,1081296.84,683614.95
1971-07-21,99.28,-0.04,-0.04,108.37,-8.39,True,1,10888,-99.28,-397781.17,1080960.64,683179.47
1971-07-22,99.11,-0.17,-0.17,108.37,-8.54,True,1,10889,-99.11,-397880.28,1079208.79,681328.51
1971-07-23,98.94,-0.17,-0.17,108.37,-8.7,True,1,10890,-98.94,-397979.22,1077456.6,679477.38
1971-07-26,98.14,-0.8,-0.81,108.37,-9.44,True,1,10891,-98.14,-398077.36,1068842.74,670765.38
1971-07-27,97.78,-0.36,-0.37,108.37,-9.77,True,1,10892,-97.78,-398175.14,1065019.76,666844.62
1971-07-28,97.07,-0.71,-0.73,108.37,-10.43,True,1,10893,-97.07,-398272.21,1057383.51,659111.3
1971-07-29,96.02,-1.05,-1.08,108.37,-11.4,True,1,10894,-96.02,-398368.23,1046041.88,647673.65
1971-07-30,95.58,-0.44,-0.46,108.37,-11.8,True,1,10895,-95.58,-398463.81,1041344.1,642880.29
1971-08-02,95.96,0.38,0.4,108.37,-11.45,True,1,10896,-95.96,-398559.77,1045580.16,647020.39
1971-08-03,94.51,-1.45,-1.51,108.37,-12.79,True,1,10897,-94.51,-398654.28,1029875.47,631221.19
1971-08-04,93.89,-0.62,-0.66,108.37,-13.36,True,1,10898,-93.89,-398748.17,1023213.22,624465.05
1971-08-05,94.09,0.2,0.21,108.37,-13.18,True,1,10899,-94.09,-398842.26,1025486.91,626644.65
1971-08-06,94.25,0.16,0.17,108.37,-13.03,True,1,10900,-94.25,-398936.51,1027325.0,628388.49
1971-08-09,93.53,-0.72,-0.76,108.37,-13.69,True,1,10901,-93.53,-399030.04,1019570.53,620540.49
1971-08-10,93.54,0.01,0.01,108.37,-13.68,True,1,10902,-93.54,-399123.58,1019773.08,620649.5
1971-08-11,94.66,1.12,1.2,108.37,-12.65,True,1,10903,-94.66,-399218.24,1032077.98,632859.74
1971-08-12,96.0,1.34,1.42,108.37,-11.42,True,1,10904,-96.0,-399314.24,1046784.0,647469.76
1971-08-13,95.69,-0.31,-0.32,108.37,-11.7,True,1,10905,-95.69,-399409.93,1043499.45,644089.52
1971-08-16,98.76,3.07,3.21,108.37,-8.87,True,1,10906,-98.76,-399508.69,1077076.56,677567.87
1971-08-17,99.99,1.23,1.25,108.37,-7.73,True,1,10907,-99.99,-399608.68,1090590.93,690982.25
1971-08-18,98.6,-1.39,-1.39,108.37,-9.02,True,1,10908,-98.6,-399707.28,1075528.8,675821.52
1971-08-19,98.16,-0.44,-0.45,108.37,-9.42,True,1,10909,-98.16,-399805.44,1070827.44,671022.0
1971-08-20,98.33,0.17,0.17,108.37,-9.26,True,1,10910,-98.33,-399903.77,1072780.3,672876.53
1971-08-23,99.25,0.92,0.94,108.37,-8.42,True,1,10911,-99.25,-400003.02,1082916.75,682913.73
1971-08-24,100.4,1.15,1.16,108.37,-7.35,True,1,10912,-100.4,-400103.42,1095564.8,695461.38
1971-08-25,100.41,0.01,0.01,108.37,-7.34,True,1,10913,-100.41,-400203.83,1095774.33,695570.5
1971-08-26,100.24,-0.17,-0.17,108.37,-7.5,True,1,10914,-100.24,-400304.07,1094019.36,693715.29
1971-08-27,100.48,0.24,0.24,108.37,-7.28,True,1,10915,-100.48,-400404.55,1096739.2,696334.65
1971-08-30,99.52,-0.96,-0.96,108.37,-8.17,True,1,10916,-99.52,-400504.07,1086360.32,685856.25
1971-08-31,99.03,-0.49,-0.49,108.37,-8.62,True,1,10917,-99.03,-400603.1,1081110.51,680507.41
1971-09-01,99.07,0.04,0.04,108.37,-8.58,True,1,10918,-99.07,-400702.17,1081646.26,680944.09
1971-09-02,99.29,0.22,0.22,108.37,-8.38,True,1,10919,-99.29,-400801.46,1084147.51,683346.05
1971-09-03,100.69,1.4,1.41,108.37,-7.09,True,1,10920,-100.69,-400902.15,1099534.8,698632.65
1971-09-07,101.15,0.46,0.46,108.37,-6.66,True,1,10921,-101.15,-401003.3,1104659.15,703655.85
1971-09-08,101.34,0.19,0.19,108.37,-6.49,True,1,10922,-101.34,-401104.64,1106835.48,705730.84
1971-09-09,100.8,-0.54,-0.53,108.37,-6.98,True,1,10923,-100.8,-401205.44,1101038.4,699832.96
1971-09-10,100.42,-0.38,-0.38,108.37,-7.34,True,1,10924,-100.42,-401305.86,1096988.08,695682.22
1971-09-13,100.07,-0.35,-0.35,108.37,-7.66,True,1,10925,-100.07,-401405.93,1093264.75,691858.82
1971-09-14,99.34,-0.73,-0.73,108.37,-8.33,True,1,10926,-99.34,-401505.27,1085388.84,683883.57
1971-09-15,99.77,0.43,0.43,108.37,-7.94,True,1,10927,-99.77,-401605.04,1090186.79,688581.75
1971-09-16,99.66,-0.11,-0.11,108.37,-8.04,True,1,10928,-99.66,-401704.7,1089084.48,687379.78
1971-09-17,99.96,0.3,0.3,108.37,-7.76,True,1,10929,-99.96,-401804.66,1092462.84,690658.18
1971-09-20,99.68,-0.28,-0.28,108.37,-8.02,True,1,10930,-99.68,-401904.34,1089502.4,687598.06
1971-09-21,99.34,-0.34,-0.34,108.37,-8.33,True,1,10931,-99.34,-402003.68,1085885.54,683881.86
1971-09-22,98.47,-0.87,-0.88,108.37,-9.14,True,1,10932,-98.47,-402102.15,1076474.04,674371.89
1971-09-23,98.38,-0.09,-0.09,108.37,-9.22,True,1,10933,-98.38,-402200.53,1075588.54,673388.01
1971-09-24,98.15,-0.23,-0.23,108.37,-9.43,True,1,10934,-98.15,-402298.68,1073172.1,670873.42
1971-09-27,97.62,-0.53,-0.54,108.37,-9.92,True,1,10935,-97.62,-402396.3,1067474.7,665078.4
1971-09-28,97.88,0.26,0.27,108.37,-9.68,True,1,10936,-97.88,-402494.18,1070415.68,667921.5
1971-09-29,97.9,0.02,0.02,108.37,-9.66,True,1,10937,-97.9,-402592.08,1070732.3,668140.22
1971-09-30,98.34,0.44,0.45,108.37,-9.26,True,1,10938,-98.34,-402690.42,1075642.92,672952.5
1971-10-01,98.93,0.59,0.6,108.37,-8.71,True,1,10939,-98.93,-402789.35,1082195.27,679405.92
1971-10-04,99.21,0.28,0.28,108.37,-8.45,True,1,10940,-99.21,-402888.56,1085357.4,682468.84
1971-10-05,99.11,-0.1,-0.1,108.37,-8.54,True,1,10941,-99.11,-402987.67,1084362.51,681374.84
1971-10-06,99.82,0.71,0.72,108.37,-7.89,True,1,10942,-99.82,-403087.49,1092230.44,689142.95
1971-10-07,100.02,0.2,0.2,108.37,-7.7,True,1,10943,-100.02,-403187.51,1094518.86,691331.35
1971-10-08,99.36,-0.66,-0.66,108.37,-8.31,True,1,10944,-99.36,-403286.87,1087395.84,684108.97
1971-10-11,99.21,-0.15,-0.15,108.37,-8.45,True,1,10945,-99.21,-403386.08,1085853.45,682467.37
1971-10-12,99.57,0.36,0.36,108.37,-8.12,True,1,10946,-99.57,-403485.65,1089893.22,686407.57
1971-10-13,99.03,-0.54,-0.54,108.37,-8.62,True,1,10947,-99.03,-403584.68,1084081.41,680496.73
1971-10-14,98.13,-0.9,-0.91,108.37,-9.45,True,1,10948,-98.13,-403682.81,1074327.24,670644.43
1971-10-15,97.79,-0.34,-0.35,108.37,-9.76,True,1,10949,-97.79,-403780.6,1070702.71,666922.11
1971-10-18,97.35,-0.44,-0.45,108.37,-10.17,True,1,10950,-97.35,-403877.95,1065982.5,662104.55
1971-10-19,97.0,-0.35,-0.36,108.37,-10.49,True,1,10951,-97.0,-403974.95,1062247.0,658272.05
1971-10-20,95.65,-1.35,-1.39,108.37,-11.74,True,1,10952,-95.65,-404070.6,1047558.8,643488.2
1971-10-21,95.6,-0.05,-0.05,108.37,-11.78,True,1,10953,-95.6,-404166.2,1047106.8,642940.6
1971-10-22,95.57,-0.03,-0.03,108.37,-11.81,True,1,10954,-95.57,-404261.77,1046873.78,642612.01
1971-10-25,95.1,-0.47,-0.49,108.37,-12.24,True,1,10955,-95.1,-404356.87,1041820.5,637463.63
1971-10-26,94.74,-0.36,-0.38,108.37,-12.58,True,1,10956,-94.74,-404451.61,1037971.44,633519.83
1971-10-27,93.79,-0.95,-1.0,108.37,-13.45,True,1,10957,-93.79,-404545.4,1027657.03,623111.63
1971-10-28,93.96,0.17,0.18,108.37,-13.3,True,1,10958,-93.96,-404639.36,1029613.68,624974.32
1971-10-29,94.23,0.27,0.29,108.37,-13.05,True,1,10959,-94.23,-404733.59,1032666.57,627932.98
1971-11-01,92.8,-1.43,-1.52,108.37,-14.37,True,1,10960,-92.8,-404826.39,1017088.0,612261.61
1971-11-02,93.18,0.38,0.41,108.37,-14.02,True,1,10961,-93.18,-404919.57,1021345.98,616426.41
1971-11-03,94.91,1.73,1.86,108.37,-12.42,True,1,10962,-94.91,-405014.48,1040403.42,635388.94
1971-11-04,94.79,-0.12,-0.13,108.37,-12.53,True,1,10963,-94.79,-405109.27,1039182.77,634073.5
1971-11-05,94.46,-0.33,-0.35,108.37,-12.84,True,1,10964,-94.46,-405203.73,1035659.44,630455.71
1971-11-08,94.39,-0.07,-0.07,108.37,-12.9,True,1,10965,-94.39,-405298.12,1034986.35,629688.23
1971-11-09,94.46,0.07,0.07,108.37,-12.84,True,1,10966,-94.46,-405392.58,1035848.36,630455.78
1971-11-10,93.41,-1.05,-1.11,108.37,-13.8,True,1,10967,-93.41,-405485.99,1024427.47,618941.48
1971-11-11,92.12,-1.29,-1.38,108.37,-15.0,True,1,10968,-92.12,-405578.11,1010372.16,604794.05
1971-11-12,92.12,0.0,0.0,108.37,-15.0,True,1,10969,-92.12,-405670.23,1010464.28,604794.05
1971-11-15,91.81,-0.31,-0.34,108.37,-15.28,True,1,10970,-91.81,-405762.04,1007155.7,601393.66
1971-11-16,92.71,0.9,0.98,108.37,-14.45,True,1,10971,-92.71,-405854.75,1017121.41,611266.66
1971-11-17,92.85,0.14,0.15,108.37,-14.32,True,1,10972,-92.85,-405947.6,1018750.2,612802.6
1971-11-18,92.13,-0.72,-0.78,108.37,-14.99,True,1,10973,-92.13,-406039.73,1010942.49,604902.76
1971-11-19,91.61,-0.52,-0.56,108.37,-15.47,True,1,10974,-91.61,-406131.34,1005328.14,599196.8
1971-11-22,90.79,-0.82,-0.9,108.37,-16.22,True,1,10975,-90.79,-406222.13,996420.25,590198.12
1971-11-23,90.16,-0.63,-0.69,108.37,-16.8,True,1,10976,-90.16,-406312.29,989596.16,583283.87
1971-11-24,90.33,0.17,0.19,108.37,-16.65,True,1,10977,-90.33,-406402.62,991552.41,585149.79
1971-11-26,91.94,1.61,1.78,108.37,-15.16,True,1,10978,-91.94,-406494.56,1009317.32,602822.76
1971-11-29,93.41,1.47,1.6,108.37,-13.8,True,1,10979,-93.41,-406587.97,1025548.39,618960.42
1971-11-30,93.99,0.58,0.62,108.37,-13.27,True,1,10980,-93.99,-406681.96,1032010.2,625328.24
1971-12-01,95.44,1.45,1.54,108.37,-11.93,True,1,10981,-95.44,-406777.4,1048026.64,641249.24
1971-12-02,95.84,0.4,0.42,108.37,-11.56,True,1,10982,-95.84,-406873.24,1052514.88,645641.64
1971-12-03,97.06,1.22,1.27,108.37,-10.44,True,1,10983,-97.06,-406970.3,1066009.98,659039.68
1971-12-06,96.51,-0.55,-0.57,108.37,-10.94,True,1,10984,-96.51,-407066.81,1060065.84,652999.03
1971-12-07,96.87,0.36,0.37,108.37,-10.61,True,1,10985,-96.87,-407163.68,1064116.95,656953.27
1971-12-08,96.92,0.05,0.05,108.37,-10.57,True,1,10986,-96.92,-407260.6,1064763.12,657502.52
1971-12-09,96.96,0.04,0.04,108.37,-10.53,True,1,10987,-96.96,-407357.56,1065299.52,657941.96
1971-12-10,97.69,0.73,0.75,108.37,-9.86,True,1,10988,-97.69,-407455.25,1073417.72,665962.47
1971-12-13,97.97,0.28,0.29,108.37,-9.6,True,1,10989,-97.97,-407553.22,1076592.33,669039.11
1971-12-14,97.67,-0.3,-0.31,108.37,-9.87,True,1,10990,-97.67,-407650.89,1073393.3,665742.41
1971-12-15,98.54,0.87,0.89,108.37,-9.07,True,1,10991,-98.54,-407749.43,1083053.14,675303.71
1971-12-16,99.74,1.2,1.22,108.37,-7.96,True,1,10992,-99.74,-407849.17,1096342.08,688492.91
1971-12-17,100.26,0.52,0.52,108.37,-7.48,True,1,10993,-100.26,-407949.43,1102158.18,694208.75
1971-12-20,101.55,1.29,1.29,108.37,-6.29,True,1,10994,-101.55,-408050.98,1116440.7,708389.72
1971-12-21,101.8,0.25,0.25,108.37,-6.06,True,1,10995,-101.8,-408152.78,1119291.0,711138.22
1971-12-22,101.18,-0.62,-0.61,108.37,-6.64,True,1,10996,-101.18,-408253.96,1112575.28,704321.32
1971-12-23,100.74,-0.44,-0.44,108.37,-7.04,True,1,10997,-100.74,-408354.7,1107837.78,699483.08
1971-12-27,100.95,0.21,0.21,108.37,-6.85,True,1,10998,-100.95,-408455.65,1110248.1,701792.45
1971-12-28,101.95,1.0,0.99,108.37,-5.92,True,1,10999,-101.95,-408557.6,1121348.05,712790.45
1971-12-29,102.21,0.26,0.26,108.37,-5.68,True,1,11000,-102.21,-408659.81,1124310.0,715650.19
1971-12-30,101.78,-0.43,-0.42,108.37,-6.08,True,1,11001,-101.78,-408761.59,1119681.78,710920.19
1971-12-31,102.09,0.31,0.3,108.37,-5.8,True,1,11002,-102.09,-408863.68,1123194.18,714330.5
1972-01-03,101.67,-0.42,-0.41,108.37,-6.18,True,1,11003,-101.67,-408965.35,1118675.01,709709.66
1972-01-04,102.09,0.42,0.41,108.37,-5.8,True,1,11004,-102.09,-409067.44,1123398.36,714330.92
1972-01-05,103.06,0.97,0.95,108.37,-4.9,True,1,11005,-103.06,-409170.5,1134175.3,725004.8
1972-01-06,103.51,0.45,0.44,108.37,-4.49,True,1,11006,-103.51,-409274.01,1139231.06,729957.05
1972-01-07,103.47,-0.04,-0.04,108.37,-4.52,True,1,11007,-103.47,-409377.48,1138894.29,729516.81
1972-01-10,103.32,-0.15,-0.14,108.37,-4.66,True,1,11008,-103.32,-409480.8,1137346.56,727865.76
1972-01-11,103.65,0.33,0.32,108.37,-4.36,True,1,11009,-103.65,-409584.45,1141082.85,731498.4
1972-01-12,103.59,-0.06,-0.06,108.37,-4.41,True,1,11010,-103.59,-409688.04,1140525.9,730837.86
1972-01-13,102.99,-0.6,-0.58,108.37,-4.96,True,1,11011,-102.99,-409791.03,1134022.89,724231.86
1972-01-14,103.39,0.4,0.39,108.37,-4.6,True,1,11012,-103.39,-409894.42,1138530.68,728636.26
1972-01-17,103.7,0.31,0.3,108.37,-4.31,True,1,11013,-103.7,-409998.12,1142048.1,732049.98
1972-01-18,104.05,0.35,0.34,108.37,-3.99,True,1,11014,-104.05,-410102.17,1146006.7,735904.53
1972-01-19,103.88,-0.17,-0.16,108.37,-4.14,True,1,11015,-103.88,-410206.05,1144238.2,734032.15
1972-01-20,103.88,0.0,0.0,108.37,-4.14,True,1,11016,-103.88,-410309.93,1144342.08,734032.15
1972-01-21,103.65,-0.23,-0.22,108.37,-4.36,True,1,11017,-103.65,-410413.58,1141912.05,731498.47
1972-01-24,102.57,-1.08,-1.04,108.37,-5.35,True,1,11018,-102.57,-410516.15,1130116.26,719600.11
1972-01-25,102.7,0.13,0.13,108.37,-5.23,True,1,11019,-102.7,-410618.85,1131651.3,721032.45
1972-01-26,102.5,-0.2,-0.2,108.37,-5.42,True,1,11020,-102.5,-410721.35,1129550.0,718828.65
1972-01-27,103.5,1.0,0.98,108.37,-4.49,True,1,11021,-103.5,-410824.85,1140673.5,729848.65
1972-01-28,104.16,0.66,0.64,108.37,-3.88,True,1,11022,-104.16,-410929.01,1148051.52,737122.51
1972-01-31,103.94,-0.22,-0.21,108.37,-4.09,True,1,11023,-103.94,-411032.95,1145730.62,734697.67
1972-02-01,104.01,0.07,0.07,108.37,-4.02,True,1,11024,-104.01,-411136.96,1146606.24,735469.28
1972-02-02,104.68,0.67,0.64,108.37,-3.4,True,1,11025,-104.68,-411241.64,1154097.0,742855.36
1972-02-03,104.64,-0.04,-0.04,108.37,-3.44,True,1,11026,-104.64,-411346.28,1153760.64,742414.36
1972-02-04,104.86,0.22,0.21,108.37,-3.24,True,1,11027,-104.86,-411451.14,1156291.22,744840.08
1972-02-07,104.54,-0.32,-0.3,108.37,-3.53,True,1,11028,-104.54,-411555.68,1152867.12,741311.44
1972-02-08,104.74,0.2,0.19,108.37,-3.35,True,1,11029,-104.74,-411660.42,1155177.46,743517.04
1972-02-09,105.55,0.81,0.77,108.37,-2.6,True,1,11030,-105.55,-411765.97,1164216.5,752450.53
1972-02-10,105.59,0.04,0.04,108.37,-2.56,True,1,11031,-105.59,-411871.56,1164763.29,752891.73
1972-02-11,105.08,-0.51,-0.48,108.37,-3.04,True,1,11032,-105.08,-411976.64,1159242.56,747265.92
1972-02-14,104.59,-0.49,-0.47,108.37,-3.49,True,1,11033,-104.59,-412081.23,1153941.47,741860.24
1972-02-15,105.03,0.44,0.42,108.37,-3.08,True,1,11034,-105.03,-412186.26,1158901.02,746714.76
1972-02-16,105.62,0.59,0.56,108.37,-2.54,True,1,11035,-105.62,-412291.88,1165516.7,753224.82
1972-02-17,105.59,-0.03,-0.03,108.37,-2.56,True,1,11036,-105.59,-412397.47,1165291.24,752893.77
1972-02-18,105.28,-0.31,-0.29,108.37,-2.85,True,1,11037,-105.28,-412502.75,1161975.36,749472.61
1972-02-22,105.29,0.01,0.01,108.37,-2.84,True,1,11038,-105.29,-412608.04,1162191.02,749582.98
1972-02-23,105.38,0.09,0.08,108.37,-2.76,True,1,11039,-105.38,-412713.42,1163289.82,750576.4
1972-02-24,105.45,0.07,0.07,108.37,-2.69,True,1,11040,-105.45,-412818.87,1164168.0,751349.13
1972-02-25,106.18,0.73,0.69,108.37,-2.02,True,1,11041,-106.18,-412925.05,1172333.38,759408.33
1972-02-28,106.19,0.01,0.01,108.37,-2.01,True,1,11042,-106.19,-413031.24,1172549.98,759518.74
1972-02-29,106.57,0.38,0.36,108.37,-1.66,True,1,11043,-106.57,-413137.81,1176852.51,763714.7
1972-03-01,107.35,0.78,0.73,108.37,-0.94,True,1,11044,-107.35,-413245.16,1185573.4,772328.24
1972-03-02,107.32,-0.03,-0.03,108.37,-0.97,True,1,11045,-107.32,-413352.48,1185349.4,771996.92
1972-03-03,107.94,0.62,0.58,108.37,-0.4,True,1,11046,-107.94,-413460.42,1192305.24,778844.82
1972-03-06,108.77,0.83,0.77,108.77,0.0,True,1,11047,-108.77,-413569.19,1201582.19,788013.0
1972-03-07,108.87,0.1,0.09,108.87,0.0,True,1,11048,-108.87,-413678.06,1202795.76,789117.7
1972-03-08,108.96,0.09,0.08,108.96,0.0,True,1,11049,-108.96,-413787.02,1203899.04,790112.02
1972-03-09,108.94,-0.02,-0.02,108.96,-0.02,True,1,11050,-108.94,-413895.96,1203787.0,789891.04
1972-03-10,108.38,-0.56,-0.51,108.96,-0.53,True,1,11051,-108.38,-414004.34,1197707.38,783703.04
1972-03-13,107.33,-1.05,-0.97,108.96,-1.5,True,1,11052,-107.33,-414111.67,1186211.16,772099.49
1972-03-14,107.61,0.28,0.26,108.96,-1.24,True,1,11053,-107.61,-414219.28,1189413.33,775194.05
1972-03-15,107.75,0.14,0.13,108.96,-1.11,True,1,11054,-107.75,-414327.03,1191068.5,776741.47
1972-03-16,107.5,-0.25,-0.23,108.96,-1.34,True,1,11055,-107.5,-414434.53,1188412.5,773977.97
1972-03-17,107.92,0.42,0.39,108.96,-0.95,True,1,11056,-107.92,-414542.45,1193163.52,778621.07
1972-03-20,107.59,-0.33,-0.31,108.96,-1.26,True,1,11057,-107.59,-414650.04,1189622.63,774972.59
1972-03-21,106.69,-0.9,-0.84,108.96,-2.08,True,1,11058,-106.69,-414756.73,1179778.02,765021.29
1972-03-22,106.84,0.15,0.14,108.96,-1.95,True,1,11059,-106.84,-414863.57,1181543.56,766679.99
1972-03-23,107.75,0.91,0.85,108.96,-1.11,True,1,11060,-107.75,-414971.32,1191715.0,776743.68
1972-03-24,107.52,-0.23,-0.21,108.96,-1.32,True,1,11061,-107.52,-415078.84,1189278.72,774199.88
1972-03-27,107.3,-0.22,-0.2,108.96,-1.52,True,1,11062,-107.3,-415186.14,1186952.6,771766.46
1972-03-28,107.17,-0.13,-0.12,108.96,-1.64,True,1,11063,-107.17,-415293.31,1185621.71,770328.4
1972-03-29,106.49,-0.68,-0.64,108.96,-2.27,True,1,11064,-106.49,-415399.8,1178205.36,762805.56
1972-03-30,107.2,0.71,0.67,108.96,-1.62,True,1,11065,-107.2,-415507.0,1186168.0,770661.0
1972-04-03,107.48,0.28,0.26,108.96,-1.36,True,1,11066,-107.48,-415614.48,1189373.68,773759.2
1972-04-04,108.12,0.64,0.6,108.96,-0.77,True,1,11067,-108.12,-415722.6,1196564.04,780841.44
1972-04-05,109.0,0.88,0.81,109.0,0.0,True,1,11068,-109.0,-415831.6,1206412.0,790580.4
1972-04-06,109.53,0.53,0.49,109.53,0.0,True,1,11069,-109.53,-415941.13,1212387.57,796446.44
1972-04-07,109.62,0.09,0.08,109.62,0.0,True,1,11070,-109.62,-416050.75,1213493.4,797442.65
1972-04-10,109.45,-0.17,-0.16,109.62,-0.16,True,1,11071,-109.45,-416160.2,1211720.95,795560.75
1972-04-11,109.76,0.31,0.28,109.76,0.0,True,1,11072,-109.76,-416269.96,1215262.72,798992.76
1972-04-12,110.18,0.42,0.38,110.18,0.0,True,1,11073,-110.18,-416380.14,1220023.14,803643.0
1972-04-13,109.91,-0.27,-0.24,110.18,-0.24,True,1,11074,-109.91,-416490.05,1217143.34,800653.29
1972-04-14,109.84,-0.07,-0.06,110.18,-0.31,True,1,11075,-109.84,-416599.89,1216478.0,799878.11
1972-04-17,109.51,-0.33,-0.3,110.18,-0.61,True,1,11076,-109.51,-416709.4,1212932.76,796223.36
1972-04-18,109.77,0.26,0.24,110.18,-0.37,True,1,11077,-109.77,-416819.17,1215922.29,799103.12
1972-04-19,109.2,-0.57,-0.52,110.18,-0.89,True,1,11078,-109.2,-416928.37,1209717.6,792789.23
1972-04-20,109.04,-0.16,-0.15,110.18,-1.03,True,1,11079,-109.04,-417037.41,1208054.16,791016.75
1972-04-21,108.89,-0.15,-0.14,110.18,-1.17,True,1,11080,-108.89,-417146.3,1206501.2,789354.9
1972-04-24,108.19,-0.7,-0.64,110.18,-1.81,True,1,11081,-108.19,-417254.49,1198853.39,781598.9
1972-04-25,107.12,-1.07,-0.99,110.18,-2.78,True,1,11082,-107.12,-417361.61,1187103.84,769742.23
1972-04-26,106.89,-0.23,-0.22,110.18,-2.99,True,1,11083,-106.89,-417468.5,1184661.87,767193.37
1972-04-27,107.05,0.16,0.15,110.18,-2.84,True,1,11084,-107.05,-417575.55,1186542.2,768966.65
1972-04-28,107.67,0.62,0.58,110.18,-2.28,True,1,11085,-107.67,-417683.22,1193521.95,775838.73
1972-05-01,106.69,-0.98,-0.91,110.18,-3.17,True,1,11086,-106.69,-417789.91,1182765.34,764975.43
1972-05-02,106.08,-0.61,-0.57,110.18,-3.72,True,1,11087,-106.08,-417895.99,1176108.96,758212.97
1972-05-03,105.99,-0.09,-0.08,110.18,-3.8,True,1,11088,-105.99,-418001.98,1175217.12,757215.14
1972-05-04,106.25,0.26,0.24,110.18,-3.57,True,1,11089,-106.25,-418108.23,1178206.25,760098.02
1972-05-05,106.63,0.38,0.36,110.18,-3.22,True,1,11090,-106.63,-418214.86,1182526.7,764311.84
1972-05-08,106.14,-0.49,-0.46,110.18,-3.67,True,1,11091,-106.14,-418321.0,1177198.74,758877.74
1972-05-09,104.74,-1.4,-1.32,110.18,-4.94,True,1,11092,-104.74,-418425.74,1161776.08,743350.34
1972-05-10,105.42,0.68,0.65,110.18,-4.32,True,1,11093,-105.42,-418531.16,1169424.06,750892.9
1972-05-11,105.77,0.35,0.33,110.18,-4.0,True,1,11094,-105.77,-418636.93,1173412.38,754775.45
1972-05-12,106.38,0.61,0.58,110.18,-3.45,True,1,11095,-106.38,-418743.31,1180286.1,761542.79
1972-05-15,106.86,0.48,0.45,110.18,-3.01,True,1,11096,-106.86,-418850.17,1185718.56,766868.39
1972-05-16,106.66,-0.2,-0.19,110.18,-3.2,True,1,11097,-106.66,-418956.83,1183606.02,764649.19
1972-05-17,106.89,0.23,0.22,110.18,-2.99,True,1,11098,-106.89,-419063.72,1186265.22,767201.5
1972-05-18,107.94,1.05,0.98,110.18,-2.03,True,1,11099,-107.94,-419171.66,1198026.06,778854.4
1972-05-19,108.98,1.04,0.96,110.18,-1.09,True,1,11100,-108.98,-419280.64,1209678.0,790397.36
1972-05-22,109.69,0.71,0.65,110.18,-0.44,True,1,11101,-109.69,-419390.33,1217668.69,798278.36
1972-05-23,109.78,0.09,0.08,110.18,-0.36,True,1,11102,-109.78,-419500.11,1218777.56,799277.45
1972-05-24,110.31,0.53,0.48,110.31,0.0,True,1,11103,-110.31,-419610.42,1224771.93,805161.51
1972-05-25,110.46,0.15,0.14,110.46,0.0,True,1,11104,-110.46,-419720.88,1226547.84,806826.96
1972-05-26,110.66,0.2,0.18,110.66,0.0,True,1,11105,-110.66,-419831.54,1228879.3,809047.76
1972-05-30,110.35,-0.31,-0.28,110.66,-0.28,True,1,11106,-110.35,-419941.89,1225547.1,805605.21
1972-05-31,109.53,-0.82,-0.74,110.66,-1.02,True,1,11107,-109.53,-420051.42,1216549.71,796498.29
1972-06-01,109.69,0.16,0.15,110.66,-0.88,True,1,11108,-109.69,-420161.11,1218436.52,798275.41
1972-06-02,109.73,0.04,0.04,110.66,-0.84,True,1,11109,-109.73,-420270.84,1218990.57,798719.73
1972-06-05,108.82,-0.91,-0.83,110.66,-1.66,True,1,11110,-108.82,-420379.66,1208990.2,788610.54
1972-06-06,108.21,-0.61,-0.56,110.66,-2.21,True,1,11111,-108.21,-420487.87,1202321.31,781833.44
1972-06-07,107.65,-0.56,-0.52,110.66,-2.72,True,1,11112,-107.65,-420595.52,1196206.8,775611.28
1972-06-08,107.28,-0.37,-0.34,110.66,-3.05,True,1,11113,-107.28,-420702.8,1192202.64,771499.84
1972-06-09,106.86,-0.42,-0.39,110.66,-3.43,True,1,11114,-106.86,-420809.66,1187642.04,766832.38
1972-06-12,107.01,0.15,0.14,110.66,-3.3,True,1,11115,-107.01,-420916.67,1189416.15,768499.48
1972-06-13,107.55,0.54,0.5,110.66,-2.81,True,1,11116,-107.55,-421024.22,1195525.8,774501.58
1972-06-14,108.39,0.84,0.78,110.66,-2.05,True,1,11117,-108.39,-421132.61,1204971.63,783839.02
1972-06-15,108.44,0.05,0.05,110.66,-2.01,True,1,11118,-108.44,-421241.05,1205635.92,784394.87
1972-06-16,108.36,-0.08,-0.07,110.66,-2.08,True,1,11119,-108.36,-421349.41,1204854.84,783505.43
1972-06-19,108.11,-0.25,-0.23,110.66,-2.3,True,1,11120,-108.11,-421457.52,1202183.2,780725.68
1972-06-20,108.56,0.45,0.42,110.66,-1.9,True,1,11121,-108.56,-421566.08,1207295.76,785729.68
1972-06-21,108.79,0.23,0.21,110.66,-1.69,True,1,11122,-108.79,-421674.87,1209962.38,788287.51
1972-06-22,108.68,-0.11,-0.1,110.66,-1.79,True,1,11123,-108.68,-421783.55,1208847.64,787064.09
1972-06-23,108.27,-0.41,-0.38,110.66,-2.16,True,1,11124,-108.27,-421891.82,1204395.48,782503.66
1972-06-26,107.48,-0.79,-0.73,110.66,-2.87,True,1,11125,-107.48,-421999.3,1195715.0,773715.7
1972-06-27,107.37,-0.11,-0.1,110.66,-2.97,True,1,11126,-107.37,-422106.67,1194598.62,772491.95
1972-06-28,107.02,-0.35,-0.33,110.66,-3.29,True,1,11127,-107.02,-422213.69,1190811.54,768597.85
1972-06-29,106.82,-0.2,-0.19,110.66,-3.47,True,1,11128,-106.82,-422320.51,1188692.96,766372.45
1972-06-30,107.14,0.32,0.3,110.66,-3.18,True,1,11129,-107.14,-422427.65,1192361.06,769933.41
1972-07-03,107.49,0.35,0.33,110.66,-2.86,True,1,11130,-107.49,-422535.14,1196363.7,773828.56
1972-07-05,108.1,0.61,0.57,110.66,-2.31,True,1,11131,-108.1,-422643.24,1203261.1,780617.86
1972-07-06,109.04,0.94,0.87,110.66,-1.46,True,1,11132,-109.04,-422752.28,1213833.28,791081.0
1972-07-07,108.69,-0.35,-0.32,110.66,-1.78,True,1,11133,-108.69,-422860.97,1210045.77,787184.8
1972-07-10,108.11,-0.58,-0.53,110.66,-2.3,True,1,11134,-108.11,-422969.08,1203696.74,780727.66
1972-07-11,107.32,-0.79,-0.73,110.66,-3.02,True,1,11135,-107.32,-423076.4,1195008.2,771931.8
1972-07-12,106.89,-0.43,-0.4,110.66,-3.41,True,1,11136,-106.89,-423183.29,1190327.04,767143.75
1972-07-13,106.28,-0.61,-0.57,110.66,-3.96,True,1,11137,-106.28,-423289.57,1183640.36,760350.79
1972-07-14,106.8,0.52,0.49,110.66,-3.49,True,1,11138,-106.8,-423396.37,1189538.4,766142.03
1972-07-17,105.88,-0.92,-0.86,110.66,-4.32,True,1,11139,-105.88,-423502.25,1179397.32,755895.07
1972-07-18,105.83,-0.05,-0.05,110.66,-4.36,True,1,11140,-105.83,-423608.08,1178946.2,755338.12
1972-07-19,106.14,0.31,0.29,110.66,-4.08,True,1,11141,-106.14,-423714.22,1182505.74,758791.52
1972-07-20,105.81,-0.33,-0.31,110.66,-4.38,True,1,11142,-105.81,-423820.03,1178935.02,755114.99
1972-07-21,106.66,0.85,0.8,110.66,-3.62,True,1,11143,-106.66,-423926.69,1188512.38,764585.69
1972-07-24,107.92,1.26,1.18,110.66,-2.48,True,1,11144,-107.92,-424034.61,1202660.48,778625.87
1972-07-25,107.6,-0.32,-0.3,110.66,-2.76,True,1,11145,-107.6,-424142.21,1199202.0,775059.79
1972-07-26,107.53,-0.07,-0.06,110.66,-2.83,True,1,11146,-107.53,-424249.74,1198529.38,774279.64
1972-07-27,107.28,-0.25,-0.23,110.66,-3.05,True,1,11147,-107.28,-424357.02,1195850.16,771493.14
1972-07-28,107.38,0.1,0.09,110.66,-2.96,True,1,11148,-107.38,-424464.4,1197072.24,772607.84
1972-07-31,107.39,0.01,0.01,110.66,-2.96,True,1,11149,-107.39,-424571.79,1197291.11,772719.32
1972-08-01,108.4,1.01,0.94,110.66,-2.04,True,1,11150,-108.4,-424680.19,1208660.0,783979.81
1972-08-02,109.29,0.89,0.82,110.66,-1.24,True,1,11151,-109.29,-424789.48,1218692.79,793903.31
1972-08-03,110.14,0.85,0.78,110.66,-0.47,True,1,11152,-110.14,-424899.62,1228281.28,803381.66
1972-08-04,110.43,0.29,0.26,110.66,-0.21,True,1,11153,-110.43,-425010.05,1231625.79,806615.74
1972-08-07,110.61,0.18,0.16,110.66,-0.04,True,1,11154,-110.61,-425120.66,1233743.94,808623.28
1972-08-08,110.69,0.08,0.07,110.69,0.0,True,1,11155,-110.69,-425231.35,1234746.95,809515.6
1972-08-09,110.86,0.17,0.15,110.86,0.0,True,1,11156,-110.86,-425342.21,1236754.16,811411.95
1972-08-10,111.05,0.19,0.17,111.05,0.0,True,1,11157,-111.05,-425453.26,1238984.85,813531.59
1972-08-11,111.95,0.9,0.81,111.95,0.0,True,1,11158,-111.95,-425565.21,1249138.1,823572.89
1972-08-14,112.55,0.6,0.54,112.55,0.0,True,1,11159,-112.55,-425677.76,1255945.45,830267.69
1972-08-15,112.06,-0.49,-0.44,112.55,-0.44,True,1,11160,-112.06,-425789.82,1250589.6,824799.78
1972-08-16,111.66,-0.4,-0.36,112.55,-0.79,True,1,11161,-111.66,-425901.48,1246237.26,820335.78
1972-08-17,111.34,-0.32,-0.29,112.55,-1.08,True,1,11162,-111.34,-426012.82,1242777.08,816764.26
1972-08-18,111.76,0.42,0.38,112.55,-0.7,True,1,11163,-111.76,-426124.58,1247576.88,821452.3
1972-08-21,111.72,-0.04,-0.04,112.55,-0.74,True,1,11164,-111.72,-426236.3,1247242.08,821005.78
1972-08-22,112.41,0.69,0.62,112.55,-0.12,True,1,11165,-112.41,-426348.71,1255057.65,828708.94
1972-08-23,112.26,-0.15,-0.13,112.55,-0.26,True,1,11166,-112.26,-426460.97,1253495.16,827034.19
1972-08-24,111.02,-1.24,-1.1,112.55,-1.36,True,1,11167,-111.02,-426571.99,1239760.34,813188.35
1972-08-25,110.67,-0.35,-0.32,112.55,-1.67,True,1,11168,-110.67,-426682.66,1235962.56,809279.9
1972-08-28,110.23,-0.44,-0.4,112.55,-2.06,True,1,11169,-110.23,-426792.89,1231158.87,804365.98
1972-08-29,110.41,0.18,0.16,112.55,-1.9,True,1,11170,-110.41,-426903.3,1233279.7,806376.4
1972-08-30,110.57,0.16,0.14,112.55,-1.76,True,1,11171,-110.57,-427013.87,1235177.47,808163.6
1972-08-31,111.09,0.52,0.47,112.55,-1.3,True,1,11172,-111.09,-427124.96,1241097.48,813972.52
1972-09-01,111.51,0.42,0.38,112.55,-0.92,True,1,11173,-111.51,-427236.47,1245901.23,818664.76
1972-09-05,111.23,-0.28,-0.25,112.55,-1.17,True,1,11174,-111.23,-427347.7,1242884.02,815536.32
1972-09-06,110.55,-0.68,-0.61,112.55,-1.78,True,1,11175,-110.55,-427458.25,1235396.25,807938.0
1972-09-07,110.29,-0.26,-0.24,112.55,-2.01,True,1,11176,-110.29,-427568.54,1232601.04,805032.5
1972-09-08,110.15,-0.14,-0.13,112.55,-2.13,True,1,11177,-110.15,-427678.69,1231146.55,803467.86
1972-09-11,109.51,-0.64,-0.58,112.55,-2.7,True,1,11178,-109.51,-427788.2,1224102.78,796314.58
1972-09-12,108.47,-1.04,-0.95,112.55,-3.62,True,1,11179,-108.47,-427896.67,1212586.13,784689.46
1972-09-13,108.9,0.43,0.4,112.55,-3.24,True,1,11180,-108.9,-428005.57,1217502.0,789496.43
1972-09-14,108.93,0.03,0.03,112.55,-3.22,True,1,11181,-108.93,-428114.5,1217946.33,789831.83
1972-09-15,108.81,-0.12,-0.11,112.55,-3.32,True,1,11182,-108.81,-428223.31,1216713.42,788490.11
1972-09-18,108.61,-0.2,-0.18,112.55,-3.5,True,1,11183,-108.61,-428331.92,1214585.63,786253.71
1972-09-19,108.55,-0.06,-0.06,112.55,-3.55,True,1,11184,-108.55,-428440.47,1214023.2,785582.73
1972-09-20,108.6,0.05,0.05,112.55,-3.51,True,1,11185,-108.6,-428549.07,1214691.0,786141.93
1972-09-21,108.43,-0.17,-0.16,112.55,-3.66,True,1,11186,-108.43,-428657.5,1212897.98,784240.48
1972-09-22,108.52,0.09,0.08,112.55,-3.58,True,1,11187,-108.52,-428766.02,1214013.24,785247.22
1972-09-25,108.05,-0.47,-0.43,112.55,-4.0,True,1,11188,-108.05,-428874.07,1208863.4,779989.33
1972-09-26,108.12,0.07,0.06,112.55,-3.94,True,1,11189,-108.12,-428982.19,1209754.68,780772.49
1972-09-27,109.66,1.54,1.42,112.55,-2.57,True,1,11190,-109.66,-429091.85,1227095.4,798003.55
1972-09-28,110.35,0.69,0.63,112.55,-1.96,True,1,11191,-110.35,-429202.2,1234926.85,805724.65
1972-09-29,110.55,0.2,0.18,112.55,-1.78,True,1,11192,-110.55,-429312.75,1237275.6,807962.85
1972-10-02,110.16,-0.39,-0.35,112.55,-2.12,True,1,11193,-110.16,-429422.91,1233020.88,803597.97
1972-10-03,110.3,0.14,0.13,112.55,-2.0,True,1,11194,-110.3,-429533.21,1234698.2,805164.99
1972-10-04,110.09,-0.21,-0.19,112.55,-2.19,True,1,11195,-110.09,-429643.3,1232457.55,802814.25
1972-10-05,108.89,-1.2,-1.09,112.55,-3.25,True,1,11196,-108.89,-429752.19,1219132.44,789380.25
1972-10-06,109.62,0.73,0.67,112.55,-2.6,True,1,11197,-109.62,-429861.81,1227415.14,797553.33
1972-10-09,109.9,0.28,0.26,112.55,-2.36,True,1,11198,-109.9,-429971.71,1230660.2,800688.49
1972-10-10,109.99,0.09,0.08,112.55,-2.28,True,1,11199,-109.99,-430081.7,1231778.01,801696.31
1972-10-11,109.5,-0.49,-0.44,112.55,-2.71,True,1,11200,-109.5,-430191.2,1226400.0,796208.8
1972-10-12,108.6,-0.9,-0.82,112.55,-3.51,True,1,11201,-108.6,-430299.8,1216428.6,786128.8
1972-10-13,107.92,-0.68,-0.63,112.55,-4.11,True,1,11202,-107.92,-430407.72,1208919.84,778512.12
1972-10-16,106.77,-1.15,-1.07,112.55,-5.14,True,1,11203,-106.77,-430514.49,1196144.31,765629.82
1972-10-17,107.5,0.73,0.68,112.55,-4.49,True,1,11204,-107.5,-430621.99,1204430.0,773808.01
1972-10-18,108.19,0.69,0.64,112.55,-3.87,True,1,11205,-108.19,-430730.18,1212268.95,781538.77
1972-10-19,108.05,-0.14,-0.13,112.55,-4.0,True,1,11206,-108.05,-430838.23,1210808.3,779970.07
1972-10-20,109.24,1.19,1.1,112.55,-2.94,True,1,11207,-109.24,-430947.47,1224252.68,793305.21
1972-10-23,110.35,1.11,1.02,112.55,-1.96,True,1,11208,-110.35,-431057.82,1236802.8,805744.98
1972-10-24,110.81,0.46,0.42,112.55,-1.55,True,1,11209,-110.81,-431168.63,1242069.29,810900.66
1972-10-25,110.72,-0.09,-0.08,112.55,-1.63,True,1,11210,-110.72,-431279.35,1241171.2,809891.85
1972-10-26,110.99,0.27,0.24,112.55,-1.39,True,1,11211,-110.99,-431390.34,1244308.89,812918.55
1972-10-27,110.62,-0.37,-0.33,112.55,-1.72,True,1,11212,-110.62,-431500.96,1240271.44,808770.48
1972-10-30,110.59,-0.03,-0.03,112.55,-1.74,True,1,11213,-110.59,-431611.55,1240045.67,808434.12
1972-10-31,111.58,0.99,0.9,112.55,-0.86,True,1,11214,-111.58,-431723.13,1251258.12,819534.99
1972-11-01,112.67,1.09,0.98,112.67,0.0,True,1,11215,-112.67,-431835.8,1263594.05,831758.25
1972-11-02,113.23,0.56,0.5,113.23,0.0,True,1,11216,-113.23,-431949.03,1269987.68,838038.65
1972-11-03,114.22,0.99,0.87,114.22,0.0,True,1,11217,-114.22,-432063.25,1281205.74,849142.49
1972-11-06,113.98,-0.24,-0.21,114.22,-0.21,True,1,11218,-113.98,-432177.23,1278627.64,846450.41
1972-11-08,113.35,-0.63,-0.55,114.22,-0.76,True,1,11219,-113.35,-432290.58,1271673.65,839383.07
1972-11-09,113.5,0.15,0.13,114.22,-0.63,True,1,11220,-113.5,-432404.08,1273470.0,841065.92
1972-11-10,113.73,0.23,0.2,114.22,-0.43,True,1,11221,-113.73,-432517.81,1276164.33,843646.52
1972-11-13,113.9,0.17,0.15,114.22,-0.28,True,1,11222,-113.9,-432631.71,1278185.8,845554.09
1972-11-14,114.95,1.05,0.92,114.95,0.0,True,1,11223,-114.95,-432746.66,1290083.85,857337.19
1972-11-15,114.5,-0.45,-0.39,114.95,-0.39,True,1,11224,-114.5,-432861.16,1285148.0,852286.84
1972-11-16,115.13,0.63,0.55,115.13,0.0,True,1,11225,-115.13,-432976.29,1292334.25,859357.96
1972-11-17,115.49,0.36,0.31,115.49,0.0,True,1,11226,-115.49,-433091.78,1296490.74,863398.96
1972-11-20,115.53,0.04,0.04,115.53,0.0,True,1,11227,-115.53,-433207.31,1297055.31,863848.0
1972-11-21,116.21,0.68,0.59,116.21,0.0,True,1,11228,-116.21,-433323.52,1304805.88,871482.36
1972-11-22,116.9,0.69,0.59,116.9,0.0,True,1,11229,-116.9,-433440.42,1312670.1,879229.68
1972-11-24,117.27,0.37,0.32,117.27,0.0,True,1,11230,-117.27,-433557.69,1316942.1,883384.41
1972-11-27,116.72,-0.55,-0.47,117.27,-0.47,True,1,11231,-116.72,-433674.41,1310882.32,877207.91
1972-11-28,116.47,-0.25,-0.21,117.27,-0.68,True,1,11232,-116.47,-433790.88,1308191.04,874400.16
1972-11-29,116.52,0.05,0.04,117.27,-0.64,True,1,11233,-116.52,-433907.4,1308869.16,874961.76
1972-11-30,116.67,0.15,0.13,117.27,-0.51,True,1,11234,-116.67,-434024.07,1310670.78,876646.71
1972-12-01,117.38,0.71,0.61,117.38,0.0,True,1,11235,-117.38,-434141.45,1318764.3,884622.85
1972-12-04,117.77,0.39,0.33,117.77,0.0,True,1,11236,-117.77,-434259.22,1323263.72,889004.5
1972-12-05,117.58,-0.19,-0.16,117.77,-0.16,True,1,11237,-117.58,-434376.8,1321246.46,886869.66
1972-12-06,118.01,0.43,0.37,118.01,0.0,True,1,11238,-118.01,-434494.81,1326196.38,891701.57
1972-12-07,118.6,0.59,0.5,118.6,0.0,True,1,11239,-118.6,-434613.41,1332945.4,898331.99
1972-12-08,118.86,0.26,0.22,118.86,0.0,True,1,11240,-118.86,-434732.27,1335986.4,901254.13
1972-12-11,119.12,0.26,0.22,119.12,0.0,True,1,11241,-119.12,-434851.39,1339027.92,904176.53
1972-12-12,118.66,-0.46,-0.39,119.12,-0.39,True,1,11242,-118.66,-434970.05,1333975.72,899005.67
1972-12-13,118.56,-0.1,-0.08,119.12,-0.47,True,1,11243,-118.56,-435088.61,1332970.08,897881.47
1972-12-14,118.24,-0.32,-0.27,119.12,-0.74,True,1,11244,-118.24,-435206.85,1329490.56,894283.71
1972-12-15,118.26,0.02,0.02,119.12,-0.72,True,1,11245,-118.26,-435325.11,1329833.7,894508.59
1972-12-18,116.9,-1.36,-1.15,119.12,-1.86,True,1,11246,-116.9,-435442.01,1314657.4,879215.39
1972-12-19,116.34,-0.56,-0.48,119.12,-2.33,True,1,11247,-116.34,-435558.35,1308475.98,872917.63
1972-12-20,115.95,-0.39,-0.34,119.12,-2.66,True,1,11248,-115.95,-435674.3,1304205.6,868531.3
1972-12-21,115.11,-0.84,-0.72,119.12,-3.37,True,1,11249,-115.11,-435789.41,1294872.39,859082.98
1972-12-22,115.83,0.72,0.62,119.12,-2.76,True,1,11250,-115.83,-435905.24,1303087.5,867182.26
1972-12-26,116.3,0.47,0.41,119.12,-2.37,True,1,11251,-116.3,-436021.54,1308491.3,872469.76
1972-12-27,116.93,0.63,0.54,119.12,-1.84,True,1,11252,-116.93,-436138.47,1315696.36,879557.89
1972-12-29,118.05,1.12,0.96,119.12,-0.9,True,1,11253,-118.05,-436256.52,1328416.65,892160.13
1973-01-02,119.1,1.05,0.89,119.12,-0.02,True,1,11254,-119.1,-436375.62,1340351.4,903975.78
1973-01-03,119.57,0.47,0.4,119.57,0.0,True,1,11255,-119.57,-436495.19,1345760.35,909265.16
1973-01-04,119.4,-0.17,-0.14,119.57,-0.14,True,1,11256,-119.4,-436614.59,1343966.4,907351.81
1973-01-05,119.87,0.47,0.39,119.87,0.0,True,1,11257,-119.87,-436734.46,1349376.59,912642.13
1973-01-08,119.85,-0.02,-0.02,119.87,-0.02,True,1,11258,-119.85,-436854.31,1349271.3,912416.99
1973-01-09,119.73,-0.12,-0.1,119.87,-0.12,True,1,11259,-119.73,-436974.04,1348040.07,911066.03
1973-01-10,119.43,-0.3,-0.25,119.87,-0.37,True,1,11260,-119.43,-437093.47,1344781.8,907688.33
1973-01-11,120.24,0.81,0.68,120.24,0.0,True,1,11261,-120.24,-437213.71,1354022.64,916808.93
1973-01-12,119.3,-0.94,-0.78,120.24,-0.78,True,1,11262,-119.3,-437333.01,1343556.6,906223.59
1973-01-15,118.44,-0.86,-0.72,120.24,-1.5,True,1,11263,-118.44,-437451.45,1333989.72,896538.27
1973-01-16,118.14,-0.3,-0.25,120.24,-1.75,True,1,11264,-118.14,-437569.59,1330728.96,893159.37
1973-01-17,118.68,0.54,0.46,120.24,-1.3,True,1,11265,-118.68,-437688.27,1336930.2,899241.93
1973-01-18,118.85,0.17,0.14,120.24,-1.16,True,1,11266,-118.85,-437807.12,1338964.1,901156.98
1973-01-19,118.78,-0.07,-0.06,120.24,-1.21,True,1,11267,-118.78,-437925.9,1338294.26,900368.36
1973-01-22,118.21,-0.57,-0.48,120.24,-1.69,True,1,11268,-118.21,-438044.11,1331990.28,893946.17
1973-01-23,118.22,0.01,0.01,120.24,-1.68,True,1,11269,-118.22,-438162.33,1332221.18,894058.85
1973-01-24,116.73,-1.49,-1.26,120.24,-2.92,True,1,11270,-116.73,-438279.06,1315547.1,877268.04
1973-01-26,116.45,-0.28,-0.24,120.24,-3.15,True,1,11271,-116.45,-438395.51,1312507.95,874112.44
1973-01-29,116.01,-0.44,-0.38,120.24,-3.52,True,1,11272,-116.01,-438511.52,1307664.72,869153.2
1973-01-30,115.83,-0.18,-0.16,120.24,-3.67,True,1,11273,-115.83,-438627.35,1305751.59,867124.24
1973-01-31,116.03,0.2,0.17,120.24,-3.5,True,1,11274,-116.03,-438743.38,1308122.22,869378.84
1973-02-01,114.76,-1.27,-1.1,120.24,-4.56,True,1,11275,-114.76,-438858.14,1293919.0,855060.86
1973-02-02,114.35,-0.41,-0.36,120.24,-4.9,True,1,11276,-114.35,-438972.49,1289410.6,850438.11
1973-02-05,114.23,-0.12,-0.1,120.24,-5.0,True,1,11277,-114.23,-439086.72,1288171.71,849084.99
1973-02-06,114.45,0.22,0.19,120.24,-4.82,True,1,11278,-114.45,-439201.17,1290767.1,851565.93
1973-02-07,113.66,-0.79,-0.69,120.24,-5.47,True,1,11279,-113.66,-439314.83,1281971.14,842656.31
1973-02-08,113.16,-0.5,-0.44,120.24,-5.89,True,1,11280,-113.16,-439427.99,1276444.8,837016.81
1973-02-09,114.68,1.52,1.34,120.24,-4.62,True,1,11281,-114.68,-439542.67,1293705.08,854162.41
1973-02-12,116.06,1.38,1.2,120.24,-3.48,True,1,11282,-116.06,-439658.73,1309388.92,869730.19
1973-02-13,116.78,0.72,0.62,120.24,-2.88,True,1,11283,-116.78,-439775.51,1317628.74,877853.23
1973-02-14,115.1,-1.68,-1.44,120.24,-4.28,True,1,11284,-115.1,-439890.61,1298788.4,858897.79
1973-02-15,114.45,-0.65,-0.56,120.24,-4.82,True,1,11285,-114.45,-440005.06,1291568.25,851563.19
1973-02-16,114.98,0.53,0.46,120.24,-4.38,True,1,11286,-114.98,-440120.04,1297664.28,857544.24
1973-02-20,115.4,0.42,0.36,120.24,-4.03,True,1,11287,-115.4,-440235.44,1302519.8,862284.36
1973-02-21,114.69,-0.71,-0.62,120.24,-4.62,True,1,11288,-114.69,-440350.13,1294620.72,854270.59
1973-02-22,114.44,-0.25,-0.22,120.24,-4.82,True,1,11289,-114.44,-440464.57,1291913.16,851448.59
1973-02-23,113.16,-1.28,-1.12,120.24,-5.89,True,1,11290,-113.16,-440577.73,1277576.4,836998.67
1973-02-26,112.19,-0.97,-0.86,120.24,-6.7,True,1,11291,-112.19,-440689.92,1266737.29,826047.37
1973-02-27,110.9,-1.29,-1.15,120.24,-7.77,True,1,11292,-110.9,-440800.82,1252282.8,811481.98
1973-02-28,111.68,0.78,0.7,120.24,-7.12,True,1,11293,-111.68,-440912.5,1261202.24,820289.74
1973-03-01,111.05,-0.63,-0.56,120.24,-7.64,True,1,11294,-111.05,-441023.55,1254198.7,813175.15
1973-03-02,112.28,1.23,1.11,120.24,-6.62,True,1,11295,-112.28,-441135.83,1268202.6,827066.77
1973-03-05,112.68,0.4,0.36,120.24,-6.29,True,1,11296,-112.68,-441248.51,1272833.28,831584.77
1973-03-06,114.1,1.42,1.26,120.24,-5.11,True,1,11297,-114.1,-441362.61,1288987.7,847625.09
1973-03-07,114.45,0.35,0.31,120.24,-4.82,True,1,11298,-114.45,-441477.06,1293056.1,851579.04
1973-03-08,114.23,-0.22,-0.19,120.24,-5.0,True,1,11299,-114.23,-441591.29,1290684.77,849093.48
1973-03-09,113.79,-0.44,-0.38,120.24,-5.36,True,1,11300,-113.79,-441705.08,1285827.0,844121.92
1973-03-12,113.86,0.07,0.06,120.24,-5.31,True,1,11301,-113.86,-441818.94,1286731.86,844912.92
1973-03-13,114.48,0.62,0.55,120.24,-4.79,True,1,11302,-114.48,-441933.42,1293852.96,851919.54
1973-03-14,114.98,0.5,0.44,120.24,-4.38,True,1,11303,-114.98,-442048.4,1299618.94,857570.54
1973-03-15,114.12,-0.86,-0.75,120.24,-5.09,True,1,11304,-114.12,-442162.52,1290012.48,847849.96
1973-03-16,113.54,-0.58,-0.51,120.24,-5.57,True,1,11305,-113.54,-442276.06,1283569.7,841293.64
1973-03-19,112.17,-1.37,-1.21,120.24,-6.71,True,1,11306,-112.17,-442388.23,1268194.02,825805.79
1973-03-20,111.95,-0.22,-0.2,120.24,-6.9,True,1,11307,-111.95,-442500.18,1265818.65,823318.47
1973-03-21,110.49,-1.46,-1.3,120.24,-8.11,True,1,11308,-110.49,-442610.67,1249420.92,806810.25
1973-03-22,108.84,-1.65,-1.49,120.24,-9.48,True,1,11309,-108.84,-442719.51,1230871.56,788152.05
1973-03-23,108.88,0.04,0.04,120.24,-9.45,True,1,11310,-108.88,-442828.39,1231432.8,788604.41
1973-03-26,109.84,0.96,0.88,120.24,-8.65,True,1,11311,-109.84,-442938.23,1242400.24,799462.01
1973-03-27,111.56,1.72,1.57,120.24,-7.22,True,1,11312,-111.56,-443049.79,1261966.72,818916.93
1973-03-28,111.62,0.06,0.05,120.24,-7.17,True,1,11313,-111.62,-443161.41,1262757.06,819595.65
1973-03-29,112.71,1.09,0.98,120.24,-6.26,True,1,11314,-112.71,-443274.12,1275200.94,831926.82
1973-03-30,111.52,-1.19,-1.06,120.24,-7.25,True,1,11315,-111.52,-443385.64,1261848.8,818463.16
1973-04-02,110.18,-1.34,-1.2,120.24,-8.37,True,1,11316,-110.18,-443495.82,1246796.88,803301.06
1973-04-03,109.24,-0.94,-0.85,120.24,-9.15,True,1,11317,-109.24,-443605.06,1236269.08,792664.02
1973-04-04,108.77,-0.47,-0.43,120.24,-9.54,True,1,11318,-108.77,-443713.83,1231058.86,787345.03
1973-04-05,108.52,-0.25,-0.23,120.24,-9.75,True,1,11319,-108.52,-443822.35,1228337.88,784515.53
1973-04-06,109.28,0.76,0.7,120.24,-9.12,True,1,11320,-109.28,-443931.63,1237049.6,793117.97
1973-04-09,110.86,1.58,1.45,120.24,-7.8,True,1,11321,-110.86,-444042.49,1255046.06,811003.57
1973-04-10,112.21,1.35,1.22,120.24,-6.68,True,1,11322,-112.21,-444154.7,1270441.62,826286.92
1973-04-11,112.68,0.47,0.42,120.24,-6.29,True,1,11323,-112.68,-444267.38,1275875.64,831608.26
1973-04-12,112.58,-0.1,-0.09,120.24,-6.37,True,1,11324,-112.58,-444379.96,1274855.92,830475.96
1973-04-13,112.08,-0.5,-0.44,120.24,-6.79,True,1,11325,-112.08,-444492.04,1269306.0,824813.96
1973-04-16,111.44,-0.64,-0.57,120.24,-7.32,True,1,11326,-111.44,-444603.48,1262169.44,817565.96
1973-04-17,110.94,-0.5,-0.45,120.24,-7.74,True,1,11327,-110.94,-444714.42,1256617.38,811902.96
1973-04-18,111.54,0.6,0.54,120.24,-7.24,True,1,11328,-111.54,-444825.96,1263525.12,818699.16
1973-04-19,112.17,0.63,0.56,120.24,-6.71,True,1,11329,-112.17,-444938.13,1270773.93,825835.8
1973-04-23,111.57,-0.6,-0.54,120.24,-7.21,True,1,11330,-111.57,-445049.7,1264088.1,819038.4
1973-04-24,109.99,-1.58,-1.42,120.24,-8.52,True,1,11331,-109.99,-445159.69,1246296.69,801137.0
1973-04-25,108.34,-1.65,-1.5,120.24,-9.9,True,1,11332,-108.34,-445268.03,1227708.88,782440.85
1973-04-26,108.89,0.55,0.51,120.24,-9.44,True,1,11333,-108.89,-445376.92,1234050.37,788673.45
1973-04-27,107.23,-1.66,-1.52,120.24,-10.82,True,1,11334,-107.23,-445484.15,1215344.82,769860.67
1973-04-30,106.97,-0.26,-0.24,120.24,-11.04,True,1,11335,-106.97,-445591.12,1212504.95,766913.83
1973-05-01,107.1,0.13,0.12,120.24,-10.93,True,1,11336,-107.1,-445698.22,1214085.6,768387.38
1973-05-02,108.43,1.33,1.24,120.24,-9.82,True,1,11337,-108.43,-445806.65,1229270.91,783464.26
1973-05-03,110.22,1.79,1.65,120.24,-8.33,True,1,11338,-110.22,-445916.87,1249674.36,803757.49
1973-05-04,111.0,0.78,0.71,120.24,-7.68,True,1,11339,-111.0,-446027.87,1258629.0,812601.13
1973-05-07,110.53,-0.47,-0.42,120.24,-8.08,True,1,11340,-110.53,-446138.4,1253410.2,807271.8
1973-05-08,111.25,0.72,0.65,120.24,-7.48,True,1,11341,-111.25,-446249.65,1261686.25,815436.6
1973-05-09,110.44,-0.81,-0.73,120.24,-8.15,True,1,11342,-110.44,-446360.09,1252610.48,806250.39
1973-05-10,109.54,-0.9,-0.82,120.24,-8.9,True,1,11343,-109.54,-446469.63,1242512.22,796042.59
1973-05-11,108.17,-1.37,-1.25,120.24,-10.04,True,1,11344,-108.17,-446577.8,1227080.48,780502.68
1973-05-14,105.9,-2.27,-2.1,120.24,-11.93,True,1,11345,-105.9,-446683.7,1201435.5,754751.8
1973-05-15,106.57,0.67,0.63,120.24,-11.37,True,1,11346,-106.57,-446790.27,1209143.22,762352.95
1973-05-16,106.43,-0.14,-0.13,120.24,-11.48,True,1,11347,-106.43,-446896.7,1207661.21,760764.51
1973-05-17,105.56,-0.87,-0.82,120.24,-12.21,True,1,11348,-105.56,-447002.26,1197894.88,750892.62
1973-05-18,103.86,-1.7,-1.61,120.24,-13.62,True,1,11349,-103.86,-447106.12,1178707.14,731601.02
1973-05-21,102.73,-1.13,-1.09,120.24,-14.56,True,1,11350,-102.73,-447208.85,1165985.5,718776.65
1973-05-22,103.58,0.85,0.83,120.24,-13.86,True,1,11351,-103.58,-447312.43,1175736.58,728424.15
1973-05-23,104.07,0.49,0.47,120.24,-13.45,True,1,11352,-104.07,-447416.5,1181402.64,733986.14
1973-05-24,107.14,3.07,2.95,120.24,-10.9,True,1,11353,-107.14,-447523.64,1216360.42,768836.78
1973-05-25,107.94,0.8,0.75,120.24,-10.23,True,1,11354,-107.94,-447631.58,1225550.76,777919.18
1973-05-29,107.51,-0.43,-0.4,120.24,-10.59,True,1,11355,-107.51,-447739.09,1220776.05,773036.96
1973-05-30,105.91,-1.6,-1.49,120.24,-11.92,True,1,11356,-105.91,-447845.0,1202713.96,754868.96
1973-05-31,104.95,-0.96,-0.91,120.24,-12.72,True,1,11357,-104.95,-447949.95,1191917.15,743967.2
1973-06-01,103.93,-1.02,-0.97,120.24,-13.56,True,1,11358,-103.93,-448053.88,1180436.94,732383.06
1973-06-04,102.97,-0.96,-0.92,120.24,-14.36,True,1,11359,-102.97,-448156.85,1169636.23,721479.38
1973-06-05,104.62,1.65,1.6,120.24,-12.99,True,1,11360,-104.62,-448261.47,1188483.2,740221.73
1973-06-06,104.31,-0.31,-0.3,120.24,-13.25,True,1,11361,-104.31,-448365.78,1185065.91,736700.13
1973-06-07,105.84,1.53,1.47,120.24,-11.98,True,1,11362,-105.84,-448471.62,1202554.08,754082.46
1973-06-08,107.03,1.19,1.12,120.24,-10.99,True,1,11363,-107.03,-448578.65,1216181.89,767603.24
1973-06-11,106.7,-0.33,-0.31,120.24,-11.26,True,1,11364,-106.7,-448685.35,1212538.8,763853.45
1973-06-12,108.29,1.59,1.49,120.24,-9.94,True,1,11365,-108.29,-448793.64,1230715.85,781922.21
1973-06-13,107.6,-0.69,-0.64,120.24,-10.51,True,1,11366,-107.6,-448901.24,1222981.6,774080.36
1973-06-14,106.4,-1.2,-1.12,120.24,-11.51,True,1,11367,-106.4,-449007.64,1209448.8,760441.16
1973-06-15,105.1,-1.3,-1.22,120.24,-12.59,True,1,11368,-105.1,-449112.74,1194776.8,745664.06
1973-06-18,103.6,-1.5,-1.43,120.24,-13.84,True,1,11369,-103.6,-449216.34,1177828.4,728612.06
1973-06-19,103.99,0.39,0.38,120.24,-13.52,True,1,11370,-103.99,-449320.33,1182366.3,733045.97
1973-06-20,104.44,0.45,0.43,120.24,-13.14,True,1,11371,-104.44,-449424.77,1187587.24,738162.47
1973-06-21,103.21,-1.23,-1.18,120.24,-14.16,True,1,11372,-103.21,-449527.98,1173704.12,724176.14
1973-06-22,103.7,0.49,0.48,120.24,-13.76,True,1,11373,-103.7,-449631.68,1179380.1,729748.42
1973-06-25,102.25,-1.45,-1.4,120.24,-14.96,True,1,11374,-102.25,-449733.93,1162991.5,713257.57
1973-06-26,103.3,1.05,1.03,120.24,-14.09,True,1,11375,-103.3,-449837.23,1175037.5,725200.27
1973-06-27,103.62,0.32,0.31,120.24,-13.82,True,1,11376,-103.62,-449940.85,1178781.12,728840.27
1973-06-28,104.69,1.07,1.03,120.24,-12.93,True,1,11377,-104.69,-450045.54,1191058.13,741012.59
1973-06-29,104.26,-0.43,-0.41,120.24,-13.29,True,1,11378,-104.26,-450149.8,1186270.28,736120.48
1973-07-02,102.9,-1.36,-1.3,120.24,-14.42,True,1,11379,-102.9,-450252.7,1170899.1,720646.4
1973-07-03,101.87,-1.03,-1.0,120.24,-15.28,True,1,11380,-101.87,-450354.57,1159280.6,708926.03
1973-07-05,101.78,-0.09,-0.09,120.24,-15.35,True,1,11381,-101.78,-450456.35,1158358.18,707901.83
1973-07-06,101.28,-0.5,-0.49,120.24,-15.77,True,1,11382,-101.28,-450557.63,1152768.96,702211.33
1973-07-09,102.14,0.86,0.85,120.24,-15.05,True,1,11383,-102.14,-450659.77,1162659.62,711999.85
1973-07-10,103.52,1.38,1.35,120.24,-13.91,True,1,11384,-103.52,-450763.29,1178471.68,727708.39
1973-07-11,105.8,2.28,2.2,120.24,-12.01,True,1,11385,-105.8,-450869.09,1204533.0,753663.91
1973-07-12,105.5,-0.3,-0.28,120.24,-12.26,True,1,11386,-105.5,-450974.59,1201223.0,750248.41
1973-07-13,104.09,-1.41,-1.34,120.24,-13.43,True,1,11387,-104.09,-451078.68,1185272.83,734194.15
1973-07-16,105.67,1.58,1.52,120.24,-12.12,True,1,11388,-105.67,-451184.35,1203369.96,752185.61
1973-07-17,105.72,0.05,0.05,120.24,-12.08,True,1,11389,-105.72,-451290.07,1204045.08,752755.01
1973-07-18,106.35,0.63,0.6,120.24,-11.55,True,1,11390,-106.35,-451396.42,1211326.5,759930.08
1973-07-19,106.55,0.2,0.19,120.24,-11.39,True,1,11391,-106.55,-451502.97,1213711.05,762208.08
1973-07-20,107.14,0.59,0.55,120.24,-10.9,True,1,11392,-107.14,-451610.11,1220538.88,768928.77
1973-07-23,107.52,0.38,0.36,120.24,-10.58,True,1,11393,-107.52,-451717.63,1224975.36,773257.73
1973-07-24,108.14,0.62,0.58,120.24,-10.06,True,1,11394,-108.14,-451825.77,1232147.16,780321.39
1973-07-25,109.64,1.5,1.39,120.24,-8.82,True,1,11395,-109.64,-451935.41,1249347.8,797412.39
1973-07-26,109.85,0.21,0.19,120.24,-8.64,True,1,11396,-109.85,-452045.26,1251850.6,799805.34
1973-07-27,109.59,-0.26,-0.24,120.24,-8.86,True,1,11397,-109.59,-452154.85,1248997.23,796842.38
1973-07-30,109.25,-0.34,-0.31,120.24,-9.14,True,1,11398,-109.25,-452264.1,1245231.5,792967.4
1973-07-31,108.22,-1.03,-0.94,120.24,-10.0,True,1,11399,-108.22,-452372.32,1233599.78,781227.46
1973-08-01,106.83,-1.39,-1.28,120.24,-11.15,True,1,11400,-106.83,-452479.15,1217862.0,765382.85
1973-08-02,106.67,-0.16,-0.15,120.24,-11.29,True,1,11401,-106.67,-452585.82,1216144.67,763558.85
1973-08-03,106.49,-0.18,-0.17,120.24,-11.44,True,1,11402,-106.49,-452692.31,1214198.98,761506.67
1973-08-06,106.73,0.24,0.22,120.24,-11.24,True,1,11403,-106.73,-452799.04,1217042.19,764243.15
1973-08-07,106.55,-0.18,-0.17,120.24,-11.39,True,1,11404,-106.55,-452905.59,1215096.2,762190.61
1973-08-08,105.55,-1.0,-0.94,120.24,-12.22,True,1,11405,-105.55,-453011.14,1203797.75,750786.61
1973-08-09,105.61,0.06,0.06,120.24,-12.17,True,1,11406,-105.61,-453116.75,1204587.66,751470.91
1973-08-10,104.77,-0.84,-0.8,120.24,-12.87,True,1,11407,-104.77,-453221.52,1195111.39,741889.87
1973-08-13,103.71,-1.06,-1.01,120.24,-13.75,True,1,11408,-103.71,-453325.23,1183123.68,729798.45
1973-08-14,102.71,-1.0,-0.96,120.24,-14.58,True,1,11409,-102.71,-453427.94,1171818.39,718390.45
1973-08-15,103.01,0.3,0.29,120.24,-14.33,True,1,11410,-103.01,-453530.95,1175344.1,721813.15
1973-08-16,102.29,-0.72,-0.7,120.24,-14.93,True,1,11411,-102.29,-453633.24,1167231.19,713597.95
1973-08-17,102.31,0.02,0.02,120.24,-14.91,True,1,11412,-102.31,-453735.55,1167561.72,713826.17
1973-08-20,101.61,-0.7,-0.68,120.24,-15.49,True,1,11413,-101.61,-453837.16,1159674.93,705837.77
1973-08-21,100.89,-0.72,-0.71,120.24,-16.09,True,1,11414,-100.89,-453938.05,1151558.46,697620.41
1973-08-22,100.53,-0.36,-0.36,120.24,-16.39,True,1,11415,-100.53,-454038.58,1147549.95,693511.37
1973-08-23,101.91,1.38,1.37,120.24,-15.24,True,1,11416,-101.91,-454140.49,1163404.56,709264.07
1973-08-24,101.62,-0.29,-0.28,120.24,-15.49,True,1,11417,-101.62,-454242.11,1160195.54,705953.43
1973-08-27,102.42,0.8,0.79,120.24,-14.82,True,1,11418,-102.42,-454344.53,1169431.56,715087.03
1973-08-28,103.02,0.6,0.59,120.24,-14.32,True,1,11419,-103.02,-454447.55,1176385.38,721937.83
1973-08-29,104.03,1.01,0.98,120.24,-13.48,True,1,11420,-104.03,-454551.58,1188022.6,733471.02
1973-08-30,103.88,-0.15,-0.14,120.24,-13.61,True,1,11421,-103.88,-454655.46,1186413.48,731758.02
1973-08-31,104.25,0.37,0.36,120.24,-13.3,True,1,11422,-104.25,-454759.71,1190743.5,735983.79
1973-09-04,104.51,0.26,0.25,120.24,-13.08,True,1,11423,-104.51,-454864.22,1193817.73,738953.51
1973-09-05,104.64,0.13,0.12,120.24,-12.97,True,1,11424,-104.64,-454968.86,1195407.36,740438.5
1973-09-06,105.15,0.51,0.49,120.24,-12.55,True,1,11425,-105.15,-455074.01,1201338.75,746264.74
1973-09-07,104.76,-0.39,-0.37,120.24,-12.87,True,1,11426,-104.76,-455178.77,1196987.76,741808.99
1973-09-10,103.85,-0.91,-0.87,120.24,-13.63,True,1,11427,-103.85,-455282.62,1186693.95,731411.33
1973-09-11,103.22,-0.63,-0.61,120.24,-14.16,True,1,11428,-103.22,-455385.84,1179598.16,724212.32
1973-09-12,103.06,-0.16,-0.16,120.24,-14.29,True,1,11429,-103.06,-455488.9,1177872.74,722383.84
1973-09-13,103.36,0.3,0.29,120.24,-14.04,True,1,11430,-103.36,-455592.26,1181404.8,725812.54
1973-09-14,104.44,1.08,1.04,120.24,-13.14,True,1,11431,-104.44,-455696.7,1193853.64,738156.94
1973-09-17,104.15,-0.29,-0.28,120.24,-13.38,True,1,11432,-104.15,-455800.85,1190642.8,734841.95
1973-09-18,103.77,-0.38,-0.36,120.24,-13.7,True,1,11433,-103.77,-455904.62,1186402.41,730497.79
1973-09-19,105.88,2.11,2.03,120.24,-11.94,True,1,11434,-105.88,-456010.5,1210631.92,754621.42
1973-09-20,106.76,0.88,0.83,120.24,-11.21,True,1,11435,-106.76,-456117.26,1220800.6,764683.34
1973-09-21,107.2,0.44,0.41,120.24,-10.84,True,1,11436,-107.2,-456224.46,1225939.2,769714.74
1973-09-24,107.36,0.16,0.15,120.24,-10.71,True,1,11437,-107.36,-456331.82,1227876.32,771544.5
1973-09-25,108.05,0.69,0.64,120.24,-10.14,True,1,11438,-108.05,-456439.87,1235875.9,779436.03
1973-09-26,108.83,0.78,0.72,120.24,-9.49,True,1,11439,-108.83,-456548.7,1244906.37,788357.67
1973-09-27,109.08,0.25,0.23,120.24,-9.28,True,1,11440,-109.08,-456657.78,1247875.2,791217.42
1973-09-28,108.43,-0.65,-0.6,120.24,-9.82,True,1,11441,-108.43,-456766.21,1240547.63,783781.42
1973-10-01,108.21,-0.22,-0.2,120.24,-10.01,True,1,11442,-108.21,-456874.42,1238138.82,781264.4
1973-10-02,108.79,0.58,0.54,120.24,-9.52,True,1,11443,-108.79,-456983.21,1244883.97,787900.76
1973-10-03,108.78,-0.01,-0.01,120.24,-9.53,True,1,11444,-108.78,-457091.99,1244878.32,787786.33
1973-10-04,108.41,-0.37,-0.34,120.24,-9.84,True,1,11445,-108.41,-457200.4,1240752.45,783552.05
1973-10-05,109.85,1.44,1.33,120.24,-8.64,True,1,11446,-109.85,-457310.25,1257343.1,800032.85
1973-10-08,110.23,0.38,0.35,120.24,-8.32,True,1,11447,-110.23,-457420.48,1261802.81,804382.33
1973-10-09,110.13,-0.1,-0.09,120.24,-8.41,True,1,11448,-110.13,-457530.61,1260768.24,803237.63
1973-10-10,109.22,-0.91,-0.83,120.24,-9.16,True,1,11449,-109.22,-457639.83,1250459.78,792819.95
1973-10-11,111.09,1.87,1.71,120.24,-7.61,True,1,11450,-111.09,-457750.92,1271980.5,814229.58
1973-10-12,111.44,0.35,0.32,120.24,-7.32,True,1,11451,-111.44,-457862.36,1276099.44,818237.08
1973-10-15,110.05,-1.39,-1.25,120.24,-8.48,True,1,11452,-110.05,-457972.41,1260292.6,802320.19
1973-10-16,110.19,0.14,0.13,120.24,-8.36,True,1,11453,-110.19,-458082.6,1262006.07,803923.47
1973-10-17,109.97,-0.22,-0.2,120.24,-8.54,True,1,11454,-109.97,-458192.57,1259596.38,801403.81
1973-10-18,110.01,0.04,0.04,120.24,-8.51,True,1,11455,-110.01,-458302.58,1260164.55,801861.97
1973-10-19,110.22,0.21,0.19,120.24,-8.33,True,1,11456,-110.22,-458412.8,1262680.32,804267.52
1973-10-22,109.16,-1.06,-0.96,120.24,-9.22,True,1,11457,-109.16,-458521.96,1250646.12,792124.16
1973-10-23,109.75,0.59,0.54,120.24,-8.72,True,1,11458,-109.75,-458631.71,1257515.5,798883.79
1973-10-24,110.27,0.52,0.47,120.24,-8.29,True,1,11459,-110.27,-458741.98,1263583.93,804841.95
1973-10-25,110.5,0.23,0.21,120.24,-8.1,True,1,11460,-110.5,-458852.48,1266330.0,807477.52
1973-10-26,111.38,0.88,0.8,120.24,-7.37,True,1,11461,-111.38,-458963.86,1276526.18,817562.32
1973-10-29,111.15,-0.23,-0.21,120.24,-7.56,True,1,11462,-111.15,-459075.01,1274001.3,814926.29
1973-10-30,109.33,-1.82,-1.64,120.24,-9.07,True,1,11463,-109.33,-459184.34,1253249.79,794065.45
1973-10-31,108.29,-1.04,-0.95,120.24,-9.94,True,1,11464,-108.29,-459292.63,1241436.56,782143.93
1973-11-01,107.69,-0.6,-0.55,120.24,-10.44,True,1,11465,-107.69,-459400.32,1234665.85,775265.53
1973-11-02,107.07,-0.62,-0.58,120.24,-10.95,True,1,11466,-107.07,-459507.39,1227664.62,768157.23
1973-11-05,105.52,-1.55,-1.45,120.24,-12.24,True,1,11467,-105.52,-459612.91,1209997.84,750384.93
1973-11-06,104.96,-0.56,-0.53,120.24,-12.71,True,1,11468,-104.96,-459717.87,1203681.28,743963.41
1973-11-07,105.8,0.84,0.8,120.24,-12.01,True,1,11469,-105.8,-459823.67,1213420.2,753596.53
1973-11-08,107.02,1.22,1.15,120.24,-11.0,True,1,11470,-107.02,-459930.69,1227519.4,767588.71
1973-11-09,105.3,-1.72,-1.61,120.24,-12.42,True,1,11471,-105.3,-460035.99,1207896.3,747860.31
1973-11-12,104.44,-0.86,-0.82,120.24,-13.14,True,1,11472,-104.44,-460140.43,1198135.68,737995.25
1973-11-13,104.36,-0.08,-0.08,120.24,-13.21,True,1,11473,-104.36,-460244.79,1197322.28,737077.49
1973-11-14,102.45,-1.91,-1.83,120.24,-14.8,True,1,11474,-102.45,-460347.24,1175511.3,715164.06
1973-11-15,102.43,-0.02,-0.02,120.24,-14.81,True,1,11475,-102.43,-460449.67,1175384.25,714934.58
1973-11-16,103.88,1.45,1.42,120.24,-13.61,True,1,11476,-103.88,-460553.55,1192126.88,731573.33
1973-11-19,100.71,-3.17,-3.05,120.24,-16.24,True,1,11477,-100.71,-460654.26,1155848.67,695194.41
1973-11-20,98.66,-2.05,-2.04,120.24,-17.95,True,1,11478,-98.66,-460752.92,1132419.48,671666.56
1973-11-21,99.76,1.1,1.12,120.24,-17.03,True,1,11479,-99.76,-460852.68,1145145.04,684292.36
1973-11-23,99.44,-0.32,-0.32,120.24,-17.3,True,1,11480,-99.44,-460952.12,1141571.2,680619.08
1973-11-26,96.58,-2.86,-2.88,120.24,-19.68,True,1,11481,-96.58,-461048.7,1108834.98,647786.28
1973-11-27,95.7,-0.88,-0.91,120.24,-20.41,True,1,11482,-95.7,-461144.4,1098827.4,637683.0
1973-11-28,97.65,1.95,2.04,120.24,-18.79,True,1,11483,-97.65,-461242.05,1121314.95,660072.9
1973-11-29,97.31,-0.34,-0.35,120.24,-19.07,True,1,11484,-97.31,-461339.36,1117508.04,656168.68
1973-11-30,95.96,-1.35,-1.39,120.24,-20.19,True,1,11485,-95.96,-461435.32,1102100.6,640665.28
1973-12-03,93.9,-2.06,-2.15,120.24,-21.91,True,1,11486,-93.9,-461529.22,1078535.4,617006.18
1973-12-04,93.59,-0.31,-0.33,120.24,-22.16,True,1,11487,-93.59,-461622.81,1075068.33,613445.52
1973-12-05,92.16,-1.43,-1.53,120.24,-23.35,True,1,11488,-92.16,-461714.97,1058734.08,597019.11
1973-12-06,94.42,2.26,2.45,120.24,-21.47,True,1,11489,-94.42,-461809.39,1084791.38,622981.99
1973-12-07,96.51,2.09,2.21,120.24,-19.74,True,1,11490,-96.51,-461905.9,1108899.9,646994.0
1973-12-10,97.95,1.44,1.49,120.24,-18.54,True,1,11491,-97.95,-462003.85,1125543.45,663539.6
1973-12-11,96.04,-1.91,-1.95,120.24,-20.13,True,1,11492,-96.04,-462099.89,1103691.68,641591.79
1973-12-12,93.57,-2.47,-2.57,120.24,-22.18,True,1,11493,-93.57,-462193.46,1075400.01,613206.55
1973-12-13,92.38,-1.19,-1.27,120.24,-23.17,True,1,11494,-92.38,-462285.84,1061815.72,599529.88
1973-12-14,93.29,0.91,0.98,120.24,-22.41,True,1,11495,-93.29,-462379.13,1072368.55,609989.42
1973-12-17,92.75,-0.54,-0.58,120.24,-22.86,True,1,11496,-92.75,-462471.88,1066254.0,603782.12
1973-12-18,94.74,1.99,2.15,120.24,-21.21,True,1,11497,-94.74,-462566.62,1089225.78,626659.16
1973-12-19,94.82,0.08,0.08,120.24,-21.14,True,1,11498,-94.82,-462661.44,1090240.36,627578.92
1973-12-20,94.55,-0.27,-0.28,120.24,-21.37,True,1,11499,-94.55,-462755.99,1087230.45,624474.46
1973-12-21,93.54,-1.01,-1.07,120.24,-22.21,True,1,11500,-93.54,-462849.53,1075710.0,612860.47
1973-12-24,92.9,-0.64,-0.68,120.24,-22.74,True,1,11501,-92.9,-462942.43,1068442.9,605500.47
1973-12-26,95.74,2.84,3.06,120.24,-20.38,True,1,11502,-95.74,-463038.17,1101201.48,638163.31
1973-12-27,97.74,2.0,2.09,120.24,-18.71,True,1,11503,-97.74,-463135.91,1124303.22,661167.31
1973-12-28,97.54,-0.2,-0.2,120.24,-18.88,True,1,11504,-97.54,-463233.45,1122100.16,658866.71
1973-12-31,97.55,0.01,0.01,120.24,-18.87,True,1,11505,-97.55,-463331.0,1122312.75,658981.75
1974-01-02,97.68,0.13,0.13,120.24,-18.76,True,1,11506,-97.68,-463428.68,1123906.08,660477.4
1974-01-03,99.8,2.12,2.17,120.24,-17.0,True,1,11507,-99.8,-463528.48,1148398.6,684870.12
1974-01-04,98.9,-0.9,-0.9,120.24,-17.75,True,1,11508,-98.9,-463627.38,1138141.2,674513.82
1974-01-07,98.07,-0.83,-0.84,120.24,-18.44,True,1,11509,-98.07,-463725.45,1128687.63,664962.18
1974-01-08,96.12,-1.95,-1.99,120.24,-20.06,True,1,11510,-96.12,-463821.57,1106341.2,642519.63
1974-01-09,93.42,-2.7,-2.81,120.24,-22.3,True,1,11511,-93.42,-463914.99,1075357.62,611442.63
1974-01-10,92.39,-1.03,-1.1,120.24,-23.16,True,1,11512,-92.39,-464007.38,1063593.68,599586.3
1974-01-11,93.66,1.27,1.38,120.24,-22.11,True,1,11513,-93.66,-464101.04,1078307.58,614206.54
1974-01-14,93.42,-0.24,-0.26,120.24,-22.3,True,1,11514,-93.42,-464194.46,1075637.88,611443.42
1974-01-15,94.23,0.81,0.87,120.24,-21.63,True,1,11515,-94.23,-464288.69,1085058.45,620769.76
1974-01-16,95.67,1.44,1.53,120.24,-20.43,True,1,11516,-95.67,-464384.36,1101735.72,637351.36
1974-01-17,97.3,1.63,1.7,120.24,-19.08,True,1,11517,-97.3,-464481.66,1120604.1,656122.44
1974-01-18,95.56,-1.74,-1.79,120.24,-20.53,True,1,11518,-95.56,-464577.22,1100660.08,636082.86
1974-01-21,95.4,-0.16,-0.17,120.24,-20.66,True,1,11519,-95.4,-464672.62,1098912.6,634239.98
1974-01-22,96.55,1.15,1.2,120.24,-19.7,True,1,11520,-96.55,-464769.17,1112256.0,647486.83
1974-01-23,97.07,0.52,0.54,120.24,-19.27,True,1,11521,-97.07,-464866.24,1118343.47,653477.23
1974-01-24,96.82,-0.25,-0.26,120.24,-19.48,True,1,11522,-96.82,-464963.06,1115560.04,650596.98
1974-01-25,96.63,-0.19,-0.2,120.24,-19.64,True,1,11523,-96.63,-465059.69,1113467.49,648407.8
1974-01-28,96.09,-0.54,-0.56,120.24,-20.08,True,1,11524,-96.09,-465155.78,1107341.16,642185.38
1974-01-29,96.01,-0.08,-0.08,120.24,-20.15,True,1,11525,-96.01,-465251.79,1106515.25,641263.46
1974-01-30,97.06,1.05,1.09,120.24,-19.28,True,1,11526,-97.06,-465348.85,1118713.56,653364.71
1974-01-31,96.57,-0.49,-0.5,120.24,-19.69,True,1,11527,-96.57,-465445.42,1113162.39,647716.97
1974-02-01,95.32,-1.25,-1.29,120.24,-20.72,True,1,11528,-95.32,-465540.74,1098848.96,633308.22
1974-02-04,93.29,-2.03,-2.13,120.24,-22.41,True,1,11529,-93.29,-465634.03,1075540.41,609906.38
1974-02-05,93.0,-0.29,-0.31,120.24,-22.66,True,1,11530,-93.0,-465727.03,1072290.0,606562.97
1974-02-06,93.26,0.26,0.28,120.24,-22.44,True,1,11531,-93.26,-465820.29,1075381.06,609560.77
1974-02-07,93.3,0.04,0.04,120.24,-22.4,True,1,11532,-93.3,-465913.59,1075935.6,610022.01
1974-02-08,92.33,-0.97,-1.04,120.24,-23.21,True,1,11533,-92.33,-466005.92,1064841.89,598835.97
1974-02-11,90.66,-1.67,-1.81,120.24,-24.6,True,1,11534,-90.66,-466096.58,1045672.44,579575.86
1974-02-12,90.94,0.28,0.31,120.24,-24.37,True,1,11535,-90.94,-466187.52,1048992.9,582805.38
1974-02-13,90.98,0.04,0.04,120.24,-24.34,True,1,11536,-90.98,-466278.5,1049545.28,583266.78
1974-02-14,90.95,-0.03,-0.03,120.24,-24.36,True,1,11537,-90.95,-466369.45,1049290.15,582920.7
1974-02-15,92.27,1.32,1.45,120.24,-23.26,True,1,11538,-92.27,-466461.72,1064611.26,598149.54
1974-02-19,92.12,-0.15,-0.16,120.24,-23.39,True,1,11539,-92.12,-466553.84,1062972.68,596418.84
1974-02-20,93.44,1.32,1.43,120.24,-22.29,True,1,11540,-93.44,-466647.28,1078297.6,611650.32
1974-02-21,94.71,1.27,1.36,120.24,-21.23,True,1,11541,-94.71,-466741.99,1093048.11,626306.12
1974-02-22,95.39,0.68,0.72,120.24,-20.67,True,1,11542,-95.39,-466837.38,1100991.38,634154.0
1974-02-25,95.03,-0.36,-0.38,120.24,-20.97,True,1,11543,-95.03,-466932.41,1096931.29,629998.88
1974-02-26,96.0,0.97,1.02,120.24,-20.16,True,1,11544,-96.0,-467028.41,1108224.0,641195.59
1974-02-27,96.4,0.4,0.42,120.24,-19.83,True,1,11545,-96.4,-467124.81,1112938.0,645813.19
1974-02-28,96.22,-0.18,-0.19,120.24,-19.98,True,1,11546,-96.22,-467221.03,1110956.12,643735.09
1974-03-01,95.53,-0.69,-0.72,120.24,-20.55,True,1,11547,-95.53,-467316.56,1103084.91,635768.35
1974-03-04,95.53,0.0,0.0,120.24,-20.55,True,1,11548,-95.53,-467412.09,1103180.44,635768.35
1974-03-05,97.32,1.79,1.87,120.24,-19.06,True,1,11549,-97.32,-467509.41,1123948.68,656439.27
1974-03-06,97.98,0.66,0.68,120.24,-18.51,True,1,11550,-97.98,-467607.39,1131669.0,664061.61
1974-03-07,96.94,-1.04,-1.06,120.24,-19.38,True,1,11551,-96.94,-467704.33,1119753.94,652049.61
1974-03-08,97.78,0.84,0.87,120.24,-18.68,True,1,11552,-97.78,-467802.11,1129554.56,661752.45
1974-03-11,98.88,1.1,1.12,120.24,-17.76,True,1,11553,-98.88,-467900.99,1142360.64,674459.65
1974-03-12,99.15,0.27,0.27,120.24,-17.54,True,1,11554,-99.15,-468000.14,1145579.1,677578.96
1974-03-13,99.74,0.59,0.6,120.24,-17.05,True,1,11555,-99.74,-468099.88,1152495.7,684395.82
1974-03-14,99.65,-0.09,-0.09,120.24,-17.12,True,1,11556,-99.65,-468199.53,1151555.4,683355.87
1974-03-15,99.28,-0.37,-0.37,120.24,-17.43,True,1,11557,-99.28,-468298.81,1147378.96,679080.15
1974-03-18,98.05,-1.23,-1.24,120.24,-18.45,True,1,11558,-98.05,-468396.86,1133261.9,664865.04
1974-03-19,97.23,-0.82,-0.84,120.24,-19.14,True,1,11559,-97.23,-468494.09,1123881.57,655387.48
1974-03-20,97.57,0.34,0.35,120.24,-18.85,True,1,11560,-97.57,-468591.66,1127909.2,659317.54
1974-03-21,97.34,-0.23,-0.24,120.24,-19.05,True,1,11561,-97.34,-468689.0,1125347.74,656658.74
1974-03-22,97.27,-0.07,-0.07,120.24,-19.1,True,1,11562,-97.27,-468786.27,1124635.74,655849.47
1974-03-25,97.64,0.37,0.38,120.24,-18.8,True,1,11563,-97.64,-468883.91,1129011.32,660127.41
1974-03-26,97.95,0.31,0.32,120.24,-18.54,True,1,11564,-97.95,-468981.86,1132693.8,663711.94
1974-03-27,96.59,-1.36,-1.39,120.24,-19.67,True,1,11565,-96.59,-469078.45,1117063.35,647984.9
1974-03-28,94.82,-1.77,-1.83,120.24,-21.14,True,1,11566,-94.82,-469173.27,1096688.12,627514.85
1974-03-29,93.98,-0.84,-0.89,120.24,-21.84,True,1,11567,-93.98,-469267.25,1087066.66,617799.41
1974-04-01,93.25,-0.73,-0.78,120.24,-22.45,True,1,11568,-93.25,-469360.5,1078716.0,609355.5
1974-04-02,93.35,0.1,0.11,120.24,-22.36,True,1,11569,-93.35,-469453.85,1079966.15,610512.3
1974-04-03,94.33,0.98,1.05,120.24,-21.55,True,1,11570,-94.33,-469548.18,1091398.1,621849.92
1974-04-04,94.33,0.0,0.0,120.24,-21.55,True,1,11571,-94.33,-469642.51,1091492.43,621849.92
1974-04-05,93.01,-1.32,-1.4,120.24,-22.65,True,1,11572,-93.01,-469735.52,1076311.72,606576.2
1974-04-08,92.03,-0.98,-1.05,120.24,-23.46,True,1,11573,-92.03,-469827.55,1065063.19,595235.64
1974-04-09,92.61,0.58,0.63,120.24,-22.98,True,1,11574,-92.61,-469920.16,1071868.14,601947.98
1974-04-10,92.4,-0.21,-0.23,120.24,-23.15,True,1,11575,-92.4,-470012.56,1069530.0,599517.44
1974-04-11,92.12,-0.28,-0.3,120.24,-23.39,True,1,11576,-92.12,-470104.68,1066381.12,596276.44
1974-04-15,92.05,-0.07,-0.08,120.24,-23.44,True,1,11577,-92.05,-470196.73,1065662.85,595466.12
1974-04-16,93.66,1.61,1.75,120.24,-22.11,True,1,11578,-93.66,-470290.39,1084395.48,614105.09
1974-04-17,94.36,0.7,0.75,120.24,-21.52,True,1,11579,-94.36,-470384.75,1092594.44,622209.69
1974-04-18,94.78,0.42,0.44,120.24,-21.17,True,1,11580,-94.78,-470479.53,1097552.4,627072.87
1974-04-19,93.75,-1.03,-1.09,120.24,-22.03,True,1,11581,-93.75,-470573.28,1085718.75,615145.47
1974-04-22,93.38,-0.37,-0.4,120.24,-22.34,True,1,11582,-93.38,-470666.66,1081527.16,610860.5
1974-04-23,91.81,-1.57,-1.68,120.24,-23.64,True,1,11583,-91.81,-470758.47,1063435.23,592676.76
1974-04-24,90.3,-1.51,-1.64,120.24,-24.9,True,1,11584,-90.3,-470848.77,1046035.2,575186.43
1974-04-25,89.57,-0.73,-0.81,120.24,-25.51,True,1,11585,-89.57,-470938.34,1037668.45,566730.11
1974-04-26,90.18,0.61,0.68,120.24,-25.0,True,1,11586,-90.18,-471028.52,1044825.48,573796.96
1974-04-29,90.0,-0.18,-0.2,120.24,-25.15,True,1,11587,-90.0,-471118.52,1042830.0,571711.48
1974-04-30,90.31,0.31,0.34,120.24,-24.89,True,1,11588,-90.31,-471208.83,1046512.28,575303.45
1974-05-01,92.22,1.91,2.12,120.24,-23.3,True,1,11589,-92.22,-471301.05,1068737.58,597436.53
1974-05-02,92.09,-0.13,-0.14,120.24,-23.41,True,1,11590,-92.09,-471393.14,1067323.1,595929.96
1974-05-03,91.29,-0.8,-0.87,120.24,-24.08,True,1,11591,-91.29,-471484.43,1058142.39,586657.96
1974-05-06,91.12,-0.17,-0.19,120.24,-24.22,True,1,11592,-91.12,-471575.55,1056263.04,584687.49
1974-05-07,91.46,0.34,0.37,120.24,-23.94,True,1,11593,-91.46,-471667.01,1060295.78,588628.77
1974-05-08,91.64,0.18,0.2,120.24,-23.79,True,1,11594,-91.64,-471758.65,1062474.16,590715.51
1974-05-09,92.96,1.32,1.44,120.24,-22.69,True,1,11595,-92.96,-471851.61,1077871.2,606019.59
1974-05-10,91.47,-1.49,-1.6,120.24,-23.93,True,1,11596,-91.47,-471943.08,1060686.12,588743.04
1974-05-13,90.66,-0.81,-0.89,120.24,-24.6,True,1,11597,-90.66,-472033.74,1051384.02,579350.28
1974-05-14,90.69,0.03,0.03,120.24,-24.58,True,1,11598,-90.69,-472124.43,1051822.62,579698.19
1974-05-15,90.45,-0.24,-0.26,120.24,-24.78,True,1,11599,-90.45,-472214.88,1049129.55,576914.67
1974-05-16,89.72,-0.73,-0.81,120.24,-25.38,True,1,11600,-89.72,-472304.6,1040752.0,568447.4
1974-05-17,88.21,-1.51,-1.68,120.24,-26.64,True,1,11601,-88.21,-472392.81,1023324.21,550931.4
1974-05-20,87.86,-0.35,-0.4,120.24,-26.93,True,1,11602,-87.86,-472480.67,1019351.72,546871.05
1974-05-21,87.91,0.05,0.06,120.24,-26.89,True,1,11603,-87.91,-472568.58,1020019.73,547451.15
1974-05-22,87.09,-0.82,-0.93,120.24,-27.57,True,1,11604,-87.09,-472655.67,1010592.36,537936.69
1974-05-23,87.29,0.2,0.23,120.24,-27.4,True,1,11605,-87.29,-472742.96,1013000.45,540257.49
1974-05-24,88.58,1.29,1.48,120.24,-26.33,True,1,11606,-88.58,-472831.54,1028059.48,555227.94
1974-05-28,88.37,-0.21,-0.24,120.24,-26.5,True,1,11607,-88.37,-472919.91,1025710.59,552790.68
1974-05-29,86.89,-1.48,-1.68,120.24,-27.74,True,1,11608,-86.89,-473006.8,1008619.12,535612.32
1974-05-30,87.43,0.54,0.62,120.24,-27.29,True,1,11609,-87.43,-473094.23,1014974.87,541880.64
1974-05-31,87.28,-0.15,-0.17,120.24,-27.41,True,1,11610,-87.28,-473181.51,1013320.8,540139.29
1974-06-03,89.1,1.82,2.08,120.24,-25.9,True,1,11611,-89.1,-473270.61,1034540.1,561269.49
1974-06-04,90.14,1.04,1.17,120.24,-25.03,True,1,11612,-90.14,-473360.75,1046705.68,573344.93
1974-06-05,90.31,0.17,0.19,120.24,-24.89,True,1,11613,-90.31,-473451.06,1048770.03,575318.97
1974-06-06,91.96,1.65,1.83,120.24,-23.52,True,1,11614,-91.96,-473543.02,1068023.44,594480.42
1974-06-07,92.55,0.59,0.64,120.24,-23.03,True,1,11615,-92.55,-473635.57,1074968.25,601332.68
1974-06-10,93.1,0.55,0.59,120.24,-22.57,True,1,11616,-93.1,-473728.67,1081449.6,607720.93
1974-06-11,92.28,-0.82,-0.88,120.24,-23.25,True,1,11617,-92.28,-473820.95,1072016.76,598195.81
1974-06-12,92.06,-0.22,-0.24,120.24,-23.44,True,1,11618,-92.06,-473913.01,1069553.08,595640.07
1974-06-13,92.34,0.28,0.3,120.24,-23.2,True,1,11619,-92.34,-474005.35,1072898.46,598893.11
1974-06-14,91.3,-1.04,-1.13,120.24,-24.07,True,1,11620,-91.3,-474096.65,1060906.0,586809.35
1974-06-17,90.04,-1.26,-1.38,120.24,-25.12,True,1,11621,-90.04,-474186.69,1046354.84,572168.15
1974-06-18,89.45,-0.59,-0.66,120.24,-25.61,True,1,11622,-89.45,-474276.14,1039587.9,565311.76
1974-06-19,88.84,-0.61,-0.68,120.24,-26.11,True,1,11623,-88.84,-474364.98,1032587.32,558222.34
1974-06-20,88.21,-0.63,-0.71,120.24,-26.64,True,1,11624,-88.21,-474453.19,1025353.04,550899.85
1974-06-21,87.46,-0.75,-0.85,120.24,-27.26,True,1,11625,-87.46,-474540.65,1016722.5,542181.85
1974-06-24,87.69,0.23,0.26,120.24,-27.07,True,1,11626,-87.69,-474628.34,1019483.94,544855.6
1974-06-25,88.98,1.29,1.47,120.24,-26.0,True,1,11627,-88.98,-474717.32,1034570.46,559853.14
1974-06-26,87.61,-1.37,-1.54,120.24,-27.14,True,1,11628,-87.61,-474804.93,1018729.08,543924.15
1974-06-27,86.31,-1.3,-1.48,120.24,-28.22,True,1,11629,-86.31,-474891.24,1003698.99,528807.75
1974-06-28,86.0,-0.31,-0.36,120.24,-28.48,True,1,11630,-86.0,-474977.24,1000180.0,525202.76
1974-07-01,86.02,0.02,0.02,120.24,-28.46,True,1,11631,-86.02,-475063.26,1000498.62,525435.36
1974-07-02,84.3,-1.72,-2.0,120.24,-29.89,True,1,11632,-84.3,-475147.56,980577.6,505430.04
1974-07-03,84.25,-0.05,-0.06,120.24,-29.93,True,1,11633,-84.25,-475231.81,980080.25,504848.44
1974-07-05,83.66,-0.59,-0.7,120.24,-30.42,True,1,11634,-83.66,-475315.47,973300.44,497984.97
1974-07-08,81.09,-2.57,-3.07,120.24,-32.56,True,1,11635,-81.09,-475396.56,943482.15,468085.59
1974-07-09,81.48,0.39,0.48,120.24,-32.24,True,1,11636,-81.48,-475478.04,948101.28,472623.24
1974-07-10,79.99,-1.49,-1.83,120.24,-33.48,True,1,11637,-79.99,-475558.03,930843.63,455285.6
1974-07-11,79.89,-0.1,-0.12,120.24,-33.56,True,1,11638,-79.89,-475637.92,929759.82,454121.9
1974-07-12,83.15,3.26,4.08,120.24,-30.85,True,1,11639,-83.15,-475721.07,967782.85,492061.78
1974-07-15,83.78,0.63,0.76,120.24,-30.32,True,1,11640,-83.78,-475804.85,975199.2,499394.35
1974-07-16,82.81,-0.97,-1.16,120.24,-31.13,True,1,11641,-82.81,-475887.66,963991.21,488103.55
1974-07-17,83.7,0.89,1.08,120.24,-30.39,True,1,11642,-83.7,-475971.36,974435.4,498464.04
1974-07-18,83.78,0.08,0.1,120.24,-30.32,True,1,11643,-83.78,-476055.14,975450.54,499395.4
1974-07-19,83.54,-0.24,-0.29,120.24,-30.52,True,1,11644,-83.54,-476138.68,972739.76,496601.08
1974-07-22,83.81,0.27,0.32,120.24,-30.3,True,1,11645,-83.81,-476222.49,975967.45,499744.96
1974-07-23,84.65,0.84,1.0,120.24,-29.6,True,1,11646,-84.65,-476307.14,985833.9,509526.76
1974-07-24,84.99,0.34,0.4,120.24,-29.32,True,1,11647,-84.99,-476392.13,989878.53,513486.4
1974-07-25,83.98,-1.01,-1.19,120.24,-30.16,True,1,11648,-83.98,-476476.11,978199.04,501722.93
1974-07-26,82.4,-1.58,-1.88,120.24,-31.47,True,1,11649,-82.4,-476558.51,959877.6,483319.09
1974-07-29,80.94,-1.46,-1.77,120.24,-32.68,True,1,11650,-80.94,-476639.45,942951.0,466311.55
1974-07-30,80.5,-0.44,-0.54,120.24,-33.05,True,1,11651,-80.5,-476719.95,937905.5,461185.55
1974-07-31,79.31,-1.19,-1.48,120.24,-34.04,True,1,11652,-79.31,-476799.26,924120.12,447320.86
1974-08-01,78.75,-0.56,-0.71,120.24,-34.51,True,1,11653,-78.75,-476878.01,917673.75,440795.74
1974-08-02,78.59,-0.16,-0.2,120.24,-34.64,True,1,11654,-78.59,-476956.6,915887.86,438931.26
1974-08-05,79.29,0.7,0.89,120.24,-34.06,True,1,11655,-79.29,-477035.89,924124.95,447089.06
1974-08-06,80.52,1.23,1.55,120.24,-33.03,True,1,11656,-80.52,-477116.41,938541.12,461424.71
1974-08-07,82.65,2.13,2.64,120.24,-31.26,True,1,11657,-82.65,-477199.06,963451.05,486251.99
1974-08-08,81.57,-1.08,-1.31,120.24,-32.16,True,1,11658,-81.57,-477280.63,950943.06,473662.43
1974-08-09,80.86,-0.71,-0.87,120.24,-32.75,True,1,11659,-80.86,-477361.49,942746.74,465385.25
1974-08-12,79.75,-1.11,-1.37,120.24,-33.67,True,1,11660,-79.75,-477441.24,929885.0,452443.76
1974-08-13,78.49,-1.26,-1.58,120.24,-34.72,True,1,11661,-78.49,-477519.73,915271.89,437752.16
1974-08-14,76.73,-1.76,-2.24,120.24,-36.19,True,1,11662,-76.73,-477596.46,894825.26,417228.8
1974-08-15,76.3,-0.43,-0.56,120.24,-36.54,True,1,11663,-76.3,-477672.76,889886.9,412214.14
1974-08-16,75.67,-0.63,-0.83,120.24,-37.07,True,1,11664,-75.67,-477748.43,882614.88,404866.45
1974-08-19,74.57,-1.1,-1.45,120.24,-37.98,True,1,11665,-74.57,-477823.0,869859.05,392036.05
1974-08-20,74.95,0.38,0.51,120.24,-37.67,True,1,11666,-74.95,-477897.95,874366.7,396468.75
1974-08-21,73.51,-1.44,-1.92,120.24,-38.86,True,1,11667,-73.51,-477971.46,857641.17,379669.71
1974-08-22,72.8,-0.71,-0.97,120.24,-39.45,True,1,11668,-72.8,-478044.26,849430.4,371386.14
1974-08-23,71.55,-1.25,-1.72,120.24,-40.49,True,1,11669,-71.55,-478115.81,834916.95,356801.14
1974-08-26,72.16,0.61,0.85,120.24,-39.99,True,1,11670,-72.16,-478187.97,842107.2,363919.23
1974-08-27,70.94,-1.22,-1.69,120.24,-41.0,True,1,11671,-70.94,-478258.91,827940.74,349681.83
1974-08-28,70.76,-0.18,-0.25,120.24,-41.15,True,1,11672,-70.76,-478329.67,825910.72,347581.05
1974-08-29,69.99,-0.77,-1.09,120.24,-41.79,True,1,11673,-69.99,-478399.66,816993.27,338593.61
1974-08-30,72.15,2.16,3.09,120.24,-39.99,True,1,11674,-72.15,-478471.81,842279.1,363807.29
1974-09-03,70.52,-1.63,-2.26,120.24,-41.35,True,1,11675,-70.52,-478542.33,823321.0,344778.67
1974-09-04,68.69,-1.83,-2.6,120.24,-42.87,True,1,11676,-68.69,-478611.02,802024.44,323413.42
1974-09-05,70.87,2.18,3.17,120.24,-41.06,True,1,11677,-70.87,-478681.89,827548.99,348867.1
1974-09-06,71.42,0.55,0.78,120.24,-40.6,True,1,11678,-71.42,-478753.31,834042.76,355289.45
1974-09-09,69.72,-1.7,-2.38,120.24,-42.02,True,1,11679,-69.72,-478823.03,814259.88,335436.85
1974-09-10,69.24,-0.48,-0.69,120.24,-42.42,True,1,11680,-69.24,-478892.27,808723.2,329830.93
1974-09-11,68.55,-0.69,-1.0,120.24,-42.99,True,1,11681,-68.55,-478960.82,800732.55,321771.73
1974-09-12,66.71,-1.84,-2.68,120.24,-44.52,True,1,11682,-66.71,-479027.53,779306.22,300278.69
1974-09-13,65.2,-1.51,-2.26,120.24,-45.78,True,1,11683,-65.2,-479092.73,761731.6,282638.87
1974-09-16,66.26,1.06,1.63,120.24,-44.89,True,1,11684,-66.26,-479158.99,774181.84,295022.85
1974-09-17,67.38,1.12,1.69,120.24,-43.96,True,1,11685,-67.38,-479226.37,787335.3,308108.93
1974-09-18,67.72,0.34,0.5,120.24,-43.68,True,1,11686,-67.72,-479294.09,791375.92,312081.83
1974-09-19,70.09,2.37,3.5,120.24,-41.71,True,1,11687,-70.09,-479364.18,819141.83,339777.65
1974-09-20,70.14,0.05,0.07,120.24,-41.67,True,1,11688,-70.14,-479434.32,819796.32,340362.0
1974-09-23,69.42,-0.72,-1.03,120.24,-42.26,True,1,11689,-69.42,-479503.74,811450.38,331946.64
1974-09-24,68.02,-1.4,-2.02,120.24,-43.43,True,1,11690,-68.02,-479571.76,795153.8,315582.04
1974-09-25,67.57,-0.45,-0.66,120.24,-43.8,True,1,11691,-67.57,-479639.33,789960.87,310321.54
1974-09-26,66.46,-1.11,-1.64,120.24,-44.73,True,1,11692,-66.46,-479705.79,777050.32,297344.53
1974-09-27,64.94,-1.52,-2.29,120.24,-45.99,True,1,11693,-64.94,-479770.73,759343.42,279572.69
1974-09-30,63.54,-1.4,-2.16,120.24,-47.16,True,1,11694,-63.54,-479834.27,743036.76,263202.49
1974-10-01,63.39,-0.15,-0.24,120.24,-47.28,True,1,11695,-63.39,-479897.66,741346.05,261448.39
1974-10-02,63.38,-0.01,-0.02,120.24,-47.29,True,1,11696,-63.38,-479961.04,741292.48,261331.44
1974-10-03,62.28,-1.1,-1.74,120.24,-48.2,True,1,11697,-62.28,-480023.32,728489.16,248465.84
1974-10-04,62.34,0.06,0.1,120.24,-48.15,True,1,11698,-62.34,-480085.66,729253.32,249167.66
1974-10-07,64.95,2.61,4.19,120.24,-45.98,True,1,11699,-64.95,-480150.61,759850.05,279699.44
1974-10-08,64.84,-0.11,-0.17,120.24,-46.08,True,1,11700,-64.84,-480215.45,758628.0,278412.55
1974-10-09,67.82,2.98,4.6,120.24,-43.6,True,1,11701,-67.82,-480283.27,793561.82,313278.55
1974-10-10,69.79,1.97,2.9,120.24,-41.96,True,1,11702,-69.79,-480353.06,816682.58,336329.52
1974-10-11,71.14,1.35,1.93,120.24,-40.84,True,1,11703,-71.14,-480424.2,832551.42,352127.22
1974-10-14,72.74,1.6,2.25,120.24,-39.5,True,1,11704,-72.74,-480496.94,851348.96,370852.02
1974-10-15,71.44,-1.3,-1.79,120.24,-40.58,True,1,11705,-71.44,-480568.38,836205.2,355636.82
1974-10-16,70.33,-1.11,-1.55,120.24,-41.51,True,1,11706,-70.33,-480638.71,823282.98,342644.27
1974-10-17,71.17,0.84,1.19,120.24,-40.81,True,1,11707,-71.17,-480709.88,833187.19,352477.31
1974-10-18,72.28,1.11,1.56,120.24,-39.89,True,1,11708,-72.28,-480782.16,846254.24,365472.08
1974-10-21,73.5,1.22,1.69,120.24,-38.87,True,1,11709,-73.5,-480855.66,860611.5,379755.84
1974-10-22,73.13,-0.37,-0.5,120.24,-39.18,True,1,11710,-73.13,-480928.79,856352.3,375423.51
1974-10-23,71.03,-2.1,-2.87,120.24,-40.93,True,1,11711,-71.03,-480999.82,831832.33,350832.51
1974-10-24,70.22,-0.81,-1.14,120.24,-41.6,True,1,11712,-70.22,-481070.04,822416.64,341346.6
1974-10-25,70.12,-0.1,-0.14,120.24,-41.68,True,1,11713,-70.12,-481140.16,821315.56,340175.4
1974-10-28,70.09,-0.03,-0.04,120.24,-41.71,True,1,11714,-70.09,-481210.25,821034.26,339824.01
1974-10-29,72.83,2.74,3.91,120.24,-39.43,True,1,11715,-72.83,-481283.08,853203.45,371920.37
1974-10-30,74.31,1.48,2.03,120.24,-38.2,True,1,11716,-74.31,-481357.39,870615.96,389258.57
1974-10-31,73.9,-0.41,-0.55,120.24,-38.54,True,1,11717,-73.9,-481431.29,865886.3,384455.01
1974-11-01,73.88,-0.02,-0.03,120.24,-38.56,True,1,11718,-73.88,-481505.17,865725.84,384220.67
1974-11-04,73.08,-0.8,-1.08,120.24,-39.22,True,1,11719,-73.08,-481578.25,856424.52,374846.27
1974-11-05,75.11,2.03,2.78,120.24,-37.53,True,1,11720,-75.11,-481653.36,880289.2,398635.84
1974-11-06,74.75,-0.36,-0.48,120.24,-37.83,True,1,11721,-74.75,-481728.11,876144.75,394416.64
1974-11-07,75.21,0.46,0.62,120.24,-37.45,True,1,11722,-75.21,-481803.32,881611.62,399808.3
1974-11-08,74.91,-0.3,-0.4,120.24,-37.7,True,1,11723,-74.91,-481878.23,878169.93,396291.7
1974-11-11,75.15,0.24,0.32,120.24,-37.5,True,1,11724,-75.15,-481953.38,881058.6,399105.22
1974-11-12,73.67,-1.48,-1.97,120.24,-38.73,True,1,11725,-73.67,-482027.05,863780.75,381753.7
1974-11-13,73.35,-0.32,-0.43,120.24,-39.0,True,1,11726,-73.35,-482100.4,860102.1,378001.7
1974-11-14,73.06,-0.29,-0.4,120.24,-39.24,True,1,11727,-73.06,-482173.46,856774.62,374601.16
1974-11-15,71.91,-1.15,-1.57,120.24,-40.2,True,1,11728,-71.91,-482245.37,843360.48,361115.11
1974-11-18,69.27,-2.64,-3.67,120.24,-42.39,True,1,11729,-69.27,-482314.64,812467.83,330153.19
1974-11-19,68.2,-1.07,-1.54,120.24,-43.28,True,1,11730,-68.2,-482382.84,799986.0,317603.16
1974-11-20,67.9,-0.3,-0.44,120.24,-43.53,True,1,11731,-67.9,-482450.74,796534.9,314084.16
1974-11-21,68.18,0.28,0.41,120.24,-43.3,True,1,11732,-68.18,-482518.92,799887.76,317368.84
1974-11-22,68.9,0.72,1.06,120.24,-42.7,True,1,11733,-68.9,-482587.82,808403.7,325815.88
1974-11-25,68.83,-0.07,-0.1,120.24,-42.76,True,1,11734,-68.83,-482656.65,807651.22,324994.57
1974-11-26,69.47,0.64,0.93,120.24,-42.22,True,1,11735,-69.47,-482726.12,815230.45,332504.33
1974-11-27,69.94,0.47,0.68,120.24,-41.83,True,1,11736,-69.94,-482796.06,820815.84,338019.78
1974-11-29,69.97,0.03,0.04,120.24,-41.81,True,1,11737,-69.97,-482866.03,821237.89,338371.86
1974-12-02,68.11,-1.86,-2.66,120.24,-43.36,True,1,11738,-68.11,-482934.14,799475.18,316541.04
1974-12-03,67.17,-0.94,-1.38,120.24,-44.14,True,1,11739,-67.17,-483001.31,788508.63,305507.32
1974-12-04,67.41,0.24,0.36,120.24,-43.94,True,1,11740,-67.41,-483068.72,791393.4,308324.68
1974-12-05,66.13,-1.28,-1.9,120.24,-45.0,True,1,11741,-66.13,-483134.85,776432.33,293297.48
1974-12-06,65.01,-1.12,-1.69,120.24,-45.93,True,1,11742,-65.01,-483199.86,763347.42,280147.56
1974-12-09,65.6,0.59,0.91,120.24,-45.44,True,1,11743,-65.6,-483265.46,770340.8,287075.34
1974-12-10,67.28,1.68,2.56,120.24,-44.04,True,1,11744,-67.28,-483332.74,790136.32,306803.58
1974-12-11,67.67,0.39,0.58,120.24,-43.72,True,1,11745,-67.67,-483400.41,794784.15,311383.74
1974-12-12,67.45,-0.22,-0.32,120.24,-43.9,True,1,11746,-67.45,-483467.86,792267.7,308799.84
1974-12-13,67.07,-0.38,-0.56,120.24,-44.22,True,1,11747,-67.07,-483534.93,787871.29,304336.36
1974-12-16,66.46,-0.61,-0.91,120.24,-44.73,True,1,11748,-66.46,-483601.39,780772.08,297170.69
1974-12-17,67.58,1.12,1.68,120.24,-43.8,True,1,11749,-67.58,-483668.97,793997.42,310328.45
1974-12-18,67.9,0.32,0.47,120.24,-43.53,True,1,11750,-67.9,-483736.87,797825.0,314088.13
1974-12-19,67.65,-0.25,-0.37,120.24,-43.74,True,1,11751,-67.65,-483804.52,794955.15,311150.63
1974-12-20,66.91,-0.74,-1.09,120.24,-44.35,True,1,11752,-66.91,-483871.43,786326.32,302454.89
1974-12-23,65.96,-0.95,-1.42,120.24,-45.14,True,1,11753,-65.96,-483937.39,775227.88,291290.49
1974-12-24,66.88,0.92,1.4,120.24,-44.38,True,1,11754,-66.88,-484004.27,786107.52,302103.25
1974-12-26,67.44,0.56,0.84,120.24,-43.91,True,1,11755,-67.44,-484071.71,792757.2,308685.49
1974-12-27,67.14,-0.3,-0.44,120.24,-44.16,True,1,11756,-67.14,-484138.85,789297.84,305158.99
1974-12-30,67.16,0.02,0.03,120.24,-44.14,True,1,11757,-67.16,-484206.01,789600.12,305394.11
1974-12-31,68.56,1.4,2.08,120.24,-42.98,True,1,11758,-68.56,-484274.57,806128.48,321853.91
1975-01-02,70.23,1.67,2.44,120.24,-41.59,True,1,11759,-70.23,-484344.8,825834.57,341489.77
1975-01-03,70.71,0.48,0.68,120.24,-41.19,True,1,11760,-70.71,-484415.51,831549.6,347134.09
1975-01-06,71.07,0.36,0.51,120.24,-40.89,True,1,11761,-71.07,-484486.58,835854.27,351367.69
1975-01-07,71.02,-0.05,-0.07,120.24,-40.94,True,1,11762,-71.02,-484557.6,835337.24,350779.64
1975-01-08,70.04,-0.98,-1.38,120.24,-41.75,True,1,11763,-70.04,-484627.64,823880.52,339252.88
1975-01-09,71.17,1.13,1.61,120.24,-40.81,True,1,11764,-71.17,-484698.81,837243.88,352545.07
1975-01-10,72.61,1.44,2.02,120.24,-39.61,True,1,11765,-72.61,-484771.42,854256.65,369485.23
1975-01-13,72.31,-0.3,-0.41,120.24,-39.86,True,1,11766,-72.31,-484843.73,850799.46,365955.73
1975-01-14,71.68,-0.63,-0.87,120.24,-40.39,True,1,11767,-71.68,-484915.41,843458.56,358543.15
1975-01-15,72.14,0.46,0.64,120.24,-40.0,True,1,11768,-72.14,-484987.55,848943.52,363955.97
1975-01-16,72.05,-0.09,-0.12,120.24,-40.08,True,1,11769,-72.05,-485059.6,847956.45,362896.85
1975-01-17,70.96,-1.09,-1.51,120.24,-40.98,True,1,11770,-70.96,-485130.56,835199.2,350068.64
1975-01-20,71.08,0.12,0.17,120.24,-40.88,True,1,11771,-71.08,-485201.64,836682.68,351481.04
1975-01-21,70.7,-0.38,-0.54,120.24,-41.2,True,1,11772,-70.7,-485272.34,832280.4,347008.06
1975-01-22,71.74,1.04,1.47,120.24,-40.34,True,1,11773,-71.74,-485344.08,844595.02,359250.94
1975-01-23,72.07,0.33,0.46,120.24,-40.06,True,1,11774,-72.07,-485416.15,848552.18,363136.03
1975-01-24,72.98,0.91,1.26,120.24,-39.3,True,1,11775,-72.98,-485489.13,859339.5,373850.37
1975-01-27,75.37,2.39,3.28,120.24,-37.32,True,1,11776,-75.37,-485564.5,887557.12,401992.62
1975-01-28,76.03,0.66,0.88,120.24,-36.77,True,1,11777,-76.03,-485640.53,895405.31,409764.78
1975-01-29,77.26,1.23,1.62,120.24,-35.74,True,1,11778,-77.26,-485717.79,909968.28,424250.49
1975-01-30,76.21,-1.05,-1.36,120.24,-36.62,True,1,11779,-76.21,-485794.0,897677.59,411883.59
1975-01-31,76.98,0.77,1.01,120.24,-35.98,True,1,11780,-76.98,-485870.98,906824.4,420953.42
1975-02-03,77.82,0.84,1.09,120.24,-35.28,True,1,11781,-77.82,-485948.8,916797.42,430848.62
1975-02-04,77.61,-0.21,-0.27,120.24,-35.45,True,1,11782,-77.61,-486026.41,914401.02,428374.61
1975-02-05,78.95,1.34,1.73,120.24,-34.34,True,1,11783,-78.95,-486105.36,930267.85,444162.49
1975-02-06,78.56,-0.39,-0.49,120.24,-34.66,True,1,11784,-78.56,-486183.92,925751.04,439567.12
1975-02-07,78.63,0.07,0.09,120.24,-34.61,True,1,11785,-78.63,-486262.55,926654.55,440392.0
1975-02-10,78.36,-0.27,-0.34,120.24,-34.83,True,1,11786,-78.36,-486340.91,923550.96,437210.05
1975-02-11,78.58,0.22,0.28,120.24,-34.65,True,1,11787,-78.58,-486419.49,926222.46,439802.97
1975-02-12,79.92,1.34,1.7,120.24,-33.53,True,1,11788,-79.92,-486499.41,942096.96,455597.55
1975-02-13,81.01,1.09,1.36,120.24,-32.63,True,1,11789,-81.01,-486580.42,955026.89,468446.47
1975-02-14,81.5,0.49,0.6,120.24,-32.22,True,1,11790,-81.5,-486661.92,960885.0,474223.08
1975-02-18,80.93,-0.57,-0.7,120.24,-32.69,True,1,11791,-80.93,-486742.85,954245.63,467502.78
1975-02-19,81.44,0.51,0.63,120.24,-32.27,True,1,11792,-81.44,-486824.29,960340.48,473516.19
1975-02-20,82.21,0.77,0.94,120.24,-31.63,True,1,11793,-82.21,-486906.5,969502.53,482596.03
1975-02-21,82.62,0.41,0.5,120.24,-31.29,True,1,11794,-82.62,-486989.12,974420.28,487431.16
1975-02-24,81.44,-1.18,-1.43,120.24,-32.27,True,1,11795,-81.44,-487070.56,960584.8,473514.24
1975-02-25,79.53,-1.91,-2.35,120.24,-33.86,True,1,11796,-79.53,-487150.09,938135.88,450985.79
1975-02-26,80.37,0.84,1.06,120.24,-33.16,True,1,11797,-80.37,-487230.46,948124.89,460894.43
1975-02-27,80.77,0.4,0.5,120.24,-32.83,True,1,11798,-80.77,-487311.23,952924.46,465613.23
1975-02-28,81.59,0.82,1.01,120.24,-32.14,True,1,11799,-81.59,-487392.82,962680.41,475287.59
1975-03-03,83.03,1.44,1.76,120.24,-30.95,True,1,11800,-83.03,-487475.85,979754.0,492278.15
1975-03-04,83.56,0.53,0.64,120.24,-30.51,True,1,11801,-83.56,-487559.41,986091.56,498532.15
1975-03-05,83.9,0.34,0.41,120.24,-30.22,True,1,11802,-83.9,-487643.31,990187.8,502544.49
1975-03-06,83.69,-0.21,-0.25,120.24,-30.4,True,1,11803,-83.69,-487727.0,987793.07,500066.07
1975-03-07,84.3,0.61,0.73,120.24,-29.89,True,1,11804,-84.3,-487811.3,995077.2,507265.9
1975-03-10,84.95,0.65,0.77,120.24,-29.35,True,1,11805,-84.95,-487896.25,1002834.75,514938.5
1975-03-11,84.36,-0.59,-0.7,120.24,-29.84,True,1,11806,-84.36,-487980.61,995954.16,507973.55
1975-03-12,83.59,-0.77,-0.91,120.24,-30.48,True,1,11807,-83.59,-488064.2,986947.13,498882.93
1975-03-13,83.74,0.15,0.18,120.24,-30.36,True,1,11808,-83.74,-488147.94,988801.92,500653.98
1975-03-14,84.76,1.02,1.22,120.24,-29.51,True,1,11809,-84.76,-488232.7,1000930.84,512698.14
1975-03-17,86.01,1.25,1.48,120.24,-28.47,True,1,11810,-86.01,-488318.71,1015778.1,527459.39
1975-03-18,85.13,-0.88,-1.02,120.24,-29.2,True,1,11811,-85.13,-488403.84,1005470.43,517066.59
1975-03-19,84.34,-0.79,-0.93,120.24,-29.86,True,1,11812,-84.34,-488488.18,996224.08,507735.9
1975-03-20,83.61,-0.73,-0.87,120.24,-30.46,True,1,11813,-83.61,-488571.79,987684.93,499113.14
1975-03-21,83.39,-0.22,-0.26,120.24,-30.65,True,1,11814,-83.39,-488655.18,985169.46,496514.28
1975-03-24,81.42,-1.97,-2.36,120.24,-32.28,True,1,11815,-81.42,-488736.6,961977.3,473240.7
1975-03-25,82.06,0.64,0.79,120.24,-31.75,True,1,11816,-82.06,-488818.66,969620.96,480802.3
1975-03-26,83.59,1.53,1.86,120.24,-30.48,True,1,11817,-83.59,-488902.25,987783.03,498880.78
1975-03-27,83.85,0.26,0.31,120.24,-30.26,True,1,11818,-83.85,-488986.1,990939.3,501953.2
1975-03-31,83.36,-0.49,-0.58,120.24,-30.67,True,1,11819,-83.36,-489069.46,985231.84,496162.38
1975-04-01,82.64,-0.72,-0.86,120.24,-31.27,True,1,11820,-82.64,-489152.1,976804.8,487652.7
1975-04-02,82.43,-0.21,-0.25,120.24,-31.44,True,1,11821,-82.43,-489234.53,974405.03,485170.5
1975-04-03,81.51,-0.92,-1.12,120.24,-32.21,True,1,11822,-81.51,-489316.04,963611.22,474295.18
1975-04-04,80.88,-0.63,-0.77,120.24,-32.74,True,1,11823,-80.88,-489396.92,956244.24,466847.32
1975-04-07,80.35,-0.53,-0.66,120.24,-33.17,True,1,11824,-80.35,-489477.27,950058.4,460581.13
1975-04-08,80.99,0.64,0.8,120.24,-32.64,True,1,11825,-80.99,-489558.26,957706.75,468148.49
1975-04-09,82.84,1.85,2.28,120.24,-31.1,True,1,11826,-82.84,-489641.1,979665.84,490024.74
1975-04-10,83.77,0.93,1.12,120.24,-30.33,True,1,11827,-83.77,-489724.87,990747.79,501022.92
1975-04-11,84.18,0.41,0.49,120.24,-29.99,True,1,11828,-84.18,-489809.05,995681.04,505871.99
1975-04-14,85.6,1.42,1.69,120.24,-28.81,True,1,11829,-85.6,-489894.65,1012562.4,522667.75
1975-04-15,86.3,0.7,0.82,120.24,-28.23,True,1,11830,-86.3,-489980.95,1020929.0,530948.05
1975-04-16,86.6,0.3,0.35,120.24,-27.98,True,1,11831,-86.6,-490067.55,1024564.6,534497.05
1975-04-17,87.25,0.65,0.75,120.24,-27.44,True,1,11832,-87.25,-490154.8,1032342.0,542187.2
1975-04-18,86.3,-0.95,-1.09,120.24,-28.23,True,1,11833,-86.3,-490241.1,1021187.9,530946.8
1975-04-21,87.23,0.93,1.08,120.24,-27.45,True,1,11834,-87.23,-490328.33,1032279.82,541951.49
1975-04-22,87.09,-0.14,-0.16,120.24,-27.57,True,1,11835,-87.09,-490415.42,1030710.15,540294.73
1975-04-23,86.12,-0.97,-1.11,120.24,-28.38,True,1,11836,-86.12,-490501.54,1019316.32,528814.78
1975-04-24,86.04,-0.08,-0.09,120.24,-28.44,True,1,11837,-86.04,-490587.58,1018455.48,527867.9
1975-04-25,86.62,0.58,0.67,120.24,-27.96,True,1,11838,-86.62,-490674.2,1025407.56,534733.36
1975-04-28,86.23,-0.39,-0.45,120.24,-28.28,True,1,11839,-86.23,-490760.43,1020876.97,530116.54
1975-04-29,85.64,-0.59,-0.68,120.24,-28.78,True,1,11840,-85.64,-490846.07,1013977.6,523131.53
1975-04-30,87.3,1.66,1.94,120.24,-27.4,True,1,11841,-87.3,-490933.37,1033719.3,542785.93
1975-05-01,88.1,0.8,0.92,120.24,-26.73,True,1,11842,-88.1,-491021.47,1043280.2,552258.73
1975-05-02,89.22,1.12,1.27,120.24,-25.8,True,1,11843,-89.22,-491110.69,1056632.46,565521.77
1975-05-05,90.08,0.86,0.96,120.24,-25.08,True,1,11844,-90.08,-491200.77,1066907.52,575706.75
1975-05-06,88.64,-1.44,-1.6,120.24,-26.28,True,1,11845,-88.64,-491289.41,1049940.8,558651.39
1975-05-07,89.08,0.44,0.5,120.24,-25.92,True,1,11846,-89.08,-491378.49,1055241.68,563863.19
1975-05-08,89.56,0.48,0.54,120.24,-25.52,True,1,11847,-89.56,-491468.05,1061017.32,569549.27
1975-05-09,90.53,0.97,1.08,120.24,-24.71,True,1,11848,-90.53,-491558.58,1072599.44,581040.86
1975-05-12,90.61,0.08,0.09,120.24,-24.64,True,1,11849,-90.61,-491649.19,1073637.89,581988.7
1975-05-13,91.58,0.97,1.07,120.24,-23.84,True,1,11850,-91.58,-491740.77,1085223.0,593482.23
1975-05-14,92.27,0.69,0.75,120.24,-23.26,True,1,11851,-92.27,-491833.04,1093491.77,601658.73
1975-05-15,91.41,-0.86,-0.93,120.24,-23.98,True,1,11852,-91.41,-491924.45,1083391.32,591466.87
1975-05-16,90.43,-0.98,-1.07,120.24,-24.79,True,1,11853,-90.43,-492014.88,1071866.79,579851.91
1975-05-19,90.53,0.1,0.11,120.24,-24.71,True,1,11854,-90.53,-492105.41,1073142.62,581037.21
1975-05-20,90.07,-0.46,-0.51,120.24,-25.09,True,1,11855,-90.07,-492195.48,1067779.85,575584.37
1975-05-21,89.06,-1.01,-1.12,120.24,-25.93,True,1,11856,-89.06,-492284.54,1055895.36,563610.82
1975-05-22,89.39,0.33,0.37,120.24,-25.66,True,1,11857,-89.39,-492373.93,1059897.23,567523.3
1975-05-23,90.58,1.19,1.33,120.24,-24.67,True,1,11858,-90.58,-492464.51,1074097.64,581633.13
1975-05-27,90.34,-0.24,-0.26,120.24,-24.87,True,1,11859,-90.34,-492554.85,1071342.06,578787.21
1975-05-28,89.71,-0.63,-0.7,120.24,-25.39,True,1,11860,-89.71,-492644.56,1063960.6,571316.04
1975-05-29,89.68,-0.03,-0.03,120.24,-25.42,True,1,11861,-89.68,-492734.24,1063694.48,570960.24
1975-05-30,91.15,1.47,1.64,120.24,-24.19,True,1,11862,-91.15,-492825.39,1081221.3,588395.91
1975-06-02,92.58,1.43,1.57,120.24,-23.0,True,1,11863,-92.58,-492917.97,1098276.54,605358.57
1975-06-03,92.89,0.31,0.34,120.24,-22.75,True,1,11864,-92.89,-493010.86,1102046.96,609036.1
1975-06-04,92.6,-0.29,-0.31,120.24,-22.99,True,1,11865,-92.6,-493103.46,1098699.0,605595.54
1975-06-05,92.69,0.09,0.1,120.24,-22.91,True,1,11866,-92.69,-493196.15,1099859.54,606663.39
1975-06-06,92.48,-0.21,-0.23,120.24,-23.09,True,1,11867,-92.48,-493288.63,1097460.16,604171.53
1975-06-09,91.21,-1.27,-1.37,120.24,-24.14,True,1,11868,-91.21,-493379.84,1082480.28,589100.44
1975-06-10,90.44,-0.77,-0.84,120.24,-24.78,True,1,11869,-90.44,-493470.28,1073432.36,579962.08
1975-06-11,90.55,0.11,0.12,120.24,-24.69,True,1,11870,-90.55,-493560.83,1074828.5,581267.67
1975-06-12,90.08,-0.47,-0.52,120.24,-25.08,True,1,11871,-90.08,-493650.91,1069339.68,575688.77
1975-06-13,90.52,0.44,0.49,120.24,-24.72,True,1,11872,-90.52,-493741.43,1074653.44,580912.01
1975-06-16,91.46,0.94,1.04,120.24,-23.94,True,1,11873,-91.46,-493832.89,1085904.58,592071.69
1975-06-17,90.58,-0.88,-0.96,120.24,-24.67,True,1,11874,-90.58,-493923.47,1075546.92,581623.45
1975-06-18,90.39,-0.19,-0.21,120.24,-24.82,True,1,11875,-90.39,-494013.86,1073381.25,579367.39
1975-06-19,92.02,1.63,1.8,120.24,-23.47,True,1,11876,-92.02,-494105.88,1092829.52,598723.64
1975-06-20,92.61,0.59,0.64,120.24,-22.98,True,1,11877,-92.61,-494198.49,1099928.97,605730.48
1975-06-23,93.62,1.01,1.09,120.24,-22.14,True,1,11878,-93.62,-494292.11,1112018.36,617726.25
1975-06-24,94.19,0.57,0.61,120.24,-21.66,True,1,11879,-94.19,-494386.3,1118883.01,624496.71
1975-06-25,94.62,0.43,0.46,120.24,-21.31,True,1,11880,-94.62,-494480.92,1124085.6,629604.68
1975-06-26,94.81,0.19,0.2,120.24,-21.15,True,1,11881,-94.81,-494575.73,1126437.61,631861.88
1975-06-27,94.81,0.0,0.0,120.24,-21.15,True,1,11882,-94.81,-494670.54,1126532.42,631861.88
1975-06-30,95.19,0.38,0.4,120.24,-20.83,True,1,11883,-95.19,-494765.73,1131142.77,636377.04
1975-07-01,94.85,-0.34,-0.36,120.24,-21.12,True,1,11884,-94.85,-494860.58,1127197.4,632336.82
1975-07-02,94.18,-0.67,-0.71,120.24,-21.67,True,1,11885,-94.18,-494954.76,1119329.3,624374.54
1975-07-03,94.36,0.18,0.19,120.24,-21.52,True,1,11886,-94.36,-495049.12,1121562.96,626513.84
1975-07-07,93.54,-0.82,-0.87,120.24,-22.21,True,1,11887,-93.54,-495142.66,1111909.98,616767.32
1975-07-08,93.39,-0.15,-0.16,120.24,-22.33,True,1,11888,-93.39,-495236.05,1110220.32,614984.27
1975-07-09,94.8,1.41,1.51,120.24,-21.16,True,1,11889,-94.8,-495330.85,1127077.2,631746.35
1975-07-10,94.81,0.01,0.01,120.24,-21.15,True,1,11890,-94.81,-495425.66,1127290.9,631865.24
1975-07-11,94.66,-0.15,-0.16,120.24,-21.27,True,1,11891,-94.66,-495520.32,1125602.06,630081.74
1975-07-14,95.19,0.53,0.56,120.24,-20.83,True,1,11892,-95.19,-495615.51,1131999.48,636383.97
1975-07-15,95.61,0.42,0.44,120.24,-20.48,True,1,11893,-95.61,-495711.12,1137089.73,641378.61
1975-07-16,94.61,-1.0,-1.05,120.24,-21.32,True,1,11894,-94.61,-495805.73,1125291.34,629485.61
1975-07-17,93.63,-0.98,-1.04,120.24,-22.13,True,1,11895,-93.63,-495899.36,1113728.85,617829.49
1975-07-18,93.2,-0.43,-0.46,120.24,-22.49,True,1,11896,-93.2,-495992.56,1108707.2,612714.64
1975-07-21,92.44,-0.76,-0.82,120.24,-23.12,True,1,11897,-92.44,-496085.0,1099758.68,603673.68
1975-07-22,91.45,-0.99,-1.07,120.24,-23.94,True,1,11898,-91.45,-496176.45,1088072.1,591895.65
1975-07-23,90.18,-1.27,-1.39,120.24,-25.0,True,1,11899,-90.18,-496266.63,1073051.82,576785.19
1975-07-24,90.07,-0.11,-0.12,120.24,-25.09,True,1,11900,-90.07,-496356.7,1071833.0,575476.3
1975-07-25,89.29,-0.78,-0.87,120.24,-25.74,True,1,11901,-89.29,-496445.99,1062640.29,566194.3
1975-07-28,88.69,-0.6,-0.67,120.24,-26.24,True,1,11902,-88.69,-496534.68,1055588.38,559053.7
1975-07-29,88.19,-0.5,-0.56,120.24,-26.66,True,1,11903,-88.19,-496622.87,1049725.57,553102.7
1975-07-30,88.83,0.64,0.73,120.24,-26.12,True,1,11904,-88.83,-496711.7,1057432.32,560720.62
1975-07-31,88.75,-0.08,-0.09,120.24,-26.19,True,1,11905,-88.75,-496800.45,1056568.75,559768.3
1975-08-01,87.99,-0.76,-0.86,120.24,-26.82,True,1,11906,-87.99,-496888.44,1047608.94,550720.5
1975-08-04,87.15,-0.84,-0.96,120.24,-27.52,True,1,11907,-87.15,-496975.59,1037695.05,540719.46
1975-08-05,86.23,-0.92,-1.06,120.24,-28.28,True,1,11908,-86.23,-497061.82,1026826.84,529765.02
1975-08-06,86.25,0.02,0.02,120.24,-28.27,True,1,11909,-86.25,-497148.07,1027151.25,530003.18
1975-08-07,86.3,0.05,0.06,120.24,-28.23,True,1,11910,-86.3,-497234.37,1027833.0,530598.63
1975-08-08,86.02,-0.28,-0.32,120.24,-28.46,True,1,11911,-86.02,-497320.39,1024584.22,527263.83
1975-08-11,86.55,0.53,0.62,120.24,-28.02,True,1,11912,-86.55,-497406.94,1030983.6,533576.66
1975-08-12,87.12,0.57,0.66,120.24,-27.54,True,1,11913,-87.12,-497494.06,1037860.56,540366.5
1975-08-13,85.97,-1.15,-1.32,120.24,-28.5,True,1,11914,-85.97,-497580.03,1024246.58,526666.55
1975-08-14,85.6,-0.37,-0.43,120.24,-28.81,True,1,11915,-85.6,-497665.63,1019924.0,522258.37
1975-08-15,86.36,0.76,0.89,120.24,-28.18,True,1,11916,-86.36,-497751.99,1029065.76,531313.77
1975-08-18,86.2,-0.16,-0.18,120.24,-28.31,True,1,11917,-86.2,-497838.19,1027245.4,529407.21
1975-08-19,84.95,-1.25,-1.45,120.24,-29.35,True,1,11918,-84.95,-497923.14,1012434.1,514510.96
1975-08-20,83.22,-1.73,-2.04,120.24,-30.79,True,1,11919,-83.22,-498006.36,991899.18,493892.82
1975-08-21,83.07,-0.15,-0.18,120.24,-30.91,True,1,11920,-83.07,-498089.43,990194.4,492104.97
1975-08-22,84.28,1.21,1.46,120.24,-29.91,True,1,11921,-84.28,-498173.71,1004701.88,506528.17
1975-08-25,85.06,0.78,0.92,120.24,-29.26,True,1,11922,-85.06,-498258.77,1014085.32,515826.55
1975-08-26,83.96,-1.1,-1.29,120.24,-30.17,True,1,11923,-83.96,-498342.73,1001055.08,502712.35
1975-08-27,84.43,0.47,0.56,120.24,-29.78,True,1,11924,-84.43,-498427.16,1006743.32,508316.16
1975-08-28,86.4,1.97,2.33,120.24,-28.14,True,1,11925,-86.4,-498513.56,1030320.0,531806.44
1975-08-29,86.88,0.48,0.56,120.24,-27.74,True,1,11926,-86.88,-498600.44,1036130.88,537530.44
1975-09-02,85.48,-1.4,-1.61,120.24,-28.91,True,1,11927,-85.48,-498685.92,1019519.96,520834.04
1975-09-03,86.03,0.55,0.64,120.24,-28.45,True,1,11928,-86.03,-498771.95,1026165.84,527393.89
1975-09-04,86.2,0.17,0.2,120.24,-28.31,True,1,11929,-86.2,-498858.15,1028279.8,529421.65
1975-09-05,85.62,-0.58,-0.67,120.24,-28.79,True,1,11930,-85.62,-498943.77,1021446.6,522502.83
1975-09-08,85.89,0.27,0.32,120.24,-28.57,True,1,11931,-85.89,-499029.66,1024753.59,525723.93
1975-09-09,84.6,-1.29,-1.5,120.24,-29.64,True,1,11932,-84.6,-499114.26,1009447.2,510332.94
1975-09-10,83.79,-0.81,-0.96,120.24,-30.31,True,1,11933,-83.79,-499198.05,999866.07,500668.02
1975-09-11,83.45,-0.34,-0.41,120.24,-30.6,True,1,11934,-83.45,-499281.5,995892.3,496610.8
1975-09-12,83.3,-0.15,-0.18,120.24,-30.72,True,1,11935,-83.3,-499364.8,994185.5,494820.7
1975-09-15,82.88,-0.42,-0.5,120.24,-31.07,True,1,11936,-82.88,-499447.68,989255.68,489808.0
1975-09-16,82.09,-0.79,-0.95,120.24,-31.73,True,1,11937,-82.09,-499529.77,979908.33,480378.56
1975-09-17,82.37,0.28,0.34,120.24,-31.5,True,1,11938,-82.37,-499612.14,983333.06,483720.92
1975-09-18,84.06,1.69,2.05,120.24,-30.09,True,1,11939,-84.06,-499696.2,1003592.34,503896.14
1975-09-19,85.88,1.82,2.16,120.24,-28.58,True,1,11940,-85.88,-499782.08,1025407.2,525625.12
1975-09-22,85.07,-0.81,-0.94,120.24,-29.25,True,1,11941,-85.07,-499867.15,1015820.87,515953.72
1975-09-23,84.94,-0.13,-0.15,120.24,-29.36,True,1,11942,-84.94,-499952.09,1014353.48,514401.39
1975-09-24,85.74,0.8,0.94,120.24,-28.69,True,1,11943,-85.74,-500037.83,1023992.82,523954.99
1975-09-25,85.64,-0.1,-0.12,120.24,-28.78,True,1,11944,-85.64,-500123.47,1022884.16,522760.69
1975-09-26,86.19,0.55,0.64,120.24,-28.32,True,1,11945,-86.19,-500209.66,1029539.55,529329.89
1975-09-29,85.03,-1.16,-1.35,120.24,-29.28,True,1,11946,-85.03,-500294.69,1015768.38,515473.69
1975-09-30,83.87,-1.16,-1.36,120.24,-30.25,True,1,11947,-83.87,-500378.56,1001994.89,501616.33
1975-10-01,82.93,-0.94,-1.12,120.24,-31.03,True,1,11948,-82.93,-500461.49,990847.64,490386.15
1975-10-02,83.82,0.89,1.07,120.24,-30.29,True,1,11949,-83.82,-500545.31,1001565.18,501019.87
1975-10-03,85.95,2.13,2.54,120.24,-28.52,True,1,11950,-85.95,-500631.26,1027102.5,526471.24
1975-10-06,86.88,0.93,1.08,120.24,-27.74,True,1,11951,-86.88,-500718.14,1038302.88,537584.74
1975-10-07,86.77,-0.11,-0.13,120.24,-27.84,True,1,11952,-86.77,-500804.91,1037075.04,536270.13
1975-10-08,87.94,1.17,1.35,120.24,-26.86,True,1,11953,-87.94,-500892.85,1051146.82,550253.97
1975-10-09,88.37,0.43,0.49,120.24,-26.5,True,1,11954,-88.37,-500981.22,1056374.98,555393.76
1975-10-10,88.21,-0.16,-0.18,120.24,-26.64,True,1,11955,-88.21,-501069.43,1054550.55,553481.12
1975-10-13,89.46,1.25,1.42,120.24,-25.6,True,1,11956,-89.46,-501158.89,1069583.76,568424.87
1975-10-14,89.28,-0.18,-0.2,120.24,-25.75,True,1,11957,-89.28,-501248.17,1067520.96,566272.79
1975-10-15,89.23,-0.05,-0.06,120.24,-25.79,True,1,11958,-89.23,-501337.4,1067012.34,565674.94
1975-10-16,89.37,0.14,0.16,120.24,-25.67,True,1,11959,-89.37,-501426.77,1068775.83,567349.06
1975-10-17,88.86,-0.51,-0.57,120.24,-26.1,True,1,11960,-88.86,-501515.63,1062765.6,561249.97
1975-10-20,89.82,0.96,1.08,120.24,-25.3,True,1,11961,-89.82,-501605.45,1074337.02,572731.57
1975-10-21,90.56,0.74,0.82,120.24,-24.68,True,1,11962,-90.56,-501696.01,1083278.72,581582.71
1975-10-22,90.71,0.15,0.17,120.24,-24.56,True,1,11963,-90.71,-501786.72,1085163.73,583377.01
1975-10-23,91.24,0.53,0.58,120.24,-24.12,True,1,11964,-91.24,-501877.96,1091595.36,589717.4
1975-10-24,89.83,-1.41,-1.54,120.24,-25.29,True,1,11965,-89.83,-501967.79,1074815.95,572848.16
1975-10-27,89.73,-0.1,-0.11,120.24,-25.37,True,1,11966,-89.73,-502057.52,1073709.18,571651.66
1975-10-28,90.51,0.78,0.87,120.24,-24.73,True,1,11967,-90.51,-502148.03,1083133.17,580985.14
1975-10-29,89.39,-1.12,-1.24,120.24,-25.66,True,1,11968,-89.39,-502237.42,1069819.52,567582.1
1975-10-30,89.31,-0.08,-0.09,120.24,-25.72,True,1,11969,-89.31,-502326.73,1068951.39,566624.66
1975-10-31,89.04,-0.27,-0.3,120.24,-25.95,True,1,11970,-89.04,-502415.77,1065808.8,563393.03
1975-11-03,88.09,-0.95,-1.07,120.24,-26.74,True,1,11971,-88.09,-502503.86,1054525.39,552021.53
1975-11-04,88.51,0.42,0.48,120.24,-26.39,True,1,11972,-88.51,-502592.37,1059641.72,557049.35
1975-11-05,89.15,0.64,0.72,120.24,-25.86,True,1,11973,-89.15,-502681.52,1067392.95,564711.43
1975-11-06,89.55,0.4,0.45,120.24,-25.52,True,1,11974,-89.55,-502771.07,1072271.7,569500.63
1975-11-07,89.33,-0.22,-0.25,120.24,-25.71,True,1,11975,-89.33,-502860.4,1069726.75,566866.35
1975-11-10,89.34,0.01,0.01,120.24,-25.7,True,1,11976,-89.34,-502949.74,1069935.84,566986.1
1975-11-11,89.87,0.53,0.59,120.24,-25.26,True,1,11977,-89.87,-503039.61,1076372.99,573333.38
1975-11-12,91.19,1.32,1.47,120.24,-24.16,True,1,11978,-91.19,-503130.8,1092273.82,589143.02
1975-11-13,91.04,-0.15,-0.16,120.24,-24.28,True,1,11979,-91.04,-503221.84,1090568.16,587346.32
1975-11-14,90.97,-0.07,-0.08,120.24,-24.34,True,1,11980,-90.97,-503312.81,1089820.6,586507.79
1975-11-17,91.46,0.49,0.54,120.24,-23.94,True,1,11981,-91.46,-503404.27,1095782.26,592377.99
1975-11-18,91.0,-0.46,-0.5,120.24,-24.32,True,1,11982,-91.0,-503495.27,1090362.0,586866.73
1975-11-19,89.98,-1.02,-1.12,120.24,-25.17,True,1,11983,-89.98,-503585.25,1078230.34,574645.09
1975-11-20,89.64,-0.34,-0.38,120.24,-25.45,True,1,11984,-89.64,-503674.89,1074245.76,570570.87
1975-11-21,89.53,-0.11,-0.12,120.24,-25.54,True,1,11985,-89.53,-503764.42,1073017.05,569252.63
1975-11-24,89.7,0.17,0.19,120.24,-25.4,True,1,11986,-89.7,-503854.12,1075144.2,571290.08
1975-11-25,90.71,1.01,1.13,120.24,-24.56,True,1,11987,-90.71,-503944.83,1087340.77,583395.94
1975-11-26,90.94,0.23,0.25,120.24,-24.37,True,1,11988,-90.94,-504035.77,1090188.72,586152.95
1975-11-28,91.24,0.3,0.33,120.24,-24.12,True,1,11989,-91.24,-504127.01,1093876.36,589749.35
1975-12-01,90.67,-0.57,-0.62,120.24,-24.59,True,1,11990,-90.67,-504217.68,1087133.3,582915.62
1975-12-02,89.33,-1.34,-1.48,120.24,-25.71,True,1,11991,-89.33,-504307.01,1071156.03,566849.02
1975-12-03,87.6,-1.73,-1.94,120.24,-27.15,True,1,11992,-87.6,-504394.61,1050499.2,546104.59
1975-12-04,87.84,0.24,0.27,120.24,-26.95,True,1,11993,-87.84,-504482.45,1053465.12,548982.67
1975-12-05,86.82,-1.02,-1.16,120.24,-27.79,True,1,11994,-86.82,-504569.27,1041319.08,536749.81
1975-12-08,87.07,0.25,0.29,120.24,-27.59,True,1,11995,-87.07,-504656.34,1044404.65,539748.31
1975-12-09,87.3,0.23,0.26,120.24,-27.4,True,1,11996,-87.3,-504743.64,1047250.8,542507.16
1975-12-10,88.08,0.78,0.89,120.24,-26.75,True,1,11997,-88.08,-504831.72,1056695.76,551864.04
1975-12-11,87.8,-0.28,-0.32,120.24,-26.98,True,1,11998,-87.8,-504919.52,1053424.4,548504.88
1975-12-12,87.83,0.03,0.03,120.24,-26.95,True,1,11999,-87.83,-505007.35,1053872.17,548864.82
1975-12-15,88.09,0.26,0.3,120.24,-26.74,True,1,12000,-88.09,-505095.44,1057080.0,551984.56
1975-12-16,88.93,0.84,0.95,120.24,-26.04,True,1,12001,-88.93,-505184.37,1067248.93,562064.56
1975-12-17,89.15,0.22,0.25,120.24,-25.86,True,1,12002,-89.15,-505273.52,1069978.3,564704.78
1975-12-18,89.43,0.28,0.31,120.24,-25.62,True,1,12003,-89.43,-505362.95,1073428.29,568065.34
1975-12-19,88.8,-0.63,-0.7,120.24,-26.15,True,1,12004,-88.8,-505451.75,1065955.2,560503.45
1975-12-22,88.14,-0.66,-0.74,120.24,-26.7,True,1,12005,-88.14,-505539.89,1058120.7,552580.81
1975-12-23,88.73,0.59,0.67,120.24,-26.21,True,1,12006,-88.73,-505628.62,1065292.38,559663.76
1975-12-24,89.46,0.73,0.82,120.24,-25.6,True,1,12007,-89.46,-505718.08,1074146.22,568428.14
1975-12-26,90.25,0.79,0.88,120.24,-24.94,True,1,12008,-90.25,-505808.33,1083722.0,577913.67
1975-12-29,90.13,-0.12,-0.13,120.24,-25.04,True,1,12009,-90.13,-505898.46,1082371.17,576472.71
1975-12-30,89.77,-0.36,-0.4,120.24,-25.34,True,1,12010,-89.77,-505988.23,1078137.7,572149.47
1975-12-31,90.19,0.42,0.47,120.24,-24.99,True,1,12011,-90.19,-506078.42,1083272.09,577193.67
1976-01-02,90.9,0.71,0.79,120.24,-24.4,True,1,12012,-90.9,-506169.32,1091890.8,585721.48
1976-01-05,92.58,1.68,1.85,120.24,-23.0,True,1,12013,-92.58,-506261.9,1112163.54,605901.64
1976-01-06,93.53,0.95,1.03,120.24,-22.21,True,1,12014,-93.53,-506355.43,1123669.42,617313.99
1976-01-07,93.95,0.42,0.45,120.24,-21.86,True,1,12015,-93.95,-506449.38,1128809.25,622359.87
1976-01-08,94.58,0.63,0.67,120.24,-21.34,True,1,12016,-94.58,-506543.96,1136473.28,629929.32
1976-01-09,94.95,0.37,0.39,120.24,-21.03,True,1,12017,-94.95,-506638.91,1141014.15,634375.24
1976-01-12,96.33,1.38,1.45,120.24,-19.89,True,1,12018,-96.33,-506735.24,1157693.94,650958.7
1976-01-13,95.57,-0.76,-0.79,120.24,-20.52,True,1,12019,-95.57,-506830.81,1148655.83,641825.02
1976-01-14,97.13,1.56,1.63,120.24,-19.22,True,1,12020,-97.13,-506927.94,1167502.6,660574.66
1976-01-15,96.61,-0.52,-0.54,120.24,-19.65,True,1,12021,-96.61,-507024.55,1161348.81,654324.26
1976-01-16,97.0,0.39,0.4,120.24,-19.33,True,1,12022,-97.0,-507121.55,1166134.0,659012.45
1976-01-19,98.32,1.32,1.36,120.24,-18.23,True,1,12023,-98.32,-507219.87,1182101.36,674881.49
1976-01-20,98.86,0.54,0.55,120.24,-17.78,True,1,12024,-98.86,-507318.73,1188692.64,681373.91
1976-01-21,98.24,-0.62,-0.63,120.24,-18.3,True,1,12025,-98.24,-507416.97,1181336.0,673919.03
1976-01-22,98.04,-0.2,-0.2,120.24,-18.46,True,1,12026,-98.04,-507515.01,1179029.04,671514.03
1976-01-23,99.21,1.17,1.19,120.24,-17.49,True,1,12027,-99.21,-507614.22,1193198.67,685584.45
1976-01-26,99.68,0.47,0.47,120.24,-17.1,True,1,12028,-99.68,-507713.9,1198951.04,691237.14
1976-01-27,99.07,-0.61,-0.61,120.24,-17.61,True,1,12029,-99.07,-507812.97,1191713.03,683900.06
1976-01-28,98.53,-0.54,-0.55,120.24,-18.06,True,1,12030,-98.53,-507911.5,1185315.9,677404.4
1976-01-29,100.11,1.58,1.6,120.24,-16.74,True,1,12031,-100.11,-508011.61,1204423.41,696411.8
1976-01-30,100.86,0.75,0.75,120.24,-16.12,True,1,12032,-100.86,-508112.47,1213547.52,705435.05
1976-02-02,100.87,0.01,0.01,120.24,-16.11,True,1,12033,-100.87,-508213.34,1213768.71,705555.37
1976-02-03,101.18,0.31,0.31,120.24,-15.85,True,1,12034,-101.18,-508314.52,1217600.12,709285.6
1976-02-04,101.91,0.73,0.72,120.24,-15.24,True,1,12035,-101.91,-508416.43,1226486.85,718070.42
1976-02-05,100.39,-1.52,-1.49,120.24,-16.51,True,1,12036,-100.39,-508516.82,1208294.04,699777.22
1976-02-06,99.46,-0.93,-0.93,120.24,-17.28,True,1,12037,-99.46,-508616.28,1197200.02,688583.74
1976-02-09,99.62,0.16,0.16,120.24,-17.15,True,1,12038,-99.62,-508715.9,1199225.56,690509.66
1976-02-10,100.47,0.85,0.85,120.24,-16.44,True,1,12039,-100.47,-508816.37,1209558.33,700741.96
1976-02-11,100.77,0.3,0.3,120.24,-16.19,True,1,12040,-100.77,-508917.14,1213270.8,704353.66
1976-02-12,100.25,-0.52,-0.52,120.24,-16.62,True,1,12041,-100.25,-509017.39,1207110.25,698092.86
1976-02-13,99.67,-0.58,-0.58,120.24,-17.11,True,1,12042,-99.67,-509117.06,1200226.14,691109.08
1976-02-17,99.05,-0.62,-0.62,120.24,-17.62,True,1,12043,-99.05,-509216.11,1192859.15,683643.04
1976-02-18,99.85,0.8,0.81,120.24,-16.96,True,1,12044,-99.85,-509315.96,1202593.4,693277.44
1976-02-19,101.41,1.56,1.56,120.24,-15.66,True,1,12045,-101.41,-509417.37,1221483.45,712066.08
1976-02-20,102.1,0.69,0.68,120.24,-15.09,True,1,12046,-102.1,-509519.47,1229896.6,720377.13
1976-02-23,101.61,-0.49,-0.48,120.24,-15.49,True,1,12047,-101.61,-509621.08,1224095.67,714474.59
1976-02-24,102.03,0.42,0.41,120.24,-15.14,True,1,12048,-102.03,-509723.11,1229257.44,719534.33
1976-02-25,101.69,-0.34,-0.33,120.24,-15.43,True,1,12049,-101.69,-509824.8,1225262.81,715438.01
1976-02-26,100.11,-1.58,-1.55,120.24,-16.74,True,1,12050,-100.11,-509924.91,1206325.5,696400.59
1976-02-27,99.71,-0.4,-0.4,120.24,-17.07,True,1,12051,-99.71,-510024.62,1201605.21,691580.59
1976-03-01,100.02,0.31,0.31,120.24,-16.82,True,1,12052,-100.02,-510124.64,1205441.04,695316.4
1976-03-02,100.58,0.56,0.56,120.24,-16.35,True,1,12053,-100.58,-510225.22,1212290.74,702065.52
1976-03-03,99.98,-0.6,-0.6,120.24,-16.85,True,1,12054,-99.98,-510325.2,1205158.92,694833.72
1976-03-04,98.92,-1.06,-1.06,120.24,-17.73,True,1,12055,-98.92,-510424.12,1192480.6,682056.48
1976-03-05,99.11,0.19,0.19,120.24,-17.57,True,1,12056,-99.11,-510523.23,1194870.16,684346.93
1976-03-08,100.19,1.08,1.09,120.24,-16.68,True,1,12057,-100.19,-510623.42,1207990.83,697367.41
1976-03-09,100.58,0.39,0.39,120.24,-16.35,True,1,12058,-100.58,-510724.0,1212793.64,702069.64
1976-03-10,100.94,0.36,0.36,120.24,-16.05,True,1,12059,-100.94,-510824.94,1217235.46,706410.52
1976-03-11,101.89,0.95,0.94,120.24,-15.26,True,1,12060,-101.89,-510926.83,1228793.4,717866.57
1976-03-12,100.86,-1.03,-1.01,120.24,-16.12,True,1,12061,-100.86,-511027.69,1216472.46,705444.77
1976-03-15,99.8,-1.06,-1.05,120.24,-17.0,True,1,12062,-99.8,-511127.49,1203787.6,692660.11
1976-03-16,100.92,1.12,1.12,120.24,-16.07,True,1,12063,-100.92,-511228.41,1217397.96,706169.55
1976-03-17,100.86,-0.06,-0.06,120.24,-16.12,True,1,12064,-100.86,-511329.27,1216775.04,705445.77
1976-03-18,100.45,-0.41,-0.41,120.24,-16.46,True,1,12065,-100.45,-511429.72,1211929.25,700499.53
1976-03-19,100.58,0.13,0.13,120.24,-16.35,True,1,12066,-100.58,-511530.3,1213598.28,702067.98
1976-03-22,100.71,0.13,0.13,120.24,-16.24,True,1,12067,-100.71,-511631.01,1215267.57,703636.56
1976-03-23,102.24,1.53,1.52,120.24,-14.97,True,1,12068,-102.24,-511733.25,1233832.32,722099.07
1976-03-24,103.42,1.18,1.15,120.24,-13.99,True,1,12069,-103.42,-511836.67,1248175.98,736339.31
1976-03-25,102.85,-0.57,-0.55,120.24,-14.46,True,1,12070,-102.85,-511939.52,1241399.5,729459.98
1976-03-26,102.85,0.0,0.0,120.24,-14.46,True,1,12071,-102.85,-512042.37,1241502.35,729459.98
1976-03-29,102.41,-0.44,-0.43,120.24,-14.83,True,1,12072,-102.41,-512144.78,1236293.52,724148.74
1976-03-30,102.01,-0.4,-0.39,120.24,-15.16,True,1,12073,-102.01,-512246.79,1231566.73,719319.94
1976-03-31,102.77,0.76,0.74,120.24,-14.53,True,1,12074,-102.77,-512349.56,1240844.98,728495.42
1976-04-01,102.24,-0.53,-0.52,120.24,-14.97,True,1,12075,-102.24,-512451.8,1234548.0,722096.2
1976-04-02,102.25,0.01,0.01,120.24,-14.96,True,1,12076,-102.25,-512554.05,1234771.0,722216.95
1976-04-05,103.51,1.26,1.23,120.24,-13.91,True,1,12077,-103.51,-512657.56,1250090.27,737432.71
1976-04-06,103.36,-0.15,-0.14,120.24,-14.04,True,1,12078,-103.36,-512760.92,1248382.08,735621.16
1976-04-07,102.21,-1.15,-1.11,120.24,-15.0,True,1,12079,-102.21,-512863.13,1234594.59,721731.46
1976-04-08,101.28,-0.93,-0.91,120.24,-15.77,True,1,12080,-101.28,-512964.41,1223462.4,710497.99
1976-04-09,100.35,-0.93,-0.92,120.24,-16.54,True,1,12081,-100.35,-513064.76,1212328.35,699263.59
1976-04-12,100.2,-0.15,-0.15,120.24,-16.67,True,1,12082,-100.2,-513164.96,1210616.4,697451.44
1976-04-13,101.05,0.85,0.85,120.24,-15.96,True,1,12083,-101.05,-513266.01,1220987.15,707721.14
1976-04-14,100.31,-0.74,-0.73,120.24,-16.58,True,1,12084,-100.31,-513366.32,1212146.04,698779.72
1976-04-15,100.67,0.36,0.36,120.24,-16.28,True,1,12085,-100.67,-513466.99,1216596.95,703129.96
1976-04-19,101.44,0.77,0.76,120.24,-15.64,True,1,12086,-101.44,-513568.43,1226003.84,712435.41
1976-04-20,102.87,1.43,1.41,120.24,-14.45,True,1,12087,-102.87,-513671.3,1243389.69,729718.39
1976-04-21,103.32,0.45,0.44,120.24,-14.07,True,1,12088,-103.32,-513774.62,1248932.16,735157.54
1976-04-22,102.98,-0.34,-0.33,120.24,-14.36,True,1,12089,-102.98,-513877.6,1244925.22,731047.62
1976-04-23,102.29,-0.69,-0.67,120.24,-14.93,True,1,12090,-102.29,-513979.89,1236686.1,722706.21
1976-04-26,102.43,0.14,0.14,120.24,-14.81,True,1,12091,-102.43,-514082.32,1238481.13,724398.81
1976-04-27,101.86,-0.57,-0.56,120.24,-15.29,True,1,12092,-101.86,-514184.18,1231691.12,717506.94
1976-04-28,102.13,0.27,0.26,120.24,-15.06,True,1,12093,-102.13,-514286.31,1235058.09,720771.78
1976-04-29,102.13,0.0,0.0,120.24,-15.06,True,1,12094,-102.13,-514388.44,1235160.22,720771.78
1976-04-30,101.64,-0.49,-0.48,120.24,-15.47,True,1,12095,-101.64,-514490.08,1229335.8,714845.72
1976-05-03,100.92,-0.72,-0.71,120.24,-16.07,True,1,12096,-100.92,-514591.0,1220728.32,706137.32
1976-05-04,101.46,0.54,0.54,120.24,-15.62,True,1,12097,-101.46,-514692.46,1227361.62,712669.16
1976-05-05,100.88,-0.58,-0.57,120.24,-16.1,True,1,12098,-100.88,-514793.34,1220446.24,705652.9
1976-05-06,101.16,0.28,0.28,120.24,-15.87,True,1,12099,-101.16,-514894.5,1223934.84,709040.34
1976-05-07,101.88,0.72,0.71,120.24,-15.27,True,1,12100,-101.88,-514996.38,1232748.0,717751.62
1976-05-10,103.1,1.22,1.2,120.24,-14.26,True,1,12101,-103.1,-515099.48,1247613.1,732513.62
1976-05-11,102.95,-0.15,-0.14,120.24,-14.38,True,1,12102,-102.95,-515202.43,1245900.9,730698.47
1976-05-12,102.77,-0.18,-0.18,120.24,-14.53,True,1,12103,-102.77,-515305.2,1243825.31,728520.11
1976-05-13,102.16,-0.61,-0.59,120.24,-15.04,True,1,12104,-102.16,-515407.36,1236544.64,721137.28
1976-05-14,101.34,-0.82,-0.8,120.24,-15.72,True,1,12105,-101.34,-515508.7,1226720.7,711212.0
1976-05-17,101.09,-0.25,-0.25,120.24,-15.93,True,1,12106,-101.09,-515609.79,1223795.54,708185.75
1976-05-18,101.26,0.17,0.17,120.24,-15.78,True,1,12107,-101.26,-515711.05,1225954.82,710243.77
1976-05-19,101.18,-0.08,-0.08,120.24,-15.85,True,1,12108,-101.18,-515812.23,1225087.44,709275.21
1976-05-20,102.0,0.82,0.81,120.24,-15.17,True,1,12109,-102.0,-515914.23,1235118.0,719203.77
1976-05-21,101.26,-0.74,-0.72,120.24,-15.78,True,1,12110,-101.26,-516015.49,1226258.6,710243.11
1976-05-24,99.44,-1.82,-1.8,120.24,-17.3,True,1,12111,-99.44,-516114.93,1204317.84,688202.91
1976-05-25,99.49,0.05,0.05,120.24,-17.26,True,1,12112,-99.49,-516214.42,1205022.88,688808.46
1976-05-26,99.34,-0.15,-0.15,120.24,-17.38,True,1,12113,-99.34,-516313.76,1203305.42,686991.66
1976-05-27,99.38,0.04,0.04,120.24,-17.35,True,1,12114,-99.38,-516413.14,1203889.32,687476.18
1976-05-28,100.18,0.8,0.8,120.24,-16.68,True,1,12115,-100.18,-516513.32,1213680.7,697167.38
1976-06-01,99.85,-0.33,-0.33,120.24,-16.96,True,1,12116,-99.85,-516613.17,1209782.6,693169.43
1976-06-02,100.22,0.37,0.37,120.24,-16.65,True,1,12117,-100.22,-516713.39,1214365.74,697652.35
1976-06-03,100.13,-0.09,-0.09,120.24,-16.73,True,1,12118,-100.13,-516813.52,1213375.34,696561.82
1976-06-04,99.15,-0.98,-0.98,120.24,-17.54,True,1,12119,-99.15,-516912.67,1201598.85,684686.18
1976-06-07,98.63,-0.52,-0.52,120.24,-17.97,True,1,12120,-98.63,-517011.3,1195395.6,678384.3
1976-06-08,98.8,0.17,0.17,120.24,-17.83,True,1,12121,-98.8,-517110.1,1197554.8,680444.7
1976-06-09,98.74,-0.06,-0.06,120.24,-17.88,True,1,12122,-98.74,-517208.84,1196926.28,679717.44
1976-06-10,99.56,0.82,0.83,120.24,-17.2,True,1,12123,-99.56,-517308.4,1206965.88,689657.48
1976-06-11,100.92,1.36,1.37,120.24,-16.07,True,1,12124,-100.92,-517409.32,1223554.08,706144.76
1976-06-14,101.95,1.03,1.02,120.24,-15.21,True,1,12125,-101.95,-517511.27,1236143.75,718632.48
1976-06-15,101.46,-0.49,-0.48,120.24,-15.62,True,1,12126,-101.46,-517612.73,1230303.96,712691.23
1976-06-16,102.01,0.55,0.54,120.24,-15.16,True,1,12127,-102.01,-517714.74,1237075.27,719360.53
1976-06-17,103.61,1.6,1.57,120.24,-13.83,True,1,12128,-103.61,-517818.35,1256582.08,738763.73
1976-06-18,103.76,0.15,0.14,120.24,-13.71,True,1,12129,-103.76,-517922.11,1258505.04,740582.93
1976-06-21,104.28,0.52,0.5,120.24,-13.27,True,1,12130,-104.28,-518026.39,1264916.4,746890.01
1976-06-22,103.47,-0.81,-0.78,120.24,-13.95,True,1,12131,-103.47,-518129.86,1255194.57,737064.71
1976-06-23,103.25,-0.22,-0.21,120.24,-14.13,True,1,12132,-103.25,-518233.11,1252629.0,734395.89
1976-06-24,103.79,0.54,0.52,120.24,-13.68,True,1,12133,-103.79,-518336.9,1259284.07,740947.17
1976-06-25,103.72,-0.07,-0.07,120.24,-13.74,True,1,12134,-103.72,-518440.62,1258538.48,740097.86
1976-06-28,103.43,-0.29,-0.28,120.24,-13.98,True,1,12135,-103.43,-518544.05,1255123.05,736579.0
1976-06-29,103.86,0.43,0.42,120.24,-13.62,True,1,12136,-103.86,-518647.91,1260444.96,741797.05
1976-06-30,104.28,0.42,0.4,120.24,-13.27,True,1,12137,-104.28,-518752.19,1265646.36,746894.17
1976-07-01,103.59,-0.69,-0.66,120.24,-13.85,True,1,12138,-103.59,-518855.78,1257375.42,738519.64
1976-07-02,104.11,0.52,0.5,120.24,-13.42,True,1,12139,-104.11,-518959.89,1263791.29,744831.4
1976-07-06,103.54,-0.57,-0.55,120.24,-13.89,True,1,12140,-103.54,-519063.43,1256975.6,737912.17
1976-07-07,103.83,0.29,0.28,120.24,-13.65,True,1,12141,-103.83,-519167.26,1260600.03,741432.77
1976-07-08,103.98,0.15,0.14,120.24,-13.52,True,1,12142,-103.98,-519271.24,1262525.16,743253.92
1976-07-09,104.98,1.0,0.96,120.24,-12.69,True,1,12143,-104.98,-519376.22,1274772.14,755395.92
1976-07-12,105.9,0.92,0.88,120.24,-11.93,True,1,12144,-105.9,-519482.12,1286049.6,766567.48
1976-07-13,105.67,-0.23,-0.22,120.24,-12.12,True,1,12145,-105.67,-519587.79,1283362.15,763774.36
1976-07-14,105.95,0.28,0.26,120.24,-11.88,True,1,12146,-105.95,-519693.74,1286868.7,767174.96
1976-07-15,105.2,-0.75,-0.71,120.24,-12.51,True,1,12147,-105.2,-519798.94,1277864.4,758065.46
1976-07-16,104.68,-0.52,-0.49,120.24,-12.94,True,1,12148,-104.68,-519903.62,1271652.64,751749.02
1976-07-19,104.29,-0.39,-0.37,120.24,-13.26,True,1,12149,-104.29,-520007.91,1267019.21,747011.3
1976-07-20,103.72,-0.57,-0.55,120.24,-13.74,True,1,12150,-103.72,-520111.63,1260198.0,740086.37
1976-07-21,103.82,0.1,0.1,120.24,-13.66,True,1,12151,-103.82,-520215.45,1261516.82,741301.37
1976-07-22,103.93,0.11,0.11,120.24,-13.56,True,1,12152,-103.93,-520319.38,1262957.36,742637.98
1976-07-23,104.06,0.13,0.12,120.24,-13.46,True,1,12153,-104.06,-520423.44,1264641.18,744217.74
1976-07-26,104.07,0.01,0.01,120.24,-13.45,True,1,12154,-104.07,-520527.51,1264866.78,744339.27
1976-07-27,103.48,-0.59,-0.57,120.24,-13.94,True,1,12155,-103.48,-520630.99,1257799.4,737168.41
1976-07-28,103.05,-0.43,-0.42,120.24,-14.3,True,1,12156,-103.05,-520734.04,1252675.8,731941.76
1976-07-29,102.93,-0.12,-0.12,120.24,-14.4,True,1,12157,-102.93,-520836.97,1251320.01,730483.04
1976-07-30,103.44,0.51,0.5,120.24,-13.97,True,1,12158,-103.44,-520940.41,1257623.52,736683.11
1976-08-02,103.19,-0.25,-0.24,120.24,-14.18,True,1,12159,-103.19,-521043.6,1254687.21,733643.61
1976-08-03,104.14,0.95,0.92,120.24,-13.39,True,1,12160,-104.14,-521147.74,1266342.4,745194.66
1976-08-04,104.43,0.29,0.28,120.24,-13.15,True,1,12161,-104.43,-521252.17,1269973.23,748721.06
1976-08-05,103.85,-0.58,-0.56,120.24,-13.63,True,1,12162,-103.85,-521356.02,1263023.7,741667.68
1976-08-06,103.79,-0.06,-0.06,120.24,-13.68,True,1,12163,-103.79,-521459.81,1262397.77,740937.96
1976-08-09,103.49,-0.3,-0.29,120.24,-13.93,True,1,12164,-103.49,-521563.3,1258852.36,737289.06
1976-08-10,104.41,0.92,0.89,120.24,-13.16,True,1,12165,-104.41,-521667.71,1270147.65,748479.94
1976-08-11,104.06,-0.35,-0.34,120.24,-13.46,True,1,12166,-104.06,-521771.77,1265993.96,744222.19
1976-08-12,104.22,0.16,0.15,120.24,-13.32,True,1,12167,-104.22,-521875.99,1268044.74,746168.75
1976-08-13,104.25,0.03,0.03,120.24,-13.3,True,1,12168,-104.25,-521980.24,1268514.0,746533.76
1976-08-16,104.43,0.18,0.17,120.24,-13.15,True,1,12169,-104.43,-522084.67,1270808.67,748724.0
1976-08-17,104.8,0.37,0.35,120.24,-12.84,True,1,12170,-104.8,-522189.47,1275416.0,753226.53
1976-08-18,104.56,-0.24,-0.23,120.24,-13.04,True,1,12171,-104.56,-522294.03,1272599.76,750305.73
1976-08-19,103.39,-1.17,-1.12,120.24,-14.01,True,1,12172,-103.39,-522397.42,1258463.08,736065.66
1976-08-20,102.37,-1.02,-0.99,120.24,-14.86,True,1,12173,-102.37,-522499.79,1246150.01,723650.22
1976-08-23,101.96,-0.41,-0.4,120.24,-15.2,True,1,12174,-101.96,-522601.75,1241261.04,718659.29
1976-08-24,101.27,-0.69,-0.68,120.24,-15.78,True,1,12175,-101.27,-522703.02,1232962.25,710259.23
1976-08-25,102.03,0.76,0.75,120.24,-15.14,True,1,12176,-102.03,-522805.05,1242317.28,719512.23
1976-08-26,101.32,-0.71,-0.7,120.24,-15.74,True,1,12177,-101.32,-522906.37,1233773.64,710867.27
1976-08-27,101.48,0.16,0.16,120.24,-15.6,True,1,12178,-101.48,-523007.85,1235823.44,712815.59
1976-08-30,102.07,0.59,0.58,120.24,-15.11,True,1,12179,-102.07,-523109.92,1243110.53,720000.61
1976-08-31,102.91,0.84,0.82,120.24,-14.41,True,1,12180,-102.91,-523212.83,1253443.8,730230.97
1976-09-01,104.06,1.15,1.12,120.24,-13.46,True,1,12181,-104.06,-523316.89,1267554.86,744237.97
1976-09-02,103.92,-0.14,-0.14,120.24,-13.57,True,1,12182,-103.92,-523420.81,1265953.44,742532.63
1976-09-03,104.3,0.38,0.37,120.24,-13.26,True,1,12183,-104.3,-523525.11,1270686.9,747161.79
1976-09-07,105.03,0.73,0.7,120.24,-12.65,True,1,12184,-105.03,-523630.14,1279685.52,756055.38
1976-09-08,104.94,-0.09,-0.09,120.24,-12.72,True,1,12185,-104.94,-523735.08,1278693.9,754958.82
1976-09-09,104.4,-0.54,-0.52,120.24,-13.17,True,1,12186,-104.4,-523839.48,1272218.4,748378.92
1976-09-10,104.65,0.25,0.24,120.24,-12.97,True,1,12187,-104.65,-523944.13,1275369.55,751425.42
1976-09-13,104.29,-0.36,-0.34,120.24,-13.26,True,1,12188,-104.29,-524048.42,1271086.52,747038.1
1976-09-14,103.94,-0.35,-0.34,120.24,-13.56,True,1,12189,-103.94,-524152.36,1266924.66,742772.3
1976-09-15,104.25,0.31,0.3,120.24,-13.3,True,1,12190,-104.25,-524256.61,1270807.5,746550.89
1976-09-16,105.34,1.09,1.05,120.24,-12.39,True,1,12191,-105.34,-524361.95,1284199.94,759837.99
1976-09-17,106.27,0.93,0.88,120.24,-11.62,True,1,12192,-106.27,-524468.22,1295643.84,771175.62
1976-09-20,106.32,0.05,0.05,120.24,-11.58,True,1,12193,-106.32,-524574.54,1296359.76,771785.22
1976-09-21,107.83,1.51,1.42,120.24,-10.32,True,1,12194,-107.83,-524682.37,1314879.02,790196.65
1976-09-22,107.46,-0.37,-0.34,120.24,-10.63,True,1,12195,-107.46,-524789.83,1310474.7,785684.87
1976-09-23,106.92,-0.54,-0.5,120.24,-11.08,True,1,12196,-106.92,-524896.75,1303996.32,779099.57
1976-09-24,106.8,-0.12,-0.11,120.24,-11.18,True,1,12197,-106.8,-525003.55,1302639.6,777636.05
1976-09-27,107.27,0.47,0.44,120.24,-10.79,True,1,12198,-107.27,-525110.82,1308479.46,783368.64
1976-09-28,105.92,-1.35,-1.26,120.24,-11.91,True,1,12199,-105.92,-525216.74,1292118.08,766901.34
1976-09-29,105.37,-0.55,-0.52,120.24,-12.37,True,1,12200,-105.37,-525322.11,1285514.0,760191.89
1976-09-30,105.24,-0.13,-0.12,120.24,-12.48,True,1,12201,-105.24,-525427.35,1284033.24,758605.89
1976-10-01,104.17,-1.07,-1.02,120.24,-13.36,True,1,12202,-104.17,-525531.52,1271082.34,745550.82
1976-10-04,104.03,-0.14,-0.13,120.24,-13.48,True,1,12203,-104.03,-525635.55,1269478.09,743842.54
1976-10-05,103.23,-0.8,-0.77,120.24,-14.15,True,1,12204,-103.23,-525738.78,1259818.92,734080.14
1976-10-06,102.97,-0.26,-0.25,120.24,-14.36,True,1,12205,-102.97,-525841.75,1256748.85,730907.1
1976-10-07,103.54,0.57,0.55,120.24,-13.89,True,1,12206,-103.54,-525945.29,1263809.24,737863.95
1976-10-08,102.56,-0.98,-0.95,120.24,-14.7,True,1,12207,-102.56,-526047.85,1251949.92,725902.07
1976-10-11,101.64,-0.92,-0.9,120.24,-15.47,True,1,12208,-101.64,-526149.49,1240821.12,714671.63
1976-10-12,100.81,-0.83,-0.82,120.24,-16.16,True,1,12209,-100.81,-526250.3,1230789.29,704538.99
1976-10-13,102.12,1.31,1.3,120.24,-15.07,True,1,12210,-102.12,-526352.42,1246885.2,720532.78
1976-10-14,100.85,-1.27,-1.24,120.24,-16.13,True,1,12211,-100.85,-526453.27,1231479.35,705026.08
1976-10-15,100.88,0.03,0.03,120.24,-16.1,True,1,12212,-100.88,-526554.15,1231946.56,705392.41
1976-10-18,101.47,0.59,0.58,120.24,-15.61,True,1,12213,-101.47,-526655.62,1239253.11,712597.49
1976-10-19,101.45,-0.02,-0.02,120.24,-15.63,True,1,12214,-101.45,-526757.07,1239110.3,712353.23
1976-10-20,101.74,0.29,0.29,120.24,-15.39,True,1,12215,-101.74,-526858.81,1242754.1,715895.29
1976-10-21,100.77,-0.97,-0.95,120.24,-16.19,True,1,12216,-100.77,-526959.58,1231006.32,704046.74
1976-10-22,99.96,-0.81,-0.8,120.24,-16.87,True,1,12217,-99.96,-527059.54,1221211.32,694151.78
1976-10-25,100.07,0.11,0.11,120.24,-16.77,True,1,12218,-100.07,-527159.61,1222655.26,695495.65
1976-10-26,101.06,0.99,0.99,120.24,-15.95,True,1,12219,-101.06,-527260.67,1234852.14,707591.47
1976-10-27,101.76,0.7,0.69,120.24,-15.37,True,1,12220,-101.76,-527362.43,1243507.2,716144.77
1976-10-28,101.61,-0.15,-0.15,120.24,-15.49,True,1,12221,-101.61,-527464.04,1241775.81,714311.77
1976-10-29,102.9,1.29,1.27,120.24,-14.42,True,1,12222,-102.9,-527566.94,1257643.8,730076.86
1976-11-01,103.1,0.2,0.19,120.24,-14.26,True,1,12223,-103.1,-527670.04,1260191.3,732521.26
1976-11-03,101.92,-1.18,-1.14,120.24,-15.24,True,1,12224,-101.92,-527771.96,1245870.08,718098.12
1976-11-04,102.41,0.49,0.48,120.24,-14.83,True,1,12225,-102.41,-527874.37,1251962.25,724087.88
1976-11-05,100.82,-1.59,-1.55,120.24,-16.15,True,1,12226,-100.82,-527975.19,1232625.32,704650.13
1976-11-08,99.6,-1.22,-1.21,120.24,-17.17,True,1,12227,-99.6,-528074.79,1217809.2,689734.41
1976-11-09,99.32,-0.28,-0.28,120.24,-17.4,True,1,12228,-99.32,-528174.11,1214484.96,686310.85
1976-11-10,98.81,-0.51,-0.51,120.24,-17.82,True,1,12229,-98.81,-528272.92,1208347.49,680074.57
1976-11-11,99.64,0.83,0.84,120.24,-17.13,True,1,12230,-99.64,-528372.56,1218597.2,690224.64
1976-11-12,99.24,-0.4,-0.4,120.24,-17.46,True,1,12231,-99.24,-528471.8,1213804.44,685332.64
1976-11-15,99.9,0.66,0.66,120.24,-16.92,True,1,12232,-99.9,-528571.7,1221976.8,693405.1
1976-11-16,100.04,0.14,0.14,120.24,-16.8,True,1,12233,-100.04,-528671.74,1223789.32,695117.58
1976-11-17,100.61,0.57,0.57,120.24,-16.33,True,1,12234,-100.61,-528772.35,1230862.74,702090.39
1976-11-18,101.89,1.28,1.27,120.24,-15.26,True,1,12235,-101.89,-528874.24,1246624.15,717749.91
1976-11-19,101.92,0.03,0.03,120.24,-15.24,True,1,12236,-101.92,-528976.16,1247093.12,718116.96
1976-11-22,102.59,0.67,0.66,120.24,-14.68,True,1,12237,-102.59,-529078.75,1255393.83,726315.08
1976-11-23,101.96,-0.63,-0.61,120.24,-15.2,True,1,12238,-101.96,-529180.71,1247786.48,718605.77
1976-11-24,102.41,0.45,0.44,120.24,-14.83,True,1,12239,-102.41,-529283.12,1253395.99,724112.87
1976-11-26,103.15,0.74,0.72,120.24,-14.21,True,1,12240,-103.15,-529386.27,1262556.0,733169.73
1976-11-29,102.44,-0.71,-0.69,120.24,-14.8,True,1,12241,-102.44,-529488.71,1253968.04,724479.33
1976-11-30,102.1,-0.34,-0.33,120.24,-15.09,True,1,12242,-102.1,-529590.81,1249908.2,720317.39
1976-12-01,102.49,0.39,0.38,120.24,-14.76,True,1,12243,-102.49,-529693.3,1254785.07,725091.77
1976-12-02,102.12,-0.37,-0.36,120.24,-15.07,True,1,12244,-102.12,-529795.42,1250357.28,720561.86
1976-12-03,102.76,0.64,0.63,120.24,-14.54,True,1,12245,-102.76,-529898.18,1258296.2,728398.02
1976-12-06,103.56,0.8,0.78,120.24,-13.87,True,1,12246,-103.56,-530001.74,1268195.76,738194.02
1976-12-07,103.49,-0.07,-0.07,120.24,-13.93,True,1,12247,-103.49,-530105.23,1267442.03,737336.8
1976-12-08,104.08,0.59,0.57,120.24,-13.44,True,1,12248,-104.08,-530209.31,1274771.84,744562.53
1976-12-09,104.51,0.43,0.41,120.24,-13.08,True,1,12249,-104.51,-530313.82,1280142.99,749829.17
1976-12-10,104.7,0.19,0.18,120.24,-12.92,True,1,12250,-104.7,-530418.52,1282575.0,752156.48
1976-12-13,104.63,-0.07,-0.07,120.24,-12.98,True,1,12251,-104.63,-530523.15,1281822.13,751298.98
1976-12-14,105.07,0.44,0.42,120.24,-12.62,True,1,12252,-105.07,-530628.22,1287317.64,756689.42
1976-12-15,105.14,0.07,0.07,120.24,-12.56,True,1,12253,-105.14,-530733.36,1288280.42,757547.06
1976-12-16,104.8,-0.34,-0.32,120.24,-12.84,True,1,12254,-104.8,-530838.16,1284219.2,753381.04
1976-12-17,104.26,-0.54,-0.52,120.24,-13.29,True,1,12255,-104.26,-530942.42,1277706.3,746763.88
1976-12-20,103.65,-0.61,-0.58,120.24,-13.8,True,1,12256,-103.65,-531046.07,1270334.4,739288.33
1976-12-21,104.22,0.57,0.55,120.24,-13.32,True,1,12257,-104.22,-531150.29,1277424.54,746274.25
1976-12-22,104.71,0.49,0.47,120.24,-12.92,True,1,12258,-104.71,-531255.0,1283535.18,752280.18
1976-12-23,104.84,0.13,0.12,120.24,-12.81,True,1,12259,-104.84,-531359.84,1285233.56,753873.72
1976-12-27,106.06,1.22,1.16,120.24,-11.79,True,1,12260,-106.06,-531465.9,1300295.6,768829.7
1976-12-28,106.77,0.71,0.67,120.24,-11.2,True,1,12261,-106.77,-531572.67,1309106.97,777534.3
1976-12-29,106.34,-0.43,-0.4,120.24,-11.56,True,1,12262,-106.34,-531679.01,1303941.08,772262.07
1976-12-30,106.88,0.54,0.51,120.24,-11.11,True,1,12263,-106.88,-531785.89,1310669.44,778883.55
1976-12-31,107.46,0.58,0.54,120.24,-10.63,True,1,12264,-107.46,-531893.35,1317889.44,785996.09
1977-01-03,107.0,-0.46,-0.43,120.24,-11.01,True,1,12265,-107.0,-532000.35,1312355.0,780354.65
1977-01-04,105.7,-1.3,-1.22,120.24,-12.09,True,1,12266,-105.7,-532106.05,1296516.2,764410.15
1977-01-05,104.76,-0.94,-0.89,120.24,-12.87,True,1,12267,-104.76,-532210.81,1285090.92,752880.11
1977-01-06,105.02,0.26,0.25,120.24,-12.66,True,1,12268,-105.02,-532315.83,1288385.36,756069.53
1977-01-07,105.01,-0.01,-0.01,120.24,-12.67,True,1,12269,-105.01,-532420.84,1288367.69,755946.85
1977-01-10,105.2,0.19,0.18,120.24,-12.51,True,1,12270,-105.2,-532526.04,1290804.0,758277.96
1977-01-11,104.12,-1.08,-1.03,120.24,-13.41,True,1,12271,-104.12,-532630.16,1277656.52,745026.36
1977-01-12,103.4,-0.72,-0.69,120.24,-14.0,True,1,12272,-103.4,-532733.56,1268924.8,736191.24
1977-01-13,104.2,0.8,0.77,120.24,-13.34,True,1,12273,-104.2,-532837.76,1278846.6,746008.84
1977-01-14,104.01,-0.19,-0.18,120.24,-13.5,True,1,12274,-104.01,-532941.77,1276618.74,743676.97
1977-01-17,103.73,-0.28,-0.27,120.24,-13.73,True,1,12275,-103.73,-533045.5,1273285.75,740240.25
1977-01-18,103.32,-0.41,-0.4,120.24,-14.07,True,1,12276,-103.32,-533148.82,1268356.32,735207.5
1977-01-19,103.85,0.53,0.51,120.24,-13.63,True,1,12277,-103.85,-533252.67,1274966.45,741713.78
1977-01-20,102.97,-0.88,-0.85,120.24,-14.36,True,1,12278,-102.97,-533355.64,1264265.66,730910.02
1977-01-21,103.32,0.35,0.34,120.24,-14.07,True,1,12279,-103.32,-533458.96,1268666.28,735207.32
1977-01-24,103.25,-0.07,-0.07,120.24,-14.13,True,1,12280,-103.25,-533562.21,1267910.0,734347.79
1977-01-25,103.13,-0.12,-0.12,120.24,-14.23,True,1,12281,-103.13,-533665.34,1266539.53,732874.19
1977-01-26,102.34,-0.79,-0.77,120.24,-14.89,True,1,12282,-102.34,-533767.68,1256939.88,723172.2
1977-01-27,101.79,-0.55,-0.54,120.24,-15.34,True,1,12283,-101.79,-533869.47,1250286.57,716417.1
1977-01-28,101.93,0.14,0.14,120.24,-15.23,True,1,12284,-101.93,-533971.4,1252108.12,718136.72
1977-01-31,102.03,0.1,0.1,120.24,-15.14,True,1,12285,-102.03,-534073.43,1253438.55,719365.12
1977-02-01,102.54,0.51,0.5,120.24,-14.72,True,1,12286,-102.54,-534175.97,1259806.44,725630.47
1977-02-02,102.36,-0.18,-0.18,120.24,-14.87,True,1,12287,-102.36,-534278.33,1257697.32,723418.99
1977-02-03,101.85,-0.51,-0.5,120.24,-15.29,True,1,12288,-101.85,-534380.18,1251532.8,717152.62
1977-02-04,101.88,0.03,0.03,120.24,-15.27,True,1,12289,-101.88,-534482.06,1252003.32,717521.26
1977-02-07,101.89,0.01,0.01,120.24,-15.26,True,1,12290,-101.89,-534583.95,1252228.1,717644.15
1977-02-08,101.6,-0.29,-0.28,120.24,-15.5,True,1,12291,-101.6,-534685.55,1248765.6,714080.05
1977-02-09,100.73,-0.87,-0.86,120.24,-16.23,True,1,12292,-100.73,-534786.28,1238173.16,703386.88
1977-02-10,100.82,0.09,0.09,120.24,-16.15,True,1,12293,-100.82,-534887.1,1239380.26,704493.16
1977-02-11,100.22,-0.6,-0.6,120.24,-16.65,True,1,12294,-100.22,-534987.32,1232104.68,697117.36
1977-02-14,100.74,0.52,0.52,120.24,-16.22,True,1,12295,-100.74,-535088.06,1238598.3,703510.24
1977-02-15,101.04,0.3,0.3,120.24,-15.97,True,1,12296,-101.04,-535189.1,1242387.84,707198.74
1977-02-16,101.5,0.46,0.46,120.24,-15.58,True,1,12297,-101.5,-535290.6,1248145.5,712854.9
1977-02-17,100.92,-0.58,-0.57,120.24,-16.07,True,1,12298,-100.92,-535391.52,1241114.16,705722.64
1977-02-18,100.49,-0.43,-0.43,120.24,-16.42,True,1,12299,-100.49,-535492.01,1235926.51,700434.5
1977-02-22,100.49,0.0,0.0,120.24,-16.42,True,1,12300,-100.49,-535592.5,1236027.0,700434.5
1977-02-23,100.19,-0.3,-0.3,120.24,-16.68,True,1,12301,-100.19,-535692.69,1232437.19,696744.5
1977-02-24,99.6,-0.59,-0.59,120.24,-17.17,True,1,12302,-99.6,-535792.29,1225279.2,689486.91
1977-02-25,99.48,-0.12,-0.12,120.24,-17.26,True,1,12303,-99.48,-535891.77,1223902.44,688010.67
1977-02-28,99.82,0.34,0.34,120.24,-16.98,True,1,12304,-99.82,-535991.59,1228185.28,692193.69
1977-03-01,100.66,0.84,0.84,120.24,-16.28,True,1,12305,-100.66,-536092.25,1238621.3,702529.05
1977-03-02,100.39,-0.27,-0.27,120.24,-16.51,True,1,12306,-100.39,-536192.64,1235399.34,699206.7
1977-03-03,100.88,0.49,0.49,120.24,-16.1,True,1,12307,-100.88,-536293.52,1241530.16,705236.64
1977-03-04,101.2,0.32,0.32,120.24,-15.84,True,1,12308,-101.2,-536394.72,1245569.6,709174.88
1977-03-07,101.25,0.05,0.05,120.24,-15.79,True,1,12309,-101.25,-536495.97,1246286.25,709790.28
1977-03-08,100.87,-0.38,-0.38,120.24,-16.11,True,1,12310,-100.87,-536596.84,1241709.7,705112.86
1977-03-09,100.1,-0.77,-0.76,120.24,-16.75,True,1,12311,-100.1,-536696.94,1232331.1,695634.16
1977-03-10,100.67,0.57,0.57,120.24,-16.28,True,1,12312,-100.67,-536797.61,1239449.04,702651.43
1977-03-11,100.65,-0.02,-0.02,120.24,-16.29,True,1,12313,-100.65,-536898.26,1239303.45,702405.19
1977-03-14,101.42,0.77,0.76,120.24,-15.65,True,1,12314,-101.42,-536999.68,1248885.88,711886.2
1977-03-15,101.98,0.56,0.55,120.24,-15.19,True,1,12315,-101.98,-537101.66,1255883.7,718782.04
1977-03-16,102.17,0.19,0.19,120.24,-15.03,True,1,12316,-102.17,-537203.83,1258325.72,721121.89
1977-03-17,102.08,-0.09,-0.09,120.24,-15.1,True,1,12317,-102.08,-537305.91,1257319.36,720013.45
1977-03-18,101.86,-0.22,-0.22,120.24,-15.29,True,1,12318,-101.86,-537407.77,1254711.48,717303.71
1977-03-21,101.31,-0.55,-0.54,120.24,-15.74,True,1,12319,-101.31,-537509.08,1248037.89,710528.81
1977-03-22,101.0,-0.31,-0.31,120.24,-16.0,True,1,12320,-101.0,-537610.08,1244320.0,706709.92
1977-03-23,100.2,-0.8,-0.79,120.24,-16.67,True,1,12321,-100.2,-537710.28,1234564.2,696853.92
1977-03-24,99.7,-0.5,-0.5,120.24,-17.08,True,1,12322,-99.7,-537809.98,1228503.4,690693.42
1977-03-25,99.06,-0.64,-0.64,120.24,-17.61,True,1,12323,-99.06,-537909.04,1220716.38,682807.34
1977-03-28,99.0,-0.06,-0.06,120.24,-17.66,True,1,12324,-99.0,-538008.04,1220076.0,682067.96
1977-03-29,99.69,0.69,0.7,120.24,-17.09,True,1,12325,-99.69,-538107.73,1228679.25,690571.52
1977-03-30,98.54,-1.15,-1.15,120.24,-18.05,True,1,12326,-98.54,-538206.27,1214604.04,676397.77
1977-03-31,98.42,-0.12,-0.12,120.24,-18.15,True,1,12327,-98.42,-538304.69,1213223.34,674918.65
1977-04-01,99.21,0.79,0.8,120.24,-17.49,True,1,12328,-99.21,-538403.9,1223060.88,684656.98
1977-04-04,98.23,-0.98,-0.99,120.24,-18.3,True,1,12329,-98.23,-538502.13,1211077.67,672575.54
1977-04-05,98.01,-0.22,-0.22,120.24,-18.49,True,1,12330,-98.01,-538600.14,1208463.3,669863.16
1977-04-06,97.91,-0.1,-0.1,120.24,-18.57,True,1,12331,-97.91,-538698.05,1207328.21,668630.16
1977-04-07,98.35,0.44,0.45,120.24,-18.2,True,1,12332,-98.35,-538796.4,1212852.2,674055.8
1977-04-11,98.88,0.53,0.54,120.24,-17.76,True,1,12333,-98.88,-538895.28,1219487.04,680591.76
1977-04-12,100.15,1.27,1.28,120.24,-16.71,True,1,12334,-100.15,-538995.43,1235250.1,696254.67
1977-04-13,100.16,0.01,0.01,120.24,-16.7,True,1,12335,-100.16,-539095.59,1235473.6,696378.01
1977-04-14,101.0,0.84,0.84,120.24,-16.0,True,1,12336,-101.0,-539196.59,1245936.0,706739.41
1977-04-15,101.04,0.04,0.04,120.24,-15.97,True,1,12337,-101.04,-539297.63,1246530.48,707232.85
1977-04-18,100.54,-0.5,-0.5,120.24,-16.38,True,1,12338,-100.54,-539398.17,1240462.52,701064.35
1977-04-19,100.07,-0.47,-0.47,120.24,-16.77,True,1,12339,-100.07,-539498.24,1234763.73,695265.49
1977-04-20,100.4,0.33,0.33,120.24,-16.5,True,1,12340,-100.4,-539598.64,1238936.0,699337.36
1977-04-21,99.75,-0.65,-0.65,120.24,-17.04,True,1,12341,-99.75,-539698.39,1231014.75,691316.36
1977-04-22,98.44,-1.31,-1.31,120.24,-18.13,True,1,12342,-98.44,-539796.83,1214946.48,675149.65
1977-04-25,97.15,-1.29,-1.31,120.24,-19.2,True,1,12343,-97.15,-539893.98,1199122.45,659228.47
1977-04-26,97.11,-0.04,-0.04,120.24,-19.24,True,1,12344,-97.11,-539991.09,1198725.84,658734.75
1977-04-27,97.96,0.85,0.88,120.24,-18.53,True,1,12345,-97.96,-540089.05,1209316.2,669227.15
1977-04-28,98.2,0.24,0.24,120.24,-18.33,True,1,12346,-98.2,-540187.25,1212377.2,672189.95
1977-04-29,98.44,0.24,0.24,120.24,-18.13,True,1,12347,-98.44,-540285.69,1215438.68,675152.99
1977-05-02,98.93,0.49,0.5,120.24,-17.72,True,1,12348,-98.93,-540384.62,1221587.64,681203.02
1977-05-03,99.43,0.5,0.5,120.24,-17.31,True,1,12349,-99.43,-540484.05,1227861.07,687377.02
1977-05-04,99.96,0.53,0.53,120.24,-16.87,True,1,12350,-99.96,-540584.01,1234506.0,693921.99
1977-05-05,100.11,0.15,0.15,120.24,-16.74,True,1,12351,-100.11,-540684.12,1236458.61,695774.49
1977-05-06,99.49,-0.62,-0.62,120.24,-17.26,True,1,12352,-99.49,-540783.61,1228900.48,688116.87
1977-05-09,99.18,-0.31,-0.31,120.24,-17.52,True,1,12353,-99.18,-540882.79,1225170.54,684287.75
1977-05-10,99.47,0.29,0.29,120.24,-17.27,True,1,12354,-99.47,-540982.26,1228852.38,687870.12
1977-05-11,98.78,-0.69,-0.69,120.24,-17.85,True,1,12355,-98.78,-541081.04,1220426.9,679345.86
1977-05-12,98.73,-0.05,-0.05,120.24,-17.89,True,1,12356,-98.73,-541179.77,1219907.88,678728.11
1977-05-13,99.03,0.3,0.3,120.24,-17.64,True,1,12357,-99.03,-541278.8,1223713.71,682434.91
1977-05-16,99.47,0.44,0.44,120.24,-17.27,True,1,12358,-99.47,-541378.27,1229250.26,687871.99
1977-05-17,99.77,0.3,0.3,120.24,-17.02,True,1,12359,-99.77,-541478.04,1233057.43,691579.39
1977-05-18,100.3,0.53,0.53,120.24,-16.58,True,1,12360,-100.3,-541578.34,1239708.0,698129.66
1977-05-19,99.88,-0.42,-0.42,120.24,-16.93,True,1,12361,-99.88,-541678.22,1234616.68,692938.46
1977-05-20,99.45,-0.43,-0.43,120.24,-17.29,True,1,12362,-99.45,-541777.67,1229400.9,687623.23
1977-05-23,98.15,-1.3,-1.31,120.24,-18.37,True,1,12363,-98.15,-541875.82,1213428.45,671552.63
1977-05-24,97.67,-0.48,-0.49,120.24,-18.77,True,1,12364,-97.67,-541973.49,1207591.88,665618.39
1977-05-25,96.77,-0.9,-0.92,120.24,-19.52,True,1,12365,-96.77,-542070.26,1196561.05,654490.79
1977-05-26,97.01,0.24,0.25,120.24,-19.32,True,1,12366,-97.01,-542167.27,1199625.66,657458.39
1977-05-27,96.27,-0.74,-0.76,120.24,-19.93,True,1,12367,-96.27,-542263.54,1190571.09,648307.55
1977-05-31,96.12,-0.15,-0.16,120.24,-20.06,True,1,12368,-96.12,-542359.66,1188812.16,646452.5
1977-06-01,96.93,0.81,0.84,120.24,-19.39,True,1,12369,-96.93,-542456.59,1198927.17,656470.58
1977-06-02,96.74,-0.19,-0.2,120.24,-19.54,True,1,12370,-96.74,-542553.33,1196673.8,654120.47
1977-06-03,97.69,0.95,0.98,120.24,-18.75,True,1,12371,-97.69,-542651.02,1208522.99,665871.97
1977-06-06,97.23,-0.46,-0.47,120.24,-19.14,True,1,12372,-97.23,-542748.25,1202929.56,660181.31
1977-06-07,97.73,0.5,0.51,120.24,-18.72,True,1,12373,-97.73,-542845.98,1209213.29,666367.31
1977-06-08,98.2,0.47,0.48,120.24,-18.33,True,1,12374,-98.2,-542944.18,1215126.8,672182.62
1977-06-09,98.14,-0.06,-0.06,120.24,-18.38,True,1,12375,-98.14,-543042.32,1214482.5,671440.18
1977-06-10,98.46,0.32,0.33,120.24,-18.11,True,1,12376,-98.46,-543140.78,1218540.96,675400.18
1977-06-13,98.74,0.28,0.28,120.24,-17.88,True,1,12377,-98.74,-543239.52,1222104.98,678865.46
1977-06-14,99.86,1.12,1.13,120.24,-16.95,True,1,12378,-99.86,-543339.38,1236067.08,692727.7
1977-06-15,99.61,-0.25,-0.25,120.24,-17.16,True,1,12379,-99.61,-543438.99,1233072.19,689633.2
1977-06-16,99.85,0.24,0.24,120.24,-16.96,True,1,12380,-99.85,-543538.84,1236143.0,692604.16
1977-06-17,99.97,0.12,0.12,120.24,-16.86,True,1,12381,-99.97,-543638.81,1237728.57,694089.76
1977-06-20,100.42,0.45,0.45,120.24,-16.48,True,1,12382,-100.42,-543739.23,1243400.44,699661.21
1977-06-21,100.74,0.32,0.32,120.24,-16.22,True,1,12383,-100.74,-543839.97,1247463.42,703623.45
1977-06-22,100.46,-0.28,-0.28,120.24,-16.45,True,1,12384,-100.46,-543940.43,1244096.64,700156.21
1977-06-23,100.62,0.16,0.16,120.24,-16.32,True,1,12385,-100.62,-544041.05,1246178.7,702137.65
1977-06-24,101.19,0.57,0.57,120.24,-15.84,True,1,12386,-101.19,-544142.24,1253339.34,709197.1
1977-06-27,100.98,-0.21,-0.21,120.24,-16.02,True,1,12387,-100.98,-544243.22,1250839.26,706596.04
1977-06-28,100.14,-0.84,-0.83,120.24,-16.72,True,1,12388,-100.14,-544343.36,1240534.32,696190.96
1977-06-29,100.11,-0.03,-0.03,120.24,-16.74,True,1,12389,-100.11,-544443.47,1240262.79,695819.32
1977-06-30,100.48,0.37,0.37,120.24,-16.43,True,1,12390,-100.48,-544543.95,1244947.2,700403.25
1977-07-01,100.1,-0.38,-0.38,120.24,-16.75,True,1,12391,-100.1,-544644.05,1240339.1,695695.05
1977-07-05,100.09,-0.01,-0.01,120.24,-16.76,True,1,12392,-100.09,-544744.14,1240315.28,695571.14
1977-07-06,99.58,-0.51,-0.51,120.24,-17.18,True,1,12393,-99.58,-544843.72,1234094.94,689251.22
1977-07-07,99.93,0.35,0.35,120.24,-16.89,True,1,12394,-99.93,-544943.65,1238532.42,693588.77
1977-07-08,99.79,-0.14,-0.14,120.24,-17.01,True,1,12395,-99.79,-545043.44,1236897.05,691853.61
1977-07-11,99.55,-0.24,-0.24,120.24,-17.21,True,1,12396,-99.55,-545142.99,1234021.8,688878.81
1977-07-12,99.45,-0.1,-0.1,120.24,-17.29,True,1,12397,-99.45,-545242.44,1232881.65,687639.21
1977-07-13,99.59,0.14,0.14,120.24,-17.17,True,1,12398,-99.59,-545342.03,1234716.82,689374.79
1977-07-15,100.18,0.59,0.59,120.24,-16.68,True,1,12399,-100.18,-545442.21,1242131.82,696689.61
1977-07-18,100.95,0.77,0.77,120.24,-16.04,True,1,12400,-100.95,-545543.16,1251780.0,706236.84
1977-07-19,101.79,0.84,0.83,120.24,-15.34,True,1,12401,-101.79,-545644.95,1262297.79,716652.84
1977-07-20,101.73,-0.06,-0.06,120.24,-15.39,True,1,12402,-101.73,-545746.68,1261655.46,715908.78
1977-07-21,101.59,-0.14,-0.14,120.24,-15.51,True,1,12403,-101.59,-545848.27,1260020.77,714172.5
1977-07-22,101.67,0.08,0.08,120.24,-15.44,True,1,12404,-101.67,-545949.94,1261114.68,715164.74
1977-07-25,100.85,-0.82,-0.81,120.24,-16.13,True,1,12405,-100.85,-546050.79,1251044.25,704993.46
1977-07-26,100.27,-0.58,-0.57,120.24,-16.61,True,1,12406,-100.27,-546151.06,1243949.62,697798.56
1977-07-27,98.64,-1.63,-1.63,120.24,-17.96,True,1,12407,-98.64,-546249.7,1223826.48,677576.78
1977-07-28,98.79,0.15,0.15,120.24,-17.84,True,1,12408,-98.79,-546348.49,1225786.32,679437.83
1977-07-29,98.85,0.06,0.06,120.24,-17.79,True,1,12409,-98.85,-546447.34,1226629.65,680182.31
1977-08-01,99.12,0.27,0.27,120.24,-17.57,True,1,12410,-99.12,-546546.46,1230079.2,683532.74
1977-08-02,98.5,-0.62,-0.63,120.24,-18.08,True,1,12411,-98.5,-546644.96,1222483.5,675838.54
1977-08-03,98.37,-0.13,-0.13,120.24,-18.19,True,1,12412,-98.37,-546743.33,1220968.44,674225.11
1977-08-04,98.74,0.37,0.38,120.24,-17.88,True,1,12413,-98.74,-546842.07,1225659.62,678817.55
1977-08-05,98.76,0.02,0.02,120.24,-17.86,True,1,12414,-98.76,-546940.83,1226006.64,679065.81
1977-08-08,97.99,-0.77,-0.78,120.24,-18.5,True,1,12415,-97.99,-547038.82,1216545.85,669507.03
1977-08-09,98.05,0.06,0.06,120.24,-18.45,True,1,12416,-98.05,-547136.87,1217388.8,670251.93
1977-08-10,98.92,0.87,0.89,120.24,-17.73,True,1,12417,-98.92,-547235.79,1228289.64,681053.85
1977-08-11,98.16,-0.76,-0.77,120.24,-18.36,True,1,12418,-98.16,-547333.95,1218950.88,671616.93
1977-08-12,97.88,-0.28,-0.28,120.24,-18.6,True,1,12419,-97.88,-547431.83,1215571.72,668139.89
1977-08-15,98.18,0.3,0.31,120.24,-18.35,True,1,12420,-98.18,-547530.01,1219395.6,671865.59
1977-08-16,97.73,-0.45,-0.46,120.24,-18.72,True,1,12421,-97.73,-547627.74,1213904.33,666276.59
1977-08-17,97.74,0.01,0.01,120.24,-18.71,True,1,12422,-97.74,-547725.48,1214126.28,666400.8
1977-08-18,97.68,-0.06,-0.06,120.24,-18.76,True,1,12423,-97.68,-547823.16,1213478.64,665655.48
1977-08-19,97.51,-0.17,-0.17,120.24,-18.9,True,1,12424,-97.51,-547920.67,1211464.24,663543.57
1977-08-22,97.79,0.28,0.29,120.24,-18.67,True,1,12425,-97.79,-548018.46,1215040.75,667022.29
1977-08-23,97.62,-0.17,-0.17,120.24,-18.81,True,1,12426,-97.62,-548116.08,1213026.12,664910.04
1977-08-24,97.23,-0.39,-0.4,120.24,-19.14,True,1,12427,-97.23,-548213.31,1208277.21,660063.9
1977-08-25,96.15,-1.08,-1.11,120.24,-20.04,True,1,12428,-96.15,-548309.46,1194952.2,646642.74
1977-08-26,96.06,-0.09,-0.09,120.24,-20.11,True,1,12429,-96.06,-548405.52,1193929.74,645524.22
1977-08-29,96.92,0.86,0.9,120.24,-19.4,True,1,12430,-96.92,-548502.44,1204715.6,656213.16
1977-08-30,96.38,-0.54,-0.56,120.24,-19.84,True,1,12431,-96.38,-548598.82,1198099.78,649500.96
1977-08-31,96.77,0.39,0.4,120.24,-19.52,True,1,12432,-96.77,-548695.59,1203044.64,654349.05
1977-09-01,96.83,0.06,0.06,120.24,-19.47,True,1,12433,-96.83,-548792.42,1203887.39,655094.97
1977-09-02,97.45,0.62,0.64,120.24,-18.95,True,1,12434,-97.45,-548889.87,1211693.3,662803.43
1977-09-06,97.71,0.26,0.27,120.24,-18.74,True,1,12435,-97.71,-548987.58,1215023.85,666036.27
1977-09-07,98.01,0.3,0.31,120.24,-18.49,True,1,12436,-98.01,-549085.59,1218852.36,669766.77
1977-09-08,97.28,-0.73,-0.74,120.24,-19.1,True,1,12437,-97.28,-549182.87,1209871.36,660688.49
1977-09-09,96.37,-0.91,-0.94,120.24,-19.85,True,1,12438,-96.37,-549279.24,1198650.06,649370.82
1977-09-12,96.03,-0.34,-0.35,120.24,-20.14,True,1,12439,-96.03,-549375.27,1194517.17,645141.9
1977-09-13,96.09,0.06,0.06,120.24,-20.08,True,1,12440,-96.09,-549471.36,1195359.6,645888.24
1977-09-14,96.55,0.46,0.48,120.24,-19.7,True,1,12441,-96.55,-549567.91,1201178.55,651610.64
1977-09-15,96.8,0.25,0.26,120.24,-19.49,True,1,12442,-96.8,-549664.71,1204385.6,654720.89
1977-09-16,96.48,-0.32,-0.33,120.24,-19.76,True,1,12443,-96.48,-549761.19,1200500.64,650739.45
1977-09-19,95.85,-0.63,-0.65,120.24,-20.28,True,1,12444,-95.85,-549857.04,1192757.4,642900.36
1977-09-20,95.89,0.04,0.04,120.24,-20.25,True,1,12445,-95.89,-549952.93,1193351.05,643398.12
1977-09-21,95.1,-0.79,-0.82,120.24,-20.91,True,1,12446,-95.1,-550048.03,1183614.6,633566.57
1977-09-22,95.09,-0.01,-0.01,120.24,-20.92,True,1,12447,-95.09,-550143.12,1183585.23,633442.11
1977-09-23,95.04,-0.05,-0.05,120.24,-20.96,True,1,12448,-95.04,-550238.16,1183057.92,632819.76
1977-09-26,95.38,0.34,0.36,120.24,-20.68,True,1,12449,-95.38,-550333.54,1187385.62,637052.08
1977-09-27,95.24,-0.14,-0.15,120.24,-20.79,True,1,12450,-95.24,-550428.78,1185738.0,635309.22
1977-09-28,95.31,0.07,0.07,120.24,-20.73,True,1,12451,-95.31,-550524.09,1186704.81,636180.72
1977-09-29,95.85,0.54,0.57,120.24,-20.28,True,1,12452,-95.85,-550619.94,1193524.2,642904.26
1977-09-30,96.53,0.68,0.71,120.24,-19.72,True,1,12453,-96.53,-550716.47,1202088.09,651371.62
1977-10-03,96.74,0.21,0.22,120.24,-19.54,True,1,12454,-96.74,-550813.21,1204799.96,653986.75
1977-10-04,96.03,-0.71,-0.73,120.24,-20.14,True,1,12455,-96.03,-550909.24,1196053.65,645144.41
1977-10-05,95.68,-0.35,-0.36,120.24,-20.43,True,1,12456,-95.68,-551004.92,1191790.08,640785.16
1977-10-06,96.05,0.37,0.39,120.24,-20.12,True,1,12457,-96.05,-551100.97,1196494.85,645393.88
1977-10-07,95.97,-0.08,-0.08,120.24,-20.18,True,1,12458,-95.97,-551196.94,1195594.26,644397.32
1977-10-10,95.75,-0.22,-0.23,120.24,-20.37,True,1,12459,-95.75,-551292.69,1192949.25,641656.56
1977-10-11,94.93,-0.82,-0.86,120.24,-21.05,True,1,12460,-94.93,-551387.62,1182827.8,631440.18
1977-10-12,94.04,-0.89,-0.94,120.24,-21.79,True,1,12461,-94.04,-551481.66,1171832.44,620350.78
1977-10-13,93.46,-0.58,-0.62,120.24,-22.27,True,1,12462,-93.46,-551575.12,1164698.52,613123.4
1977-10-14,93.56,0.1,0.11,120.24,-22.19,True,1,12463,-93.56,-551668.68,1166038.28,614369.6
1977-10-17,93.47,-0.09,-0.1,120.24,-22.26,True,1,12464,-93.47,-551762.15,1165010.08,613247.93
1977-10-18,93.46,-0.01,-0.01,120.24,-22.27,True,1,12465,-93.46,-551855.61,1164978.9,613123.29
1977-10-19,92.38,-1.08,-1.16,120.24,-23.17,True,1,12466,-92.38,-551947.99,1151609.08,599661.09
1977-10-20,92.67,0.29,0.31,120.24,-22.93,True,1,12467,-92.67,-552040.66,1155316.89,603276.23
1977-10-21,92.32,-0.35,-0.38,120.24,-23.22,True,1,12468,-92.32,-552132.98,1151045.76,598912.78
1977-10-24,91.63,-0.69,-0.75,120.24,-23.79,True,1,12469,-91.63,-552224.61,1142534.47,590309.86
1977-10-25,91.0,-0.63,-0.69,120.24,-24.32,True,1,12470,-91.0,-552315.61,1134770.0,582454.39
1977-10-26,92.1,1.1,1.21,120.24,-23.4,True,1,12471,-92.1,-552407.71,1148579.1,596171.39
1977-10-27,92.34,0.24,0.26,120.24,-23.2,True,1,12472,-92.34,-552500.05,1151664.48,599164.43
1977-10-28,92.61,0.27,0.29,120.24,-22.98,True,1,12473,-92.61,-552592.66,1155124.53,602531.87
1977-10-31,92.34,-0.27,-0.29,120.24,-23.2,True,1,12474,-92.34,-552685.0,1151849.16,599164.16
1977-11-01,91.35,-0.99,-1.07,120.24,-24.03,True,1,12475,-91.35,-552776.35,1139591.25,586814.9
1977-11-02,90.71,-0.64,-0.7,120.24,-24.56,True,1,12476,-90.71,-552867.06,1131697.96,578830.9
1977-11-03,90.76,0.05,0.06,120.24,-24.52,True,1,12477,-90.76,-552957.82,1132412.52,579454.7
1977-11-04,91.58,0.82,0.9,120.24,-23.84,True,1,12478,-91.58,-553049.4,1142735.24,589685.84
1977-11-07,92.29,0.71,0.78,120.24,-23.24,True,1,12479,-92.29,-553141.69,1151686.91,598545.22
1977-11-08,92.46,0.17,0.18,120.24,-23.1,True,1,12480,-92.46,-553234.15,1153900.8,600666.65
1977-11-09,92.98,0.52,0.56,120.24,-22.67,True,1,12481,-92.98,-553327.13,1160483.38,607156.25
1977-11-10,94.71,1.73,1.86,120.24,-21.23,True,1,12482,-94.71,-553421.84,1182170.22,628748.38
1977-11-11,95.98,1.27,1.34,120.24,-20.18,True,1,12483,-95.98,-553517.82,1198118.34,644600.52
1977-11-14,95.32,-0.66,-0.69,120.24,-20.72,True,1,12484,-95.32,-553613.14,1189974.88,636361.74
1977-11-15,95.93,0.61,0.64,120.24,-20.22,True,1,12485,-95.93,-553709.07,1197686.05,643976.98
1977-11-16,95.45,-0.48,-0.5,120.24,-20.62,True,1,12486,-95.45,-553804.52,1191788.7,637984.18
1977-11-17,95.16,-0.29,-0.3,120.24,-20.86,True,1,12487,-95.16,-553899.68,1188262.92,634363.24
1977-11-18,95.33,0.17,0.18,120.24,-20.72,True,1,12488,-95.33,-553995.01,1190481.04,636486.03
1977-11-21,95.25,-0.08,-0.08,120.24,-20.78,True,1,12489,-95.25,-554090.26,1189577.25,635486.99
1977-11-22,96.09,0.84,0.88,120.24,-20.08,True,1,12490,-96.09,-554186.35,1200164.1,645977.75
1977-11-23,96.49,0.4,0.42,120.24,-19.75,True,1,12491,-96.49,-554282.84,1205256.59,650973.75
1977-11-25,96.69,0.2,0.21,120.24,-19.59,True,1,12492,-96.69,-554379.53,1207851.48,653471.95
1977-11-28,96.04,-0.65,-0.67,120.24,-20.13,True,1,12493,-96.04,-554475.57,1199827.72,645352.15
1977-11-29,94.55,-1.49,-1.55,120.24,-21.37,True,1,12494,-94.55,-554570.12,1181307.7,626737.58
1977-11-30,94.83,0.28,0.3,120.24,-21.13,True,1,12495,-94.83,-554664.95,1184900.85,630235.9
1977-12-01,94.69,-0.14,-0.15,120.24,-21.25,True,1,12496,-94.69,-554759.64,1183246.24,628486.6
1977-12-02,94.67,-0.02,-0.02,120.24,-21.27,True,1,12497,-94.67,-554854.31,1183090.99,628236.68
1977-12-05,94.27,-0.4,-0.42,120.24,-21.6,True,1,12498,-94.27,-554948.58,1178186.46,623237.88
1977-12-06,92.83,-1.44,-1.53,120.24,-22.8,True,1,12499,-92.83,-555041.41,1160282.17,605240.76
1977-12-07,92.78,-0.05,-0.05,120.24,-22.84,True,1,12500,-92.78,-555134.19,1159750.0,604615.81
1977-12-08,92.96,0.18,0.19,120.24,-22.69,True,1,12501,-92.96,-555227.15,1162092.96,606865.81
1977-12-09,93.65,0.69,0.74,120.24,-22.11,True,1,12502,-93.65,-555320.8,1170812.3,615491.5
1977-12-12,93.63,-0.02,-0.02,120.24,-22.13,True,1,12503,-93.63,-555414.43,1170655.89,615241.46
1977-12-13,93.56,-0.07,-0.08,120.24,-22.19,True,1,12504,-93.56,-555507.99,1169874.24,614366.25
1977-12-14,94.03,0.47,0.5,120.24,-21.8,True,1,12505,-94.03,-555602.02,1175845.15,620243.13
1977-12-15,93.55,-0.48,-0.51,120.24,-22.2,True,1,12506,-93.55,-555695.57,1169936.3,614240.73
1977-12-16,93.4,-0.15,-0.16,120.24,-22.32,True,1,12507,-93.4,-555788.97,1168153.8,612364.83
1977-12-19,92.69,-0.71,-0.76,120.24,-22.91,True,1,12508,-92.69,-555881.66,1159366.52,603484.86
1977-12-20,92.5,-0.19,-0.2,120.24,-23.07,True,1,12509,-92.5,-555974.16,1157082.5,601108.34
1977-12-21,93.05,0.55,0.6,120.24,-22.61,True,1,12510,-93.05,-556067.21,1164055.5,607988.29
1977-12-22,93.8,0.75,0.81,120.24,-21.99,True,1,12511,-93.8,-556161.01,1173531.8,617370.79
1977-12-23,94.69,0.89,0.95,120.24,-21.25,True,1,12512,-94.69,-556255.7,1184761.28,628505.58
1977-12-27,94.69,0.0,0.0,120.24,-21.25,True,1,12513,-94.69,-556350.39,1184855.97,628505.58
1977-12-28,94.75,0.06,0.06,120.24,-21.2,True,1,12514,-94.75,-556445.14,1185701.5,629256.36
1977-12-29,94.94,0.19,0.2,120.24,-21.04,True,1,12515,-94.94,-556540.08,1188174.1,631634.02
1977-12-30,95.1,0.16,0.17,120.24,-20.91,True,1,12516,-95.1,-556635.18,1190271.6,633636.42
1978-01-03,93.82,-1.28,-1.35,120.24,-21.97,True,1,12517,-93.82,-556729.0,1174344.94,617615.94
1978-01-04,93.52,-0.3,-0.32,120.24,-22.22,True,1,12518,-93.52,-556822.52,1170683.36,613860.84
1978-01-05,92.74,-0.78,-0.83,120.24,-22.87,True,1,12519,-92.74,-556915.26,1161012.06,604096.8
1978-01-06,91.62,-1.12,-1.21,120.24,-23.8,True,1,12520,-91.62,-557006.88,1147082.4,590075.52
1978-01-09,90.64,-0.98,-1.07,120.24,-24.62,True,1,12521,-90.64,-557097.52,1134903.44,577805.92
1978-01-10,90.17,-0.47,-0.52,120.24,-25.01,True,1,12522,-90.17,-557187.69,1129108.74,571921.05
1978-01-11,89.74,-0.43,-0.48,120.24,-25.37,True,1,12523,-89.74,-557277.43,1123814.02,566536.59
1978-01-12,89.82,0.08,0.09,120.24,-25.3,True,1,12524,-89.82,-557367.25,1124905.68,567538.43
1978-01-13,89.69,-0.13,-0.14,120.24,-25.41,True,1,12525,-89.69,-557456.94,1123367.25,565910.31
1978-01-16,89.43,-0.26,-0.29,120.24,-25.62,True,1,12526,-89.43,-557546.37,1120200.18,562653.81
1978-01-17,89.88,0.45,0.5,120.24,-25.25,True,1,12527,-89.88,-557636.25,1125926.76,568290.51
1978-01-18,90.56,0.68,0.76,120.24,-24.68,True,1,12528,-90.56,-557726.81,1134535.68,576808.87
1978-01-19,90.09,-0.47,-0.52,120.24,-25.08,True,1,12529,-90.09,-557816.9,1128737.61,570920.71
1978-01-20,89.89,-0.2,-0.22,120.24,-25.24,True,1,12530,-89.89,-557906.79,1126321.7,568414.91
1978-01-23,89.24,-0.65,-0.72,120.24,-25.78,True,1,12531,-89.24,-557996.03,1118266.44,560270.41
1978-01-24,89.25,0.01,0.01,120.24,-25.77,True,1,12532,-89.25,-558085.28,1118481.0,560395.72
1978-01-25,89.39,0.14,0.16,120.24,-25.66,True,1,12533,-89.39,-558174.67,1120324.87,562150.2
1978-01-26,88.58,-0.81,-0.91,120.24,-26.33,True,1,12534,-88.58,-558263.25,1110261.72,551998.47
1978-01-27,88.58,0.0,0.0,120.24,-26.33,True,1,12535,-88.58,-558351.83,1110350.3,551998.47
1978-01-30,89.34,0.76,0.86,120.24,-25.7,True,1,12536,-89.34,-558441.17,1119966.24,561525.07
1978-01-31,89.25,-0.09,-0.1,120.24,-25.77,True,1,12537,-89.25,-558530.42,1118927.25,560396.83
1978-02-01,89.93,0.68,0.76,120.24,-25.21,True,1,12538,-89.93,-558620.35,1127542.34,568921.99
1978-02-02,90.13,0.2,0.22,120.24,-25.04,True,1,12539,-90.13,-558710.48,1130140.07,571429.59
1978-02-03,89.62,-0.51,-0.57,120.24,-25.47,True,1,12540,-89.62,-558800.1,1123834.8,565034.7
1978-02-06,89.5,-0.12,-0.13,120.24,-25.57,True,1,12541,-89.5,-558889.6,1122419.5,563529.9
1978-02-07,90.33,0.83,0.93,120.24,-24.88,True,1,12542,-90.33,-558979.93,1132918.86,573938.93
1978-02-08,90.83,0.5,0.55,120.24,-24.46,True,1,12543,-90.83,-559070.76,1139280.69,580209.93
1978-02-09,90.3,-0.53,-0.58,120.24,-24.9,True,1,12544,-90.3,-559161.06,1132723.2,573562.14
1978-02-10,90.08,-0.22,-0.24,120.24,-25.08,True,1,12545,-90.08,-559251.14,1130053.6,570802.46
1978-02-13,89.86,-0.22,-0.24,120.24,-25.27,True,1,12546,-89.86,-559341.0,1127383.56,568042.56
1978-02-14,89.04,-0.82,-0.91,120.24,-25.95,True,1,12547,-89.04,-559430.04,1117184.88,557754.84
1978-02-15,88.83,-0.21,-0.24,120.24,-26.12,True,1,12548,-88.83,-559518.87,1114638.84,555119.97
1978-02-16,88.08,-0.75,-0.84,120.24,-26.75,True,1,12549,-88.08,-559606.95,1105315.92,545708.97
1978-02-17,87.96,-0.12,-0.14,120.24,-26.85,True,1,12550,-87.96,-559694.91,1103898.0,544203.09
1978-02-21,87.59,-0.37,-0.42,120.24,-27.15,True,1,12551,-87.59,-559782.5,1099342.09,539559.59
1978-02-22,87.56,-0.03,-0.03,120.24,-27.18,True,1,12552,-87.56,-559870.06,1099053.12,539183.06
1978-02-23,87.64,0.08,0.09,120.24,-27.11,True,1,12553,-87.64,-559957.7,1100144.92,540187.22
1978-02-24,88.49,0.85,0.97,120.24,-26.41,True,1,12554,-88.49,-560046.19,1110903.46,550857.27
1978-02-27,87.72,-0.77,-0.87,120.24,-27.05,True,1,12555,-87.72,-560133.91,1101324.6,541190.69
1978-02-28,87.04,-0.68,-0.78,120.24,-27.61,True,1,12556,-87.04,-560220.95,1092874.24,532653.29
1978-03-01,87.19,0.15,0.17,120.24,-27.49,True,1,12557,-87.19,-560308.14,1094844.83,534536.69
1978-03-02,87.32,0.13,0.15,120.24,-27.38,True,1,12558,-87.32,-560395.46,1096564.56,536169.1
1978-03-03,87.45,0.13,0.15,120.24,-27.27,True,1,12559,-87.45,-560482.91,1098284.55,537801.64
1978-03-06,86.9,-0.55,-0.63,120.24,-27.73,True,1,12560,-86.9,-560569.81,1091464.0,530894.19
1978-03-07,87.36,0.46,0.53,120.24,-27.34,True,1,12561,-87.36,-560657.17,1097328.96,536671.79
1978-03-08,87.84,0.48,0.55,120.24,-26.95,True,1,12562,-87.84,-560745.01,1103446.08,542701.07
1978-03-09,87.89,0.05,0.06,120.24,-26.9,True,1,12563,-87.89,-560832.9,1104162.07,543329.17
1978-03-10,88.88,0.99,1.13,120.24,-26.08,True,1,12564,-88.88,-560921.78,1116688.32,555766.54
1978-03-13,88.95,0.07,0.08,120.24,-26.02,True,1,12565,-88.95,-561010.73,1117656.75,556646.02
1978-03-14,89.35,0.4,0.45,120.24,-25.69,True,1,12566,-89.35,-561100.08,1122772.1,561672.02
1978-03-15,89.12,-0.23,-0.26,120.24,-25.88,True,1,12567,-89.12,-561189.2,1119971.04,558781.84
1978-03-16,89.51,0.39,0.44,120.24,-25.56,True,1,12568,-89.51,-561278.71,1124961.68,563682.97
1978-03-17,90.2,0.69,0.77,120.24,-24.98,True,1,12569,-90.2,-561368.91,1133723.8,572354.89
1978-03-20,90.82,0.62,0.69,120.24,-24.47,True,1,12570,-90.82,-561459.73,1141607.4,580147.67
1978-03-21,89.79,-1.03,-1.13,120.24,-25.32,True,1,12571,-89.79,-561549.52,1128750.09,567200.57
1978-03-22,89.47,-0.32,-0.36,120.24,-25.59,True,1,12572,-89.47,-561638.99,1124816.84,563177.85
1978-03-23,89.36,-0.11,-0.12,120.24,-25.68,True,1,12573,-89.36,-561728.35,1123523.28,561794.93
1978-03-27,88.87,-0.49,-0.55,120.24,-26.09,True,1,12574,-88.87,-561817.22,1117451.38,555634.16
1978-03-28,89.5,0.63,0.71,120.24,-25.57,True,1,12575,-89.5,-561906.72,1125462.5,563555.78
1978-03-29,89.64,0.14,0.16,120.24,-25.45,True,1,12576,-89.64,-561996.36,1127312.64,565316.28
1978-03-30,89.41,-0.23,-0.26,120.24,-25.64,True,1,12577,-89.41,-562085.77,1124509.57,562423.8
1978-03-31,89.21,-0.2,-0.22,120.24,-25.81,True,1,12578,-89.21,-562174.98,1122083.38,559908.4
1978-04-03,88.46,-0.75,-0.84,120.24,-26.43,True,1,12579,-88.46,-562263.44,1112738.34,550474.9
1978-04-04,88.86,0.4,0.45,120.24,-26.1,True,1,12580,-88.86,-562352.3,1117858.8,555506.5
1978-04-05,89.64,0.78,0.88,120.24,-25.45,True,1,12581,-89.64,-562441.94,1127760.84,565318.9
1978-04-06,89.79,0.15,0.17,120.24,-25.32,True,1,12582,-89.79,-562531.73,1129737.78,567206.05
1978-04-07,90.17,0.38,0.42,120.24,-25.01,True,1,12583,-90.17,-562621.9,1134609.11,571987.21
1978-04-10,90.49,0.32,0.36,120.24,-24.74,True,1,12584,-90.49,-562712.39,1138726.16,576013.77
1978-04-11,90.25,-0.24,-0.26,120.24,-24.94,True,1,12585,-90.25,-562802.64,1135796.25,572993.61
1978-04-12,90.11,-0.14,-0.16,120.24,-25.06,True,1,12586,-90.11,-562892.75,1134124.46,571231.71
1978-04-13,90.98,0.87,0.96,120.24,-24.34,True,1,12587,-90.98,-562983.73,1145165.26,582181.53
1978-04-14,92.92,1.94,2.13,120.24,-22.72,True,1,12588,-92.92,-563076.65,1169676.96,606600.31
1978-04-17,94.45,1.53,1.65,120.24,-21.45,True,1,12589,-94.45,-563171.1,1189031.05,625859.95
1978-04-18,93.43,-1.02,-1.08,120.24,-22.3,True,1,12590,-93.43,-563264.53,1176283.7,613019.17
1978-04-19,93.86,0.43,0.46,120.24,-21.94,True,1,12591,-93.86,-563358.39,1181791.26,618432.87
1978-04-20,94.54,0.68,0.72,120.24,-21.37,True,1,12592,-94.54,-563452.93,1190447.68,626994.75
1978-04-21,94.34,-0.2,-0.21,120.24,-21.54,True,1,12593,-94.34,-563547.27,1188023.62,624476.35
1978-04-24,95.77,1.43,1.52,120.24,-20.35,True,1,12594,-95.77,-563643.04,1206127.38,642484.34
1978-04-25,96.64,0.87,0.91,120.24,-19.63,True,1,12595,-96.64,-563739.68,1217180.8,653441.12
1978-04-26,96.82,0.18,0.19,120.24,-19.48,True,1,12596,-96.82,-563836.5,1219544.72,655708.22
1978-04-27,95.86,-0.96,-0.99,120.24,-20.28,True,1,12597,-95.86,-563932.36,1207548.42,643616.06
1978-04-28,96.83,0.97,1.01,120.24,-19.47,True,1,12598,-96.83,-564029.19,1219864.34,655835.15
1978-05-01,97.67,0.84,0.87,120.24,-18.77,True,1,12599,-97.67,-564126.86,1230544.33,666417.47
1978-05-02,97.25,-0.42,-0.43,120.24,-19.12,True,1,12600,-97.25,-564224.11,1225350.0,661125.89
1978-05-03,96.26,-0.99,-1.02,120.24,-19.94,True,1,12601,-96.26,-564320.37,1212972.26,648651.89
1978-05-04,95.93,-0.33,-0.34,120.24,-20.22,True,1,12602,-95.93,-564416.3,1208909.86,644493.56
1978-05-05,96.53,0.6,0.62,120.24,-19.72,True,1,12603,-96.53,-564512.83,1216567.59,652054.76
1978-05-08,96.19,-0.34,-0.35,120.24,-20.0,True,1,12604,-96.19,-564609.02,1212378.76,647769.74
1978-05-09,95.9,-0.29,-0.3,120.24,-20.24,True,1,12605,-95.9,-564704.92,1208819.5,644114.58
1978-05-10,95.92,0.02,0.02,120.24,-20.23,True,1,12606,-95.92,-564800.84,1209167.52,644366.68
1978-05-11,97.2,1.28,1.33,120.24,-19.16,True,1,12607,-97.2,-564898.04,1225400.4,660502.36
1978-05-12,98.07,0.87,0.9,120.24,-18.44,True,1,12608,-98.07,-564996.11,1236466.56,671470.45
1978-05-15,98.76,0.69,0.7,120.24,-17.86,True,1,12609,-98.76,-565094.87,1245264.84,680169.97
1978-05-16,99.35,0.59,0.6,120.24,-17.37,True,1,12610,-99.35,-565194.22,1252803.5,687609.28
1978-05-17,99.6,0.25,0.25,120.24,-17.17,True,1,12611,-99.6,-565293.82,1256055.6,690761.78
1978-05-18,98.62,-0.98,-0.98,120.24,-17.98,True,1,12612,-98.62,-565392.44,1243795.44,678403.0
1978-05-19,98.12,-0.5,-0.51,120.24,-18.4,True,1,12613,-98.12,-565490.56,1237587.56,672097.0
1978-05-22,99.09,0.97,0.99,120.24,-17.59,True,1,12614,-99.09,-565589.65,1249921.26,684331.61
1978-05-23,98.05,-1.04,-1.05,120.24,-18.45,True,1,12615,-98.05,-565687.7,1236900.75,671213.05
1978-05-24,97.08,-0.97,-0.99,120.24,-19.26,True,1,12616,-97.08,-565784.78,1224761.28,658976.5
1978-05-25,96.8,-0.28,-0.29,120.24,-19.49,True,1,12617,-96.8,-565881.58,1221325.6,655444.02
1978-05-26,96.58,-0.22,-0.23,120.24,-19.68,True,1,12618,-96.58,-565978.16,1218646.44,652668.28
1978-05-30,96.86,0.28,0.29,120.24,-19.44,True,1,12619,-96.86,-566075.02,1222276.34,656201.32
1978-05-31,97.24,0.38,0.39,120.24,-19.13,True,1,12620,-97.24,-566172.26,1227168.8,660996.54
1978-06-01,97.35,0.11,0.11,120.24,-19.04,True,1,12621,-97.35,-566269.61,1228654.35,662384.74
1978-06-02,98.14,0.79,0.81,120.24,-18.38,True,1,12622,-98.14,-566367.75,1238723.08,672355.33
1978-06-05,99.95,1.81,1.84,120.24,-16.88,True,1,12623,-99.95,-566467.7,1261668.85,695201.15
1978-06-06,100.32,0.37,0.37,120.24,-16.57,True,1,12624,-100.32,-566568.02,1266439.68,699871.66
1978-06-07,100.12,-0.2,-0.2,120.24,-16.73,True,1,12625,-100.12,-566668.14,1264015.0,697346.86
1978-06-08,100.21,0.09,0.09,120.24,-16.66,True,1,12626,-100.21,-566768.35,1265251.46,698483.11
1978-06-09,99.93,-0.28,-0.28,120.24,-16.89,True,1,12627,-99.93,-566868.28,1261816.11,694947.83
1978-06-12,99.55,-0.38,-0.38,120.24,-17.21,True,1,12628,-99.55,-566967.83,1257117.4,690149.57
1978-06-13,99.57,0.02,0.02,120.24,-17.19,True,1,12629,-99.57,-567067.4,1257469.53,690402.13
1978-06-14,99.48,-0.09,-0.09,120.24,-17.26,True,1,12630,-99.48,-567166.88,1256432.4,689265.52
1978-06-15,98.34,-1.14,-1.15,120.24,-18.21,True,1,12631,-98.34,-567265.22,1242132.54,674867.32
1978-06-16,97.42,-0.92,-0.94,120.24,-18.98,True,1,12632,-97.42,-567362.64,1230609.44,663246.8
1978-06-19,97.49,0.07,0.07,120.24,-18.92,True,1,12633,-97.49,-567460.13,1231591.17,664131.04
1978-06-20,96.51,-0.98,-1.0,120.24,-19.74,True,1,12634,-96.51,-567556.64,1219307.34,651750.7
1978-06-21,96.01,-0.5,-0.52,120.24,-20.15,True,1,12635,-96.01,-567652.65,1213086.35,645433.7
1978-06-22,96.24,0.23,0.24,120.24,-19.96,True,1,12636,-96.24,-567748.89,1216088.64,648339.75
1978-06-23,95.85,-0.39,-0.4,120.24,-20.28,True,1,12637,-95.85,-567844.74,1211256.45,643411.71
1978-06-26,94.6,-1.25,-1.3,120.24,-21.32,True,1,12638,-94.6,-567939.34,1195554.8,627615.46
1978-06-27,94.98,0.38,0.4,120.24,-21.01,True,1,12639,-94.98,-568034.32,1200452.22,632417.9
1978-06-28,95.4,0.42,0.44,120.24,-20.66,True,1,12640,-95.4,-568129.72,1205856.0,637726.28
1978-06-29,95.57,0.17,0.18,120.24,-20.52,True,1,12641,-95.57,-568225.29,1208100.37,639875.08
1978-06-30,95.53,-0.04,-0.04,120.24,-20.55,True,1,12642,-95.53,-568320.82,1207690.26,639369.44
1978-07-03,95.09,-0.44,-0.46,120.24,-20.92,True,1,12643,-95.09,-568415.91,1202222.87,633806.96
1978-07-05,94.27,-0.82,-0.86,120.24,-21.6,True,1,12644,-94.27,-568510.18,1191949.88,623439.7
1978-07-06,94.32,0.05,0.05,120.24,-21.56,True,1,12645,-94.32,-568604.5,1192676.4,624071.9
1978-07-07,94.89,0.57,0.6,120.24,-21.08,True,1,12646,-94.89,-568699.39,1199978.94,631279.55
1978-07-10,95.27,0.38,0.4,120.24,-20.77,True,1,12647,-95.27,-568794.66,1204879.69,636085.03
1978-07-11,95.93,0.66,0.69,120.24,-20.22,True,1,12648,-95.93,-568890.59,1213322.64,644432.05
1978-07-12,96.24,0.31,0.32,120.24,-19.96,True,1,12649,-96.24,-568986.83,1217339.76,648352.93
1978-07-13,96.25,0.01,0.01,120.24,-19.95,True,1,12650,-96.25,-569083.08,1217562.5,648479.42
1978-07-14,97.58,1.33,1.38,120.24,-18.85,True,1,12651,-97.58,-569180.66,1234484.58,665303.92
1978-07-17,97.78,0.2,0.2,120.24,-18.68,True,1,12652,-97.78,-569278.44,1237112.56,667834.12
1978-07-18,96.87,-0.91,-0.93,120.24,-19.44,True,1,12653,-96.87,-569375.31,1225696.11,656320.8
1978-07-19,98.12,1.25,1.29,120.24,-18.4,True,1,12654,-98.12,-569473.43,1241610.48,672137.05
1978-07-20,98.03,-0.09,-0.09,120.24,-18.47,True,1,12655,-98.03,-569571.46,1240569.65,670998.19
1978-07-21,97.75,-0.28,-0.29,120.24,-18.7,True,1,12656,-97.75,-569669.21,1237124.0,667454.79
1978-07-24,97.72,-0.03,-0.03,120.24,-18.73,True,1,12657,-97.72,-569766.93,1236842.04,667075.11
1978-07-25,98.44,0.72,0.74,120.24,-18.13,True,1,12658,-98.44,-569865.37,1246053.52,676188.15
1978-07-26,99.08,0.64,0.65,120.24,-17.6,True,1,12659,-99.08,-569964.45,1254253.72,684289.27
1978-07-27,99.54,0.46,0.46,120.24,-17.22,True,1,12660,-99.54,-570063.99,1260176.4,690112.41
1978-07-28,100.0,0.46,0.46,120.24,-16.83,True,1,12661,-100.0,-570163.99,1266100.0,695936.01
1978-07-31,100.68,0.68,0.68,120.24,-16.27,True,1,12662,-100.68,-570264.67,1274810.16,704545.49
1978-08-01,100.66,-0.02,-0.02,120.24,-16.28,True,1,12663,-100.66,-570365.33,1274657.58,704292.25
1978-08-02,102.92,2.26,2.24,120.24,-14.4,True,1,12664,-102.92,-570468.25,1303378.88,732910.63
1978-08-03,103.51,0.59,0.57,120.24,-13.91,True,1,12665,-103.51,-570571.76,1310954.15,740382.39
1978-08-04,103.92,0.41,0.4,120.24,-13.57,True,1,12666,-103.92,-570675.68,1316250.72,745575.04
1978-08-07,103.55,-0.37,-0.36,120.24,-13.88,True,1,12667,-103.55,-570779.23,1311667.85,740888.62
1978-08-08,104.01,0.46,0.44,120.24,-13.5,True,1,12668,-104.01,-570883.24,1317598.68,746715.44
1978-08-09,104.5,0.49,0.47,120.24,-13.09,True,1,12669,-104.5,-570987.74,1323910.5,752922.76
1978-08-10,103.66,-0.84,-0.8,120.24,-13.79,True,1,12670,-103.66,-571091.4,1313372.2,742280.8
1978-08-11,103.96,0.3,0.29,120.24,-13.54,True,1,12671,-103.96,-571195.36,1317277.16,746081.8
1978-08-14,103.97,0.01,0.01,120.24,-13.53,True,1,12672,-103.97,-571299.33,1317507.84,746208.51
1978-08-15,103.85,-0.12,-0.12,120.24,-13.63,True,1,12673,-103.85,-571403.18,1316091.05,744687.87
1978-08-16,104.65,0.8,0.77,120.24,-12.97,True,1,12674,-104.65,-571507.83,1326334.1,754826.27
1978-08-17,105.08,0.43,0.41,120.24,-12.61,True,1,12675,-105.08,-571612.91,1331889.0,760276.09
1978-08-18,104.73,-0.35,-0.33,120.24,-12.9,True,1,12676,-104.73,-571717.64,1327557.48,755839.84
1978-08-21,103.89,-0.84,-0.8,120.24,-13.6,True,1,12677,-103.89,-571821.53,1317013.53,745192.0
1978-08-22,104.31,0.42,0.4,120.24,-13.25,True,1,12678,-104.31,-571925.84,1322442.18,750516.34
1978-08-23,104.91,0.6,0.57,120.24,-12.75,True,1,12679,-104.91,-572030.75,1330153.89,758123.14
1978-08-24,105.08,0.17,0.16,120.24,-12.61,True,1,12680,-105.08,-572135.83,1332414.4,760278.57
1978-08-25,104.9,-0.18,-0.17,120.24,-12.76,True,1,12681,-104.9,-572240.73,1330236.9,757996.17
1978-08-28,103.96,-0.94,-0.9,120.24,-13.54,True,1,12682,-103.96,-572344.69,1318420.72,746076.03
1978-08-29,103.39,-0.57,-0.55,120.24,-14.01,True,1,12683,-103.39,-572448.08,1311295.37,738847.29
1978-08-30,103.5,0.11,0.11,120.24,-13.92,True,1,12684,-103.5,-572551.58,1312794.0,740242.42
1978-08-31,103.29,-0.21,-0.2,120.24,-14.1,True,1,12685,-103.29,-572654.87,1310233.65,737578.78
1978-09-01,103.68,0.39,0.38,120.24,-13.77,True,1,12686,-103.68,-572758.55,1315284.48,742525.93
1978-09-05,104.49,0.81,0.78,120.24,-13.1,True,1,12687,-104.49,-572863.04,1325664.63,752801.59
1978-09-06,105.38,0.89,0.85,120.24,-12.36,True,1,12688,-105.38,-572968.42,1337061.44,764093.02
1978-09-07,105.42,0.04,0.04,120.24,-12.32,True,1,12689,-105.42,-573073.84,1337674.38,764600.54
1978-09-08,106.79,1.37,1.3,120.24,-11.19,True,1,12690,-106.79,-573180.63,1355165.1,781984.47
1978-09-11,106.98,0.19,0.18,120.24,-11.03,True,1,12691,-106.98,-573287.61,1357683.18,784395.57
1978-09-12,106.99,0.01,0.01,120.24,-11.02,True,1,12692,-106.99,-573394.6,1357917.08,784522.48
1978-09-13,106.34,-0.65,-0.61,120.24,-11.56,True,1,12693,-106.34,-573500.94,1349773.62,776272.68
1978-09-14,105.1,-1.24,-1.17,120.24,-12.59,True,1,12694,-105.1,-573606.04,1334139.4,760533.36
1978-09-15,104.12,-0.98,-0.93,120.24,-13.41,True,1,12695,-104.12,-573710.16,1321803.4,748093.24
1978-09-18,103.21,-0.91,-0.87,120.24,-14.16,True,1,12696,-103.21,-573813.37,1310354.16,736540.79
1978-09-19,102.53,-0.68,-0.66,120.24,-14.73,True,1,12697,-102.53,-573915.9,1301823.41,727907.51
1978-09-20,101.73,-0.8,-0.78,120.24,-15.39,True,1,12698,-101.73,-574017.63,1291767.54,717749.91
1978-09-21,101.9,0.17,0.17,120.24,-15.25,True,1,12699,-101.9,-574119.53,1294028.1,719908.57
1978-09-22,101.84,-0.06,-0.06,120.24,-15.3,True,1,12700,-101.84,-574221.37,1293368.0,719146.63
1978-09-25,101.86,0.02,0.02,120.24,-15.29,True,1,12701,-101.86,-574323.23,1293723.86,719400.63
1978-09-26,102.62,0.76,0.75,120.24,-14.65,True,1,12702,-102.62,-574425.85,1303479.24,729053.39
1978-09-27,101.66,-0.96,-0.94,120.24,-15.45,True,1,12703,-101.66,-574527.51,1291386.98,716859.47
1978-09-28,101.96,0.3,0.3,120.24,-15.2,True,1,12704,-101.96,-574629.47,1295299.84,720670.37
1978-09-29,102.54,0.58,0.57,120.24,-14.72,True,1,12705,-102.54,-574732.01,1302770.7,728038.69
1978-10-02,102.96,0.42,0.41,120.24,-14.37,True,1,12706,-102.96,-574834.97,1308209.76,733374.79
1978-10-03,102.6,-0.36,-0.35,120.24,-14.67,True,1,12707,-102.6,-574937.57,1303738.2,728800.63
1978-10-04,103.06,0.46,0.45,120.24,-14.29,True,1,12708,-103.06,-575040.63,1309686.48,734645.85
1978-10-05,103.27,0.21,0.2,120.24,-14.11,True,1,12709,-103.27,-575143.9,1312458.43,737314.53
1978-10-06,103.52,0.25,0.24,120.24,-13.91,True,1,12710,-103.52,-575247.42,1315739.2,740491.78
1978-10-09,104.59,1.07,1.03,120.24,-13.02,True,1,12711,-104.59,-575352.01,1329443.49,754091.48
1978-10-10,104.46,-0.13,-0.12,120.24,-13.12,True,1,12712,-104.46,-575456.47,1327895.52,752439.05
1978-10-11,105.39,0.93,0.89,120.24,-12.35,True,1,12713,-105.39,-575561.86,1339823.07,764261.21
1978-10-12,104.88,-0.51,-0.48,120.24,-12.77,True,1,12714,-104.88,-575666.74,1333444.32,757777.58
1978-10-13,104.66,-0.22,-0.21,120.24,-12.96,True,1,12715,-104.66,-575771.4,1330751.9,754980.5
1978-10-16,102.61,-2.05,-1.96,120.24,-14.66,True,1,12716,-102.61,-575874.01,1304788.76,728914.75
1978-10-17,101.26,-1.35,-1.32,120.24,-15.78,True,1,12717,-101.26,-575975.27,1287723.42,711748.15
1978-10-18,100.49,-0.77,-0.76,120.24,-16.42,True,1,12718,-100.49,-576075.76,1278031.82,701956.06
1978-10-19,99.33,-1.16,-1.15,120.24,-17.39,True,1,12719,-99.33,-576175.09,1263378.27,687203.18
1978-10-20,97.95,-1.38,-1.39,120.24,-18.54,True,1,12720,-97.95,-576273.04,1245924.0,669650.96
1978-10-23,98.18,0.23,0.24,120.24,-18.35,True,1,12721,-98.18,-576371.22,1248947.78,672576.56
1978-10-24,97.49,-0.69,-0.7,120.24,-18.92,True,1,12722,-97.49,-576468.71,1240267.78,663799.07
1978-10-25,97.31,-0.18,-0.18,120.24,-19.07,True,1,12723,-97.31,-576566.02,1238075.13,661509.11
1978-10-26,96.03,-1.28,-1.32,120.24,-20.14,True,1,12724,-96.03,-576662.05,1221885.72,645223.67
1978-10-27,94.59,-1.44,-1.5,120.24,-21.33,True,1,12725,-94.59,-576756.64,1203657.75,626901.11
1978-10-30,95.06,0.47,0.5,120.24,-20.94,True,1,12726,-95.06,-576851.7,1209733.56,632881.86
1978-10-31,93.15,-1.91,-2.01,120.24,-22.53,True,1,12727,-93.15,-576944.85,1185520.05,608575.2
1978-11-01,96.85,3.7,3.97,120.24,-19.45,True,1,12728,-96.85,-577041.7,1232706.8,655665.1
1978-11-02,95.61,-1.24,-1.28,120.24,-20.48,True,1,12729,-95.61,-577137.31,1217019.69,639882.38
1978-11-03,96.18,0.57,0.6,120.24,-20.01,True,1,12730,-96.18,-577233.49,1224371.4,647137.91
1978-11-06,95.19,-0.99,-1.03,120.24,-20.83,True,1,12731,-95.19,-577328.68,1211863.89,634535.21
1978-11-07,93.85,-1.34,-1.41,120.24,-21.95,True,1,12732,-93.85,-577422.53,1194898.2,617475.67
1978-11-08,94.45,0.6,0.64,120.24,-21.45,True,1,12733,-94.45,-577516.98,1202631.85,625114.87
1978-11-09,94.42,-0.03,-0.03,120.24,-21.47,True,1,12734,-94.42,-577611.4,1202344.28,624732.88
1978-11-10,94.77,0.35,0.37,120.24,-21.18,True,1,12735,-94.77,-577706.17,1206895.95,629189.78
1978-11-13,93.13,-1.64,-1.73,120.24,-22.55,True,1,12736,-93.13,-577799.3,1186103.68,608304.38
1978-11-14,92.49,-0.64,-0.69,120.24,-23.08,True,1,12737,-92.49,-577891.79,1178045.13,600153.34
1978-11-15,92.71,0.22,0.24,120.24,-22.9,True,1,12738,-92.71,-577984.5,1180939.98,602955.48
1978-11-16,93.71,1.0,1.08,120.24,-22.06,True,1,12739,-93.71,-578078.21,1193771.69,615693.48
1978-11-17,94.42,0.71,0.76,120.24,-21.47,True,1,12740,-94.42,-578172.63,1202910.8,624738.17
1978-11-20,95.25,0.83,0.88,120.24,-20.78,True,1,12741,-95.25,-578267.88,1213580.25,635312.37
1978-11-21,95.01,-0.24,-0.25,120.24,-20.98,True,1,12742,-95.01,-578362.89,1210617.42,632254.53
1978-11-22,95.48,0.47,0.5,120.24,-20.59,True,1,12743,-95.48,-578458.37,1216701.64,638243.27
1978-11-24,95.79,0.31,0.32,120.24,-20.33,True,1,12744,-95.79,-578554.16,1220747.76,642193.6
1978-11-27,95.99,0.2,0.21,120.24,-20.17,True,1,12745,-95.99,-578650.15,1223392.55,644742.4
1978-11-28,95.15,-0.84,-0.88,120.24,-20.87,True,1,12746,-95.15,-578745.3,1212781.9,634036.6
1978-11-29,93.75,-1.4,-1.47,120.24,-22.03,True,1,12747,-93.75,-578839.05,1195031.25,616192.2
1978-11-30,94.7,0.95,1.01,120.24,-21.24,True,1,12748,-94.7,-578933.75,1207235.6,628301.85
1978-12-01,96.28,1.58,1.67,120.24,-19.93,True,1,12749,-96.28,-579030.03,1227473.72,648443.69
1978-12-04,96.15,-0.13,-0.14,120.24,-20.04,True,1,12750,-96.15,-579126.18,1225912.5,646786.32
1978-12-05,97.44,1.29,1.34,120.24,-18.96,True,1,12751,-97.44,-579223.62,1242457.44,663233.82
1978-12-06,97.49,0.05,0.05,120.24,-18.92,True,1,12752,-97.49,-579321.11,1243192.48,663871.37
1978-12-07,97.08,-0.41,-0.42,120.24,-19.26,True,1,12753,-97.08,-579418.19,1238061.24,658643.05
1978-12-08,96.63,-0.45,-0.46,120.24,-19.64,True,1,12754,-96.63,-579514.82,1232419.02,652904.2
1978-12-11,97.11,0.48,0.5,120.24,-19.24,True,1,12755,-97.11,-579611.93,1238638.05,659026.12
1978-12-12,96.59,-0.52,-0.54,120.24,-19.67,True,1,12756,-96.59,-579708.52,1232102.04,652393.52
1978-12-13,96.06,-0.53,-0.55,120.24,-20.11,True,1,12757,-96.06,-579804.58,1225437.42,645632.84
1978-12-14,96.04,-0.02,-0.02,120.24,-20.13,True,1,12758,-96.04,-579900.62,1225278.32,645377.7
1978-12-15,95.33,-0.71,-0.74,120.24,-20.72,True,1,12759,-95.33,-579995.95,1216315.47,636319.52
1978-12-18,93.44,-1.89,-1.98,120.24,-22.29,True,1,12760,-93.44,-580089.39,1192294.4,612205.01
1978-12-19,94.24,0.8,0.86,120.24,-21.62,True,1,12761,-94.24,-580183.63,1202596.64,622413.01
1978-12-20,94.68,0.44,0.47,120.24,-21.26,True,1,12762,-94.68,-580278.31,1208306.16,628027.85
1978-12-21,94.71,0.03,0.03,120.24,-21.23,True,1,12763,-94.71,-580373.02,1208783.73,628410.71
1978-12-22,96.31,1.6,1.69,120.24,-19.9,True,1,12764,-96.31,-580469.33,1229300.84,648831.51
1978-12-26,97.52,1.21,1.26,120.24,-18.9,True,1,12765,-97.52,-580566.85,1244842.8,664275.95
1978-12-27,96.66,-0.86,-0.88,120.24,-19.61,True,1,12766,-96.66,-580663.51,1233961.56,653298.05
1978-12-28,96.28,-0.38,-0.39,120.24,-19.93,True,1,12767,-96.28,-580759.79,1229206.76,648446.97
1978-12-29,96.11,-0.17,-0.18,120.24,-20.07,True,1,12768,-96.11,-580855.9,1227132.48,646276.58
1979-01-02,96.73,0.62,0.64,120.24,-19.55,True,1,12769,-96.73,-580952.63,1235145.37,654192.74
1979-01-03,97.8,1.07,1.11,120.24,-18.66,True,1,12770,-97.8,-581050.43,1248906.0,667855.57
1979-01-04,98.58,0.78,0.8,120.24,-18.01,True,1,12771,-98.58,-581149.01,1258965.18,677816.17
1979-01-05,99.13,0.55,0.56,120.24,-17.56,True,1,12772,-99.13,-581248.14,1266088.36,684840.22
1979-01-08,98.8,-0.33,-0.33,120.24,-17.83,True,1,12773,-98.8,-581346.94,1261972.4,680625.46
1979-01-09,99.33,0.53,0.54,120.24,-17.39,True,1,12774,-99.33,-581446.27,1268841.42,687395.15
1979-01-10,98.77,-0.56,-0.56,120.24,-17.86,True,1,12775,-98.77,-581545.04,1261786.75,680241.71
1979-01-11,99.1,0.33,0.33,120.24,-17.58,True,1,12776,-99.1,-581644.14,1266101.6,684457.46
1979-01-12,99.93,0.83,0.84,120.24,-16.89,True,1,12777,-99.93,-581744.07,1276805.61,695061.54
1979-01-15,100.69,0.76,0.76,120.24,-16.26,True,1,12778,-100.69,-581844.76,1286616.82,704772.06
1979-01-16,99.46,-1.23,-1.22,120.24,-17.28,True,1,12779,-99.46,-581944.22,1270999.34,689055.12
1979-01-17,99.48,0.02,0.02,120.24,-17.26,True,1,12780,-99.48,-582043.7,1271354.4,689310.7
1979-01-18,99.72,0.24,0.24,120.24,-17.07,True,1,12781,-99.72,-582143.42,1274521.32,692377.9
1979-01-19,99.75,0.03,0.03,120.24,-17.04,True,1,12782,-99.75,-582243.17,1275004.5,692761.33
1979-01-22,99.9,0.15,0.15,120.24,-16.92,True,1,12783,-99.9,-582343.07,1277021.7,694678.63
1979-01-23,100.6,0.7,0.7,120.24,-16.33,True,1,12784,-100.6,-582443.67,1286070.4,703626.73
1979-01-24,100.16,-0.44,-0.44,120.24,-16.7,True,1,12785,-100.16,-582543.83,1280545.6,698001.77
1979-01-25,101.19,1.03,1.03,120.24,-15.84,True,1,12786,-101.19,-582645.02,1293815.34,711170.32
1979-01-26,101.86,0.67,0.66,120.24,-15.29,True,1,12787,-101.86,-582746.88,1302483.82,719736.94
1979-01-29,101.55,-0.31,-0.3,120.24,-15.54,True,1,12788,-101.55,-582848.43,1298621.4,715772.97
1979-01-30,101.05,-0.5,-0.49,120.24,-15.96,True,1,12789,-101.05,-582949.48,1292328.45,709378.97
1979-01-31,99.93,-1.12,-1.11,120.24,-16.89,True,1,12790,-99.93,-583049.41,1278104.7,695055.29
1979-02-01,99.96,0.03,0.03,120.24,-16.87,True,1,12791,-99.96,-583149.37,1278588.36,695438.99
1979-02-02,99.5,-0.46,-0.46,120.24,-17.25,True,1,12792,-99.5,-583248.87,1272804.0,689555.13
1979-02-05,98.09,-1.41,-1.42,120.24,-18.42,True,1,12793,-98.09,-583346.96,1254865.37,671518.41
1979-02-06,98.05,-0.04,-0.04,120.24,-18.45,True,1,12794,-98.05,-583445.01,1254451.7,671006.69
1979-02-07,97.16,-0.89,-0.91,120.24,-19.2,True,1,12795,-97.16,-583542.17,1243162.2,659620.03
1979-02-08,97.65,0.49,0.5,120.24,-18.79,True,1,12796,-97.65,-583639.82,1249529.4,665889.58
1979-02-09,97.87,0.22,0.22,120.24,-18.6,True,1,12797,-97.87,-583737.69,1252442.39,668704.7
1979-02-12,98.2,0.33,0.34,120.24,-18.33,True,1,12798,-98.2,-583835.89,1256763.6,672927.71
1979-02-13,98.93,0.73,0.74,120.24,-17.72,True,1,12799,-98.93,-583934.82,1266205.07,682270.25
1979-02-14,98.87,-0.06,-0.06,120.24,-17.77,True,1,12800,-98.87,-584033.69,1265536.0,681502.31
1979-02-15,98.73,-0.14,-0.14,120.24,-17.89,True,1,12801,-98.73,-584132.42,1263842.73,679710.31
1979-02-16,98.67,-0.06,-0.06,120.24,-17.94,True,1,12802,-98.67,-584231.09,1263173.34,678942.25
1979-02-20,99.42,0.75,0.76,120.24,-17.32,True,1,12803,-99.42,-584330.51,1272874.26,688543.75
1979-02-21,99.07,-0.35,-0.35,120.24,-17.61,True,1,12804,-99.07,-584429.58,1268492.28,684062.7
1979-02-22,98.33,-0.74,-0.75,120.24,-18.22,True,1,12805,-98.33,-584527.91,1259115.65,674587.74
1979-02-23,97.78,-0.55,-0.56,120.24,-18.68,True,1,12806,-97.78,-584625.69,1252170.68,667544.99
1979-02-26,97.67,-0.11,-0.11,120.24,-18.77,True,1,12807,-97.67,-584723.36,1250859.69,666136.33
1979-02-27,96.13,-1.54,-1.58,120.24,-20.05,True,1,12808,-96.13,-584819.49,1231233.04,646413.55
1979-02-28,96.28,0.15,0.16,120.24,-19.93,True,1,12809,-96.28,-584915.77,1233250.52,648334.75
1979-03-01,96.9,0.62,0.64,120.24,-19.41,True,1,12810,-96.9,-585012.67,1241289.0,656276.33
1979-03-02,96.97,0.07,0.07,120.24,-19.35,True,1,12811,-96.97,-585109.64,1242282.67,657173.03
1979-03-05,98.06,1.09,1.12,120.24,-18.45,True,1,12812,-98.06,-585207.7,1256344.72,671137.02
1979-03-06,97.87,-0.19,-0.19,120.24,-18.6,True,1,12813,-97.87,-585305.57,1254008.31,668702.74
1979-03-07,98.44,0.57,0.58,120.24,-18.13,True,1,12814,-98.44,-585404.01,1261410.16,676006.15
1979-03-08,99.58,1.14,1.16,120.24,-17.18,True,1,12815,-99.58,-585503.59,1276117.7,690614.11
1979-03-09,99.54,-0.04,-0.04,120.24,-17.22,True,1,12816,-99.54,-585603.13,1275704.64,690101.51
1979-03-12,99.67,0.13,0.13,120.24,-17.11,True,1,12817,-99.67,-585702.8,1277470.39,691767.59
1979-03-13,99.84,0.17,0.17,120.24,-16.97,True,1,12818,-99.84,-585802.64,1279749.12,693946.48
1979-03-14,99.71,-0.13,-0.13,120.24,-17.07,True,1,12819,-99.71,-585902.35,1278182.49,692280.14
1979-03-15,99.86,0.15,0.15,120.24,-16.95,True,1,12820,-99.86,-586002.21,1280205.2,694202.99
1979-03-16,100.69,0.83,0.83,120.24,-16.26,True,1,12821,-100.69,-586102.9,1290946.49,704843.59
1979-03-19,101.06,0.37,0.37,120.24,-15.95,True,1,12822,-101.06,-586203.96,1295791.32,709587.36
1979-03-20,100.5,-0.56,-0.55,120.24,-16.42,True,1,12823,-100.5,-586304.46,1288711.5,702407.04
1979-03-21,101.25,0.75,0.75,120.24,-15.79,True,1,12824,-101.25,-586405.71,1298430.0,712024.29
1979-03-22,101.67,0.42,0.42,120.24,-15.44,True,1,12825,-101.67,-586507.38,1303917.75,717410.37
1979-03-23,101.6,-0.07,-0.07,120.24,-15.5,True,1,12826,-101.6,-586608.98,1303121.6,716512.62
1979-03-26,101.04,-0.56,-0.55,120.24,-15.97,True,1,12827,-101.04,-586710.02,1296040.08,709330.06
1979-03-27,102.48,1.44,1.42,120.24,-14.77,True,1,12828,-102.48,-586812.5,1314613.44,727800.94
1979-03-28,102.12,-0.36,-0.35,120.24,-15.07,True,1,12829,-102.12,-586914.62,1310097.48,723182.86
1979-03-29,102.03,-0.09,-0.09,120.24,-15.14,True,1,12830,-102.03,-587016.65,1309044.9,722028.25
1979-03-30,101.59,-0.44,-0.43,120.24,-15.51,True,1,12831,-101.59,-587118.24,1303501.29,716383.05
1979-04-02,100.9,-0.69,-0.68,120.24,-16.08,True,1,12832,-100.9,-587219.14,1294748.8,707529.66
1979-04-03,102.4,1.5,1.49,120.24,-14.84,True,1,12833,-102.4,-587321.54,1314099.2,726777.66
1979-04-04,102.65,0.25,0.24,120.24,-14.63,True,1,12834,-102.65,-587424.19,1317410.1,729985.91
1979-04-05,103.26,0.61,0.59,120.24,-14.12,True,1,12835,-103.26,-587527.45,1325342.1,737814.65
1979-04-06,103.18,-0.08,-0.08,120.24,-14.19,True,1,12836,-103.18,-587630.63,1324418.48,736787.85
1979-04-09,102.87,-0.31,-0.3,120.24,-14.45,True,1,12837,-102.87,-587733.5,1320542.19,732808.69
1979-04-10,103.34,0.47,0.46,120.24,-14.06,True,1,12838,-103.34,-587836.84,1326678.92,738842.08
1979-04-11,102.31,-1.03,-1.0,120.24,-14.91,True,1,12839,-102.31,-587939.15,1313558.09,725618.94
1979-04-12,102.0,-0.31,-0.3,120.24,-15.17,True,1,12840,-102.0,-588041.15,1309680.0,721638.85
1979-04-16,101.12,-0.88,-0.86,120.24,-15.9,True,1,12841,-101.12,-588142.27,1298481.92,710339.65
1979-04-17,101.24,0.12,0.12,120.24,-15.8,True,1,12842,-101.24,-588243.51,1300124.08,711880.57
1979-04-18,101.7,0.46,0.45,120.24,-15.42,True,1,12843,-101.7,-588345.21,1306133.1,717787.89
1979-04-19,101.28,-0.42,-0.41,120.24,-15.77,True,1,12844,-101.28,-588446.49,1300840.32,712393.83
1979-04-20,101.23,-0.05,-0.05,120.24,-15.81,True,1,12845,-101.23,-588547.72,1300299.35,711751.63
1979-04-23,101.57,0.34,0.34,120.24,-15.53,True,1,12846,-101.57,-588649.29,1304768.22,716118.93
1979-04-24,102.2,0.63,0.62,120.24,-15.0,True,1,12847,-102.2,-588751.49,1312963.4,724211.91
1979-04-25,102.5,0.3,0.29,120.24,-14.75,True,1,12848,-102.5,-588853.99,1316920.0,728066.01
1979-04-26,102.01,-0.49,-0.48,120.24,-15.16,True,1,12849,-102.01,-588956.0,1310726.49,721770.49
1979-04-27,101.8,-0.21,-0.21,120.24,-15.34,True,1,12850,-101.8,-589057.8,1308130.0,719072.2
1979-04-30,101.76,-0.04,-0.04,120.24,-15.37,True,1,12851,-101.76,-589159.56,1307717.76,718558.2
1979-05-01,101.68,-0.08,-0.08,120.24,-15.44,True,1,12852,-101.68,-589261.24,1306791.36,717530.12
1979-05-02,101.72,0.04,0.04,120.24,-15.4,True,1,12853,-101.72,-589362.96,1307407.16,718044.2
1979-05-03,101.81,0.09,0.09,120.24,-15.33,True,1,12854,-101.81,-589464.77,1308665.74,719200.97
1979-05-04,100.69,-1.12,-1.1,120.24,-16.26,True,1,12855,-100.69,-589565.46,1294369.95,704804.49
1979-05-07,99.02,-1.67,-1.66,120.24,-17.65,True,1,12856,-99.02,-589664.48,1273001.12,683336.64
1979-05-08,99.17,0.15,0.15,120.24,-17.52,True,1,12857,-99.17,-589763.65,1275028.69,685265.04
1979-05-09,99.46,0.29,0.29,120.24,-17.28,True,1,12858,-99.46,-589863.11,1278856.68,688993.57
1979-05-10,98.52,-0.94,-0.94,120.24,-18.06,True,1,12859,-98.52,-589961.63,1266868.68,676907.05
1979-05-11,98.52,0.0,0.0,120.24,-18.06,True,1,12860,-98.52,-590060.15,1266967.2,676907.05
1979-05-14,98.06,-0.46,-0.47,120.24,-18.45,True,1,12861,-98.06,-590158.21,1261149.66,670991.45
1979-05-15,98.14,0.08,0.08,120.24,-18.38,True,1,12862,-98.14,-590256.35,1262276.68,672020.33
1979-05-16,98.42,0.28,0.28,120.24,-18.15,True,1,12863,-98.42,-590354.77,1265976.46,675621.69
1979-05-17,99.94,1.52,1.54,120.24,-16.88,True,1,12864,-99.94,-590454.71,1285628.16,695173.45
1979-05-18,99.93,-0.01,-0.01,120.24,-16.89,True,1,12865,-99.93,-590554.64,1285599.45,695044.81
1979-05-21,100.14,0.21,0.21,120.24,-16.72,True,1,12866,-100.14,-590654.78,1288401.24,697746.46
1979-05-22,100.51,0.37,0.37,120.24,-16.41,True,1,12867,-100.51,-590755.29,1293262.17,702506.88
1979-05-23,99.89,-0.62,-0.62,120.24,-16.92,True,1,12868,-99.89,-590855.18,1285384.52,694529.34
1979-05-24,99.93,0.04,0.04,120.24,-16.89,True,1,12869,-99.93,-590955.11,1285999.17,695044.06
1979-05-25,100.22,0.29,0.29,120.24,-16.65,True,1,12870,-100.22,-591055.33,1289831.4,698776.07
1979-05-29,100.05,-0.17,-0.17,120.24,-16.79,True,1,12871,-100.05,-591155.38,1287743.55,696588.17
1979-05-30,99.11,-0.94,-0.94,120.24,-17.57,True,1,12872,-99.11,-591254.49,1275743.92,684489.43
1979-05-31,99.08,-0.03,-0.03,120.24,-17.6,True,1,12873,-99.08,-591353.57,1275456.84,684103.27
1979-06-01,99.17,0.09,0.09,120.24,-17.52,True,1,12874,-99.17,-591452.74,1276714.58,685261.84
1979-06-04,99.32,0.15,0.15,120.24,-17.4,True,1,12875,-99.32,-591552.06,1278745.0,687192.94
1979-06-05,100.62,1.3,1.31,120.24,-16.32,True,1,12876,-100.62,-591652.68,1295583.12,703930.44
1979-06-06,101.3,0.68,0.68,120.24,-15.75,True,1,12877,-101.3,-591753.98,1304440.1,712686.12
1979-06-07,101.79,0.49,0.48,120.24,-15.34,True,1,12878,-101.79,-591855.77,1310851.62,718995.85
1979-06-08,101.49,-0.3,-0.3,120.24,-15.59,True,1,12879,-101.49,-591957.26,1307089.71,715132.45
1979-06-11,101.91,0.42,0.41,120.24,-15.24,True,1,12880,-101.91,-592059.17,1312600.8,720541.63
1979-06-12,102.85,0.94,0.92,120.24,-14.46,True,1,12881,-102.85,-592162.02,1324810.85,732648.83
1979-06-13,102.31,-0.54,-0.52,120.24,-14.91,True,1,12882,-102.31,-592264.33,1317957.42,725693.09
1979-06-14,102.2,-0.11,-0.11,120.24,-15.0,True,1,12883,-102.2,-592366.53,1316642.6,724276.07
1979-06-15,102.09,-0.11,-0.11,120.24,-15.1,True,1,12884,-102.09,-592468.62,1315327.56,722858.94
1979-06-18,101.56,-0.53,-0.52,120.24,-15.54,True,1,12885,-101.56,-592570.18,1308600.6,716030.42
1979-06-19,101.58,0.02,0.02,120.24,-15.52,True,1,12886,-101.58,-592671.76,1308959.88,716288.12
1979-06-20,101.63,0.05,0.05,120.24,-15.48,True,1,12887,-101.63,-592773.39,1309705.81,716932.42
1979-06-21,102.09,0.46,0.45,120.24,-15.1,True,1,12888,-102.09,-592875.48,1315735.92,722860.44
1979-06-22,102.64,0.55,0.54,120.24,-14.64,True,1,12889,-102.64,-592978.12,1322926.96,729948.84
1979-06-25,102.09,-0.55,-0.54,120.24,-15.1,True,1,12890,-102.09,-593080.21,1315940.1,722859.89
1979-06-26,101.66,-0.43,-0.42,120.24,-15.45,True,1,12891,-101.66,-593181.87,1310499.06,717317.19
1979-06-27,102.27,0.61,0.6,120.24,-14.94,True,1,12892,-102.27,-593284.14,1318464.84,725180.7
1979-06-28,102.8,0.53,0.52,120.24,-14.5,True,1,12893,-102.8,-593386.94,1325400.4,732013.46
1979-06-29,102.91,0.11,0.11,120.24,-14.41,True,1,12894,-102.91,-593489.85,1326921.54,733431.69
1979-07-02,101.99,-0.92,-0.89,120.24,-15.18,True,1,12895,-101.99,-593591.84,1315161.05,721569.21
1979-07-03,102.09,0.1,0.1,120.24,-15.1,True,1,12896,-102.09,-593693.93,1316552.64,722858.71
1979-07-05,102.43,0.34,0.33,120.24,-14.81,True,1,12897,-102.43,-593796.36,1321039.71,727243.35
1979-07-06,103.62,1.19,1.16,120.24,-13.82,True,1,12898,-103.62,-593899.98,1336490.76,742590.78
1979-07-09,104.47,0.85,0.82,120.24,-13.12,True,1,12899,-104.47,-594004.45,1347558.53,753554.08
1979-07-10,104.2,-0.27,-0.26,120.24,-13.34,True,1,12900,-104.2,-594108.65,1344180.0,750071.35
1979-07-11,103.64,-0.56,-0.54,120.24,-13.81,True,1,12901,-103.64,-594212.29,1337059.64,742847.35
1979-07-12,102.69,-0.95,-0.92,120.24,-14.6,True,1,12902,-102.69,-594314.98,1324906.38,730591.4
1979-07-13,102.32,-0.37,-0.36,120.24,-14.9,True,1,12903,-102.32,-594417.3,1320234.96,725817.66
1979-07-16,102.74,0.42,0.41,120.24,-14.55,True,1,12904,-102.74,-594520.04,1325756.96,731236.92
1979-07-17,101.83,-0.91,-0.89,120.24,-15.31,True,1,12905,-101.83,-594621.87,1314116.15,719494.28
1979-07-18,101.69,-0.14,-0.14,120.24,-15.43,True,1,12906,-101.69,-594723.56,1312411.14,717687.58
1979-07-19,101.61,-0.08,-0.08,120.24,-15.49,True,1,12907,-101.61,-594825.17,1311480.27,716655.1
1979-07-20,101.82,0.21,0.21,120.24,-15.32,True,1,12908,-101.82,-594926.99,1314292.56,719365.57
1979-07-23,101.59,-0.23,-0.23,120.24,-15.51,True,1,12909,-101.59,-595028.58,1311425.31,716396.73
1979-07-24,101.97,0.38,0.37,120.24,-15.2,True,1,12910,-101.97,-595130.55,1316432.7,721302.15
1979-07-25,103.08,1.11,1.09,120.24,-14.27,True,1,12911,-103.08,-595233.63,1330865.88,735632.25
1979-07-26,103.1,0.02,0.02,120.24,-14.26,True,1,12912,-103.1,-595336.73,1331227.2,735890.47
1979-07-27,103.1,0.0,0.0,120.24,-14.26,True,1,12913,-103.1,-595439.83,1331330.3,735890.47
1979-07-30,103.15,0.05,0.05,120.24,-14.21,True,1,12914,-103.15,-595542.98,1332079.1,736536.12
1979-07-31,103.81,0.66,0.64,120.24,-13.66,True,1,12915,-103.81,-595646.79,1340706.15,745059.36
1979-08-01,104.17,0.36,0.35,120.24,-13.36,True,1,12916,-104.17,-595750.96,1345459.72,749708.76
1979-08-02,104.1,-0.07,-0.07,120.24,-13.42,True,1,12917,-104.1,-595855.06,1344659.7,748804.64
1979-08-03,104.04,-0.06,-0.06,120.24,-13.47,True,1,12918,-104.04,-595959.1,1343988.72,748029.62
1979-08-06,104.3,0.26,0.25,120.24,-13.26,True,1,12919,-104.3,-596063.4,1347451.7,751388.3
1979-08-07,105.65,1.35,1.29,120.24,-12.13,True,1,12920,-105.65,-596169.05,1364998.0,768828.95
1979-08-08,105.98,0.33,0.31,120.24,-11.86,True,1,12921,-105.98,-596275.03,1369367.58,773092.55
1979-08-09,105.49,-0.49,-0.46,120.24,-12.27,True,1,12922,-105.49,-596380.52,1363141.78,766761.26
1979-08-10,106.4,0.91,0.86,120.24,-11.51,True,1,12923,-106.4,-596486.92,1375007.2,778520.28
1979-08-13,107.42,1.02,0.96,120.24,-10.66,True,1,12924,-107.42,-596594.34,1388296.08,791701.74
1979-08-14,107.52,0.1,0.09,120.24,-10.58,True,1,12925,-107.52,-596701.86,1389696.0,792994.14
1979-08-15,108.25,0.73,0.68,120.24,-9.97,True,1,12926,-108.25,-596810.11,1399239.5,802429.39
1979-08-16,108.09,-0.16,-0.15,120.24,-10.1,True,1,12927,-108.09,-596918.2,1397279.43,800361.23
1979-08-17,108.3,0.21,0.19,120.24,-9.93,True,1,12928,-108.3,-597026.5,1400102.4,803075.9
1979-08-20,108.83,0.53,0.49,120.24,-9.49,True,1,12929,-108.83,-597135.33,1407063.07,809927.74
1979-08-21,108.91,0.08,0.07,120.24,-9.42,True,1,12930,-108.91,-597244.24,1408206.3,810962.06
1979-08-22,108.99,0.08,0.07,120.24,-9.36,True,1,12931,-108.99,-597353.23,1409349.69,811996.46
1979-08-23,108.63,-0.36,-0.33,120.24,-9.66,True,1,12932,-108.63,-597461.86,1404803.16,807341.3
1979-08-24,108.6,-0.03,-0.03,120.24,-9.68,True,1,12933,-108.6,-597570.46,1404523.8,806953.34
1979-08-27,109.14,0.54,0.5,120.24,-9.23,True,1,12934,-109.14,-597679.6,1411616.76,813937.16
1979-08-28,109.02,-0.12,-0.11,120.24,-9.33,True,1,12935,-109.02,-597788.62,1410173.7,812385.08
1979-08-29,109.02,0.0,0.0,120.24,-9.33,True,1,12936,-109.02,-597897.64,1410282.72,812385.08
1979-08-30,109.02,0.0,0.0,120.24,-9.33,True,1,12937,-109.02,-598006.66,1410391.74,812385.08
1979-08-31,109.32,0.3,0.28,120.24,-9.08,True,1,12938,-109.32,-598115.98,1414382.16,816266.18
1979-09-04,107.44,-1.88,-1.72,120.24,-10.64,True,1,12939,-107.44,-598223.42,1390166.16,791942.74
1979-09-05,106.4,-1.04,-0.97,120.24,-11.51,True,1,12940,-106.4,-598329.82,1376816.0,778486.18
1979-09-06,106.85,0.45,0.42,120.24,-11.14,True,1,12941,-106.85,-598436.67,1382745.85,784309.18
1979-09-07,107.66,0.81,0.76,120.24,-10.46,True,1,12942,-107.66,-598544.33,1393335.72,794791.39
1979-09-10,108.17,0.51,0.47,120.24,-10.04,True,1,12943,-108.17,-598652.5,1400044.31,801391.81
1979-09-11,107.51,-0.66,-0.61,120.24,-10.59,True,1,12944,-107.51,-598760.01,1391609.44,792849.43
1979-09-12,107.82,0.31,0.29,120.24,-10.33,True,1,12945,-107.82,-598867.83,1395729.9,796862.07
1979-09-13,107.85,0.03,0.03,120.24,-10.3,True,1,12946,-107.85,-598975.68,1396226.1,797250.42
1979-09-14,108.76,0.91,0.84,120.24,-9.55,True,1,12947,-108.76,-599084.44,1408115.72,809031.28
1979-09-17,108.84,0.08,0.07,120.24,-9.48,True,1,12948,-108.84,-599193.28,1409260.32,810067.04
1979-09-18,108.0,-0.84,-0.77,120.24,-10.18,True,1,12949,-108.0,-599301.28,1398492.0,799190.72
1979-09-19,108.28,0.28,0.26,120.24,-9.95,True,1,12950,-108.28,-599409.56,1402226.0,802816.44
1979-09-20,110.51,2.23,2.06,120.24,-8.09,True,1,12951,-110.51,-599520.07,1431215.01,831694.94
1979-09-21,110.47,-0.04,-0.04,120.24,-8.12,True,1,12952,-110.47,-599630.54,1430807.44,831176.9
1979-09-24,109.61,-0.86,-0.78,120.24,-8.84,True,1,12953,-109.61,-599740.15,1419778.33,820038.18
1979-09-25,109.68,0.07,0.06,120.24,-8.78,True,1,12954,-109.68,-599849.83,1420794.72,820944.89
1979-09-26,109.96,0.28,0.26,120.24,-8.55,True,1,12955,-109.96,-599959.79,1424531.8,824572.01
1979-09-27,110.21,0.25,0.23,120.24,-8.34,True,1,12956,-110.21,-600070.0,1427880.76,827810.76
1979-09-28,109.32,-0.89,-0.81,120.24,-9.08,True,1,12957,-109.32,-600179.32,1416459.24,816279.92
1979-10-01,108.56,-0.76,-0.7,120.24,-9.71,True,1,12958,-108.56,-600287.88,1406720.48,806432.6
1979-10-02,109.59,1.03,0.95,120.24,-8.86,True,1,12959,-109.59,-600397.47,1420176.81,819779.34
1979-10-03,109.59,0.0,0.0,120.24,-8.86,True,1,12960,-109.59,-600507.06,1420286.4,819779.34
1979-10-04,110.17,0.58,0.53,120.24,-8.38,True,1,12961,-110.17,-600617.23,1427913.37,827296.14
1979-10-05,111.27,1.1,1.0,120.24,-7.46,True,1,12962,-111.27,-600728.5,1442281.74,841553.24
1979-10-08,109.88,-1.39,-1.25,120.24,-8.62,True,1,12963,-109.88,-600838.38,1424374.44,823536.06
1979-10-09,106.63,-3.25,-2.96,120.24,-11.32,True,1,12964,-106.63,-600945.01,1382351.32,781406.31
1979-10-10,105.3,-1.33,-1.25,120.24,-12.42,True,1,12965,-105.3,-601050.31,1365214.5,764164.19
1979-10-11,105.05,-0.25,-0.24,120.24,-12.63,True,1,12966,-105.05,-601155.36,1362078.3,760922.94
1979-10-12,104.49,-0.56,-0.53,120.24,-13.1,True,1,12967,-104.49,-601259.85,1354921.83,753661.98
1979-10-15,103.36,-1.13,-1.08,120.24,-14.04,True,1,12968,-103.36,-601363.21,1340372.48,739009.27
1979-10-16,103.19,-0.17,-0.16,120.24,-14.18,True,1,12969,-103.19,-601466.4,1338271.11,736804.71
1979-10-17,103.39,0.2,0.19,120.24,-14.01,True,1,12970,-103.39,-601569.79,1340968.3,739398.51
1979-10-18,103.61,0.22,0.21,120.24,-13.83,True,1,12971,-103.61,-601673.4,1343925.31,742251.91
1979-10-19,101.6,-2.01,-1.94,120.24,-15.5,True,1,12972,-101.6,-601775.0,1317955.2,716180.2
1979-10-22,100.71,-0.89,-0.88,120.24,-16.24,True,1,12973,-100.71,-601875.71,1306510.83,704635.12
1979-10-23,100.28,-0.43,-0.43,120.24,-16.6,True,1,12974,-100.28,-601975.99,1301032.72,699056.73
1979-10-24,100.44,0.16,0.16,120.24,-16.47,True,1,12975,-100.44,-602076.43,1303209.0,701132.57
1979-10-25,100.0,-0.44,-0.44,120.24,-16.83,True,1,12976,-100.0,-602176.43,1297600.0,695423.57
1979-10-26,100.57,0.57,0.57,120.24,-16.36,True,1,12977,-100.57,-602277.0,1305096.89,702819.89
1979-10-29,100.71,0.14,0.14,120.24,-16.24,True,1,12978,-100.71,-602377.71,1307014.38,704636.67
1979-10-30,102.67,1.96,1.95,120.24,-14.61,True,1,12979,-102.67,-602480.38,1332553.93,730073.55
1979-10-31,101.82,-0.85,-0.83,120.24,-15.32,True,1,12980,-101.82,-602582.2,1321623.6,719041.4
1979-11-01,102.57,0.75,0.74,120.24,-14.7,True,1,12981,-102.57,-602684.77,1331461.17,728776.4
1979-11-02,102.51,-0.06,-0.06,120.24,-14.75,True,1,12982,-102.51,-602787.28,1330784.82,727997.54
1979-11-05,101.82,-0.69,-0.67,120.24,-15.32,True,1,12983,-101.82,-602889.1,1321929.06,719039.96
1979-11-06,101.2,-0.62,-0.61,120.24,-15.84,True,1,12984,-101.2,-602990.3,1313980.8,710990.5
1979-11-07,99.87,-1.33,-1.31,120.24,-16.94,True,1,12985,-99.87,-603090.17,1296811.95,693721.78
1979-11-08,100.3,0.43,0.43,120.24,-16.58,True,1,12986,-100.3,-603190.47,1302495.8,699305.33
1979-11-09,101.51,1.21,1.21,120.24,-15.58,True,1,12987,-101.51,-603291.98,1318310.37,715018.39
1979-11-12,103.51,2.0,1.97,120.24,-13.91,True,1,12988,-103.51,-603395.49,1344387.88,740992.39
1979-11-13,102.94,-0.57,-0.55,120.24,-14.39,True,1,12989,-102.94,-603498.43,1337087.66,733589.23
1979-11-14,103.39,0.45,0.44,120.24,-14.01,True,1,12990,-103.39,-603601.82,1343036.1,739434.28
1979-11-15,104.13,0.74,0.72,120.24,-13.4,True,1,12991,-104.13,-603705.95,1352752.83,749046.88
1979-11-16,103.79,-0.34,-0.33,120.24,-13.68,True,1,12992,-103.79,-603809.74,1348439.68,744629.94
1979-11-19,104.23,0.44,0.42,120.24,-13.32,True,1,12993,-104.23,-603913.97,1354260.39,750346.42
1979-11-20,103.69,-0.54,-0.52,120.24,-13.76,True,1,12994,-103.69,-604017.66,1347347.86,743330.2
1979-11-21,103.89,0.2,0.19,120.24,-13.6,True,1,12995,-103.89,-604121.55,1350050.55,745929.0
1979-11-23,104.67,0.78,0.75,120.24,-12.95,True,1,12996,-104.67,-604226.22,1360291.32,756065.1
1979-11-26,106.8,2.13,2.04,120.24,-11.18,True,1,12997,-106.8,-604333.02,1388079.6,783746.58
1979-11-27,106.38,-0.42,-0.39,120.24,-11.53,True,1,12998,-106.38,-604439.4,1382727.24,778287.84
1979-11-28,106.77,0.39,0.37,120.24,-11.2,True,1,12999,-106.77,-604546.17,1387903.23,783357.06
1979-11-29,106.81,0.04,0.04,120.24,-11.17,True,1,13000,-106.81,-604652.98,1388530.0,783877.02
1979-11-30,106.16,-0.65,-0.61,120.24,-11.71,True,1,13001,-106.16,-604759.14,1380186.16,775427.02
1979-12-03,105.83,-0.33,-0.31,120.24,-11.98,True,1,13002,-105.83,-604864.97,1376001.66,771136.69
1979-12-04,106.79,0.96,0.91,120.24,-11.19,True,1,13003,-106.79,-604971.76,1388590.37,783618.61
1979-12-05,107.25,0.46,0.43,120.24,-10.8,True,1,13004,-107.25,-605079.01,1394679.0,789599.99
1979-12-06,108.0,0.75,0.7,120.24,-10.18,True,1,13005,-108.0,-605187.01,1404540.0,799352.99
1979-12-07,107.52,-0.48,-0.44,120.24,-10.58,True,1,13006,-107.52,-605294.53,1398405.12,793110.59
1979-12-10,107.67,0.15,0.14,120.24,-10.45,True,1,13007,-107.67,-605402.2,1400463.69,795061.49
1979-12-11,107.49,-0.18,-0.17,120.24,-10.6,True,1,13008,-107.49,-605509.69,1398229.92,792720.23
1979-12-12,107.52,0.03,0.03,120.24,-10.58,True,1,13009,-107.52,-605617.21,1398727.68,793110.47
1979-12-13,107.67,0.15,0.14,120.24,-10.45,True,1,13010,-107.67,-605724.88,1400786.7,795061.82
1979-12-14,108.92,1.25,1.16,120.24,-9.41,True,1,13011,-108.92,-605833.8,1417158.12,811324.32
1979-12-17,109.33,0.41,0.38,120.24,-9.07,True,1,13012,-109.33,-605943.13,1422601.96,816658.83
1979-12-18,108.3,-1.03,-0.94,120.24,-9.93,True,1,13013,-108.3,-606051.43,1409307.9,803256.47
1979-12-19,108.2,-0.1,-0.09,120.24,-10.01,True,1,13014,-108.2,-606159.63,1408114.8,801955.17
1979-12-20,108.26,0.06,0.06,120.24,-9.96,True,1,13015,-108.26,-606267.89,1409003.9,802736.01
1979-12-21,107.59,-0.67,-0.62,120.24,-10.52,True,1,13016,-107.59,-606375.48,1400391.44,794015.96
1979-12-24,107.66,0.07,0.06,120.24,-10.46,True,1,13017,-107.66,-606483.14,1401410.22,794927.08
1979-12-26,107.78,0.12,0.11,120.24,-10.36,True,1,13018,-107.78,-606590.92,1403080.04,796489.12
1979-12-27,107.96,0.18,0.17,120.24,-10.21,True,1,13019,-107.96,-606698.88,1405531.24,798832.36
1979-12-28,107.84,-0.12,-0.11,120.24,-10.31,True,1,13020,-107.84,-606806.72,1404076.8,797270.08
1979-12-31,107.94,0.1,0.09,120.24,-10.23,True,1,13021,-107.94,-606914.66,1405486.74,798572.08
1980-01-02,105.76,-2.18,-2.02,120.24,-12.04,True,1,13022,-105.76,-607020.42,1377206.72,770186.3
1980-01-03,105.22,-0.54,-0.51,120.24,-12.49,True,1,13023,-105.22,-607125.64,1370280.06,763154.42
1980-01-04,106.52,1.3,1.24,120.24,-11.41,True,1,13024,-106.52,-607232.16,1387316.48,780084.32
1980-01-07,106.81,0.29,0.27,120.24,-11.17,True,1,13025,-106.81,-607338.97,1391200.25,783861.28
1980-01-08,108.95,2.14,2.0,120.24,-9.39,True,1,13026,-108.95,-607447.92,1419182.7,811734.78
1980-01-09,109.05,0.1,0.09,120.24,-9.31,True,1,13027,-109.05,-607556.97,1420594.35,813037.38
1980-01-10,109.89,0.84,0.77,120.24,-8.61,True,1,13028,-109.89,-607666.86,1431646.92,823980.06
1980-01-11,109.92,0.03,0.03,120.24,-8.58,True,1,13029,-109.92,-607776.78,1432147.68,824370.9
1980-01-14,110.38,0.46,0.42,120.24,-8.2,True,1,13030,-110.38,-607887.16,1438251.4,830364.24
1980-01-15,111.14,0.76,0.69,120.24,-7.57,True,1,13031,-111.14,-607998.3,1448265.34,840267.04
1980-01-16,111.05,-0.09,-0.08,120.24,-7.64,True,1,13032,-111.05,-608109.35,1447203.6,839094.25
1980-01-17,110.7,-0.35,-0.32,120.24,-7.93,True,1,13033,-110.7,-608220.05,1442753.1,834533.05
1980-01-18,111.07,0.37,0.33,120.24,-7.63,True,1,13034,-111.07,-608331.12,1447686.38,839355.26
1980-01-21,112.1,1.03,0.93,120.24,-6.77,True,1,13035,-112.1,-608443.22,1461223.5,852780.28
1980-01-22,111.51,-0.59,-0.53,120.24,-7.26,True,1,13036,-111.51,-608554.73,1453644.36,845089.63
1980-01-23,113.44,1.93,1.73,120.24,-5.66,True,1,13037,-113.44,-608668.17,1478917.28,870249.11
1980-01-24,113.7,0.26,0.23,120.24,-5.44,True,1,13038,-113.7,-608781.87,1482420.6,873638.73
1980-01-25,113.61,-0.09,-0.08,120.24,-5.51,True,1,13039,-113.61,-608895.48,1481360.79,872465.31
1980-01-28,114.85,1.24,1.09,120.24,-4.48,True,1,13040,-114.85,-609010.33,1497644.0,888633.67
1980-01-29,114.07,-0.78,-0.68,120.24,-5.13,True,1,13041,-114.07,-609124.4,1487586.87,878462.47
1980-01-30,115.2,1.13,0.99,120.24,-4.19,True,1,13042,-115.2,-609239.6,1502438.4,893198.8
1980-01-31,114.16,-1.04,-0.9,120.24,-5.06,True,1,13043,-114.16,-609353.76,1488988.88,879635.12
1980-02-01,115.12,0.96,0.84,120.24,-4.26,True,1,13044,-115.12,-609468.88,1501625.28,892156.4
1980-02-04,114.37,-0.75,-0.65,120.24,-4.88,True,1,13045,-114.37,-609583.25,1491956.65,882373.4
1980-02-05,114.66,0.29,0.25,120.24,-4.64,True,1,13046,-114.66,-609697.91,1495854.36,886156.45
1980-02-06,115.72,1.06,0.92,120.24,-3.76,True,1,13047,-115.72,-609813.63,1509798.84,899985.21
1980-02-07,116.28,0.56,0.48,120.24,-3.29,True,1,13048,-116.28,-609929.91,1517221.44,907291.53
1980-02-08,117.95,1.67,1.44,120.24,-1.9,True,1,13049,-117.95,-610047.86,1539129.55,929081.69
1980-02-11,117.12,-0.83,-0.7,120.24,-2.6,True,1,13050,-117.12,-610164.98,1528416.0,918251.02
1980-02-12,117.9,0.78,0.67,120.24,-1.95,True,1,13051,-117.9,-610282.88,1538712.9,928430.02
1980-02-13,118.44,0.54,0.46,120.24,-1.5,True,1,13052,-118.44,-610401.32,1545878.88,935477.56
1980-02-14,116.72,-1.72,-1.45,120.24,-2.93,True,1,13053,-116.72,-610518.04,1523546.16,913028.12
1980-02-15,115.41,-1.31,-1.12,120.24,-4.02,True,1,13054,-115.41,-610633.45,1506562.14,895928.69
1980-02-19,114.6,-0.81,-0.7,120.24,-4.69,True,1,13055,-114.6,-610748.05,1496103.0,885354.95
1980-02-20,116.47,1.87,1.63,120.24,-3.14,True,1,13056,-116.47,-610864.52,1520632.32,909767.8
1980-02-21,115.28,-1.19,-1.02,120.24,-4.12,True,1,13057,-115.28,-610979.8,1505210.96,894231.16
1980-02-22,115.04,-0.24,-0.21,120.24,-4.32,True,1,13058,-115.04,-611094.84,1502192.32,891097.48
1980-02-25,113.33,-1.71,-1.49,120.24,-5.75,True,1,13059,-113.33,-611208.17,1479976.47,868768.3
1980-02-26,113.98,0.65,0.57,120.24,-5.21,True,1,13060,-113.98,-611322.15,1488578.8,877256.65
1980-02-27,112.38,-1.6,-1.4,120.24,-6.54,True,1,13061,-112.38,-611434.53,1467795.18,856360.65
1980-02-28,112.35,-0.03,-0.03,120.24,-6.56,True,1,13062,-112.35,-611546.88,1467515.7,855968.82
1980-02-29,113.66,1.31,1.17,120.24,-5.47,True,1,13063,-113.66,-611660.54,1484740.58,873080.04
1980-03-03,112.5,-1.16,-1.02,120.24,-6.44,True,1,13064,-112.5,-611773.04,1469700.0,857926.96
1980-03-04,112.78,0.28,0.25,120.24,-6.2,True,1,13065,-112.78,-611885.82,1473470.7,861584.88
1980-03-05,111.13,-1.65,-1.46,120.24,-7.58,True,1,13066,-111.13,-611996.95,1452024.58,840027.63
1980-03-06,108.65,-2.48,-2.23,120.24,-9.64,True,1,13067,-108.65,-612105.6,1419729.55,807623.95
1980-03-07,106.9,-1.75,-1.61,120.24,-11.09,True,1,13068,-106.9,-612212.5,1396969.2,784756.7
1980-03-10,106.51,-0.39,-0.36,120.24,-11.42,True,1,13069,-106.51,-612319.01,1391979.19,779660.18
1980-03-11,107.78,1.27,1.19,120.24,-10.36,True,1,13070,-107.78,-612426.79,1408684.6,796257.81
1980-03-12,106.87,-0.91,-0.84,120.24,-11.12,True,1,13071,-106.87,-612533.66,1396897.77,784364.11
1980-03-13,105.62,-1.25,-1.17,120.24,-12.16,True,1,13072,-105.62,-612639.28,1380664.64,768025.36
1980-03-14,105.43,-0.19,-0.18,120.24,-12.32,True,1,13073,-105.43,-612744.71,1378286.39,765541.68
1980-03-17,102.26,-3.17,-3.01,120.24,-14.95,True,1,13074,-102.26,-612846.97,1336947.24,724100.27
1980-03-18,104.1,1.84,1.8,120.24,-13.42,True,1,13075,-104.1,-612951.07,1361107.5,748156.43
1980-03-19,104.31,0.21,0.2,120.24,-13.25,True,1,13076,-104.31,-613055.38,1363957.56,750902.18
1980-03-20,103.12,-1.19,-1.14,120.24,-14.24,True,1,13077,-103.12,-613158.5,1348500.24,735341.74
1980-03-21,102.31,-0.81,-0.78,120.24,-14.91,True,1,13078,-102.31,-613260.81,1338010.18,724749.37
1980-03-24,99.28,-3.03,-2.96,120.24,-17.43,True,1,13079,-99.28,-613360.09,1298483.12,685123.03
1980-03-25,99.19,-0.09,-0.09,120.24,-17.51,True,1,13080,-99.19,-613459.28,1297405.2,683945.92
1980-03-26,98.68,-0.51,-0.51,120.24,-17.93,True,1,13081,-98.68,-613557.96,1290833.08,677275.12
1980-03-27,98.22,-0.46,-0.47,120.24,-18.31,True,1,13082,-98.22,-613656.18,1284914.04,671257.86
1980-03-28,100.68,2.46,2.5,120.24,-16.27,True,1,13083,-100.68,-613756.86,1317196.44,703439.58
1980-03-31,102.09,1.41,1.4,120.24,-15.1,True,1,13084,-102.09,-613858.95,1335745.56,721886.61
1980-04-01,102.18,0.09,0.09,120.24,-15.02,True,1,13085,-102.18,-613961.13,1337025.3,723064.17
1980-04-02,102.68,0.5,0.49,120.24,-14.6,True,1,13086,-102.68,-614063.81,1343670.48,729606.67
1980-04-03,102.15,-0.53,-0.52,120.24,-15.04,True,1,13087,-102.15,-614165.96,1336837.05,722671.09
1980-04-07,100.19,-1.96,-1.92,120.24,-16.68,True,1,13088,-100.19,-614266.15,1311286.72,697020.57
1980-04-08,101.2,1.01,1.01,120.24,-15.84,True,1,13089,-101.2,-614367.35,1324606.8,710239.45
1980-04-09,103.11,1.91,1.89,120.24,-14.25,True,1,13090,-103.11,-614470.46,1349709.9,735239.44
1980-04-10,104.08,0.97,0.94,120.24,-13.44,True,1,13091,-104.08,-614574.54,1362511.28,747936.74
1980-04-11,103.79,-0.29,-0.28,120.24,-13.68,True,1,13092,-103.79,-614678.33,1358818.68,744140.35
1980-04-14,102.84,-0.95,-0.92,120.24,-14.47,True,1,13093,-102.84,-614781.17,1346484.12,731702.95
1980-04-15,102.63,-0.21,-0.2,120.24,-14.65,True,1,13094,-102.63,-614883.8,1343837.22,728953.42
1980-04-16,101.54,-1.09,-1.06,120.24,-15.55,True,1,13095,-101.54,-614985.34,1329666.3,714680.96
1980-04-17,101.05,-0.49,-0.48,120.24,-15.96,True,1,13096,-101.05,-615086.39,1323350.8,708264.41
1980-04-18,100.55,-0.5,-0.5,120.24,-16.38,True,1,13097,-100.55,-615186.94,1316903.35,701716.41
1980-04-21,99.8,-0.75,-0.75,120.24,-17.0,True,1,13098,-99.8,-615286.74,1307180.4,691893.66
1980-04-22,103.43,3.63,3.64,120.24,-13.98,True,1,13099,-103.43,-615390.17,1354829.57,739439.4
1980-04-23,103.73,0.3,0.29,120.24,-13.73,True,1,13100,-103.73,-615493.9,1358863.0,743369.1
1980-04-24,104.4,0.67,0.65,120.24,-13.17,True,1,13101,-104.4,-615598.3,1367744.4,752146.1
1980-04-25,105.16,0.76,0.73,120.24,-12.54,True,1,13102,-105.16,-615703.46,1377806.32,762102.86
1980-04-28,105.64,0.48,0.46,120.24,-12.14,True,1,13103,-105.64,-615809.1,1384200.92,768391.82
1980-04-29,105.86,0.22,0.21,120.24,-11.96,True,1,13104,-105.86,-615914.96,1387189.44,771274.48
1980-04-30,106.29,0.43,0.41,120.24,-11.6,True,1,13105,-106.29,-616021.25,1392930.45,776909.2
1980-05-01,105.46,-0.83,-0.78,120.24,-12.29,True,1,13106,-105.46,-616126.71,1382158.76,766032.05
1980-05-02,105.58,0.12,0.11,120.24,-12.19,True,1,13107,-105.58,-616232.29,1383837.06,767604.77
1980-05-05,106.38,0.8,0.76,120.24,-11.53,True,1,13108,-106.38,-616338.67,1394429.04,778090.37
1980-05-06,106.25,-0.13,-0.12,120.24,-11.64,True,1,13109,-106.25,-616444.92,1392831.25,776386.33
1980-05-07,107.18,0.93,0.88,120.24,-10.86,True,1,13110,-107.18,-616552.1,1405129.8,788577.7
1980-05-08,106.13,-1.05,-0.98,120.24,-11.74,True,1,13111,-106.13,-616658.23,1391470.43,774812.2
1980-05-09,104.72,-1.41,-1.33,120.24,-12.91,True,1,13112,-104.72,-616762.95,1373088.64,756325.69
1980-05-12,104.78,0.06,0.06,120.24,-12.86,True,1,13113,-104.78,-616867.73,1373980.14,757112.41
1980-05-13,106.3,1.52,1.45,120.24,-11.59,True,1,13114,-106.3,-616974.03,1394018.2,777044.17
1980-05-14,106.85,0.55,0.52,120.24,-11.14,True,1,13115,-106.85,-617080.88,1401337.75,784256.87
1980-05-15,106.99,0.14,0.13,120.24,-11.02,True,1,13116,-106.99,-617187.87,1403280.84,786092.97
1980-05-16,107.35,0.36,0.34,120.24,-10.72,True,1,13117,-107.35,-617295.22,1408109.95,790814.73
1980-05-19,107.67,0.32,0.3,120.24,-10.45,True,1,13118,-107.67,-617402.89,1412415.06,795012.17
1980-05-20,107.62,-0.05,-0.05,120.24,-10.5,True,1,13119,-107.62,-617510.51,1411866.78,794356.27
1980-05-21,107.72,0.1,0.09,120.24,-10.41,True,1,13120,-107.72,-617618.23,1413286.4,795668.17
1980-05-22,109.01,1.29,1.2,120.24,-9.34,True,1,13121,-109.01,-617727.24,1430320.21,812592.97
1980-05-23,110.62,1.61,1.48,120.24,-8.0,True,1,13122,-110.62,-617837.86,1451555.64,833717.78
1980-05-27,111.4,0.78,0.7,120.24,-7.35,True,1,13123,-111.4,-617949.26,1461902.2,843952.94
1980-05-28,112.06,0.66,0.59,120.24,-6.8,True,1,13124,-112.06,-618061.32,1470675.44,852614.12
1980-05-29,110.27,-1.79,-1.6,120.24,-8.29,True,1,13125,-110.27,-618171.59,1447293.75,829122.16
1980-05-30,111.24,0.97,0.88,120.24,-7.48,True,1,13126,-111.24,-618282.83,1460136.24,841853.41
1980-06-02,110.76,-0.48,-0.43,120.24,-7.88,True,1,13127,-110.76,-618393.59,1453946.52,835552.93
1980-06-03,110.51,-0.25,-0.23,120.24,-8.09,True,1,13128,-110.51,-618504.1,1450775.28,832271.18
1980-06-04,112.61,2.1,1.9,120.24,-6.35,True,1,13129,-112.61,-618616.71,1478456.69,859839.98
1980-06-05,112.78,0.17,0.15,120.24,-6.2,True,1,13130,-112.78,-618729.49,1480801.4,862071.91
1980-06-06,113.2,0.42,0.37,120.24,-5.86,True,1,13131,-113.2,-618842.69,1486429.2,867586.51
1980-06-09,113.71,0.51,0.45,120.24,-5.43,True,1,13132,-113.71,-618956.4,1493239.72,874283.32
1980-06-10,114.66,0.95,0.84,120.24,-4.64,True,1,13133,-114.66,-619071.06,1505829.78,886758.72
1980-06-11,116.02,1.36,1.19,120.24,-3.51,True,1,13134,-116.02,-619187.08,1523806.68,904619.6
1980-06-12,115.52,-0.5,-0.43,120.24,-3.92,True,1,13135,-115.52,-619302.6,1517355.2,898052.6
1980-06-13,115.81,0.29,0.25,120.24,-3.68,True,1,13136,-115.81,-619418.41,1521280.16,901861.75
1980-06-16,116.09,0.28,0.24,120.24,-3.45,True,1,13137,-116.09,-619534.5,1525074.33,905539.83
1980-06-17,116.03,-0.06,-0.05,120.24,-3.5,True,1,13138,-116.03,-619650.53,1524402.14,904751.61
1980-06-18,116.26,0.23,0.2,120.24,-3.31,True,1,13139,-116.26,-619766.79,1527540.14,907773.35
1980-06-19,114.66,-1.6,-1.38,120.24,-4.64,True,1,13140,-114.66,-619881.45,1506632.4,886750.95
1980-06-20,114.06,-0.6,-0.52,120.24,-5.14,True,1,13141,-114.06,-619995.51,1498862.46,878866.95
1980-06-23,114.51,0.45,0.4,120.24,-4.76,True,1,13142,-114.51,-620110.02,1504890.42,884780.4
1980-06-24,115.14,0.63,0.55,120.24,-4.24,True,1,13143,-115.14,-620225.16,1513285.02,893059.86
1980-06-25,116.72,1.58,1.37,120.24,-2.93,True,1,13144,-116.72,-620341.88,1534167.68,913825.8
1980-06-26,116.19,-0.53,-0.45,120.24,-3.37,True,1,13145,-116.19,-620458.07,1527317.55,906859.48
1980-06-27,116.0,-0.19,-0.16,120.24,-3.53,True,1,13146,-116.0,-620574.07,1524936.0,904361.93
1980-06-30,114.24,-1.76,-1.52,120.24,-4.99,True,1,13147,-114.24,-620688.31,1501913.28,881224.97
1980-07-01,114.93,0.69,0.6,120.24,-4.42,True,1,13148,-114.93,-620803.24,1511099.64,890296.4
1980-07-02,115.68,0.75,0.65,120.24,-3.79,True,1,13149,-115.68,-620918.92,1521076.32,900157.4
1980-07-03,117.46,1.78,1.54,120.24,-2.31,True,1,13150,-117.46,-621036.38,1544599.0,923562.62
1980-07-07,118.29,0.83,0.71,120.24,-1.62,True,1,13151,-118.29,-621154.67,1555631.79,934477.12
1980-07-08,117.84,-0.45,-0.38,120.24,-2.0,True,1,13152,-117.84,-621272.51,1549831.68,928559.17
1980-07-09,117.98,0.14,0.12,120.24,-1.88,True,1,13153,-117.98,-621390.49,1551790.94,930400.45
1980-07-10,116.95,-1.03,-0.87,120.24,-2.74,True,1,13154,-116.95,-621507.44,1538360.3,916852.86
1980-07-11,117.84,0.89,0.76,120.24,-2.0,True,1,13155,-117.84,-621625.28,1550185.2,928559.92
1980-07-14,120.01,2.17,1.84,120.24,-0.19,True,1,13156,-120.01,-621745.29,1578851.56,957106.27
1980-07-15,119.3,-0.71,-0.59,120.24,-0.78,True,1,13157,-119.3,-621864.59,1569630.1,947765.51
1980-07-16,119.63,0.33,0.28,120.24,-0.51,True,1,13158,-119.63,-621984.22,1574091.54,952107.32
1980-07-17,121.44,1.81,1.51,121.44,0.0,True,1,13159,-121.44,-622105.66,1598028.96,975923.3
1980-07-18,122.04,0.6,0.49,122.04,0.0,True,1,13160,-122.04,-622227.7,1606046.4,983818.7
1980-07-21,122.51,0.47,0.38,122.51,0.0,True,1,13161,-122.51,-622350.21,1612354.11,990003.9
1980-07-22,122.19,-0.32,-0.26,122.51,-0.26,True,1,13162,-122.19,-622472.4,1608264.78,985792.38
1980-07-23,121.93,-0.26,-0.21,122.51,-0.47,True,1,13163,-121.93,-622594.33,1604964.59,982370.26
1980-07-24,121.79,-0.14,-0.12,122.51,-0.59,True,1,13164,-121.79,-622716.12,1603243.56,980527.44
1980-07-25,120.78,-1.01,-0.83,122.51,-1.41,True,1,13165,-120.78,-622836.9,1590068.7,967231.8
1980-07-28,121.43,0.65,0.54,122.51,-0.88,True,1,13166,-121.43,-622958.33,1598747.38,975789.05
1980-07-29,122.4,0.97,0.8,122.51,-0.09,True,1,13167,-122.4,-623080.73,1611640.8,988560.07
1980-07-30,122.23,-0.17,-0.14,122.51,-0.23,True,1,13168,-122.23,-623202.96,1609524.64,986321.68
1980-07-31,121.67,-0.56,-0.46,122.51,-0.69,True,1,13169,-121.67,-623324.63,1602272.23,978947.6
1980-08-01,121.21,-0.46,-0.38,122.51,-1.06,True,1,13170,-121.21,-623445.84,1596335.7,972889.86
1980-08-04,120.98,-0.23,-0.19,122.51,-1.25,True,1,13171,-120.98,-623566.82,1593427.58,969860.76
1980-08-05,120.74,-0.24,-0.2,122.51,-1.44,True,1,13172,-120.74,-623687.56,1590387.28,966699.72
1980-08-06,121.55,0.81,0.67,122.51,-0.78,True,1,13173,-121.55,-623809.11,1601178.15,977369.04
1980-08-07,123.3,1.75,1.44,123.3,0.0,True,1,13174,-123.3,-623932.41,1624354.2,1000421.79
1980-08-08,123.61,0.31,0.25,123.61,0.0,True,1,13175,-123.61,-624056.02,1628561.75,1004505.73
1980-08-11,124.78,1.17,0.95,124.78,0.0,True,1,13176,-124.78,-624180.8,1644101.28,1019920.48
1980-08-12,123.79,-0.99,-0.79,124.78,-0.79,True,1,13177,-123.79,-624304.59,1631180.83,1006876.24
1980-08-13,123.28,-0.51,-0.41,124.78,-1.2,True,1,13178,-123.28,-624427.87,1624583.84,1000155.97
1980-08-14,125.25,1.97,1.6,125.25,0.0,True,1,13179,-125.25,-624553.12,1650669.75,1026116.63
1980-08-15,125.72,0.47,0.38,125.72,0.0,True,1,13180,-125.72,-624678.84,1656989.6,1032310.76
1980-08-18,123.39,-2.33,-1.85,125.72,-1.85,True,1,13181,-123.39,-624802.23,1626403.59,1001601.36
1980-08-19,122.6,-0.79,-0.64,125.72,-2.48,True,1,13182,-122.6,-624924.83,1616113.2,991188.37
1980-08-20,123.77,1.17,0.95,125.72,-1.55,True,1,13183,-123.77,-625048.6,1631659.91,1006611.31
1980-08-21,125.46,1.69,1.36,125.72,-0.21,True,1,13184,-125.46,-625174.06,1654064.64,1028890.58
1980-08-22,126.02,0.56,0.45,126.02,0.0,True,1,13185,-126.02,-625300.08,1661573.7,1036273.62
1980-08-25,125.16,-0.86,-0.68,126.02,-0.68,True,1,13186,-125.16,-625425.24,1650359.76,1024934.52
1980-08-26,124.84,-0.32,-0.26,126.02,-0.94,True,1,13187,-124.84,-625550.08,1646265.08,1020715.0
1980-08-27,123.52,-1.32,-1.06,126.02,-1.98,True,1,13188,-123.52,-625673.6,1628981.76,1003308.16
1980-08-28,122.08,-1.44,-1.17,126.02,-3.13,True,1,13189,-122.08,-625795.68,1610113.12,984317.44
1980-08-29,122.38,0.3,0.25,126.02,-2.89,True,1,13190,-122.38,-625918.06,1614192.2,988274.14
1980-09-02,123.74,1.36,1.11,126.02,-1.81,True,1,13191,-123.74,-626041.8,1632254.34,1006212.54
1980-09-03,126.12,2.38,1.92,126.12,0.0,True,1,13192,-126.12,-626167.92,1663775.04,1037607.12
1980-09-04,125.42,-0.7,-0.56,126.12,-0.56,True,1,13193,-125.42,-626293.34,1654666.06,1028372.72
1980-09-05,124.88,-0.54,-0.43,126.12,-0.98,True,1,13194,-124.88,-626418.22,1647666.72,1021248.5
1980-09-08,123.31,-1.57,-1.26,126.12,-2.23,True,1,13195,-123.31,-626541.53,1627075.45,1000533.92
1980-09-09,124.07,0.76,0.62,126.12,-1.62,True,1,13196,-124.07,-626665.6,1637227.72,1010562.12
1980-09-10,124.81,0.74,0.6,126.12,-1.04,True,1,13197,-124.81,-626790.41,1647117.57,1020327.16
1980-09-11,125.66,0.85,0.68,126.12,-0.36,True,1,13198,-125.66,-626916.07,1658460.68,1031544.61
1980-09-12,125.54,-0.12,-0.1,126.12,-0.46,True,1,13199,-125.54,-627041.61,1657002.46,1029960.85
1980-09-15,125.67,0.13,0.1,126.12,-0.36,True,1,13200,-125.67,-627167.28,1658844.0,1031676.72
1980-09-16,126.74,1.07,0.85,126.74,0.0,True,1,13201,-126.74,-627294.02,1673094.74,1045800.72
1980-09-17,128.87,2.13,1.68,128.87,0.0,True,1,13202,-128.87,-627422.89,1701341.74,1073918.85
1980-09-18,128.4,-0.47,-0.36,128.87,-0.36,True,1,13203,-128.4,-627551.29,1695265.2,1067713.91
1980-09-19,129.25,0.85,0.66,129.25,0.0,True,1,13204,-129.25,-627680.54,1706617.0,1078936.46
1980-09-22,130.4,1.15,0.89,130.4,0.0,True,1,13205,-130.4,-627810.94,1721932.0,1094121.06
1980-09-23,129.43,-0.97,-0.74,130.4,-0.74,True,1,13206,-129.43,-627940.37,1709252.58,1081312.21
1980-09-24,130.37,0.94,0.73,130.4,-0.02,True,1,13207,-130.37,-628070.74,1721796.59,1093725.85
1980-09-25,128.72,-1.65,-1.27,130.4,-1.29,True,1,13208,-128.72,-628199.46,1700133.76,1071934.3
1980-09-26,126.35,-2.37,-1.84,130.4,-3.11,True,1,13209,-126.35,-628325.81,1668957.15,1040631.34
1980-09-29,123.54,-2.81,-2.22,130.4,-5.26,True,1,13210,-123.54,-628449.35,1631963.4,1003514.05
1980-09-30,125.46,1.92,1.55,130.4,-3.79,True,1,13211,-125.46,-628574.81,1657452.06,1028877.25
1980-10-01,127.13,1.67,1.33,130.4,-2.51,True,1,13212,-127.13,-628701.94,1679641.56,1050939.62
1980-10-02,128.09,0.96,0.76,130.4,-1.77,True,1,13213,-128.09,-628830.03,1692453.17,1063623.14
1980-10-03,129.33,1.24,0.97,130.4,-0.82,True,1,13214,-129.33,-628959.36,1708966.62,1080007.26
1980-10-06,131.73,2.4,1.86,131.73,0.0,True,1,13215,-131.73,-629091.09,1740811.95,1111720.86
1980-10-07,131.0,-0.73,-0.55,131.73,-0.55,True,1,13216,-131.0,-629222.09,1731296.0,1102073.91
1980-10-08,131.65,0.65,0.5,131.73,-0.06,True,1,13217,-131.65,-629353.74,1740018.05,1110664.31
1980-10-09,131.04,-0.61,-0.46,131.73,-0.52,True,1,13218,-131.04,-629484.78,1732086.72,1102601.94
1980-10-10,130.29,-0.75,-0.57,131.73,-1.09,True,1,13219,-130.29,-629615.07,1722303.51,1092688.44
1980-10-13,132.03,1.74,1.34,132.03,0.0,True,1,13220,-132.03,-629747.1,1745436.6,1115689.5
1980-10-14,132.02,-0.01,-0.01,132.03,-0.01,True,1,13221,-132.02,-629879.12,1745436.42,1115557.3
1980-10-15,133.7,1.68,1.27,133.7,0.0,True,1,13222,-133.7,-630012.82,1767781.4,1137768.58
1980-10-16,132.22,-1.48,-1.11,133.7,-1.11,True,1,13223,-132.22,-630145.04,1748345.06,1118200.02
1980-10-17,131.52,-0.7,-0.53,133.7,-1.63,True,1,13224,-131.52,-630276.56,1739220.48,1108943.92
1980-10-20,132.61,1.09,0.83,133.7,-0.82,True,1,13225,-132.61,-630409.17,1753767.25,1123358.08
1980-10-21,131.84,-0.77,-0.58,133.7,-1.39,True,1,13226,-131.84,-630541.01,1743715.84,1113174.83
1980-10-22,131.92,0.08,0.06,133.7,-1.33,True,1,13227,-131.92,-630672.93,1744905.84,1114232.91
1980-10-23,129.53,-2.39,-1.81,133.7,-3.12,True,1,13228,-129.53,-630802.46,1713422.84,1082620.38
1980-10-24,129.85,0.32,0.25,133.7,-2.88,True,1,13229,-129.85,-630932.31,1717785.65,1086853.34
1980-10-27,127.88,-1.97,-1.52,133.7,-4.35,True,1,13230,-127.88,-631060.19,1691852.4,1060792.21
1980-10-28,128.05,0.17,0.13,133.7,-4.23,True,1,13231,-128.05,-631188.24,1694229.55,1063041.31
1980-10-29,127.91,-0.14,-0.11,133.7,-4.33,True,1,13232,-127.91,-631316.15,1692505.12,1061188.97
1980-10-30,126.29,-1.62,-1.27,133.7,-5.54,True,1,13233,-126.29,-631442.44,1671195.57,1039753.13
1980-10-31,127.47,1.18,0.93,133.7,-4.66,True,1,13234,-127.47,-631569.91,1686937.98,1055368.07
1980-11-03,129.04,1.57,1.23,133.7,-3.48,True,1,13235,-129.04,-631698.95,1707844.4,1076145.45
1980-11-05,131.33,2.29,1.78,133.7,-1.77,True,1,13236,-131.33,-631830.28,1738283.88,1106453.6
1980-11-06,128.91,-2.42,-1.84,133.7,-3.58,True,1,13237,-128.91,-631959.19,1706381.67,1074422.48
1980-11-07,129.18,0.27,0.21,133.7,-3.38,True,1,13238,-129.18,-632088.37,1710084.84,1077996.47
1980-11-10,129.48,0.3,0.23,133.7,-3.16,True,1,13239,-129.48,-632217.85,1714185.72,1081967.87
1980-11-11,131.26,1.78,1.38,133.7,-1.82,True,1,13240,-131.26,-632349.11,1737882.4,1105533.29
1980-11-12,134.59,3.33,2.54,134.59,0.0,True,1,13241,-134.59,-632483.7,1782106.19,1149622.49
1980-11-13,136.49,1.9,1.41,136.49,0.0,True,1,13242,-136.49,-632620.19,1807400.58,1174780.39
1980-11-14,137.15,0.66,0.48,137.15,0.0,True,1,13243,-137.15,-632757.34,1816277.45,1183520.11
1980-11-17,137.75,0.6,0.44,137.75,0.0,True,1,13244,-137.75,-632895.09,1824361.0,1191465.91
1980-11-18,139.7,1.95,1.42,139.7,0.0,True,1,13245,-139.7,-633034.79,1850326.5,1217291.71
1980-11-19,139.06,-0.64,-0.46,139.7,-0.46,True,1,13246,-139.06,-633173.85,1841988.76,1208814.91
1980-11-20,140.4,1.34,0.96,140.4,0.0,True,1,13247,-140.4,-633314.25,1859878.8,1226564.55
1980-11-21,139.11,-1.29,-0.92,140.4,-0.92,True,1,13248,-139.11,-633453.36,1842929.28,1209475.92
1980-11-24,138.31,-0.8,-0.57,140.4,-1.49,True,1,13249,-138.31,-633591.67,1832469.19,1198877.52
1980-11-25,139.33,1.02,0.74,140.4,-0.76,True,1,13250,-139.33,-633731.0,1846122.5,1212391.5
1980-11-26,140.17,0.84,0.6,140.4,-0.16,True,1,13251,-140.17,-633871.17,1857392.67,1223521.5
1980-11-28,140.52,0.35,0.25,140.52,0.0,True,1,13252,-140.52,-634011.69,1862171.04,1228159.35
1980-12-01,137.21,-3.31,-2.36,140.52,-2.36,True,1,13253,-137.21,-634148.9,1818444.13,1184295.23
1980-12-02,136.97,-0.24,-0.18,140.52,-2.53,True,1,13254,-136.97,-634285.87,1815400.38,1181114.51
1980-12-03,136.71,-0.26,-0.19,140.52,-2.71,True,1,13255,-136.71,-634422.58,1812091.05,1177668.47
1980-12-04,136.48,-0.23,-0.17,140.52,-2.88,True,1,13256,-136.48,-634559.06,1809178.88,1174619.82
1980-12-05,134.03,-2.45,-1.8,140.52,-4.62,True,1,13257,-134.03,-634693.09,1776835.71,1142142.62
1980-12-08,130.61,-3.42,-2.55,140.52,-7.05,True,1,13258,-130.61,-634823.7,1731627.38,1096803.68
1980-12-09,130.48,-0.13,-0.1,140.52,-7.14,True,1,13259,-130.48,-634954.18,1730034.32,1095080.14
1980-12-10,128.26,-2.22,-1.7,140.52,-8.72,True,1,13260,-128.26,-635082.44,1700727.6,1065645.16
1980-12-11,127.36,-0.9,-0.7,140.52,-9.36,True,1,13261,-127.36,-635209.8,1688920.96,1053711.16
1980-12-12,129.23,1.87,1.47,140.52,-8.03,True,1,13262,-129.23,-635339.03,1713848.26,1078509.23
1980-12-15,129.45,0.22,0.17,140.52,-7.88,True,1,13263,-129.45,-635468.48,1716895.35,1081426.87
1980-12-16,130.6,1.15,0.89,140.52,-7.06,True,1,13264,-130.6,-635599.08,1732278.4,1096679.32
1980-12-17,132.89,2.29,1.75,140.52,-5.43,True,1,13265,-132.89,-635731.97,1762785.85,1127053.88
1980-12-18,133.0,0.11,0.08,140.52,-5.35,True,1,13266,-133.0,-635864.97,1764378.0,1128513.03
1980-12-19,133.7,0.7,0.53,140.52,-4.85,True,1,13267,-133.7,-635998.67,1773797.9,1137799.23
1980-12-22,135.78,2.08,1.56,140.52,-3.37,True,1,13268,-135.78,-636134.45,1801529.04,1165394.59
1980-12-23,135.3,-0.48,-0.35,140.52,-3.72,True,1,13269,-135.3,-636269.75,1795295.7,1159025.95
1980-12-24,135.88,0.58,0.43,140.52,-3.3,True,1,13270,-135.88,-636405.63,1803127.6,1166721.97
1980-12-26,136.57,0.69,0.51,140.52,-2.81,True,1,13271,-136.57,-636542.2,1812420.47,1175878.27
1980-12-29,135.03,-1.54,-1.13,140.52,-3.91,True,1,13272,-135.03,-636677.23,1792118.16,1155440.93
1980-12-30,135.33,0.3,0.22,140.52,-3.69,True,1,13273,-135.33,-636812.56,1796235.09,1159422.53
1980-12-31,135.76,0.43,0.32,140.52,-3.39,True,1,13274,-135.76,-636948.32,1802078.24,1165129.92
1981-01-02,136.34,0.58,0.43,140.52,-2.98,True,1,13275,-136.34,-637084.66,1809913.5,1172828.84
1981-01-05,137.97,1.63,1.2,140.52,-1.82,True,1,13276,-137.97,-637222.63,1831689.72,1194467.09
1981-01-06,138.12,0.15,0.11,140.52,-1.71,True,1,13277,-138.12,-637360.75,1833819.24,1196458.49
1981-01-07,135.08,-3.04,-2.2,140.52,-3.87,True,1,13278,-135.08,-637495.83,1793592.24,1156096.41
1981-01-08,133.06,-2.02,-1.5,140.52,-5.31,True,1,13279,-133.06,-637628.89,1766903.74,1129274.85
1981-01-09,133.48,0.42,0.32,140.52,-5.01,True,1,13280,-133.48,-637762.37,1772614.4,1134852.03
1981-01-12,133.52,0.04,0.03,140.52,-4.98,True,1,13281,-133.52,-637895.89,1773279.12,1135383.23
1981-01-13,133.29,-0.23,-0.17,140.52,-5.14,True,1,13282,-133.29,-638029.18,1770357.78,1132328.6
1981-01-14,133.47,0.18,0.14,140.52,-5.02,True,1,13283,-133.47,-638162.65,1772882.01,1134719.36
1981-01-15,134.22,0.75,0.56,140.52,-4.48,True,1,13284,-134.22,-638296.87,1782978.48,1144681.61
1981-01-16,134.77,0.55,0.41,140.52,-4.09,True,1,13285,-134.77,-638431.64,1790419.45,1151987.81
1981-01-19,134.37,-0.4,-0.3,140.52,-4.38,True,1,13286,-134.37,-638566.01,1785239.82,1146673.81
1981-01-20,131.65,-2.72,-2.02,140.52,-6.31,True,1,13287,-131.65,-638697.66,1749233.55,1110535.89
1981-01-21,131.36,-0.29,-0.22,140.52,-6.52,True,1,13288,-131.36,-638829.02,1745511.68,1106682.66
1981-01-22,130.26,-1.1,-0.84,140.52,-7.3,True,1,13289,-130.26,-638959.28,1731025.14,1092065.86
1981-01-23,130.23,-0.03,-0.02,140.52,-7.32,True,1,13290,-130.23,-639089.51,1730756.7,1091667.19
1981-01-26,129.84,-0.39,-0.3,140.52,-7.6,True,1,13291,-129.84,-639219.35,1725703.44,1086484.09
1981-01-27,131.12,1.28,0.99,140.52,-6.69,True,1,13292,-131.12,-639350.47,1742847.04,1103496.57
1981-01-28,130.34,-0.78,-0.6,140.52,-7.24,True,1,13293,-130.34,-639480.81,1732609.62,1093128.81
1981-01-29,130.24,-0.1,-0.08,140.52,-7.32,True,1,13294,-130.24,-639611.05,1731410.56,1091799.51
1981-01-30,129.55,-0.69,-0.53,140.52,-7.81,True,1,13295,-129.55,-639740.6,1722367.25,1082626.65
1981-02-02,126.91,-2.64,-2.04,140.52,-9.68,True,1,13296,-126.91,-639867.51,1687395.36,1047527.85
1981-02-03,128.46,1.55,1.22,140.52,-8.58,True,1,13297,-128.46,-639995.97,1708132.62,1068136.65
1981-02-04,128.59,0.13,0.1,140.52,-8.49,True,1,13298,-128.59,-640124.56,1709989.82,1069865.26
1981-02-05,129.63,1.04,0.81,140.52,-7.75,True,1,13299,-129.63,-640254.19,1723949.37,1083695.18
1981-02-06,130.6,0.97,0.75,140.52,-7.06,True,1,13300,-130.6,-640384.79,1736980.0,1096595.21
1981-02-09,129.27,-1.33,-1.02,140.52,-8.01,True,1,13301,-129.27,-640514.06,1719420.27,1078906.21
1981-02-10,129.24,-0.03,-0.02,140.52,-8.03,True,1,13302,-129.24,-640643.3,1719150.48,1078507.18
1981-02-11,128.24,-1.0,-0.77,140.52,-8.74,True,1,13303,-128.24,-640771.54,1705976.72,1065205.18
1981-02-12,127.48,-0.76,-0.59,140.52,-9.28,True,1,13304,-127.48,-640899.02,1695993.92,1055094.9
1981-02-13,126.98,-0.5,-0.39,140.52,-9.64,True,1,13305,-126.98,-641026.0,1689468.9,1048442.9
1981-02-17,127.81,0.83,0.65,140.52,-9.04,True,1,13306,-127.81,-641153.81,1700639.86,1059486.05
1981-02-18,128.48,0.67,0.52,140.52,-8.57,True,1,13307,-128.48,-641282.29,1709683.36,1068401.07
1981-02-19,126.61,-1.87,-1.46,140.52,-9.9,True,1,13308,-126.61,-641408.9,1684925.88,1043516.98
1981-02-20,126.58,-0.03,-0.02,140.52,-9.92,True,1,13309,-126.58,-641535.48,1684653.22,1043117.74
1981-02-23,127.35,0.77,0.61,140.52,-9.37,True,1,13310,-127.35,-641662.83,1695028.5,1053365.67
1981-02-24,127.39,0.04,0.03,140.52,-9.34,True,1,13311,-127.39,-641790.22,1695688.29,1053898.07
1981-02-25,128.52,1.13,0.89,140.52,-8.54,True,1,13312,-128.52,-641918.74,1710858.24,1068939.5
1981-02-26,130.1,1.58,1.23,140.52,-7.42,True,1,13313,-130.1,-642048.84,1732021.3,1089972.46
1981-02-27,131.27,1.17,0.9,140.52,-6.58,True,1,13314,-131.27,-642180.11,1747728.78,1105548.67
1981-03-02,132.01,0.74,0.56,140.52,-6.06,True,1,13315,-132.01,-642312.12,1757713.15,1115401.03
1981-03-03,130.56,-1.45,-1.1,140.52,-7.09,True,1,13316,-130.56,-642442.68,1738536.96,1096094.28
1981-03-04,130.86,0.3,0.23,140.52,-6.87,True,1,13317,-130.86,-642573.54,1742662.62,1100089.08
1981-03-05,129.93,-0.93,-0.71,140.52,-7.54,True,1,13318,-129.93,-642703.47,1730407.74,1087704.27
1981-03-06,129.85,-0.08,-0.06,140.52,-7.59,True,1,13319,-129.85,-642833.32,1729472.15,1086638.83
1981-03-09,131.12,1.27,0.98,140.52,-6.69,True,1,13320,-131.12,-642964.44,1746518.4,1103553.96
1981-03-10,130.46,-0.66,-0.5,140.52,-7.16,True,1,13321,-130.46,-643094.9,1737857.66,1094762.76
1981-03-11,129.95,-0.51,-0.39,140.52,-7.52,True,1,13322,-129.95,-643224.85,1731193.9,1087969.05
1981-03-12,133.19,3.24,2.49,140.52,-5.22,True,1,13323,-133.19,-643358.04,1774490.37,1131132.33
1981-03-13,133.11,-0.08,-0.06,140.52,-5.27,True,1,13324,-133.11,-643491.15,1773557.64,1130066.49
1981-03-16,134.68,1.57,1.18,140.52,-4.16,True,1,13325,-134.68,-643625.83,1794611.0,1150985.17
1981-03-17,133.92,-0.76,-0.56,140.52,-4.7,True,1,13326,-133.92,-643759.75,1784617.92,1140858.17
1981-03-18,134.22,0.3,0.22,140.52,-4.48,True,1,13327,-134.22,-643893.97,1788749.94,1144855.97
1981-03-19,133.46,-0.76,-0.57,140.52,-5.02,True,1,13328,-133.46,-644027.43,1778754.88,1134727.45
1981-03-20,134.08,0.62,0.46,140.52,-4.58,True,1,13329,-134.08,-644161.51,1787152.32,1142990.81
1981-03-23,135.69,1.61,1.2,140.52,-3.44,True,1,13330,-135.69,-644297.2,1808747.7,1164450.5
1981-03-24,134.67,-1.02,-0.75,140.52,-4.16,True,1,13331,-134.67,-644431.87,1795285.77,1150853.9
1981-03-25,137.11,2.44,1.81,140.52,-2.43,True,1,13332,-137.11,-644568.98,1827950.52,1183381.54
1981-03-26,136.27,-0.84,-0.61,140.52,-3.02,True,1,13333,-136.27,-644705.25,1816887.91,1172182.66
1981-03-27,134.65,-1.62,-1.19,140.52,-4.18,True,1,13334,-134.65,-644839.9,1795423.1,1150583.2
1981-03-30,134.28,-0.37,-0.28,140.52,-4.44,True,1,13335,-134.28,-644974.18,1790623.8,1145649.62
1981-03-31,136.0,1.72,1.28,140.52,-3.22,True,1,13336,-136.0,-645110.18,1813696.0,1168585.82
1981-04-01,136.57,0.57,0.42,140.52,-2.81,True,1,13337,-136.57,-645246.75,1821434.09,1176187.34
1981-04-02,136.32,-0.25,-0.18,140.52,-2.99,True,1,13338,-136.32,-645383.07,1818236.16,1172853.09
1981-04-03,135.49,-0.83,-0.61,140.52,-3.58,True,1,13339,-135.49,-645518.56,1807301.11,1161782.55
1981-04-06,133.93,-1.56,-1.15,140.52,-4.69,True,1,13340,-133.93,-645652.49,1786626.2,1140973.71
1981-04-07,133.91,-0.02,-0.02,140.52,-4.7,True,1,13341,-133.91,-645786.4,1786493.31,1140706.91
1981-04-08,134.31,0.4,0.3,140.52,-4.42,True,1,13342,-134.31,-645920.71,1791964.02,1146043.31
1981-04-09,134.67,0.36,0.27,140.52,-4.16,True,1,13343,-134.67,-646055.38,1796901.81,1150846.43
1981-04-10,134.51,-0.16,-0.12,140.52,-4.28,True,1,13344,-134.51,-646189.89,1794901.44,1148711.55
1981-04-13,133.15,-1.36,-1.01,140.52,-5.24,True,1,13345,-133.15,-646323.04,1776886.75,1130563.71
1981-04-14,132.68,-0.47,-0.35,140.52,-5.58,True,1,13346,-132.68,-646455.72,1770747.28,1124291.56
1981-04-15,134.17,1.49,1.12,140.52,-4.52,True,1,13347,-134.17,-646589.89,1790766.99,1144177.1
1981-04-16,134.7,0.53,0.4,140.52,-4.14,True,1,13348,-134.7,-646724.59,1797975.6,1151251.01
1981-04-20,135.45,0.75,0.56,140.52,-3.61,True,1,13349,-135.45,-646860.04,1808122.05,1161262.01
1981-04-21,134.23,-1.22,-0.9,140.52,-4.48,True,1,13350,-134.23,-646994.27,1791970.5,1144976.23
1981-04-22,134.14,-0.09,-0.07,140.52,-4.54,True,1,13351,-134.14,-647128.41,1790903.14,1143774.73
1981-04-23,133.94,-0.2,-0.15,140.52,-4.68,True,1,13352,-133.94,-647262.35,1788366.88,1141104.53
1981-04-24,135.14,1.2,0.9,140.52,-3.83,True,1,13353,-135.14,-647397.49,1804524.42,1157126.93
1981-04-27,135.48,0.34,0.25,140.52,-3.59,True,1,13354,-135.48,-647532.97,1809199.92,1161666.95
1981-04-28,134.33,-1.15,-0.85,140.52,-4.4,True,1,13355,-134.33,-647667.3,1793977.15,1146309.85
1981-04-29,133.05,-1.28,-0.95,140.52,-5.32,True,1,13356,-133.05,-647800.35,1777015.8,1129215.45
1981-04-30,132.81,-0.24,-0.18,140.52,-5.49,True,1,13357,-132.81,-647933.16,1773943.17,1126010.01
1981-05-01,132.72,-0.09,-0.07,140.52,-5.55,True,1,13358,-132.72,-648065.88,1772873.76,1124807.88
1981-05-04,130.67,-2.05,-1.54,140.52,-7.01,True,1,13359,-130.67,-648196.55,1745620.53,1097423.98
1981-05-05,130.32,-0.35,-0.27,140.52,-7.26,True,1,13360,-130.32,-648326.87,1741075.2,1092748.33
1981-05-06,130.78,0.46,0.35,140.52,-6.93,True,1,13361,-130.78,-648457.65,1747351.58,1098893.93
1981-05-07,131.67,0.89,0.68,140.52,-6.3,True,1,13362,-131.67,-648589.32,1759374.54,1110785.22
1981-05-08,131.66,-0.01,-0.01,140.52,-6.3,True,1,13363,-131.66,-648720.98,1759372.58,1110651.6
1981-05-11,129.71,-1.95,-1.48,140.52,-7.69,True,1,13364,-129.71,-648850.69,1733444.44,1084593.75
1981-05-12,130.72,1.01,0.78,140.52,-6.97,True,1,13365,-130.72,-648981.41,1747072.8,1098091.39
1981-05-13,130.55,-0.17,-0.13,140.52,-7.1,True,1,13366,-130.55,-649111.96,1744931.3,1095819.34
1981-05-14,131.28,0.73,0.56,140.52,-6.58,True,1,13367,-131.28,-649243.24,1754819.76,1105576.52
1981-05-15,132.17,0.89,0.68,140.52,-5.94,True,1,13368,-132.17,-649375.41,1766848.56,1117473.15
1981-05-18,132.54,0.37,0.28,140.52,-5.68,True,1,13369,-132.54,-649507.95,1771927.26,1122419.31
1981-05-19,132.09,-0.45,-0.34,140.52,-6.0,True,1,13370,-132.09,-649640.04,1766043.3,1116403.26
1981-05-20,132.0,-0.09,-0.07,140.52,-6.06,True,1,13371,-132.0,-649772.04,1764972.0,1115199.96
1981-05-21,131.75,-0.25,-0.19,140.52,-6.24,True,1,13372,-131.75,-649903.79,1761761.0,1111857.21
1981-05-22,131.33,-0.42,-0.32,140.52,-6.54,True,1,13373,-131.33,-650035.12,1756276.09,1106240.97
1981-05-26,132.77,1.44,1.1,140.52,-5.52,True,1,13374,-132.77,-650167.89,1775665.98,1125498.09
1981-05-27,133.77,1.0,0.75,140.52,-4.8,True,1,13375,-133.77,-650301.66,1789173.75,1138872.09
1981-05-28,133.45,-0.32,-0.24,140.52,-5.03,True,1,13376,-133.45,-650435.11,1785027.2,1134592.09
1981-05-29,132.59,-0.86,-0.64,140.52,-5.64,True,1,13377,-132.59,-650567.7,1773656.43,1123088.73
1981-06-01,132.41,-0.18,-0.14,140.52,-5.77,True,1,13378,-132.41,-650700.11,1771380.98,1120680.87
1981-06-02,130.62,-1.79,-1.35,140.52,-7.04,True,1,13379,-130.62,-650830.73,1747564.98,1096734.25
1981-06-03,130.71,0.09,0.07,140.52,-6.98,True,1,13380,-130.71,-650961.44,1748899.8,1097938.36
1981-06-04,130.96,0.25,0.19,140.52,-6.8,True,1,13381,-130.96,-651092.4,1752375.76,1101283.36
1981-06-05,132.22,1.26,0.96,140.52,-5.91,True,1,13382,-132.22,-651224.62,1769368.04,1118143.42
1981-06-08,132.24,0.02,0.02,140.52,-5.89,True,1,13383,-132.24,-651356.86,1769767.92,1118411.06
1981-06-09,131.97,-0.27,-0.2,140.52,-6.08,True,1,13384,-131.97,-651488.83,1766286.48,1114797.65
1981-06-10,132.32,0.35,0.26,140.52,-5.84,True,1,13385,-132.32,-651621.15,1771103.2,1119482.05
1981-06-11,133.75,1.43,1.08,140.52,-4.82,True,1,13386,-133.75,-651754.9,1790377.5,1138622.6
1981-06-12,133.49,-0.26,-0.19,140.52,-5.0,True,1,13387,-133.49,-651888.39,1787030.63,1135142.24
1981-06-15,133.61,0.12,0.09,140.52,-4.92,True,1,13388,-133.61,-652022.0,1788770.68,1136748.68
1981-06-16,132.15,-1.46,-1.09,140.52,-5.96,True,1,13389,-132.15,-652154.15,1769356.35,1117202.2
1981-06-17,133.32,1.17,0.88,140.52,-5.12,True,1,13390,-133.32,-652287.47,1785154.8,1132867.33
1981-06-18,131.64,-1.68,-1.26,140.52,-6.32,True,1,13391,-131.64,-652419.11,1762791.24,1110372.13
1981-06-19,132.27,0.63,0.48,140.52,-5.87,True,1,13392,-132.27,-652551.38,1771359.84,1118808.46
1981-06-22,131.95,-0.32,-0.24,140.52,-6.1,True,1,13393,-131.95,-652683.33,1767206.35,1114523.02
1981-06-23,133.35,1.4,1.06,140.52,-5.1,True,1,13394,-133.35,-652816.68,1786089.9,1133273.22
1981-06-24,132.66,-0.69,-0.52,140.52,-5.59,True,1,13395,-132.66,-652949.34,1776980.7,1124031.36
1981-06-25,132.81,0.15,0.11,140.52,-5.49,True,1,13396,-132.81,-653082.15,1779122.76,1126040.61
1981-06-26,132.56,-0.25,-0.19,140.52,-5.66,True,1,13397,-132.56,-653214.71,1775906.32,1122691.61
1981-06-29,131.89,-0.67,-0.5,140.52,-6.14,True,1,13398,-131.89,-653346.6,1767062.22,1113715.62
1981-06-30,131.21,-0.68,-0.52,140.52,-6.62,True,1,13399,-131.21,-653477.81,1758082.79,1104604.98
1981-07-01,129.77,-1.44,-1.1,140.52,-7.65,True,1,13400,-129.77,-653607.58,1738918.0,1085310.42
1981-07-02,128.64,-1.13,-0.87,140.52,-8.45,True,1,13401,-128.64,-653736.22,1723904.64,1070168.42
1981-07-06,127.37,-1.27,-0.99,140.52,-9.36,True,1,13402,-127.37,-653863.59,1707012.74,1053149.15
1981-07-07,128.24,0.87,0.68,140.52,-8.74,True,1,13403,-128.24,-653991.83,1718800.72,1064808.89
1981-07-08,128.32,0.08,0.06,140.52,-8.68,True,1,13404,-128.32,-654120.15,1720001.28,1065881.13
1981-07-09,129.3,0.98,0.76,140.52,-7.98,True,1,13405,-129.3,-654249.45,1733266.5,1079017.05
1981-07-10,129.37,0.07,0.05,140.52,-7.94,True,1,13406,-129.37,-654378.82,1734334.22,1079955.4
1981-07-13,129.64,0.27,0.21,140.52,-7.74,True,1,13407,-129.64,-654508.46,1738083.48,1083575.02
1981-07-14,129.65,0.01,0.01,140.52,-7.74,True,1,13408,-129.65,-654638.11,1738347.2,1083709.09
1981-07-15,130.23,0.58,0.45,140.52,-7.32,True,1,13409,-130.23,-654768.34,1746254.07,1091485.73
1981-07-16,130.34,0.11,0.08,140.52,-7.24,True,1,13410,-130.34,-654898.68,1747859.4,1092960.72
1981-07-17,130.76,0.42,0.32,140.52,-6.95,True,1,13411,-130.76,-655029.44,1753622.36,1098592.92
1981-07-20,128.72,-2.04,-1.56,140.52,-8.4,True,1,13412,-128.72,-655158.16,1726392.64,1071234.48
1981-07-21,128.34,-0.38,-0.3,140.52,-8.67,True,1,13413,-128.34,-655286.5,1721424.42,1066137.92
1981-07-22,127.13,-1.21,-0.94,140.52,-9.53,True,1,13414,-127.13,-655413.63,1705321.82,1049908.19
1981-07-23,127.4,0.27,0.21,140.52,-9.34,True,1,13415,-127.4,-655541.03,1709071.0,1053529.97
1981-07-24,128.46,1.06,0.83,140.52,-8.58,True,1,13416,-128.46,-655669.49,1723419.36,1067749.87
1981-07-27,129.9,1.44,1.12,140.52,-7.56,True,1,13417,-129.9,-655799.39,1742868.3,1087068.91
1981-07-28,129.14,-0.76,-0.58,140.52,-8.1,True,1,13418,-129.14,-655928.53,1732800.52,1076871.99
1981-07-29,129.16,0.02,0.02,140.52,-8.08,True,1,13419,-129.16,-656057.69,1733198.04,1077140.35
1981-07-30,130.01,0.85,0.66,140.52,-7.48,True,1,13420,-130.01,-656187.7,1744734.2,1088546.5
1981-07-31,130.92,0.91,0.7,140.52,-6.83,True,1,13421,-130.92,-656318.62,1757077.32,1100758.7
1981-08-03,130.48,-0.44,-0.34,140.52,-7.14,True,1,13422,-130.48,-656449.1,1751302.56,1094853.46
1981-08-04,131.18,0.7,0.54,140.52,-6.65,True,1,13423,-131.18,-656580.28,1760829.14,1104248.86
1981-08-05,132.67,1.49,1.14,140.52,-5.59,True,1,13424,-132.67,-656712.95,1780962.08,1124249.13
1981-08-06,132.64,-0.03,-0.02,140.52,-5.61,True,1,13425,-132.64,-656845.59,1780692.0,1123846.41
1981-08-07,131.75,-0.89,-0.67,140.52,-6.24,True,1,13426,-131.75,-656977.34,1768875.5,1111898.16
1981-08-10,132.54,0.79,0.6,140.52,-5.68,True,1,13427,-132.54,-657109.88,1779614.58,1122504.7
1981-08-11,133.85,1.31,0.99,140.52,-4.75,True,1,13428,-133.85,-657243.73,1797337.8,1140094.07
1981-08-12,133.4,-0.45,-0.34,140.52,-5.07,True,1,13429,-133.4,-657377.13,1791428.6,1134051.47
1981-08-13,133.51,0.11,0.08,140.52,-4.99,True,1,13430,-133.51,-657510.64,1793039.3,1135528.66
1981-08-14,132.49,-1.02,-0.76,140.52,-5.71,True,1,13431,-132.49,-657643.13,1779473.19,1121830.06
1981-08-17,131.22,-1.27,-0.96,140.52,-6.62,True,1,13432,-131.22,-657774.35,1762547.04,1104772.69
1981-08-18,130.11,-1.11,-0.85,140.52,-7.41,True,1,13433,-130.11,-657904.46,1747767.63,1089863.17
1981-08-19,130.49,0.38,0.29,140.52,-7.14,True,1,13434,-130.49,-658034.95,1753002.66,1094967.71
1981-08-20,130.69,0.2,0.15,140.52,-7.0,True,1,13435,-130.69,-658165.64,1755820.15,1097654.51
1981-08-21,129.23,-1.46,-1.12,140.52,-8.03,True,1,13436,-129.23,-658294.87,1736334.28,1078039.41
1981-08-24,125.5,-3.73,-2.89,140.52,-10.69,True,1,13437,-125.5,-658420.37,1686343.5,1027923.13
1981-08-25,125.13,-0.37,-0.3,140.52,-10.95,True,1,13438,-125.13,-658545.5,1681496.94,1022951.44
1981-08-26,124.96,-0.17,-0.14,140.52,-11.07,True,1,13439,-124.96,-658670.46,1679337.44,1020666.98
1981-08-27,123.51,-1.45,-1.16,140.52,-12.1,True,1,13440,-123.51,-658793.97,1659974.4,1001180.43
1981-08-28,124.08,0.57,0.46,140.52,-11.7,True,1,13441,-124.08,-658918.05,1667759.28,1008841.23
1981-08-31,122.79,-1.29,-1.04,140.52,-12.62,True,1,13442,-122.79,-659040.84,1650543.18,991502.34
1981-09-01,123.02,0.23,0.19,140.52,-12.45,True,1,13443,-123.02,-659163.86,1653757.86,994594.0
1981-09-02,123.49,0.47,0.38,140.52,-12.12,True,1,13444,-123.49,-659287.35,1660199.56,1000912.21
1981-09-03,121.24,-2.25,-1.82,140.52,-13.72,True,1,13445,-121.24,-659408.59,1630071.8,970663.21
1981-09-04,120.07,-1.17,-0.96,140.52,-14.55,True,1,13446,-120.07,-659528.66,1614461.22,954932.56
1981-09-08,117.98,-2.09,-1.74,140.52,-16.04,True,1,13447,-117.98,-659646.64,1586477.06,926830.42
1981-09-09,118.4,0.42,0.36,140.52,-15.74,True,1,13448,-118.4,-659765.04,1592243.2,932478.16
1981-09-10,120.14,1.74,1.47,140.52,-14.5,True,1,13449,-120.14,-659885.18,1615762.86,955877.68
1981-09-11,121.61,1.47,1.22,140.52,-13.46,True,1,13450,-121.61,-660006.79,1635654.5,975647.71
1981-09-14,120.66,-0.95,-0.78,140.52,-14.13,True,1,13451,-120.66,-660127.45,1622997.66,962870.21
1981-09-15,119.77,-0.89,-0.74,140.52,-14.77,True,1,13452,-119.77,-660247.22,1611146.04,950898.82
1981-09-16,118.87,-0.9,-0.75,140.52,-15.41,True,1,13453,-118.87,-660366.09,1599158.11,938792.02
1981-09-17,117.15,-1.72,-1.45,140.52,-16.63,True,1,13454,-117.15,-660483.24,1576136.1,915652.86
1981-09-18,116.26,-0.89,-0.76,140.52,-17.26,True,1,13455,-116.26,-660599.5,1564278.3,903678.8
1981-09-21,117.24,0.98,0.84,140.52,-16.57,True,1,13456,-117.24,-660716.74,1577581.44,916864.7
1981-09-22,116.68,-0.56,-0.48,140.52,-16.97,True,1,13457,-116.68,-660833.42,1570162.76,909329.34
1981-09-23,115.65,-1.03,-0.88,140.52,-17.7,True,1,13458,-115.65,-660949.07,1556417.7,895468.63
1981-09-24,115.01,-0.64,-0.55,140.52,-18.15,True,1,13459,-115.01,-661064.08,1547919.59,886855.51
1981-09-25,112.77,-2.24,-1.95,140.52,-19.75,True,1,13460,-112.77,-661176.85,1517884.2,856707.35
1981-09-28,115.53,2.76,2.45,140.52,-17.78,True,1,13461,-115.53,-661292.38,1555149.33,893856.95
1981-09-29,115.94,0.41,0.36,140.52,-17.49,True,1,13462,-115.94,-661408.32,1560784.28,899375.96
1981-09-30,116.18,0.24,0.21,140.52,-17.32,True,1,13463,-116.18,-661524.5,1564131.34,902606.84
1981-10-01,117.08,0.9,0.78,140.52,-16.68,True,1,13464,-117.08,-661641.58,1576365.12,914723.54
1981-10-02,119.36,2.28,1.95,140.52,-15.06,True,1,13465,-119.36,-661760.94,1607182.4,945421.46
1981-10-05,119.51,0.15,0.13,140.52,-14.95,True,1,13466,-119.51,-661880.45,1609321.66,947441.21
1981-10-06,119.39,-0.12,-0.1,140.52,-15.04,True,1,13467,-119.39,-661999.84,1607825.13,945825.29
1981-10-07,121.31,1.92,1.61,140.52,-13.67,True,1,13468,-121.31,-662121.15,1633803.08,971681.93
1981-10-08,122.31,1.0,0.82,140.52,-12.96,True,1,13469,-122.31,-662243.46,1647393.39,985149.93
1981-10-09,121.45,-0.86,-0.7,140.52,-13.57,True,1,13470,-121.45,-662364.91,1635931.5,973566.59
1981-10-12,121.21,-0.24,-0.2,140.52,-13.74,True,1,13471,-121.21,-662486.12,1632819.91,970333.79
1981-10-13,120.78,-0.43,-0.36,140.52,-14.05,True,1,13472,-120.78,-662606.9,1627148.16,964541.26
1981-10-14,118.8,-1.98,-1.64,140.52,-15.46,True,1,13473,-118.8,-662725.7,1600592.4,937866.7
1981-10-15,119.71,0.91,0.77,140.52,-14.81,True,1,13474,-119.71,-662845.41,1612972.54,950127.13
1981-10-16,119.19,-0.52,-0.43,140.52,-15.18,True,1,13475,-119.19,-662964.6,1606085.25,943120.65
1981-10-19,118.98,-0.21,-0.18,140.52,-15.33,True,1,13476,-118.98,-663083.58,1603374.48,940290.9
1981-10-20,120.28,1.3,1.09,140.52,-14.4,True,1,13477,-120.28,-663203.86,1621013.56,957809.7
1981-10-21,120.1,-0.18,-0.15,140.52,-14.53,True,1,13478,-120.1,-663323.96,1618707.8,955383.84
1981-10-22,119.64,-0.46,-0.38,140.52,-14.86,True,1,13479,-119.64,-663443.6,1612627.56,949183.96
1981-10-23,118.6,-1.04,-0.87,140.52,-15.6,True,1,13480,-118.6,-663562.2,1598728.0,935165.8
1981-10-26,118.16,-0.44,-0.37,140.52,-15.91,True,1,13481,-118.16,-663680.36,1592914.96,929234.6
1981-10-27,119.29,1.13,0.96,140.52,-15.11,True,1,13482,-119.29,-663799.65,1608267.78,944468.13
1981-10-28,119.45,0.16,0.13,140.52,-14.99,True,1,13483,-119.45,-663919.1,1610544.35,946625.25
1981-10-29,119.06,-0.39,-0.33,140.52,-15.27,True,1,13484,-119.06,-664038.16,1605405.04,941366.88
1981-10-30,121.89,2.83,2.38,140.52,-13.26,True,1,13485,-121.89,-664160.05,1643686.65,979526.6
1981-11-02,124.2,2.31,1.9,140.52,-11.61,True,1,13486,-124.2,-664284.25,1674961.2,1010676.95
1981-11-03,124.8,0.6,0.48,140.52,-11.19,True,1,13487,-124.8,-664409.05,1683177.6,1018768.55
1981-11-04,124.74,-0.06,-0.05,140.52,-11.23,True,1,13488,-124.74,-664533.79,1682493.12,1017959.33
1981-11-05,123.54,-1.2,-0.96,140.52,-12.08,True,1,13489,-123.54,-664657.33,1666431.06,1001773.73
1981-11-06,122.67,-0.87,-0.7,140.52,-12.7,True,1,13490,-122.67,-664780.0,1654818.3,990038.3
1981-11-09,123.29,0.62,0.5,140.52,-12.26,True,1,13491,-123.29,-664903.29,1663305.39,998402.1
1981-11-10,122.7,-0.59,-0.48,140.52,-12.68,True,1,13492,-122.7,-665025.99,1655468.4,990442.41
1981-11-11,122.92,0.22,0.18,140.52,-12.52,True,1,13493,-122.92,-665148.91,1658559.56,993410.65
1981-11-12,123.19,0.27,0.22,140.52,-12.33,True,1,13494,-123.19,-665272.1,1662325.86,997053.76
1981-11-13,121.67,-1.52,-1.23,140.52,-13.41,True,1,13495,-121.67,-665393.77,1641936.65,976542.88
1981-11-16,120.24,-1.43,-1.18,140.52,-14.43,True,1,13496,-120.24,-665514.01,1622759.04,957245.03
1981-11-17,121.15,0.91,0.76,140.52,-13.78,True,1,13497,-121.15,-665635.16,1635161.55,969526.39
1981-11-18,120.26,-0.89,-0.74,140.52,-14.42,True,1,13498,-120.26,-665755.42,1623269.48,957514.06
1981-11-19,120.71,0.45,0.37,140.52,-14.1,True,1,13499,-120.71,-665876.13,1629464.29,963588.16
1981-11-20,121.71,1.0,0.83,140.52,-13.39,True,1,13500,-121.71,-665997.84,1643085.0,977087.16
1981-11-23,121.6,-0.11,-0.09,140.52,-13.46,True,1,13501,-121.6,-666119.44,1641721.6,975602.16
1981-11-24,123.51,1.91,1.57,140.52,-12.1,True,1,13502,-123.51,-666242.95,1667632.02,1001389.07
1981-11-25,124.05,0.54,0.44,140.52,-11.72,True,1,13503,-124.05,-666367.0,1675047.15,1008680.15
1981-11-27,125.09,1.04,0.84,140.52,-10.98,True,1,13504,-125.09,-666492.09,1689215.36,1022723.27
1981-11-30,126.35,1.26,1.01,140.52,-10.08,True,1,13505,-126.35,-666618.44,1706356.75,1039738.31
1981-12-01,126.1,-0.25,-0.2,140.52,-10.26,True,1,13506,-126.1,-666744.54,1703106.6,1036362.06
1981-12-02,124.69,-1.41,-1.12,140.52,-11.26,True,1,13507,-124.69,-666869.23,1684187.83,1017318.6
1981-12-03,125.12,0.43,0.34,140.52,-10.96,True,1,13508,-125.12,-666994.35,1690120.96,1023126.61
1981-12-04,126.26,1.14,0.91,140.52,-10.15,True,1,13509,-126.26,-667120.61,1705646.34,1038525.73
1981-12-07,125.19,-1.07,-0.85,140.52,-10.91,True,1,13510,-125.19,-667245.8,1691316.9,1024071.1
1981-12-08,124.82,-0.37,-0.3,140.52,-11.17,True,1,13511,-124.82,-667370.62,1686443.02,1019072.4
1981-12-09,125.48,0.66,0.53,140.52,-10.7,True,1,13512,-125.48,-667496.1,1695485.76,1027989.66
1981-12-10,125.71,0.23,0.18,140.52,-10.54,True,1,13513,-125.71,-667621.81,1698719.23,1031097.42
1981-12-11,124.93,-0.78,-0.62,140.52,-11.1,True,1,13514,-124.93,-667746.74,1688304.02,1020557.28
1981-12-14,122.78,-2.15,-1.72,140.52,-12.62,True,1,13515,-122.78,-667869.52,1659371.7,991502.18
1981-12-15,122.99,0.21,0.17,140.52,-12.48,True,1,13516,-122.99,-667992.51,1662332.84,994340.33
1981-12-16,122.42,-0.57,-0.46,140.52,-12.88,True,1,13517,-122.42,-668114.93,1654751.14,986636.21
1981-12-17,123.12,0.7,0.57,140.52,-12.38,True,1,13518,-123.12,-668238.05,1664336.16,996098.11
1981-12-18,124.0,0.88,0.72,140.52,-11.76,True,1,13519,-124.0,-668362.05,1676356.0,1007993.95
1981-12-21,123.34,-0.66,-0.53,140.52,-12.23,True,1,13520,-123.34,-668485.39,1667556.8,999071.41
1981-12-22,122.88,-0.46,-0.37,140.52,-12.55,True,1,13521,-122.88,-668608.27,1661460.48,992852.21
1981-12-23,122.31,-0.57,-0.46,140.52,-12.96,True,1,13522,-122.31,-668730.58,1653875.82,985145.24
1981-12-24,122.54,0.23,0.19,140.52,-12.8,True,1,13523,-122.54,-668853.12,1657108.42,988255.3
1981-12-28,122.27,-0.27,-0.22,140.52,-12.99,True,1,13524,-122.27,-668975.39,1653579.48,984604.09
1981-12-29,121.67,-0.6,-0.49,140.52,-13.41,True,1,13525,-121.67,-669097.06,1645586.75,976489.69
1981-12-30,122.3,0.63,0.52,140.52,-12.97,True,1,13526,-122.3,-669219.36,1654229.8,985010.44
1981-12-31,122.55,0.25,0.2,140.52,-12.79,True,1,13527,-122.55,-669341.91,1657733.85,988391.94
1982-01-04,122.74,0.19,0.16,140.52,-12.65,True,1,13528,-122.74,-669464.65,1660426.72,990962.07
1982-01-05,120.05,-2.69,-2.19,140.52,-14.57,True,1,13529,-120.05,-669584.7,1624156.45,954571.75
1982-01-06,119.18,-0.87,-0.72,140.52,-15.19,True,1,13530,-119.18,-669703.88,1612505.4,942801.52
1982-01-07,118.93,-0.25,-0.21,140.52,-15.36,True,1,13531,-118.93,-669822.81,1609241.83,939419.02
1982-01-08,119.55,0.62,0.52,140.52,-14.92,True,1,13532,-119.55,-669942.36,1617750.6,947808.24
1982-01-11,116.78,-2.77,-2.32,140.52,-16.89,True,1,13533,-116.78,-670059.14,1580383.74,910324.6
1982-01-12,116.3,-0.48,-0.41,140.52,-17.24,True,1,13534,-116.3,-670175.44,1574004.2,903828.76
1982-01-13,114.88,-1.42,-1.22,140.52,-18.25,True,1,13535,-114.88,-670290.32,1554900.8,884610.48
1982-01-14,115.54,0.66,0.57,140.52,-17.78,True,1,13536,-115.54,-670405.86,1563949.44,893543.58
1982-01-15,116.33,0.79,0.68,140.52,-17.22,True,1,13537,-116.33,-670522.19,1574759.21,904237.02
1982-01-18,117.22,0.89,0.76,140.52,-16.58,True,1,13538,-117.22,-670639.41,1586924.36,916284.95
1982-01-19,115.97,-1.25,-1.07,140.52,-17.47,True,1,13539,-115.97,-670755.38,1570117.83,899362.45
1982-01-20,115.27,-0.7,-0.6,140.52,-17.97,True,1,13540,-115.27,-670870.65,1560755.8,889885.15
1982-01-21,115.75,0.48,0.42,140.52,-17.63,True,1,13541,-115.75,-670986.4,1567370.75,896384.35
1982-01-22,115.38,-0.37,-0.32,140.52,-17.89,True,1,13542,-115.38,-671101.78,1562475.96,891374.18
1982-01-25,115.41,0.03,0.03,140.52,-17.87,True,1,13543,-115.41,-671217.19,1562997.63,891780.44
1982-01-26,115.19,-0.22,-0.19,140.52,-18.03,True,1,13544,-115.19,-671332.38,1560133.36,888800.98
1982-01-27,115.74,0.55,0.48,140.52,-17.64,True,1,13545,-115.74,-671448.12,1567698.3,896250.18
1982-01-28,118.92,3.18,2.75,140.52,-15.37,True,1,13546,-118.92,-671567.04,1610890.32,939323.28
1982-01-29,120.4,1.48,1.25,140.52,-14.32,True,1,13547,-120.4,-671687.44,1631058.8,959371.36
1982-02-01,117.78,-2.62,-2.18,140.52,-16.18,True,1,13548,-117.78,-671805.22,1595683.44,923878.22
1982-02-02,118.01,0.23,0.2,140.52,-16.02,True,1,13549,-118.01,-671923.23,1598917.49,926994.26
1982-02-03,116.48,-1.53,-1.3,140.52,-17.11,True,1,13550,-116.48,-672039.71,1578304.0,906264.29
1982-02-04,116.42,-0.06,-0.05,140.52,-17.15,True,1,13551,-116.42,-672156.13,1577607.42,905451.29
1982-02-05,117.26,0.84,0.72,140.52,-16.55,True,1,13552,-117.26,-672273.39,1589107.52,916834.13
1982-02-08,114.63,-2.63,-2.24,140.52,-18.42,True,1,13553,-114.63,-672388.02,1553580.39,881192.37
1982-02-09,113.68,-0.95,-0.83,140.52,-19.1,True,1,13554,-113.68,-672501.7,1540818.72,868317.02
1982-02-10,114.66,0.98,0.86,140.52,-18.4,True,1,13555,-114.66,-672616.36,1554216.3,881599.94
1982-02-11,114.43,-0.23,-0.2,140.52,-18.57,True,1,13556,-114.43,-672730.79,1551213.08,878482.29
1982-02-12,114.38,-0.05,-0.04,140.52,-18.6,True,1,13557,-114.38,-672845.17,1550649.66,877804.49
1982-02-16,114.06,-0.32,-0.28,140.52,-18.83,True,1,13558,-114.06,-672959.23,1546425.48,873466.25
1982-02-17,113.69,-0.37,-0.32,140.52,-19.09,True,1,13559,-113.69,-673072.92,1541522.71,868449.79
1982-02-18,113.82,0.13,0.11,140.52,-19.0,True,1,13560,-113.82,-673186.74,1543399.2,870212.46
1982-02-19,113.22,-0.6,-0.53,140.52,-19.43,True,1,13561,-113.22,-673299.96,1535376.42,862076.46
1982-02-22,111.59,-1.63,-1.44,140.52,-20.59,True,1,13562,-111.59,-673411.55,1513383.58,839972.03
1982-02-23,111.51,-0.08,-0.07,140.52,-20.64,True,1,13563,-111.51,-673523.06,1512410.13,838887.07
1982-02-24,113.47,1.96,1.76,140.52,-19.25,True,1,13564,-113.47,-673636.53,1539107.08,865470.55
1982-02-25,113.21,-0.26,-0.23,140.52,-19.43,True,1,13565,-113.21,-673749.74,1535693.65,861943.91
1982-02-26,113.11,-0.1,-0.09,140.52,-19.51,True,1,13566,-113.11,-673862.85,1534450.26,860587.41
1982-03-01,113.31,0.2,0.18,140.52,-19.36,True,1,13567,-113.31,-673976.16,1537276.77,863300.61
1982-03-02,112.68,-0.63,-0.56,140.52,-19.81,True,1,13568,-112.68,-674088.84,1528842.24,854753.4
1982-03-03,110.92,-1.76,-1.56,140.52,-21.06,True,1,13569,-110.92,-674199.76,1505073.48,830873.72
1982-03-04,109.88,-1.04,-0.94,140.52,-21.8,True,1,13570,-109.88,-674309.64,1491071.6,816761.96
1982-03-05,109.34,-0.54,-0.49,140.52,-22.19,True,1,13571,-109.34,-674418.98,1483853.14,809434.16
1982-03-08,107.34,-2.0,-1.83,140.52,-23.61,True,1,13572,-107.34,-674526.32,1456818.48,782292.16
1982-03-09,108.83,1.49,1.39,140.52,-22.55,True,1,13573,-108.83,-674635.15,1477149.59,802514.44
1982-03-10,109.41,0.58,0.53,140.52,-22.14,True,1,13574,-109.41,-674744.56,1485131.34,810386.78
1982-03-11,109.36,-0.05,-0.05,140.52,-22.18,True,1,13575,-109.36,-674853.92,1484562.0,809708.08
1982-03-12,108.61,-0.75,-0.69,140.52,-22.71,True,1,13576,-108.61,-674962.53,1474489.36,799526.83
1982-03-15,109.45,0.84,0.77,140.52,-22.11,True,1,13577,-109.45,-675071.98,1486002.65,810930.67
1982-03-16,109.28,-0.17,-0.16,140.52,-22.23,True,1,13578,-109.28,-675181.26,1483803.84,808622.58
1982-03-17,109.08,-0.2,-0.18,140.52,-22.37,True,1,13579,-109.08,-675290.34,1481197.32,805906.98
1982-03-18,110.3,1.22,1.12,140.52,-21.51,True,1,13580,-110.3,-675400.64,1497874.0,822473.36
1982-03-19,110.61,0.31,0.28,140.52,-21.28,True,1,13581,-110.61,-675511.25,1502194.41,826683.16
1982-03-22,112.77,2.16,1.95,140.52,-19.75,True,1,13582,-112.77,-675624.02,1531642.14,856018.12
1982-03-23,113.55,0.78,0.69,140.52,-19.19,True,1,13583,-113.55,-675737.57,1542349.65,866612.08
1982-03-24,112.97,-0.58,-0.51,140.52,-19.61,True,1,13584,-112.97,-675850.54,1534584.48,858733.94
1982-03-25,113.21,0.24,0.21,140.52,-19.43,True,1,13585,-113.21,-675963.75,1537957.85,861994.1
1982-03-26,111.94,-1.27,-1.12,140.52,-20.34,True,1,13586,-111.94,-676075.69,1520816.84,844741.15
1982-03-29,112.3,0.36,0.32,140.52,-20.08,True,1,13587,-112.3,-676187.99,1525820.1,849632.11
1982-03-30,112.27,-0.03,-0.03,140.52,-20.1,True,1,13588,-112.27,-676300.26,1525524.76,849224.5
1982-03-31,111.96,-0.31,-0.28,140.52,-20.32,True,1,13589,-111.96,-676412.22,1521424.44,845012.22
1982-04-01,113.79,1.83,1.64,140.52,-19.02,True,1,13590,-113.79,-676526.01,1546406.1,869880.09
1982-04-02,115.12,1.33,1.17,140.52,-18.08,True,1,13591,-115.12,-676641.13,1564595.92,887954.79
1982-04-05,114.73,-0.39,-0.34,140.52,-18.35,True,1,13592,-114.73,-676755.86,1559410.16,882654.3
1982-04-06,115.36,0.63,0.55,140.52,-17.9,True,1,13593,-115.36,-676871.22,1568088.48,891217.26
1982-04-07,115.46,0.1,0.09,140.52,-17.83,True,1,13594,-115.46,-676986.68,1569563.24,892576.56
1982-04-08,116.22,0.76,0.66,140.52,-17.29,True,1,13595,-116.22,-677102.9,1580010.9,902908.0
1982-04-12,116.0,-0.22,-0.19,140.52,-17.45,True,1,13596,-116.0,-677218.9,1577136.0,899917.1
1982-04-13,115.99,-0.01,-0.01,140.52,-17.46,True,1,13597,-115.99,-677334.89,1577116.03,899781.14
1982-04-14,115.83,-0.16,-0.14,140.52,-17.57,True,1,13598,-115.83,-677450.72,1575056.34,897605.62
1982-04-15,116.35,0.52,0.45,140.52,-17.2,True,1,13599,-116.35,-677567.07,1582243.65,904676.58
1982-04-16,116.81,0.46,0.4,140.52,-16.87,True,1,13600,-116.81,-677683.88,1588616.0,910932.12
1982-04-19,116.7,-0.11,-0.09,140.52,-16.95,True,1,13601,-116.7,-677800.58,1587236.7,909436.12
1982-04-20,115.44,-1.26,-1.08,140.52,-17.85,True,1,13602,-115.44,-677916.02,1570214.88,892298.86
1982-04-21,115.72,0.28,0.24,140.52,-17.65,True,1,13603,-115.72,-678031.74,1574139.16,896107.42
1982-04-22,117.19,1.47,1.27,140.52,-16.6,True,1,13604,-117.19,-678148.93,1594252.76,916103.83
1982-04-23,118.64,1.45,1.24,140.52,-15.57,True,1,13605,-118.64,-678267.57,1614097.2,935829.63
1982-04-26,119.26,0.62,0.52,140.52,-15.13,True,1,13606,-119.26,-678386.83,1622651.56,944264.73
1982-04-27,118.0,-1.26,-1.06,140.52,-16.03,True,1,13607,-118.0,-678504.83,1605626.0,927121.17
1982-04-28,117.26,-0.74,-0.63,140.52,-16.55,True,1,13608,-117.26,-678622.09,1595674.08,917051.99
1982-04-29,116.14,-1.12,-0.96,140.52,-17.35,True,1,13609,-116.14,-678738.23,1580549.26,901811.03
1982-04-30,116.44,0.3,0.26,140.52,-17.14,True,1,13610,-116.44,-678854.67,1584748.4,905893.73
1982-05-03,116.82,0.38,0.33,140.52,-16.87,True,1,13611,-116.82,-678971.49,1590037.02,911065.53
1982-05-04,117.46,0.64,0.55,140.52,-16.41,True,1,13612,-117.46,-679088.95,1598865.52,919776.57
1982-05-05,117.67,0.21,0.18,140.52,-16.26,True,1,13613,-117.67,-679206.62,1601841.71,922635.09
1982-05-06,118.68,1.01,0.86,140.52,-15.54,True,1,13614,-118.68,-679325.3,1615709.52,936384.22
1982-05-07,119.47,0.79,0.67,140.52,-14.98,True,1,13615,-119.47,-679444.77,1626584.05,947139.28
1982-05-10,118.38,-1.09,-0.91,140.52,-15.76,True,1,13616,-118.38,-679563.15,1611862.08,932298.93
1982-05-11,119.42,1.04,0.88,140.52,-15.02,True,1,13617,-119.42,-679682.57,1626142.14,946459.57
1982-05-12,119.17,-0.25,-0.21,140.52,-15.19,True,1,13618,-119.17,-679801.74,1622857.06,943055.32
1982-05-13,118.22,-0.95,-0.8,140.52,-15.87,True,1,13619,-118.22,-679919.96,1610038.18,930118.22
1982-05-14,118.01,-0.21,-0.18,140.52,-16.02,True,1,13620,-118.01,-680037.97,1607296.2,927258.23
1982-05-17,116.71,-1.3,-1.1,140.52,-16.94,True,1,13621,-116.71,-680154.68,1589706.91,909552.23
1982-05-18,115.84,-0.87,-0.74,140.52,-17.56,True,1,13622,-115.84,-680270.52,1577972.48,897701.96
1982-05-19,114.89,-0.95,-0.82,140.52,-18.24,True,1,13623,-114.89,-680385.41,1565146.47,884761.06
1982-05-20,114.59,-0.3,-0.26,140.52,-18.45,True,1,13624,-114.59,-680500.0,1561174.16,880674.16
1982-05-21,114.89,0.3,0.26,140.52,-18.24,True,1,13625,-114.89,-680614.89,1565376.25,884761.36
1982-05-24,114.79,-0.1,-0.09,140.52,-18.31,True,1,13626,-114.79,-680729.68,1564128.54,883398.86
1982-05-25,114.4,-0.39,-0.34,140.52,-18.59,True,1,13627,-114.4,-680844.08,1558928.8,878084.72
1982-05-26,113.11,-1.29,-1.13,140.52,-19.51,True,1,13628,-113.11,-680957.19,1541463.08,860505.89
1982-05-27,112.66,-0.45,-0.4,140.52,-19.83,True,1,13629,-112.66,-681069.85,1535443.14,854373.29
1982-05-28,111.88,-0.78,-0.69,140.52,-20.38,True,1,13630,-111.88,-681181.73,1524924.4,843742.67
1982-06-01,111.68,-0.2,-0.18,140.52,-20.52,True,1,13631,-111.68,-681293.41,1522310.08,841016.67
1982-06-02,112.04,0.36,0.32,140.52,-20.27,True,1,13632,-112.04,-681405.45,1527329.28,845923.83
1982-06-03,111.86,-0.18,-0.16,140.52,-20.4,True,1,13633,-111.86,-681517.31,1524987.38,843470.07
1982-06-04,110.09,-1.77,-1.58,140.52,-21.66,True,1,13634,-110.09,-681627.4,1500967.06,819339.66
1982-06-07,110.12,0.03,0.03,140.52,-21.63,True,1,13635,-110.12,-681737.52,1501486.2,819748.68
1982-06-08,109.63,-0.49,-0.44,140.52,-21.98,True,1,13636,-109.63,-681847.15,1494914.68,813067.53
1982-06-09,108.99,-0.64,-0.58,140.52,-22.44,True,1,13637,-108.99,-681956.14,1486296.63,804340.49
1982-06-10,109.61,0.62,0.57,140.52,-22.0,True,1,13638,-109.61,-682065.75,1494861.18,812795.43
1982-06-11,111.24,1.63,1.49,140.52,-20.84,True,1,13639,-111.24,-682176.99,1517202.36,835025.37
1982-06-14,109.96,-1.28,-1.15,140.52,-21.75,True,1,13640,-109.96,-682286.95,1499854.4,817567.45
1982-06-15,109.69,-0.27,-0.25,140.52,-21.94,True,1,13641,-109.69,-682396.64,1496281.29,813884.65
1982-06-16,108.87,-0.82,-0.75,140.52,-22.52,True,1,13642,-108.87,-682505.51,1485204.54,802699.03
1982-06-17,107.6,-1.27,-1.17,140.52,-23.43,True,1,13643,-107.6,-682613.11,1467986.8,785373.69
1982-06-18,107.28,-0.32,-0.3,140.52,-23.66,True,1,13644,-107.28,-682720.39,1463728.32,781007.93
1982-06-21,107.2,-0.08,-0.08,140.52,-23.71,True,1,13645,-107.2,-682827.59,1462744.0,779916.41
1982-06-22,108.3,1.1,1.03,140.52,-22.93,True,1,13646,-108.3,-682935.89,1477861.8,794925.91
1982-06-23,110.14,1.84,1.7,140.52,-21.62,True,1,13647,-110.14,-683046.03,1503080.58,820034.55
1982-06-24,109.83,-0.31,-0.28,140.52,-21.84,True,1,13648,-109.83,-683155.86,1498959.84,815803.98
1982-06-25,109.14,-0.69,-0.63,140.52,-22.33,True,1,13649,-109.14,-683265.0,1489651.86,806386.86
1982-06-28,110.26,1.12,1.03,140.52,-21.53,True,1,13650,-110.26,-683375.26,1505049.0,821673.74
1982-06-29,110.21,-0.05,-0.04,140.52,-21.57,True,1,13651,-110.21,-683485.47,1504476.71,820991.24
1982-06-30,109.61,-0.6,-0.54,140.52,-22.0,True,1,13652,-109.61,-683595.08,1496395.72,812800.64
1982-07-01,108.71,-0.9,-0.82,140.52,-22.64,True,1,13653,-108.71,-683703.79,1484217.63,800513.84
1982-07-02,107.65,-1.06,-0.98,140.52,-23.39,True,1,13654,-107.65,-683811.44,1469853.1,786041.66
1982-07-06,107.29,-0.36,-0.33,140.52,-23.65,True,1,13655,-107.29,-683918.73,1465044.95,781126.22
1982-07-07,107.22,-0.07,-0.06,140.52,-23.7,True,1,13656,-107.22,-684025.95,1464196.32,780170.37
1982-07-08,107.53,0.31,0.29,140.52,-23.48,True,1,13657,-107.53,-684133.48,1468537.21,784403.73
1982-07-09,108.83,1.3,1.21,140.52,-22.55,True,1,13658,-108.83,-684242.31,1486400.14,802157.83
1982-07-12,109.57,0.74,0.68,140.52,-22.02,True,1,13659,-109.57,-684351.88,1496616.63,812264.75
1982-07-13,109.45,-0.12,-0.11,140.52,-22.11,True,1,13660,-109.45,-684461.33,1495087.0,810625.67
1982-07-14,110.44,0.99,0.9,140.52,-21.41,True,1,13661,-110.44,-684571.77,1508720.84,824149.07
1982-07-15,110.47,0.03,0.03,140.52,-21.38,True,1,13662,-110.47,-684682.24,1509241.14,824558.9
1982-07-16,111.07,0.6,0.54,140.52,-20.96,True,1,13663,-111.07,-684793.31,1517549.41,832756.1
1982-07-19,110.73,-0.34,-0.31,140.52,-21.2,True,1,13664,-110.73,-684904.04,1513014.72,828110.68
1982-07-20,111.54,0.81,0.73,140.52,-20.62,True,1,13665,-111.54,-685015.58,1524194.1,839178.52
1982-07-21,111.42,-0.12,-0.11,140.52,-20.71,True,1,13666,-111.42,-685127.0,1522665.72,837538.72
1982-07-22,111.48,0.06,0.05,140.52,-20.67,True,1,13667,-111.48,-685238.48,1523597.16,838358.68
1982-07-23,111.17,-0.31,-0.28,140.52,-20.89,True,1,13668,-111.17,-685349.65,1519471.56,834121.91
1982-07-26,110.36,-0.81,-0.73,140.52,-21.46,True,1,13669,-110.36,-685460.01,1508510.84,823050.83
1982-07-27,109.43,-0.93,-0.84,140.52,-22.12,True,1,13670,-109.43,-685569.44,1495908.1,810338.66
1982-07-28,107.74,-1.69,-1.54,140.52,-23.33,True,1,13671,-107.74,-685677.18,1472913.54,787236.36
1982-07-29,107.72,-0.02,-0.02,140.52,-23.34,True,1,13672,-107.72,-685784.9,1472747.84,786962.94
1982-07-30,107.09,-0.63,-0.58,140.52,-23.79,True,1,13673,-107.09,-685891.99,1464241.57,778349.58
1982-08-02,108.98,1.89,1.76,140.52,-22.44,True,1,13674,-108.98,-686000.97,1490192.52,804191.55
1982-08-03,107.83,-1.15,-1.06,140.52,-23.26,True,1,13675,-107.83,-686108.8,1474575.25,788466.45
1982-08-04,106.14,-1.69,-1.57,140.52,-24.47,True,1,13676,-106.14,-686214.94,1451570.64,765355.7
1982-08-05,105.16,-0.98,-0.92,140.52,-25.16,True,1,13677,-105.16,-686320.1,1438273.32,751953.22
1982-08-06,103.71,-1.45,-1.38,140.52,-26.2,True,1,13678,-103.71,-686423.81,1418545.38,732121.57
1982-08-09,103.08,-0.63,-0.61,140.52,-26.64,True,1,13679,-103.08,-686526.89,1410031.32,723504.43
1982-08-10,102.84,-0.24,-0.23,140.52,-26.82,True,1,13680,-102.84,-686629.73,1406851.2,720221.47
1982-08-11,102.6,-0.24,-0.23,140.52,-26.98,True,1,13681,-102.6,-686732.33,1403670.6,716938.27
1982-08-12,102.42,-0.18,-0.18,140.52,-27.11,True,1,13682,-102.42,-686834.75,1401310.44,714475.69
1982-08-13,103.85,1.43,1.4,140.52,-26.1,True,1,13683,-103.85,-686938.6,1420979.55,734040.95
1982-08-16,104.09,0.24,0.23,140.52,-25.92,True,1,13684,-104.09,-687042.69,1424367.56,737324.87
1982-08-17,109.04,4.95,4.76,140.52,-22.4,True,1,13685,-109.04,-687151.73,1492212.4,805060.67
1982-08-18,108.54,-0.5,-0.46,140.52,-22.76,True,1,13686,-108.54,-687260.27,1485478.44,798218.17
1982-08-19,109.16,0.62,0.57,140.52,-22.32,True,1,13687,-109.16,-687369.43,1494072.92,806703.49
1982-08-20,113.02,3.86,3.54,140.52,-19.57,True,1,13688,-113.02,-687482.45,1547017.76,859535.31
1982-08-23,116.11,3.09,2.73,140.52,-17.37,True,1,13689,-116.11,-687598.56,1589429.79,901831.23
1982-08-24,115.35,-0.76,-0.66,140.52,-17.91,True,1,13690,-115.35,-687713.91,1579141.5,891427.59
1982-08-25,117.58,2.23,1.93,140.52,-16.32,True,1,13691,-117.58,-687831.49,1609787.78,921956.29
1982-08-26,118.55,0.97,0.82,140.52,-15.64,True,1,13692,-118.55,-687950.04,1623186.6,935236.56
1982-08-27,117.11,-1.44,-1.22,140.52,-16.66,True,1,13693,-117.11,-688067.15,1603587.23,915520.08
1982-08-30,117.66,0.55,0.47,140.52,-16.27,True,1,13694,-117.66,-688184.81,1611236.04,923051.23
1982-08-31,119.51,1.85,1.57,140.52,-14.95,True,1,13695,-119.51,-688304.32,1636689.45,948385.13
1982-09-01,118.25,-1.26,-1.05,140.52,-15.85,True,1,13696,-118.25,-688422.57,1619552.0,931129.43
1982-09-02,120.29,2.04,1.72,140.52,-14.4,True,1,13697,-120.29,-688542.86,1647612.13,959069.27
1982-09-03,122.68,2.39,1.99,140.52,-12.7,True,1,13698,-122.68,-688665.54,1680470.64,991805.1
1982-09-07,121.37,-1.31,-1.07,140.52,-13.63,True,1,13699,-121.37,-688786.91,1662647.63,973860.72
1982-09-08,122.2,0.83,0.68,140.52,-13.04,True,1,13700,-122.2,-688909.11,1674140.0,985230.89
1982-09-09,121.97,-0.23,-0.19,140.52,-13.2,True,1,13701,-121.97,-689031.08,1671110.97,982079.89
1982-09-10,120.97,-1.0,-0.82,140.52,-13.91,True,1,13702,-120.97,-689152.05,1657530.94,968378.89
1982-09-13,122.24,1.27,1.05,140.52,-13.01,True,1,13703,-122.24,-689274.29,1675054.72,985780.43
1982-09-14,123.1,0.86,0.7,140.52,-12.4,True,1,13704,-123.1,-689397.39,1686962.4,997565.01
1982-09-15,124.29,1.19,0.97,140.52,-11.55,True,1,13705,-124.29,-689521.68,1703394.45,1013872.77
1982-09-16,123.77,-0.52,-0.42,140.52,-11.92,True,1,13706,-123.77,-689645.45,1696391.62,1006746.17
1982-09-17,122.55,-1.22,-0.99,140.52,-12.79,True,1,13707,-122.55,-689768.0,1679792.85,990024.85
1982-09-20,122.51,-0.04,-0.03,140.52,-12.82,True,1,13708,-122.51,-689890.51,1679367.08,989476.57
1982-09-21,124.88,2.37,1.94,140.52,-11.13,True,1,13709,-124.88,-690015.39,1711979.92,1021964.53
1982-09-22,123.99,-0.89,-0.71,140.52,-11.76,True,1,13710,-123.99,-690139.38,1699902.9,1009763.52
1982-09-23,123.81,-0.18,-0.14,140.52,-11.89,True,1,13711,-123.81,-690263.19,1697558.91,1007295.72
1982-09-24,123.32,-0.49,-0.4,140.52,-12.24,True,1,13712,-123.32,-690386.51,1690963.84,1000577.33
1982-09-27,123.62,0.3,0.24,140.52,-12.03,True,1,13713,-123.62,-690510.13,1695201.06,1004690.93
1982-09-28,123.24,-0.38,-0.31,140.52,-12.3,True,1,13714,-123.24,-690633.37,1690113.36,999479.99
1982-09-29,121.63,-1.61,-1.31,140.52,-13.44,True,1,13715,-121.63,-690755.0,1668155.45,977400.45
1982-09-30,120.42,-1.21,-1.0,140.52,-14.3,True,1,13716,-120.42,-690875.42,1651680.72,960805.3
1982-10-01,121.97,1.55,1.29,140.52,-13.2,True,1,13717,-121.97,-690997.39,1673062.49,982065.1
1982-10-04,121.51,-0.46,-0.38,140.52,-13.53,True,1,13718,-121.51,-691118.9,1666874.18,975755.28
1982-10-05,121.98,0.47,0.39,140.52,-13.19,True,1,13719,-121.98,-691240.88,1673443.62,982202.74
1982-10-06,125.97,3.99,3.27,140.52,-10.35,True,1,13720,-125.97,-691366.85,1728308.4,1036941.55
1982-10-07,128.8,2.83,2.25,140.52,-8.34,True,1,13721,-128.8,-691495.65,1767264.8,1075769.15
1982-10-08,131.05,2.25,1.75,140.52,-6.74,True,1,13722,-131.05,-691626.7,1798268.1,1106641.4
1982-10-11,134.47,3.42,2.61,140.52,-4.3,True,1,13723,-134.47,-691761.17,1845331.81,1153570.64
1982-10-12,134.44,-0.03,-0.02,140.52,-4.33,True,1,13724,-134.44,-691895.61,1845054.56,1153158.95
1982-10-13,136.71,2.27,1.69,140.52,-2.71,True,1,13725,-136.71,-692032.32,1876344.75,1184312.43
1982-10-14,134.57,-2.14,-1.56,140.52,-4.23,True,1,13726,-134.57,-692166.89,1847107.82,1154940.93
1982-10-15,133.57,-1.0,-0.74,140.52,-4.95,True,1,13727,-133.57,-692300.46,1833515.39,1141214.93
1982-10-18,136.73,3.16,2.37,140.52,-2.7,True,1,13728,-136.73,-692437.19,1877029.44,1184592.25
1982-10-19,136.58,-0.15,-0.11,140.52,-2.8,True,1,13729,-136.58,-692573.77,1875106.82,1182533.05
1982-10-20,139.23,2.65,1.94,140.52,-0.92,True,1,13730,-139.23,-692713.0,1911627.9,1218914.9
1982-10-21,139.06,-0.17,-0.12,140.52,-1.04,True,1,13731,-139.06,-692852.06,1909432.86,1216580.8
1982-10-22,138.83,-0.23,-0.16,140.52,-1.2,True,1,13732,-138.83,-692990.89,1906413.56,1213422.67
1982-10-25,133.32,-5.51,-3.97,140.52,-5.12,True,1,13733,-133.32,-693124.21,1830883.56,1137759.35
1982-10-26,134.48,1.16,0.87,140.52,-4.3,True,1,13734,-134.48,-693258.69,1846948.32,1153689.63
1982-10-27,135.29,0.81,0.6,140.52,-3.72,True,1,13735,-135.29,-693393.98,1858208.15,1164814.17
1982-10-28,133.59,-1.7,-1.26,140.52,-4.93,True,1,13736,-133.59,-693527.57,1834992.24,1141464.67
1982-10-29,133.72,0.13,0.1,140.52,-4.84,True,1,13737,-133.72,-693661.29,1836911.64,1143250.35
1982-11-01,135.47,1.75,1.31,140.52,-3.59,True,1,13738,-135.47,-693796.76,1861086.86,1167290.1
1982-11-02,137.49,2.02,1.49,140.52,-2.16,True,1,13739,-137.49,-693934.25,1888975.11,1195040.86
1982-11-03,142.87,5.38,3.91,142.87,0.0,True,1,13740,-142.87,-694077.12,1963033.8,1268956.68
1982-11-04,141.85,-1.02,-0.71,142.87,-0.71,True,1,13741,-141.85,-694218.97,1949160.85,1254941.88
1982-11-05,142.16,0.31,0.22,142.87,-0.5,True,1,13742,-142.16,-694361.13,1953562.72,1259201.59
1982-11-08,140.44,-1.72,-1.21,142.87,-1.7,True,1,13743,-140.44,-694501.57,1930066.92,1235565.35
1982-11-09,143.02,2.58,1.84,143.02,0.0,True,1,13744,-143.02,-694644.59,1965666.88,1271022.29
1982-11-10,141.16,-1.86,-1.3,143.02,-1.3,True,1,13745,-141.16,-694785.75,1940244.2,1245458.45
1982-11-11,141.75,0.59,0.42,143.02,-0.89,True,1,13746,-141.75,-694927.5,1948495.5,1253568.0
1982-11-12,139.53,-2.22,-1.57,143.02,-2.44,True,1,13747,-139.53,-695067.03,1918118.91,1223051.88
1982-11-15,137.03,-2.5,-1.79,143.02,-4.19,True,1,13748,-137.03,-695204.06,1883888.44,1188684.38
1982-11-16,135.42,-1.61,-1.18,143.02,-5.31,True,1,13749,-135.42,-695339.48,1861889.58,1166550.1
1982-11-17,137.93,2.51,1.85,143.02,-3.56,True,1,13750,-137.93,-695477.41,1896537.5,1201060.09
1982-11-18,138.34,0.41,0.3,143.02,-3.27,True,1,13751,-138.34,-695615.75,1902313.34,1206697.59
1982-11-19,137.02,-1.32,-0.95,143.02,-4.2,True,1,13752,-137.02,-695752.77,1884299.04,1188546.27
1982-11-22,134.22,-2.8,-2.04,143.02,-6.15,True,1,13753,-134.22,-695886.99,1845927.66,1150040.67
1982-11-23,132.93,-1.29,-0.96,143.02,-7.06,True,1,13754,-132.93,-696019.92,1828319.22,1132299.3
1982-11-24,133.88,0.95,0.72,143.02,-6.39,True,1,13755,-133.88,-696153.8,1841519.4,1145365.6
1982-11-26,134.88,1.0,0.75,143.02,-5.69,True,1,13756,-134.88,-696288.68,1855409.28,1159120.6
1982-11-29,134.2,-0.68,-0.5,143.02,-6.17,True,1,13757,-134.2,-696422.88,1846189.4,1149766.52
1982-11-30,138.53,4.33,3.23,143.02,-3.14,True,1,13758,-138.53,-696561.41,1905895.74,1209334.33
1982-12-01,138.72,0.19,0.14,143.02,-3.01,True,1,13759,-138.72,-696700.13,1908648.48,1211948.35
1982-12-02,138.82,0.1,0.07,143.02,-2.94,True,1,13760,-138.82,-696838.95,1910163.2,1213324.25
1982-12-03,138.69,-0.13,-0.09,143.02,-3.03,True,1,13761,-138.69,-696977.64,1908513.09,1211535.45
1982-12-06,141.77,3.08,2.22,143.02,-0.87,True,1,13762,-141.77,-697119.41,1951038.74,1253919.33
1982-12-07,142.72,0.95,0.67,143.02,-0.21,True,1,13763,-142.72,-697262.13,1964255.36,1266993.23
1982-12-08,141.82,-0.9,-0.63,143.02,-0.84,True,1,13764,-141.82,-697403.95,1952010.48,1254606.53
1982-12-09,140.0,-1.82,-1.28,143.02,-2.11,True,1,13765,-140.0,-697543.95,1927100.0,1229556.05
1982-12-10,139.57,-0.43,-0.31,143.02,-2.41,True,1,13766,-139.57,-697683.52,1921320.62,1223637.1
1982-12-13,139.95,0.38,0.27,143.02,-2.15,True,1,13767,-139.95,-697823.47,1926691.65,1228868.18
1982-12-14,137.4,-2.55,-1.82,143.02,-3.93,True,1,13768,-137.4,-697960.87,1891723.2,1193762.33
1982-12-15,135.24,-2.16,-1.57,143.02,-5.44,True,1,13769,-135.24,-698096.11,1862119.56,1164023.45
1982-12-16,135.3,0.06,0.04,143.02,-5.4,True,1,13770,-135.3,-698231.41,1863081.0,1164849.59
1982-12-17,137.49,2.19,1.62,143.02,-3.87,True,1,13771,-137.49,-698368.9,1893374.79,1195005.89
1982-12-20,136.25,-1.24,-0.9,143.02,-4.73,True,1,13772,-136.25,-698505.15,1876435.0,1177929.85
1982-12-21,138.61,2.36,1.73,143.02,-3.08,True,1,13773,-138.61,-698643.76,1909075.53,1210431.77
1982-12-22,138.83,0.22,0.16,143.02,-2.93,True,1,13774,-138.83,-698782.59,1912244.42,1213461.83
1982-12-23,139.72,0.89,0.64,143.02,-2.31,True,1,13775,-139.72,-698922.31,1924643.0,1225720.69
1982-12-27,142.17,2.45,1.75,143.02,-0.59,True,1,13776,-142.17,-699064.48,1958533.92,1259469.44
1982-12-28,140.77,-1.4,-0.98,143.02,-1.57,True,1,13777,-140.77,-699205.25,1939388.29,1240183.04
1982-12-29,141.24,0.47,0.33,143.02,-1.25,True,1,13778,-141.24,-699346.49,1946004.72,1246658.23
1982-12-30,140.33,-0.91,-0.64,143.02,-1.88,True,1,13779,-140.33,-699486.82,1933607.07,1234120.25
1982-12-31,140.64,0.31,0.22,143.02,-1.66,True,1,13780,-140.64,-699627.46,1938019.2,1238391.74
1983-01-03,138.34,-2.3,-1.64,143.02,-3.27,True,1,13781,-138.34,-699765.8,1906463.54,1206697.74
1983-01-04,141.36,3.02,2.18,143.02,-1.16,True,1,13782,-141.36,-699907.16,1948223.52,1248316.36
1983-01-05,141.96,0.6,0.42,143.02,-0.74,True,1,13783,-141.96,-700049.12,1956634.68,1256585.56
1983-01-06,145.27,3.31,2.33,145.27,0.0,True,1,13784,-145.27,-700194.39,2002401.68,1302207.29
1983-01-07,145.18,-0.09,-0.06,145.27,-0.06,True,1,13785,-145.18,-700339.57,2001306.3,1300966.73
1983-01-10,146.78,1.6,1.1,146.78,0.0,True,1,13786,-146.78,-700486.35,2023509.08,1323022.73
1983-01-11,145.78,-1.0,-0.68,146.78,-0.68,True,1,13787,-145.78,-700632.13,2009868.86,1309236.73
1983-01-12,146.69,0.91,0.62,146.78,-0.06,True,1,13788,-146.69,-700778.82,2022561.72,1321782.9
1983-01-13,145.73,-0.96,-0.65,146.78,-0.72,True,1,13789,-145.73,-700924.55,2009470.97,1308546.42
1983-01-14,146.65,0.92,0.63,146.78,-0.09,True,1,13790,-146.65,-701071.2,2022303.5,1321232.3
1983-01-17,146.72,0.07,0.05,146.78,-0.04,True,1,13791,-146.72,-701217.92,2023415.52,1322197.6
1983-01-18,146.4,-0.32,-0.22,146.78,-0.26,True,1,13792,-146.4,-701364.32,2019148.8,1317784.48
1983-01-19,145.27,-1.13,-0.77,146.78,-1.03,True,1,13793,-145.27,-701509.59,2003709.11,1302199.52
1983-01-20,146.29,1.02,0.7,146.78,-0.33,True,1,13794,-146.29,-701655.88,2017924.26,1316268.38
1983-01-21,143.85,-2.44,-1.67,146.78,-2.0,True,1,13795,-143.85,-701799.73,1984410.75,1282611.02
1983-01-24,139.97,-3.88,-2.7,146.78,-4.64,True,1,13796,-139.97,-701939.7,1931026.12,1229086.42
1983-01-25,141.75,1.78,1.27,146.78,-3.43,True,1,13797,-141.75,-702081.45,1955724.75,1253643.3
1983-01-26,141.54,-0.21,-0.15,146.78,-3.57,True,1,13798,-141.54,-702222.99,1952968.92,1250745.93
1983-01-27,144.27,2.73,1.93,146.78,-1.71,True,1,13799,-144.27,-702367.26,1990781.73,1288414.47
1983-01-28,144.51,0.24,0.17,146.78,-1.55,True,1,13800,-144.51,-702511.77,1994238.0,1291726.23
1983-01-31,145.3,0.79,0.55,146.78,-1.01,True,1,13801,-145.3,-702657.07,2005285.3,1302628.23
1983-02-01,142.96,-2.34,-1.61,146.78,-2.6,True,1,13802,-142.96,-702800.03,1973133.92,1270333.89
1983-02-02,143.23,0.27,0.19,146.78,-2.42,True,1,13803,-143.23,-702943.26,1977003.69,1274060.43
1983-02-03,144.26,1.03,0.72,146.78,-1.72,True,1,13804,-144.26,-703087.52,1991365.04,1288277.52
1983-02-04,146.14,1.88,1.3,146.78,-0.44,True,1,13805,-146.14,-703233.66,2017462.7,1314229.04
1983-02-07,146.93,0.79,0.54,146.93,0.0,True,1,13806,-146.93,-703380.59,2028515.58,1325134.99
1983-02-08,145.7,-1.23,-0.84,146.93,-0.84,True,1,13807,-145.7,-703526.29,2011679.9,1308153.61
1983-02-09,145.0,-0.7,-0.48,146.93,-1.31,True,1,13808,-145.0,-703671.29,2002160.0,1298488.71
1983-02-10,147.5,2.5,1.72,147.5,0.0,True,1,13809,-147.5,-703818.79,2036827.5,1333008.71
1983-02-11,147.65,0.15,0.1,147.65,0.0,True,1,13810,-147.65,-703966.44,2039046.5,1335080.06
1983-02-14,148.93,1.28,0.87,148.93,0.0,True,1,13811,-148.93,-704115.37,2056872.23,1352756.86
1983-02-15,148.3,-0.63,-0.42,148.93,-0.42,True,1,13812,-148.3,-704263.67,2048319.6,1344055.93
1983-02-16,147.43,-0.87,-0.59,148.93,-1.01,True,1,13813,-147.43,-704411.1,2036450.59,1332039.49
1983-02-17,147.44,0.01,0.01,148.93,-1.0,True,1,13814,-147.44,-704558.54,2036736.16,1332177.62
1983-02-18,148.0,0.56,0.38,148.93,-0.62,True,1,13815,-148.0,-704706.54,2044620.0,1339913.46
1983-02-22,145.48,-2.52,-1.7,148.93,-2.32,True,1,13816,-145.48,-704852.02,2009951.68,1305099.66
1983-02-23,146.79,1.31,0.9,148.93,-1.44,True,1,13817,-146.79,-704998.81,2028197.43,1323198.62
1983-02-24,149.6,2.81,1.91,149.6,0.0,True,1,13818,-149.6,-705148.41,2067172.8,1362024.39
1983-02-25,149.74,0.14,0.09,149.74,0.0,True,1,13819,-149.74,-705298.15,2069257.06,1363958.91
1983-02-28,148.06,-1.68,-1.12,149.74,-1.12,True,1,13820,-148.06,-705446.21,2046189.2,1340742.99
1983-03-01,150.88,2.82,1.9,150.88,0.0,True,1,13821,-150.88,-705597.09,2085312.48,1379715.39
1983-03-02,152.3,1.42,0.94,152.3,0.0,True,1,13822,-152.3,-705749.39,2105090.6,1399341.21
1983-03-03,153.48,1.18,0.78,153.48,0.0,True,1,13823,-153.48,-705902.87,2121554.04,1415651.17
1983-03-04,153.67,0.19,0.12,153.67,0.0,True,1,13824,-153.67,-706056.54,2124334.08,1418277.54
1983-03-07,153.67,0.0,0.0,153.67,0.0,True,1,13825,-153.67,-706210.21,2124487.75,1418277.54
1983-03-08,151.26,-2.41,-1.57,153.67,-1.57,True,1,13826,-151.26,-706361.47,2091320.76,1384959.29
1983-03-09,152.87,1.61,1.06,153.67,-0.52,True,1,13827,-152.87,-706514.34,2113733.49,1407219.15
1983-03-10,151.8,-1.07,-0.7,153.67,-1.22,True,1,13828,-151.8,-706666.14,2099090.4,1392424.26
1983-03-11,151.24,-0.56,-0.37,153.67,-1.58,True,1,13829,-151.24,-706817.38,2091497.96,1384680.58
1983-03-14,150.83,-0.41,-0.27,153.67,-1.85,True,1,13830,-150.83,-706968.21,2085978.9,1379010.69
1983-03-15,151.37,0.54,0.36,153.67,-1.5,True,1,13831,-151.37,-707119.58,2093598.47,1386478.89
1983-03-16,149.81,-1.56,-1.03,153.67,-2.51,True,1,13832,-149.81,-707269.39,2072171.92,1364902.53
1983-03-17,149.59,-0.22,-0.15,153.67,-2.66,True,1,13833,-149.59,-707418.98,2069278.47,1361859.49
1983-03-18,149.9,0.31,0.21,153.67,-2.45,True,1,13834,-149.9,-707568.88,2073716.6,1366147.72
1983-03-21,151.19,1.29,0.86,153.67,-1.61,True,1,13835,-151.19,-707720.07,2091713.65,1383993.58
1983-03-22,150.66,-0.53,-0.35,153.67,-1.96,True,1,13836,-150.66,-707870.73,2084531.76,1376661.03
1983-03-23,152.81,2.15,1.43,153.67,-0.56,True,1,13837,-152.81,-708023.54,2114431.97,1406408.43
1983-03-24,153.37,0.56,0.37,153.67,-0.2,True,1,13838,-153.37,-708176.91,2122334.06,1414157.15
1983-03-25,152.67,-0.7,-0.46,153.67,-0.65,True,1,13839,-152.67,-708329.58,2112800.13,1404470.55
1983-03-28,151.85,-0.82,-0.54,153.67,-1.18,True,1,13840,-151.85,-708481.43,2101604.0,1393122.57
1983-03-29,151.59,-0.26,-0.17,153.67,-1.35,True,1,13841,-151.59,-708633.02,2098157.19,1389524.17
1983-03-30,153.39,1.8,1.19,153.67,-0.18,True,1,13842,-153.39,-708786.41,2123224.38,1414437.97
1983-03-31,152.96,-0.43,-0.28,153.67,-0.46,True,1,13843,-152.96,-708939.37,2117425.28,1408485.91
1983-04-04,153.02,0.06,0.04,153.67,-0.42,True,1,13844,-153.02,-709092.39,2118408.88,1409316.49
1983-04-05,151.9,-1.12,-0.73,153.67,-1.15,True,1,13845,-151.9,-709244.29,2103055.5,1393811.21
1983-04-06,151.04,-0.86,-0.57,153.67,-1.71,True,1,13846,-151.04,-709395.33,2091299.84,1381904.51
1983-04-07,151.76,0.72,0.48,153.67,-1.24,True,1,13847,-151.76,-709547.09,2101420.72,1391873.63
1983-04-08,152.85,1.09,0.72,153.67,-0.53,True,1,13848,-152.85,-709699.94,2116666.8,1406966.86
1983-04-11,155.14,2.29,1.5,155.14,0.0,True,1,13849,-155.14,-709855.08,2148533.86,1438678.78
1983-04-12,155.82,0.68,0.44,155.82,0.0,True,1,13850,-155.82,-710010.9,2158107.0,1448096.1
1983-04-13,156.77,0.95,0.61,156.77,0.0,True,1,13851,-156.77,-710167.67,2171421.27,1461253.6
1983-04-14,158.12,1.35,0.86,158.12,0.0,True,1,13852,-158.12,-710325.79,2190278.24,1479952.45
1983-04-15,158.75,0.63,0.4,158.75,0.0,True,1,13853,-158.75,-710484.54,2199163.75,1488679.21
1983-04-18,159.74,0.99,0.62,159.74,0.0,True,1,13854,-159.74,-710644.28,2213037.96,1502393.68
1983-04-19,158.71,-1.03,-0.64,159.74,-0.64,True,1,13855,-158.71,-710802.99,2198927.05,1488124.06
1983-04-20,160.71,2.0,1.26,160.71,0.0,True,1,13856,-160.71,-710963.7,2226797.76,1515834.06
1983-04-21,160.05,-0.66,-0.41,160.71,-0.41,True,1,13857,-160.05,-711123.75,2217812.85,1506689.1
1983-04-22,160.42,0.37,0.23,160.71,-0.18,True,1,13858,-160.42,-711284.17,2223100.36,1511816.19
1983-04-25,158.81,-1.61,-1.0,160.71,-1.18,True,1,13859,-158.81,-711442.98,2200947.79,1489504.81
1983-04-26,161.81,3.0,1.89,161.81,0.0,True,1,13860,-161.81,-711604.79,2242686.6,1531081.81
1983-04-27,161.44,-0.37,-0.23,161.81,-0.23,True,1,13861,-161.44,-711766.23,2237719.84,1525953.61
1983-04-28,162.95,1.51,0.94,162.95,0.0,True,1,13862,-162.95,-711929.18,2258812.9,1546883.72
1983-04-29,164.43,1.48,0.91,164.43,0.0,True,1,13863,-164.43,-712093.61,2279493.09,1567399.48
1983-05-02,162.11,-2.32,-1.41,164.43,-1.41,True,1,13864,-162.11,-712255.72,2247493.04,1535237.32
1983-05-03,162.34,0.23,0.14,164.43,-1.27,True,1,13865,-162.34,-712418.06,2250844.1,1538426.04
1983-05-04,163.31,0.97,0.6,164.43,-0.68,True,1,13866,-163.31,-712581.37,2264456.46,1551875.09
1983-05-05,164.28,0.97,0.59,164.43,-0.09,True,1,13867,-164.28,-712745.65,2278070.76,1565325.11
1983-05-06,166.1,1.82,1.11,166.1,0.0,True,1,13868,-166.1,-712911.75,2303474.8,1590563.05
1983-05-09,165.81,-0.29,-0.18,166.1,-0.18,True,1,13869,-165.81,-713077.56,2299618.89,1586541.33
1983-05-10,165.95,0.14,0.08,166.1,-0.09,True,1,13870,-165.95,-713243.51,2301726.5,1588482.99
1983-05-11,164.96,-0.99,-0.6,166.1,-0.69,True,1,13871,-164.96,-713408.47,2288160.16,1574751.69
1983-05-12,164.25,-0.71,-0.43,166.1,-1.11,True,1,13872,-164.25,-713572.72,2278476.0,1564903.28
1983-05-13,164.91,0.66,0.4,166.1,-0.72,True,1,13873,-164.91,-713737.63,2287796.43,1574058.8
1983-05-16,163.4,-1.51,-0.92,166.1,-1.63,True,1,13874,-163.4,-713901.03,2267011.6,1553110.57
1983-05-17,163.71,0.31,0.19,166.1,-1.44,True,1,13875,-163.71,-714064.74,2271476.25,1557411.51
1983-05-18,163.27,-0.44,-0.27,166.1,-1.7,True,1,13876,-163.27,-714228.01,2265534.52,1551306.51
1983-05-19,161.99,-1.28,-0.78,166.1,-2.47,True,1,13877,-161.99,-714390.0,2247935.23,1533545.23
1983-05-20,162.14,0.15,0.09,166.1,-2.38,True,1,13878,-162.14,-714552.14,2250178.92,1535626.78
1983-05-23,163.43,1.29,0.8,166.1,-1.61,True,1,13879,-163.43,-714715.57,2268244.97,1553529.4
1983-05-24,165.54,2.11,1.29,166.1,-0.34,True,1,13880,-165.54,-714881.11,2297695.2,1582814.09
1983-05-25,166.21,0.67,0.4,166.21,0.0,True,1,13881,-166.21,-715047.32,2307161.01,1592113.69
1983-05-26,165.48,-0.73,-0.44,166.21,-0.44,True,1,13882,-165.48,-715212.8,2297193.36,1581980.56
1983-05-27,164.46,-1.02,-0.62,166.21,-1.05,True,1,13883,-164.46,-715377.26,2283198.18,1567820.92
1983-05-31,162.39,-2.07,-1.26,166.21,-2.3,True,1,13884,-162.39,-715539.65,2254622.76,1539083.11
1983-06-01,162.55,0.16,0.1,166.21,-2.2,True,1,13885,-162.55,-715702.2,2257006.75,1541304.55
1983-06-02,163.98,1.43,0.88,166.21,-1.34,True,1,13886,-163.98,-715866.18,2277026.28,1561160.1
1983-06-03,164.42,0.44,0.27,166.21,-1.08,True,1,13887,-164.42,-716030.6,2283300.54,1567269.94
1983-06-06,164.83,0.41,0.25,166.21,-0.83,True,1,13888,-164.83,-716195.43,2289159.04,1572963.61
1983-06-07,162.77,-2.06,-1.25,166.21,-2.07,True,1,13889,-162.77,-716358.2,2260712.53,1544354.33
1983-06-08,161.36,-1.41,-0.87,166.21,-2.92,True,1,13890,-161.36,-716519.56,2241290.4,1524770.84
1983-06-09,161.83,0.47,0.29,166.21,-2.64,True,1,13891,-161.83,-716681.39,2247980.53,1531299.14
1983-06-10,162.68,0.85,0.52,166.21,-2.12,True,1,13892,-162.68,-716844.07,2259950.56,1543106.49
1983-06-13,164.84,2.16,1.33,166.21,-0.82,True,1,13893,-164.84,-717008.91,2290122.12,1573113.21
1983-06-14,165.53,0.69,0.42,166.21,-0.41,True,1,13894,-165.53,-717174.44,2299873.82,1582699.38
1983-06-15,167.12,1.59,0.96,167.12,0.0,True,1,13895,-167.12,-717341.56,2322132.4,1604790.84
1983-06-16,169.14,2.02,1.21,169.14,0.0,True,1,13896,-169.14,-717510.7,2350369.44,1632858.74
1983-06-17,169.13,-0.01,-0.01,169.14,-0.01,True,1,13897,-169.13,-717679.83,2350399.61,1632719.78
1983-06-20,169.02,-0.11,-0.06,169.14,-0.07,True,1,13898,-169.02,-717848.85,2349039.96,1631191.11
1983-06-21,170.53,1.51,0.89,170.53,0.0,True,1,13899,-170.53,-718019.38,2370196.47,1652177.09
1983-06-22,170.99,0.46,0.27,170.99,0.0,True,1,13900,-170.99,-718190.37,2376761.0,1658570.63
1983-06-23,170.57,-0.42,-0.25,170.99,-0.25,True,1,13901,-170.57,-718360.94,2371093.57,1652732.63
1983-06-24,170.41,-0.16,-0.09,170.99,-0.34,True,1,13902,-170.41,-718531.35,2369039.82,1650508.47
1983-06-27,168.46,-1.95,-1.14,170.99,-1.48,True,1,13903,-168.46,-718699.81,2342099.38,1623399.57
1983-06-28,165.68,-2.78,-1.65,170.99,-3.1,True,1,13904,-165.68,-718865.49,2303614.72,1584749.23
1983-06-29,166.64,0.96,0.58,170.99,-2.54,True,1,13905,-166.64,-719032.13,2317129.2,1598097.07
1983-06-30,167.64,1.0,0.6,170.99,-1.96,True,1,13906,-167.64,-719199.77,2331201.84,1612002.07
1983-07-01,168.64,1.0,0.6,170.99,-1.37,True,1,13907,-168.64,-719368.41,2345276.48,1625908.07
1983-07-05,166.6,-2.04,-1.21,170.99,-2.57,True,1,13908,-166.6,-719535.01,2317072.8,1597537.79
1983-07-06,168.48,1.88,1.13,170.99,-1.47,True,1,13909,-168.48,-719703.49,2343388.32,1623684.83
1983-07-07,167.56,-0.92,-0.55,170.99,-2.01,True,1,13910,-167.56,-719871.05,2330759.6,1610888.55
1983-07-08,167.08,-0.48,-0.29,170.99,-2.29,True,1,13911,-167.08,-720038.13,2324249.88,1604211.75
1983-07-11,168.11,1.03,0.62,170.99,-1.68,True,1,13912,-168.11,-720206.24,2338746.32,1618540.08
1983-07-12,165.53,-2.58,-1.54,170.99,-3.19,True,1,13913,-165.53,-720371.77,2303018.89,1582647.12
1983-07-13,165.46,-0.07,-0.04,170.99,-3.23,True,1,13914,-165.46,-720537.23,2302210.44,1581673.21
1983-07-14,166.01,0.55,0.33,170.99,-2.91,True,1,13915,-166.01,-720703.24,2310029.15,1589325.91
1983-07-15,164.29,-1.72,-1.04,170.99,-3.92,True,1,13916,-164.29,-720867.53,2286259.64,1565392.11
1983-07-18,163.95,-0.34,-0.21,170.99,-4.12,True,1,13917,-163.95,-721031.48,2281692.15,1560660.67
1983-07-19,164.82,0.87,0.53,170.99,-3.61,True,1,13918,-164.82,-721196.3,2293964.76,1572768.46
1983-07-20,169.29,4.47,2.71,170.99,-0.99,True,1,13919,-169.29,-721365.59,2356347.51,1634981.92
1983-07-21,169.06,-0.23,-0.14,170.99,-1.13,True,1,13920,-169.06,-721534.65,2353315.2,1631780.55
1983-07-22,168.89,-0.17,-0.1,170.99,-1.23,True,1,13921,-168.89,-721703.54,2351117.69,1629414.15
1983-07-25,169.53,0.64,0.38,170.99,-0.85,True,1,13922,-169.53,-721873.07,2360196.66,1638323.59
1983-07-26,170.53,1.0,0.59,170.99,-0.27,True,1,13923,-170.53,-722043.6,2374289.19,1652245.59
1983-07-27,167.59,-2.94,-1.72,170.99,-1.99,True,1,13924,-167.59,-722211.19,2333523.16,1611311.97
1983-07-28,165.04,-2.55,-1.52,170.99,-3.48,True,1,13925,-165.04,-722376.23,2298182.0,1575805.77
1983-07-29,162.56,-2.48,-1.5,170.99,-4.93,True,1,13926,-162.56,-722538.79,2263810.56,1541271.77
1983-08-01,162.04,-0.52,-0.32,170.99,-5.23,True,1,13927,-162.04,-722700.83,2256731.08,1534030.25
1983-08-02,162.01,-0.03,-0.02,170.99,-5.25,True,1,13928,-162.01,-722862.84,2256475.28,1533612.44
1983-08-03,163.44,1.43,0.88,170.99,-4.42,True,1,13929,-163.44,-723026.28,2276555.76,1553529.48
1983-08-04,161.33,-2.11,-1.29,170.99,-5.65,True,1,13930,-161.33,-723187.61,2247326.9,1524139.29
1983-08-05,161.74,0.41,0.25,170.99,-5.41,True,1,13931,-161.74,-723349.35,2253199.94,1529850.59
1983-08-08,159.18,-2.56,-1.58,170.99,-6.91,True,1,13932,-159.18,-723508.53,2217695.76,1494187.23
1983-08-09,160.13,0.95,0.6,170.99,-6.35,True,1,13933,-160.13,-723668.66,2231091.29,1507422.63
1983-08-10,161.54,1.41,0.88,170.99,-5.53,True,1,13934,-161.54,-723830.2,2250898.36,1527068.16
1983-08-11,161.54,0.0,0.0,170.99,-5.53,True,1,13935,-161.54,-723991.74,2251059.9,1527068.16
1983-08-12,162.16,0.62,0.38,170.99,-5.16,True,1,13936,-162.16,-724153.9,2259861.76,1535707.86
1983-08-15,163.7,1.54,0.95,170.99,-4.26,True,1,13937,-163.7,-724317.6,2281486.9,1557169.3
1983-08-16,163.41,-0.29,-0.18,170.99,-4.43,True,1,13938,-163.41,-724481.01,2277608.58,1553127.57
1983-08-17,165.29,1.88,1.15,170.99,-3.33,True,1,13939,-165.29,-724646.3,2303977.31,1579331.01
1983-08-18,163.55,-1.74,-1.05,170.99,-4.35,True,1,13940,-163.55,-724809.85,2279887.0,1555077.15
1983-08-19,163.98,0.43,0.26,170.99,-4.1,True,1,13941,-163.98,-724973.83,2286045.18,1561071.35
1983-08-22,164.34,0.36,0.22,170.99,-3.89,True,1,13942,-164.34,-725138.17,2291228.28,1566090.11
1983-08-23,162.77,-1.57,-0.96,170.99,-4.81,True,1,13943,-162.77,-725300.94,2269502.11,1544201.17
1983-08-24,161.25,-1.52,-0.93,170.99,-5.7,True,1,13944,-161.25,-725462.19,2248470.0,1523007.81
1983-08-25,160.84,-0.41,-0.25,170.99,-5.94,True,1,13945,-160.84,-725623.03,2242913.8,1517290.77
1983-08-26,162.14,1.3,0.81,170.99,-5.18,True,1,13946,-162.14,-725785.17,2261204.44,1535419.27
1983-08-29,162.25,0.11,0.07,170.99,-5.11,True,1,13947,-162.25,-725947.42,2262900.75,1536953.33
1983-08-30,162.58,0.33,0.2,170.99,-4.92,True,1,13948,-162.58,-726110.0,2267665.84,1541555.84
1983-08-31,164.4,1.82,1.12,170.99,-3.85,True,1,13949,-164.4,-726274.4,2293215.6,1566941.2
1983-09-01,164.23,-0.17,-0.1,170.99,-3.95,True,1,13950,-164.23,-726438.63,2291008.5,1564569.87
1983-09-02,165.0,0.77,0.47,170.99,-3.5,True,1,13951,-165.0,-726603.63,2301915.0,1575311.37
1983-09-06,167.89,2.89,1.75,170.99,-1.81,True,1,13952,-167.89,-726771.52,2342401.28,1615629.76
1983-09-07,167.96,0.07,0.04,170.99,-1.77,True,1,13953,-167.96,-726939.48,2343545.88,1616606.4
1983-09-08,167.77,-0.19,-0.11,170.99,-1.88,True,1,13954,-167.77,-727107.25,2341062.58,1613955.33
1983-09-09,166.92,-0.85,-0.51,170.99,-2.38,True,1,13955,-166.92,-727274.17,2329368.6,1602094.43
1983-09-12,165.48,-1.44,-0.86,170.99,-3.22,True,1,13956,-165.48,-727439.65,2309438.88,1581999.23
1983-09-13,164.8,-0.68,-0.41,170.99,-3.62,True,1,13957,-164.8,-727604.45,2300113.6,1572509.15
1983-09-14,165.35,0.55,0.33,170.99,-3.3,True,1,13958,-165.35,-727769.8,2307955.3,1580185.5
1983-09-15,164.38,-0.97,-0.59,170.99,-3.87,True,1,13959,-164.38,-727934.18,2294580.42,1566646.24
1983-09-16,166.25,1.87,1.14,170.99,-2.77,True,1,13960,-166.25,-728100.43,2320850.0,1592749.57
1983-09-19,167.62,1.37,0.82,170.99,-1.97,True,1,13961,-167.62,-728268.05,2340142.82,1611874.77
1983-09-20,169.24,1.62,0.97,170.99,-1.02,True,1,13962,-169.24,-728437.29,2362928.88,1634491.59
1983-09-21,168.41,-0.83,-0.49,170.99,-1.51,True,1,13963,-168.41,-728605.7,2351508.83,1622903.13
1983-09-22,169.76,1.35,0.8,170.99,-0.72,True,1,13964,-169.76,-728775.46,2370528.64,1641753.18
1983-09-23,169.51,-0.25,-0.15,170.99,-0.87,True,1,13965,-169.51,-728944.97,2367207.15,1638262.18
1983-09-26,170.07,0.56,0.33,170.99,-0.54,True,1,13966,-170.07,-729115.04,2375197.62,1646082.58
1983-09-27,168.43,-1.64,-0.96,170.99,-1.5,True,1,13967,-168.43,-729283.47,2352461.81,1623178.34
1983-09-28,168.0,-0.43,-0.26,170.99,-1.75,True,1,13968,-168.0,-729451.47,2346624.0,1617172.53
1983-09-29,167.23,-0.77,-0.46,170.99,-2.2,True,1,13969,-167.23,-729618.7,2336035.87,1606417.17
1983-09-30,166.07,-1.16,-0.69,170.99,-2.88,True,1,13970,-166.07,-729784.77,2319997.9,1590213.13
1983-10-03,165.81,-0.26,-0.16,170.99,-3.03,True,1,13971,-165.81,-729950.58,2316531.51,1586580.93
1983-10-04,166.27,0.46,0.28,170.99,-2.76,True,1,13972,-166.27,-730116.85,2323124.44,1593007.59
1983-10-05,167.74,1.47,0.88,170.99,-1.9,True,1,13973,-167.74,-730284.59,2343831.02,1613546.43
1983-10-06,170.28,2.54,1.51,170.99,-0.42,True,1,13974,-170.28,-730454.87,2379492.72,1649037.85
1983-10-07,170.8,0.52,0.3,170.99,-0.11,True,1,13975,-170.8,-730625.67,2386930.0,1656304.33
1983-10-10,172.65,1.85,1.08,172.65,0.0,True,1,13976,-172.65,-730798.32,2412956.4,1682158.08
1983-10-11,170.34,-2.31,-1.34,172.65,-1.34,True,1,13977,-170.34,-730968.66,2380842.18,1649873.52
1983-10-12,169.62,-0.72,-0.42,172.65,-1.76,True,1,13978,-169.62,-731138.28,2370948.36,1639810.08
1983-10-13,169.87,0.25,0.15,172.65,-1.61,True,1,13979,-169.87,-731308.15,2374612.73,1643304.58
1983-10-14,169.86,-0.01,-0.01,172.65,-1.62,True,1,13980,-169.86,-731478.01,2374642.8,1643164.79
1983-10-17,170.43,0.57,0.34,172.65,-1.29,True,1,13981,-170.43,-731648.44,2382781.83,1651133.39
1983-10-18,167.81,-2.62,-1.54,172.65,-2.8,True,1,13982,-167.81,-731816.25,2346319.42,1614503.17
1983-10-19,166.73,-1.08,-0.64,172.65,-3.43,True,1,13983,-166.73,-731982.98,2331385.59,1599402.61
1983-10-20,166.98,0.25,0.15,172.65,-3.28,True,1,13984,-166.98,-732149.96,2335048.32,1602898.36
1983-10-21,165.95,-1.03,-0.62,172.65,-3.88,True,1,13985,-165.95,-732315.91,2320810.75,1588494.84
1983-10-24,165.99,0.04,0.02,172.65,-3.86,True,1,13986,-165.99,-732481.9,2321536.14,1589054.24
1983-10-25,166.47,0.48,0.29,172.65,-3.58,True,1,13987,-166.47,-732648.37,2328415.89,1595767.52
1983-10-26,165.38,-1.09,-0.66,172.65,-4.21,True,1,13988,-165.38,-732813.75,2313335.44,1580521.69
1983-10-27,164.84,-0.54,-0.33,172.65,-4.52,True,1,13989,-164.84,-732978.59,2305946.76,1572968.17
1983-10-28,163.37,-1.47,-0.89,172.65,-5.38,True,1,13990,-163.37,-733141.96,2285546.3,1552404.34
1983-10-31,163.55,0.18,0.11,172.65,-5.27,True,1,13991,-163.55,-733305.51,2288228.05,1554922.54
1983-11-01,163.66,0.11,0.07,172.65,-5.21,True,1,13992,-163.66,-733469.17,2289930.72,1556461.55
1983-11-02,164.84,1.18,0.72,172.65,-4.52,True,1,13993,-164.84,-733634.01,2306606.12,1572972.11
1983-11-03,163.45,-1.39,-0.84,172.65,-5.33,True,1,13994,-163.45,-733797.46,2287319.3,1553521.84
1983-11-04,162.44,-1.01,-0.62,172.65,-5.91,True,1,13995,-162.44,-733959.9,2273347.8,1539387.9
1983-11-07,161.91,-0.53,-0.33,172.65,-6.22,True,1,13996,-161.91,-734121.81,2266092.36,1531970.55
1983-11-08,161.76,-0.15,-0.09,172.65,-6.31,True,1,13997,-161.76,-734283.57,2264154.72,1529871.15
1983-11-09,163.97,2.21,1.37,172.65,-5.03,True,1,13998,-163.97,-734447.54,2295252.06,1560804.52
1983-11-10,164.41,0.44,0.27,172.65,-4.77,True,1,13999,-164.41,-734611.95,2301575.59,1566963.64
1983-11-11,166.29,1.88,1.14,172.65,-3.68,True,1,14000,-166.29,-734778.24,2328060.0,1593281.76
1983-11-14,166.58,0.29,0.17,172.65,-3.52,True,1,14001,-166.58,-734944.82,2332286.58,1597341.76
1983-11-15,165.36,-1.22,-0.73,172.65,-4.22,True,1,14002,-165.36,-735110.18,2315370.72,1580260.54
1983-11-16,166.08,0.72,0.44,172.65,-3.8,True,1,14003,-166.08,-735276.26,2325618.24,1590341.98
1983-11-17,166.13,0.05,0.03,172.65,-3.78,True,1,14004,-166.13,-735442.39,2326484.52,1591042.13
1983-11-18,165.09,-1.04,-0.63,172.65,-4.38,True,1,14005,-165.09,-735607.48,2312085.45,1576477.97
1983-11-21,166.05,0.96,0.58,172.65,-3.82,True,1,14006,-166.05,-735773.53,2325696.3,1589922.77
1983-11-22,166.84,0.79,0.48,172.65,-3.36,True,1,14007,-166.84,-735940.37,2336927.88,1600987.51
1983-11-23,166.96,0.12,0.07,172.65,-3.3,True,1,14008,-166.96,-736107.33,2338775.68,1602668.35
1983-11-25,167.18,0.22,0.13,172.65,-3.17,True,1,14009,-167.18,-736274.51,2342024.62,1605750.11
1983-11-28,166.54,-0.64,-0.38,172.65,-3.54,True,1,14010,-166.54,-736441.05,2333225.4,1596784.35
1983-11-29,167.91,1.37,0.82,172.65,-2.74,True,1,14011,-167.91,-736608.96,2352587.01,1615978.05
1983-11-30,166.4,-1.51,-0.9,172.65,-3.62,True,1,14012,-166.4,-736775.36,2331596.8,1594821.44
1983-12-01,166.49,0.09,0.05,172.65,-3.57,True,1,14013,-166.49,-736941.85,2333024.37,1596082.52
1983-12-02,165.44,-1.05,-0.63,172.65,-4.18,True,1,14014,-165.44,-737107.29,2318476.16,1581368.87
1983-12-05,165.76,0.32,0.19,172.65,-3.99,True,1,14015,-165.76,-737273.05,2323126.4,1585853.35
1983-12-06,165.47,-0.29,-0.18,172.65,-4.16,True,1,14016,-165.47,-737438.52,2319227.52,1581789.0
1983-12-07,165.91,0.44,0.27,172.65,-3.9,True,1,14017,-165.91,-737604.43,2325560.47,1587956.04
1983-12-08,165.2,-0.71,-0.43,172.65,-4.32,True,1,14018,-165.2,-737769.63,2315773.6,1578003.97
1983-12-09,165.08,-0.12,-0.07,172.65,-4.38,True,1,14019,-165.08,-737934.71,2314256.52,1576321.81
1983-12-12,165.62,0.54,0.33,172.65,-4.07,True,1,14020,-165.62,-738100.33,2321992.4,1583892.07
1983-12-13,164.93,-0.69,-0.42,172.65,-4.47,True,1,14021,-164.93,-738265.26,2312483.53,1574218.27
1983-12-14,163.33,-1.6,-0.97,172.65,-5.4,True,1,14022,-163.33,-738428.59,2290213.26,1551784.67
1983-12-15,161.66,-1.67,-1.02,172.65,-6.36,True,1,14023,-161.66,-738590.25,2266958.18,1528367.93
1983-12-16,162.39,0.73,0.45,172.65,-5.94,True,1,14024,-162.39,-738752.64,2277357.36,1538604.72
1983-12-19,162.32,-0.07,-0.04,172.65,-5.98,True,1,14025,-162.32,-738914.96,2276538.0,1537623.04
1983-12-20,162.0,-0.32,-0.2,172.65,-6.17,True,1,14026,-162.0,-739076.96,2272212.0,1533135.04
1983-12-21,163.56,1.56,0.96,172.65,-5.26,True,1,14027,-163.56,-739240.52,2294256.12,1555015.6
1983-12-22,163.53,-0.03,-0.02,172.65,-5.28,True,1,14028,-163.53,-739404.05,2293998.84,1554594.79
1983-12-23,163.22,-0.31,-0.19,172.65,-5.46,True,1,14029,-163.22,-739567.27,2289813.38,1550246.11
1983-12-27,164.76,1.54,0.94,172.65,-4.57,True,1,14030,-164.76,-739732.03,2311582.8,1571850.77
1983-12-28,165.34,0.58,0.35,172.65,-4.23,True,1,14031,-165.34,-739897.37,2319885.54,1579988.17
1983-12-29,164.86,-0.48,-0.29,172.65,-4.51,True,1,14032,-164.86,-740062.23,2313315.52,1573253.29
1983-12-30,164.93,0.07,0.04,172.65,-4.47,True,1,14033,-164.93,-740227.16,2314462.69,1574235.53
1984-01-03,164.04,-0.89,-0.54,172.65,-4.99,True,1,14034,-164.04,-740391.2,2302137.36,1561746.16
1984-01-04,166.78,2.74,1.67,172.65,-3.4,True,1,14035,-166.78,-740557.98,2340757.3,1600199.32
1984-01-05,168.81,2.03,1.22,172.65,-2.22,True,1,14036,-168.81,-740726.79,2369417.16,1628690.37
1984-01-06,169.28,0.47,0.28,172.65,-1.95,True,1,14037,-169.28,-740896.07,2376183.36,1635287.29
1984-01-09,168.9,-0.38,-0.22,172.65,-2.17,True,1,14038,-168.9,-741064.97,2371018.2,1629953.23
1984-01-10,167.95,-0.95,-0.56,172.65,-2.72,True,1,14039,-167.95,-741232.92,2357850.05,1616617.13
1984-01-11,167.8,-0.15,-0.09,172.65,-2.81,True,1,14040,-167.8,-741400.72,2355912.0,1614511.28
1984-01-12,167.75,-0.05,-0.03,172.65,-2.84,True,1,14041,-167.75,-741568.47,2355377.75,1613809.28
1984-01-13,167.02,-0.73,-0.44,172.65,-3.26,True,1,14042,-167.02,-741735.49,2345294.84,1603559.35
1984-01-16,167.18,0.16,0.1,172.65,-3.17,True,1,14043,-167.18,-741902.67,2347708.74,1605806.07
1984-01-17,167.83,0.65,0.39,172.65,-2.79,True,1,14044,-167.83,-742070.5,2357004.52,1614934.02
1984-01-18,167.55,-0.28,-0.17,172.65,-2.95,True,1,14045,-167.55,-742238.05,2353239.75,1611001.7
1984-01-19,167.04,-0.51,-0.3,172.65,-3.25,True,1,14046,-167.04,-742405.09,2346243.84,1603838.75
1984-01-20,166.21,-0.83,-0.5,172.65,-3.73,True,1,14047,-166.21,-742571.3,2334751.87,1592180.57
1984-01-23,164.87,-1.34,-0.81,172.65,-4.51,True,1,14048,-164.87,-742736.17,2316093.76,1573357.59
1984-01-24,165.94,1.07,0.65,172.65,-3.89,True,1,14049,-165.94,-742902.11,2331291.06,1588388.95
1984-01-25,164.84,-1.1,-0.66,172.65,-4.52,True,1,14050,-164.84,-743066.95,2316002.0,1572935.05
1984-01-26,164.24,-0.6,-0.36,172.65,-4.87,True,1,14051,-164.24,-743231.19,2307736.24,1564505.05
1984-01-27,163.94,-0.3,-0.18,172.65,-5.04,True,1,14052,-163.94,-743395.13,2303684.88,1560289.75
1984-01-30,162.87,-1.07,-0.65,172.65,-5.66,True,1,14053,-162.87,-743558.0,2288812.11,1545254.11
1984-01-31,163.41,0.54,0.33,172.65,-5.35,True,1,14054,-163.41,-743721.41,2296564.14,1552842.73
1984-02-01,162.74,-0.67,-0.41,172.65,-5.74,True,1,14055,-162.74,-743884.15,2287310.7,1543426.55
1984-02-02,163.36,0.62,0.38,172.65,-5.38,True,1,14056,-163.36,-744047.51,2296188.16,1552140.65
1984-02-03,160.91,-2.45,-1.5,172.65,-6.8,True,1,14057,-160.91,-744208.42,2261911.87,1517703.45
1984-02-06,158.08,-2.83,-1.76,172.65,-8.44,True,1,14058,-158.08,-744366.5,2222288.64,1477922.14
1984-02-07,158.74,0.66,0.42,172.65,-8.06,True,1,14059,-158.74,-744525.24,2231725.66,1487200.42
1984-02-08,155.85,-2.89,-1.82,172.65,-9.73,True,1,14060,-155.85,-744681.09,2191251.0,1446569.91
1984-02-09,155.42,-0.43,-0.28,172.65,-9.98,True,1,14061,-155.42,-744836.51,2185360.62,1440524.11
1984-02-10,156.3,0.88,0.57,172.65,-9.47,True,1,14062,-156.3,-744992.81,2197890.6,1452897.79
1984-02-13,154.95,-1.35,-0.86,172.65,-10.25,True,1,14063,-154.95,-745147.76,2179061.85,1433914.09
1984-02-14,156.61,1.66,1.07,172.65,-9.29,True,1,14064,-156.61,-745304.37,2202563.04,1457258.67
1984-02-15,156.25,-0.36,-0.23,172.65,-9.5,True,1,14065,-156.25,-745460.62,2197656.25,1452195.63
1984-02-16,156.13,-0.12,-0.08,172.65,-9.57,True,1,14066,-156.13,-745616.75,2196124.58,1450507.83
1984-02-17,155.74,-0.39,-0.25,172.65,-9.79,True,1,14067,-155.74,-745772.49,2190794.58,1445022.09
1984-02-21,154.64,-1.1,-0.71,172.65,-10.43,True,1,14068,-154.64,-745927.13,2175475.52,1429548.39
1984-02-22,154.31,-0.33,-0.21,172.65,-10.62,True,1,14069,-154.31,-746081.44,2170987.39,1424905.95
1984-02-23,154.29,-0.02,-0.01,172.65,-10.63,True,1,14070,-154.29,-746235.73,2170860.3,1424624.57
1984-02-24,157.51,3.22,2.09,172.65,-8.77,True,1,14071,-157.51,-746393.24,2216323.21,1469929.97
1984-02-27,159.3,1.79,1.14,172.65,-7.73,True,1,14072,-159.3,-746552.54,2241669.6,1495117.06
1984-02-28,156.82,-2.48,-1.56,172.65,-9.17,True,1,14073,-156.82,-746709.36,2206927.86,1460218.5
1984-02-29,157.06,0.24,0.15,172.65,-9.03,True,1,14074,-157.06,-746866.42,2210462.44,1463596.02
1984-03-01,158.19,1.13,0.72,172.65,-8.38,True,1,14075,-158.19,-747024.61,2226524.25,1479499.64
1984-03-02,159.24,1.05,0.66,172.65,-7.77,True,1,14076,-159.24,-747183.85,2241462.24,1494278.39
1984-03-05,157.89,-1.35,-0.85,172.65,-8.55,True,1,14077,-157.89,-747341.74,2222617.53,1475275.79
1984-03-06,156.25,-1.64,-1.04,172.65,-9.5,True,1,14078,-156.25,-747497.99,2199687.5,1452189.51
1984-03-07,154.57,-1.68,-1.08,172.65,-10.47,True,1,14079,-154.57,-747652.56,2176191.03,1428538.47
1984-03-08,155.19,0.62,0.4,172.65,-10.11,True,1,14080,-155.19,-747807.75,2185075.2,1437267.45
1984-03-09,154.35,-0.84,-0.54,172.65,-10.6,True,1,14081,-154.35,-747962.1,2173402.35,1425440.25
1984-03-12,156.34,1.99,1.29,172.65,-9.45,True,1,14082,-156.34,-748118.44,2201579.88,1453461.44
1984-03-13,156.78,0.44,0.28,172.65,-9.19,True,1,14083,-156.78,-748275.22,2207932.74,1459657.52
1984-03-14,156.77,-0.01,-0.01,172.65,-9.2,True,1,14084,-156.77,-748431.99,2207948.68,1459516.69
1984-03-15,157.41,0.64,0.41,172.65,-8.83,True,1,14085,-157.41,-748589.4,2217119.85,1468530.45
1984-03-16,159.27,1.86,1.18,172.65,-7.75,True,1,14086,-159.27,-748748.67,2243477.22,1494728.55
1984-03-19,157.78,-1.49,-0.94,172.65,-8.61,True,1,14087,-157.78,-748906.45,2222646.86,1473740.41
1984-03-20,158.86,1.08,0.68,172.65,-7.99,True,1,14088,-158.86,-749065.31,2238019.68,1488954.37
1984-03-21,158.66,-0.2,-0.13,172.65,-8.1,True,1,14089,-158.66,-749223.97,2235360.74,1486136.77
1984-03-22,156.69,-1.97,-1.24,172.65,-9.24,True,1,14090,-156.69,-749380.66,2207762.1,1458381.44
1984-03-23,156.86,0.17,0.11,172.65,-9.15,True,1,14091,-156.86,-749537.52,2210314.26,1460776.74
1984-03-26,156.67,-0.19,-0.12,172.65,-9.26,True,1,14092,-156.67,-749694.19,2207793.64,1458099.45
1984-03-27,157.3,0.63,0.4,172.65,-8.89,True,1,14093,-157.3,-749851.49,2216828.9,1466977.41
1984-03-28,159.88,2.58,1.64,172.65,-7.4,True,1,14094,-159.88,-750011.37,2253348.72,1503337.35
1984-03-29,159.52,-0.36,-0.22,172.65,-7.6,True,1,14095,-159.52,-750170.89,2248434.4,1498263.51
1984-03-30,159.18,-0.34,-0.21,172.65,-7.8,True,1,14096,-159.18,-750330.07,2243801.28,1493471.21
1984-04-02,157.98,-1.2,-0.75,172.65,-8.5,True,1,14097,-157.98,-750488.05,2227044.06,1476556.01
1984-04-03,157.66,-0.32,-0.2,172.65,-8.68,True,1,14098,-157.66,-750645.71,2222690.68,1472044.97
1984-04-04,157.54,-0.12,-0.08,172.65,-8.75,True,1,14099,-157.54,-750803.25,2221156.46,1470353.21
1984-04-05,155.04,-2.5,-1.59,172.65,-10.2,True,1,14100,-155.04,-750958.29,2186064.0,1435105.71
1984-04-06,155.48,0.44,0.28,172.65,-9.94,True,1,14101,-155.48,-751113.77,2192423.48,1441309.71
1984-04-09,155.45,-0.03,-0.02,172.65,-9.96,True,1,14102,-155.45,-751269.22,2192155.9,1440886.68
1984-04-10,155.87,0.42,0.27,172.65,-9.72,True,1,14103,-155.87,-751425.09,2198234.61,1446809.52
1984-04-11,155.0,-0.87,-0.56,172.65,-10.22,True,1,14104,-155.0,-751580.09,2186120.0,1434539.91
1984-04-12,157.73,2.73,1.76,172.65,-8.64,True,1,14105,-157.73,-751737.82,2224781.65,1473043.83
1984-04-13,157.31,-0.42,-0.27,172.65,-8.88,True,1,14106,-157.31,-751895.13,2219014.86,1467119.73
1984-04-16,158.32,1.01,0.64,172.65,-8.3,True,1,14107,-158.32,-752053.45,2233420.24,1481366.79
1984-04-17,158.97,0.65,0.41,172.65,-7.92,True,1,14108,-158.97,-752212.42,2242748.76,1490536.34
1984-04-18,157.9,-1.07,-0.67,172.65,-8.54,True,1,14109,-157.9,-752370.32,2227811.1,1475440.78
1984-04-19,158.02,0.12,0.08,172.65,-8.47,True,1,14110,-158.02,-752528.34,2229662.2,1477133.86
1984-04-23,156.8,-1.22,-0.77,172.65,-9.18,True,1,14111,-156.8,-752685.14,2212604.8,1459919.66
1984-04-24,158.07,1.27,0.81,172.65,-8.44,True,1,14112,-158.07,-752843.21,2230683.84,1477840.63
1984-04-25,158.65,0.58,0.37,172.65,-8.11,True,1,14113,-158.65,-753001.86,2239027.45,1486025.59
1984-04-26,160.3,1.65,1.04,172.65,-7.15,True,1,14114,-160.3,-753162.16,2262474.2,1509312.04
1984-04-27,159.89,-0.41,-0.26,172.65,-7.39,True,1,14115,-159.89,-753322.05,2256847.35,1503525.3
1984-04-30,160.05,0.16,0.1,172.65,-7.3,True,1,14116,-160.05,-753482.1,2259265.8,1505783.7
1984-05-01,161.68,1.63,1.02,172.65,-6.35,True,1,14117,-161.68,-753643.78,2282436.56,1528792.78
1984-05-02,161.9,0.22,0.14,172.65,-6.23,True,1,14118,-161.9,-753805.68,2285704.2,1531898.52
1984-05-03,161.2,-0.7,-0.43,172.65,-6.63,True,1,14119,-161.2,-753966.88,2275982.8,1522015.92
1984-05-04,159.11,-2.09,-1.3,172.65,-7.84,True,1,14120,-159.11,-754125.99,2246633.2,1492507.21
1984-05-07,159.47,0.36,0.23,172.65,-7.63,True,1,14121,-159.47,-754285.46,2251875.87,1497590.41
1984-05-08,160.52,1.05,0.66,172.65,-7.03,True,1,14122,-160.52,-754445.98,2266863.44,1512417.46
1984-05-09,160.11,-0.41,-0.26,172.65,-7.26,True,1,14123,-160.11,-754606.09,2261233.53,1506627.44
1984-05-10,160.0,-0.11,-0.07,172.65,-7.33,True,1,14124,-160.0,-754766.09,2259840.0,1505073.91
1984-05-11,158.49,-1.51,-0.94,172.65,-8.2,True,1,14125,-158.49,-754924.58,2238671.25,1483746.67
1984-05-14,157.5,-0.99,-0.62,172.65,-8.78,True,1,14126,-157.5,-755082.08,2224845.0,1469762.92
1984-05-15,158.0,0.5,0.32,172.65,-8.48,True,1,14127,-158.0,-755240.08,2232066.0,1476825.92
1984-05-16,157.99,-0.01,-0.01,172.65,-8.49,True,1,14128,-157.99,-755398.07,2232082.72,1476684.65
1984-05-17,156.57,-1.42,-0.9,172.65,-9.31,True,1,14129,-156.57,-755554.64,2212177.53,1456622.89
1984-05-18,155.78,-0.79,-0.5,172.65,-9.77,True,1,14130,-155.78,-755710.42,2201171.4,1445460.98
1984-05-21,154.73,-1.05,-0.67,172.65,-10.38,True,1,14131,-154.73,-755865.15,2186489.63,1430624.48
1984-05-22,153.88,-0.85,-0.55,172.65,-10.87,True,1,14132,-153.88,-756019.03,2174632.16,1418613.13
1984-05-23,153.15,-0.73,-0.47,172.65,-11.3,True,1,14133,-153.15,-756172.18,2164468.95,1408296.77
1984-05-24,151.23,-1.92,-1.25,172.65,-12.41,True,1,14134,-151.23,-756323.41,2137484.82,1381161.41
1984-05-25,151.62,0.39,0.26,172.65,-12.18,True,1,14135,-151.62,-756475.03,2143148.7,1386673.67
1984-05-29,150.29,-1.33,-0.88,172.65,-12.95,True,1,14136,-150.29,-756625.32,2124499.44,1367874.12
1984-05-30,150.35,0.06,0.04,172.65,-12.92,True,1,14137,-150.35,-756775.67,2125497.95,1368722.28
1984-05-31,150.55,0.2,0.13,172.65,-12.8,True,1,14138,-150.55,-756926.22,2128475.9,1371549.68
1984-06-01,153.24,2.69,1.79,172.65,-11.24,True,1,14139,-153.24,-757079.46,2166660.36,1409580.9
1984-06-04,154.34,1.1,0.72,172.65,-10.6,True,1,14140,-154.34,-757233.8,2182367.6,1425133.8
1984-06-05,153.65,-0.69,-0.45,172.65,-11.0,True,1,14141,-153.65,-757387.45,2172764.65,1415377.2
1984-06-06,155.01,1.36,0.88,172.65,-10.22,True,1,14142,-155.01,-757542.46,2192151.42,1434608.96
1984-06-07,154.92,-0.09,-0.06,172.65,-10.27,True,1,14143,-154.92,-757697.38,2191033.56,1433336.18
1984-06-08,155.17,0.25,0.16,172.65,-10.12,True,1,14144,-155.17,-757852.55,2194724.48,1436871.93
1984-06-11,153.06,-2.11,-1.36,172.65,-11.35,True,1,14145,-153.06,-758005.61,2165033.7,1407028.09
1984-06-12,152.19,-0.87,-0.57,172.65,-11.85,True,1,14146,-152.19,-758157.8,2152879.74,1394721.94
1984-06-13,152.13,-0.06,-0.04,172.65,-11.88,True,1,14147,-152.13,-758309.93,2152183.11,1393873.18
1984-06-14,150.39,-1.74,-1.14,172.65,-12.89,True,1,14148,-150.39,-758460.32,2127717.72,1369257.4
1984-06-15,149.03,-1.36,-0.9,172.65,-13.68,True,1,14149,-149.03,-758609.35,2108625.47,1350016.12
1984-06-18,151.73,2.7,1.81,172.65,-12.12,True,1,14150,-151.73,-758761.08,2146979.5,1388218.42
1984-06-19,152.61,0.88,0.58,172.65,-11.61,True,1,14151,-152.61,-758913.69,2159584.11,1400670.42
1984-06-20,154.84,2.23,1.46,172.65,-10.32,True,1,14152,-154.84,-759068.53,2191295.68,1432227.15
1984-06-21,154.51,-0.33,-0.21,172.65,-10.51,True,1,14153,-154.51,-759223.04,2186780.03,1427556.99
1984-06-22,154.46,-0.05,-0.03,172.65,-10.54,True,1,14154,-154.46,-759377.5,2186226.84,1426849.34
1984-06-25,153.97,-0.49,-0.32,172.65,-10.82,True,1,14155,-153.97,-759531.47,2179445.35,1419913.88
1984-06-26,152.71,-1.26,-0.82,172.65,-11.55,True,1,14156,-152.71,-759684.18,2161762.76,1402078.58
1984-06-27,151.64,-1.07,-0.7,172.65,-12.17,True,1,14157,-151.64,-759835.82,2146767.48,1386931.66
1984-06-28,152.84,1.2,0.79,172.65,-11.47,True,1,14158,-152.84,-759988.66,2163908.72,1403920.06
1984-06-29,153.18,0.34,0.22,172.65,-11.28,True,1,14159,-153.18,-760141.84,2168875.62,1408733.78
1984-07-02,153.2,0.02,0.01,172.65,-11.27,True,1,14160,-153.2,-760295.04,2169312.0,1409016.96
1984-07-03,153.7,0.5,0.33,172.65,-10.98,True,1,14161,-153.7,-760448.74,2176545.7,1416096.96
1984-07-05,152.76,-0.94,-0.61,172.65,-11.52,True,1,14162,-152.76,-760601.5,2163387.12,1402785.62
1984-07-06,152.24,-0.52,-0.34,172.65,-11.82,True,1,14163,-152.24,-760753.74,2156175.12,1395421.38
1984-07-09,153.36,1.12,0.74,172.65,-11.17,True,1,14164,-153.36,-760907.1,2172191.04,1411283.94
1984-07-10,152.89,-0.47,-0.31,172.65,-11.44,True,1,14165,-152.89,-761059.99,2165686.85,1404626.86
1984-07-11,150.56,-2.33,-1.52,172.65,-12.8,True,1,14166,-150.56,-761210.55,2132832.96,1371622.41
1984-07-12,150.03,-0.53,-0.35,172.65,-13.1,True,1,14167,-150.03,-761360.58,2125475.01,1364114.43
1984-07-13,150.88,0.85,0.57,172.65,-12.61,True,1,14168,-150.88,-761511.46,2137667.84,1376156.38
1984-07-16,151.6,0.72,0.48,172.65,-12.19,True,1,14169,-151.6,-761663.06,2148020.4,1386357.34
1984-07-17,152.38,0.78,0.52,172.65,-11.74,True,1,14170,-152.38,-761815.44,2159224.6,1397409.16
1984-07-18,151.4,-0.98,-0.64,172.65,-12.31,True,1,14171,-151.4,-761966.84,2145489.4,1383522.56
1984-07-19,150.37,-1.03,-0.68,172.65,-12.9,True,1,14172,-150.37,-762117.21,2131043.64,1368926.43
1984-07-20,149.55,-0.82,-0.55,172.65,-13.38,True,1,14173,-149.55,-762266.76,2119572.15,1357305.39
1984-07-23,148.95,-0.6,-0.4,172.65,-13.73,True,1,14174,-148.95,-762415.71,2111217.3,1348801.59
1984-07-24,147.82,-1.13,-0.76,172.65,-14.38,True,1,14175,-147.82,-762563.53,2095348.5,1332784.97
1984-07-25,148.83,1.01,0.68,172.65,-13.8,True,1,14176,-148.83,-762712.36,2109814.08,1347101.72
1984-07-26,150.08,1.25,0.84,172.65,-13.07,True,1,14177,-150.08,-762862.44,2127684.16,1364821.72
1984-07-27,151.19,1.11,0.74,172.65,-12.43,True,1,14178,-151.19,-763013.63,2143571.82,1380558.19
1984-07-30,150.19,-1.0,-0.66,172.65,-13.01,True,1,14179,-150.19,-763163.82,2129544.01,1366380.19
1984-07-31,150.66,0.47,0.31,172.65,-12.74,True,1,14180,-150.66,-763314.48,2136358.8,1373044.32
1984-08-01,154.08,3.42,2.27,172.65,-10.76,True,1,14181,-154.08,-763468.56,2185008.48,1421539.92
1984-08-02,157.99,3.91,2.54,172.65,-8.49,True,1,14182,-157.99,-763626.55,2240614.18,1476987.63
1984-08-03,162.35,4.36,2.76,172.65,-5.97,True,1,14183,-162.35,-763788.9,2302610.05,1538821.15
1984-08-06,162.6,0.25,0.15,172.65,-5.82,True,1,14184,-162.6,-763951.5,2306318.4,1542366.9
1984-08-07,162.72,0.12,0.07,172.65,-5.75,True,1,14185,-162.72,-764114.22,2308183.2,1544068.98
1984-08-08,161.75,-0.97,-0.6,172.65,-6.31,True,1,14186,-161.75,-764275.97,2294585.5,1530309.53
1984-08-09,165.54,3.79,2.34,172.65,-4.12,True,1,14187,-165.54,-764441.51,2348515.98,1584074.47
1984-08-10,165.42,-0.12,-0.07,172.65,-4.19,True,1,14188,-165.42,-764606.93,2346978.96,1582372.03
1984-08-13,165.43,0.01,0.01,172.65,-4.18,True,1,14189,-165.43,-764772.36,2347286.27,1582513.91
1984-08-14,164.42,-1.01,-0.61,172.65,-4.77,True,1,14190,-164.42,-764936.78,2333119.8,1568183.02
1984-08-15,162.8,-1.62,-0.98,172.65,-5.7,True,1,14191,-162.8,-765099.58,2310294.8,1545195.22
1984-08-16,163.77,0.97,0.6,172.65,-5.14,True,1,14192,-163.77,-765263.35,2324223.84,1558960.49
1984-08-17,164.14,0.37,0.23,172.65,-4.93,True,1,14193,-164.14,-765427.49,2329639.02,1564211.53
1984-08-20,164.94,0.8,0.49,172.65,-4.47,True,1,14194,-164.94,-765592.43,2341158.36,1575565.93
1984-08-21,167.83,2.89,1.75,172.65,-2.79,True,1,14195,-167.83,-765760.26,2382346.85,1616586.59
1984-08-22,167.06,-0.77,-0.46,172.65,-3.24,True,1,14196,-167.06,-765927.32,2371583.76,1605656.44
1984-08-23,167.12,0.06,0.04,172.65,-3.2,True,1,14197,-167.12,-766094.44,2372602.64,1606508.2
1984-08-24,167.51,0.39,0.23,172.65,-2.98,True,1,14198,-167.51,-766261.95,2378306.98,1612045.03
1984-08-27,166.44,-1.07,-0.64,172.65,-3.6,True,1,14199,-166.44,-766428.39,2363281.56,1596853.17
1984-08-28,167.4,0.96,0.58,172.65,-3.04,True,1,14200,-167.4,-766595.79,2377080.0,1610484.21
1984-08-29,167.09,-0.31,-0.18,172.65,-3.22,True,1,14201,-167.09,-766762.88,2372845.09,1606082.21
1984-08-30,166.6,-0.49,-0.29,172.65,-3.5,True,1,14202,-166.6,-766929.48,2366053.2,1599123.72
1984-08-31,166.68,0.08,0.05,172.65,-3.46,True,1,14203,-166.68,-767096.16,2367356.04,1600259.88
1984-09-04,164.88,-1.8,-1.08,172.65,-4.5,True,1,14204,-164.88,-767261.04,2341955.52,1574694.48
1984-09-05,164.29,-0.59,-0.36,172.65,-4.84,True,1,14205,-164.29,-767425.33,2333739.45,1566314.12
1984-09-06,165.65,1.36,0.83,172.65,-4.05,True,1,14206,-165.65,-767590.98,2353223.9,1585632.92
1984-09-07,164.37,-1.28,-0.77,172.65,-4.8,True,1,14207,-164.37,-767755.35,2335204.59,1567449.24
1984-09-10,164.26,-0.11,-0.07,172.65,-4.86,True,1,14208,-164.26,-767919.61,2333806.08,1565886.47
1984-09-11,164.45,0.19,0.12,172.65,-4.75,True,1,14209,-164.45,-768084.06,2336670.05,1568585.99
1984-09-12,164.68,0.23,0.14,172.65,-4.62,True,1,14210,-164.68,-768248.74,2340102.8,1571854.06
1984-09-13,167.94,3.26,1.98,172.65,-2.73,True,1,14211,-167.94,-768416.68,2386595.34,1618178.66
1984-09-14,168.78,0.84,0.5,172.65,-2.24,True,1,14212,-168.78,-768585.46,2398701.36,1630115.9
1984-09-17,168.87,0.09,0.05,172.65,-2.19,True,1,14213,-168.87,-768754.33,2400149.31,1631394.98
1984-09-18,167.65,-1.22,-0.72,172.65,-2.9,True,1,14214,-167.65,-768921.98,2382977.1,1614055.12
1984-09-19,166.94,-0.71,-0.42,172.65,-3.31,True,1,14215,-166.94,-769088.92,2373052.1,1603963.18
1984-09-20,167.47,0.53,0.32,172.65,-3.0,True,1,14216,-167.47,-769256.39,2380753.52,1611497.13
1984-09-21,165.67,-1.8,-1.08,172.65,-4.04,True,1,14217,-165.67,-769422.06,2355330.39,1585908.33
1984-09-24,165.28,-0.39,-0.24,172.65,-4.27,True,1,14218,-165.28,-769587.34,2349951.04,1580363.7
1984-09-25,165.62,0.34,0.21,172.65,-4.07,True,1,14219,-165.62,-769752.96,2354950.78,1585197.82
1984-09-26,166.28,0.66,0.4,172.65,-3.69,True,1,14220,-166.28,-769919.24,2364501.6,1594582.36
1984-09-27,166.96,0.68,0.41,172.65,-3.3,True,1,14221,-166.96,-770086.2,2374338.16,1604251.96
1984-09-28,166.1,-0.86,-0.52,172.65,-3.79,True,1,14222,-166.1,-770252.3,2362274.2,1592021.9
1984-10-01,164.62,-1.48,-0.89,172.65,-4.65,True,1,14223,-164.62,-770416.92,2341390.26,1570973.34
1984-10-02,163.59,-1.03,-0.63,172.65,-5.25,True,1,14224,-163.59,-770580.51,2326904.16,1556323.65
1984-10-03,162.44,-1.15,-0.7,172.65,-5.91,True,1,14225,-162.44,-770742.95,2310709.0,1539966.05
1984-10-04,162.92,0.48,0.3,172.65,-5.64,True,1,14226,-162.92,-770905.87,2317699.92,1546794.05
1984-10-05,162.68,-0.24,-0.15,172.65,-5.78,True,1,14227,-162.68,-771068.55,2314448.36,1543379.81
1984-10-08,162.13,-0.55,-0.34,172.65,-6.09,True,1,14228,-162.13,-771230.68,2306785.64,1535554.96
1984-10-09,161.67,-0.46,-0.28,172.65,-6.36,True,1,14229,-161.67,-771392.35,2300402.43,1529010.08
1984-10-10,162.11,0.44,0.27,172.65,-6.1,True,1,14230,-162.11,-771554.46,2306825.3,1535270.84
1984-10-11,162.78,0.67,0.41,172.65,-5.72,True,1,14231,-162.78,-771717.24,2316522.18,1544804.94
1984-10-12,164.18,1.4,0.86,172.65,-4.91,True,1,14232,-164.18,-771881.42,2336609.76,1564728.34
1984-10-15,165.77,1.59,0.97,172.65,-3.98,True,1,14233,-165.77,-772047.19,2359404.41,1587357.22
1984-10-16,164.78,-0.99,-0.6,172.65,-4.56,True,1,14234,-164.78,-772211.97,2345478.52,1573266.55
1984-10-17,164.14,-0.64,-0.39,172.65,-4.93,True,1,14235,-164.14,-772376.11,2336532.9,1564156.79
1984-10-18,168.1,3.96,2.41,172.65,-2.64,True,1,14236,-168.1,-772544.21,2393071.6,1620527.39
1984-10-19,167.96,-0.14,-0.08,172.65,-2.72,True,1,14237,-167.96,-772712.17,2391246.52,1618534.35
1984-10-22,167.36,-0.6,-0.36,172.65,-3.06,True,1,14238,-167.36,-772879.53,2382871.68,1609992.15
1984-10-23,167.09,-0.27,-0.16,172.65,-3.22,True,1,14239,-167.09,-773046.62,2379194.51,1606147.89
1984-10-24,167.2,0.11,0.07,172.65,-3.16,True,1,14240,-167.2,-773213.82,2380928.0,1607714.18
1984-10-25,166.31,-0.89,-0.53,172.65,-3.67,True,1,14241,-166.31,-773380.13,2368420.71,1595040.58
1984-10-26,165.29,-1.02,-0.61,172.65,-4.26,True,1,14242,-165.29,-773545.42,2354060.18,1580514.76
1984-10-29,164.78,-0.51,-0.31,172.65,-4.56,True,1,14243,-164.78,-773710.2,2346961.54,1573251.34
1984-10-30,166.84,2.06,1.25,172.65,-3.36,True,1,14244,-166.84,-773877.04,2376468.96,1602591.92
1984-10-31,166.09,-0.75,-0.45,172.65,-3.8,True,1,14245,-166.09,-774043.13,2365952.05,1591908.92
1984-11-01,167.49,1.4,0.84,172.65,-2.99,True,1,14246,-167.49,-774210.62,2386062.54,1611851.92
1984-11-02,167.42,-0.07,-0.04,172.65,-3.03,True,1,14247,-167.42,-774378.04,2385232.74,1610854.7
1984-11-05,168.58,1.16,0.69,172.65,-2.36,True,1,14248,-168.58,-774546.62,2401927.84,1627381.22
1984-11-06,170.41,1.83,1.09,172.65,-1.3,True,1,14249,-170.41,-774717.03,2428172.09,1653455.06
1984-11-07,169.17,-1.24,-0.73,172.65,-2.02,True,1,14250,-169.17,-774886.2,2410672.5,1635786.3
1984-11-08,168.68,-0.49,-0.29,172.65,-2.3,True,1,14251,-168.68,-775054.88,2403858.68,1628803.8
1984-11-09,167.6,-1.08,-0.64,172.65,-2.92,True,1,14252,-167.6,-775222.48,2388635.2,1613412.72
1984-11-12,167.36,-0.24,-0.14,172.65,-3.06,True,1,14253,-167.36,-775389.84,2385382.08,1609992.24
1984-11-13,165.97,-1.39,-0.83,172.65,-3.87,True,1,14254,-165.97,-775555.81,2365736.38,1590180.57
1984-11-14,165.99,0.02,0.01,172.65,-3.86,True,1,14255,-165.99,-775721.8,2366187.45,1590465.65
1984-11-15,165.89,-0.1,-0.06,172.65,-3.92,True,1,14256,-165.89,-775887.69,2364927.84,1589040.15
1984-11-16,164.1,-1.79,-1.08,172.65,-4.95,True,1,14257,-164.1,-776051.79,2339573.7,1563521.91
1984-11-19,163.09,-1.01,-0.62,172.65,-5.54,True,1,14258,-163.09,-776214.88,2325337.22,1549122.34
1984-11-20,164.18,1.09,0.67,172.65,-4.91,True,1,14259,-164.18,-776379.06,2341042.62,1564663.56
1984-11-21,164.51,0.33,0.2,172.65,-4.72,True,1,14260,-164.51,-776543.57,2345912.6,1569369.03
1984-11-23,166.92,2.41,1.46,172.65,-3.32,True,1,14261,-166.92,-776710.49,2380446.12,1603735.63
1984-11-26,165.55,-1.37,-0.82,172.65,-4.11,True,1,14262,-165.55,-776876.04,2361074.1,1584198.06
1984-11-27,166.29,0.74,0.45,172.65,-3.68,True,1,14263,-166.29,-777042.33,2371794.27,1594751.94
1984-11-28,165.02,-1.27,-0.76,172.65,-4.42,True,1,14264,-165.02,-777207.35,2353845.28,1576637.93
1984-11-29,163.91,-1.11,-0.67,172.65,-5.06,True,1,14265,-163.91,-777371.26,2338176.15,1560804.89
1984-11-30,163.58,-0.33,-0.2,172.65,-5.25,True,1,14266,-163.58,-777534.84,2333632.28,1556097.44
1984-12-03,162.82,-0.76,-0.46,172.65,-5.69,True,1,14267,-162.82,-777697.66,2322952.94,1545255.28
1984-12-04,163.38,0.56,0.34,172.65,-5.37,True,1,14268,-163.38,-777861.04,2331105.84,1553244.8
1984-12-05,162.1,-1.28,-0.78,172.65,-6.11,True,1,14269,-162.1,-778023.14,2313004.9,1534981.76
1984-12-06,162.76,0.66,0.41,172.65,-5.73,True,1,14270,-162.76,-778185.9,2322585.2,1544399.3
1984-12-07,162.26,-0.5,-0.31,172.65,-6.02,True,1,14271,-162.26,-778348.16,2315612.46,1537264.3
1984-12-10,162.83,0.57,0.35,172.65,-5.69,True,1,14272,-162.83,-778510.99,2323909.76,1545398.77
1984-12-11,163.07,0.24,0.15,172.65,-5.55,True,1,14273,-163.07,-778674.06,2327498.11,1548824.05
1984-12-12,162.63,-0.44,-0.27,172.65,-5.8,True,1,14274,-162.63,-778836.69,2321380.62,1542543.93
1984-12-13,161.81,-0.82,-0.5,172.65,-6.28,True,1,14275,-161.81,-778998.5,2309837.75,1530839.25
1984-12-14,162.69,0.88,0.54,172.65,-5.77,True,1,14276,-162.69,-779161.19,2322562.44,1543401.25
1984-12-17,163.61,0.92,0.56,172.65,-5.24,True,1,14277,-163.61,-779324.8,2335859.97,1556535.17
1984-12-18,168.11,4.5,2.75,172.65,-2.63,True,1,14278,-168.11,-779492.91,2400274.58,1620781.67
1984-12-19,167.16,-0.95,-0.56,172.65,-3.18,True,1,14279,-167.16,-779660.07,2386877.64,1607217.57
1984-12-20,166.38,-0.78,-0.47,172.65,-3.63,True,1,14280,-166.38,-779826.45,2375906.4,1596079.95
1984-12-21,165.51,-0.87,-0.52,172.65,-4.14,True,1,14281,-165.51,-779991.96,2363648.31,1583656.35
1984-12-24,166.76,1.25,0.76,172.65,-3.41,True,1,14282,-166.76,-780158.72,2381666.32,1601507.6
1984-12-26,166.47,-0.29,-0.17,172.65,-3.58,True,1,14283,-166.47,-780325.19,2377691.01,1597365.82
1984-12-27,165.75,-0.72,-0.43,172.65,-4.0,True,1,14284,-165.75,-780490.94,2367573.0,1587082.06
1984-12-28,166.26,0.51,0.31,172.65,-3.7,True,1,14285,-166.26,-780657.2,2375024.1,1594366.9
1984-12-31,167.24,0.98,0.59,172.65,-3.13,True,1,14286,-167.24,-780824.44,2389190.64,1608366.2
1985-01-02,165.37,-1.87,-1.12,172.65,-4.22,True,1,14287,-165.37,-780989.81,2362641.19,1581651.38
1985-01-03,164.57,-0.8,-0.48,172.65,-4.68,True,1,14288,-164.57,-781154.38,2351376.16,1570221.78
1985-01-04,163.68,-0.89,-0.54,172.65,-5.2,True,1,14289,-163.68,-781318.06,2338823.52,1557505.46
1985-01-07,164.24,0.56,0.34,172.65,-4.87,True,1,14290,-164.24,-781482.3,2346989.6,1565507.3
1985-01-08,163.99,-0.25,-0.15,172.65,-5.02,True,1,14291,-163.99,-781646.29,2343581.09,1561934.8
1985-01-09,165.18,1.19,0.73,172.65,-4.33,True,1,14292,-165.18,-781811.47,2360752.56,1578941.09
1985-01-10,168.31,3.13,1.9,172.65,-2.51,True,1,14293,-168.31,-781979.78,2405654.83,1623675.05
1985-01-11,167.91,-0.4,-0.24,172.65,-2.74,True,1,14294,-167.91,-782147.69,2400105.54,1617957.85
1985-01-14,170.51,2.6,1.55,172.65,-1.24,True,1,14295,-170.51,-782318.2,2437440.45,1655122.25
1985-01-15,170.81,0.3,0.18,172.65,-1.07,True,1,14296,-170.81,-782489.01,2441899.76,1659410.75
1985-01-16,171.19,0.38,0.22,172.65,-0.85,True,1,14297,-171.19,-782660.2,2447503.43,1664843.23
1985-01-17,170.73,-0.46,-0.27,172.65,-1.11,True,1,14298,-170.73,-782830.93,2441097.54,1658266.61
1985-01-18,171.32,0.59,0.35,172.65,-0.77,True,1,14299,-171.32,-783002.25,2449704.68,1666702.43
1985-01-21,175.23,3.91,2.28,175.23,0.0,True,1,14300,-175.23,-783177.48,2505789.0,1722611.52
1985-01-22,175.48,0.25,0.14,175.48,0.0,True,1,14301,-175.48,-783352.96,2509539.48,1726186.52
1985-01-23,177.3,1.82,1.04,177.3,0.0,True,1,14302,-177.3,-783530.26,2535744.6,1752214.34
1985-01-24,176.71,-0.59,-0.33,177.3,-0.33,True,1,14303,-176.71,-783706.97,2527483.13,1743776.16
1985-01-25,177.35,0.64,0.36,177.35,0.0,True,1,14304,-177.35,-783884.32,2536814.4,1752930.08
1985-01-28,177.4,0.05,0.03,177.4,0.0,True,1,14305,-177.4,-784061.72,2537707.0,1753645.28
1985-01-29,179.18,1.78,1.0,179.18,0.0,True,1,14306,-179.18,-784240.9,2563349.08,1779108.18
1985-01-30,179.39,0.21,0.12,179.39,0.0,True,1,14307,-179.39,-784420.29,2566532.73,1782112.44
1985-01-31,179.63,0.24,0.13,179.63,0.0,True,1,14308,-179.63,-784599.92,2570146.04,1785546.12
1985-02-01,178.63,-1.0,-0.56,179.63,-0.56,True,1,14309,-178.63,-784778.55,2556016.67,1771238.12
1985-02-04,180.35,1.72,0.96,180.35,0.0,True,1,14310,-180.35,-784958.9,2580808.5,1795849.6
1985-02-05,180.61,0.26,0.14,180.61,0.0,True,1,14311,-180.61,-785139.51,2584709.71,1799570.2
1985-02-06,180.43,-0.18,-0.1,180.61,-0.1,True,1,14312,-180.43,-785319.94,2582314.16,1796994.22
1985-02-07,181.82,1.39,0.77,181.82,0.0,True,1,14313,-181.82,-785501.76,2602389.66,1816887.9
1985-02-08,182.19,0.37,0.2,182.19,0.0,True,1,14314,-182.19,-785683.95,2607867.66,1822183.71
1985-02-11,180.51,-1.68,-0.92,182.19,-0.92,True,1,14315,-180.51,-785864.46,2584000.65,1798136.19
1985-02-12,180.56,0.05,0.03,182.19,-0.9,True,1,14316,-180.56,-786045.02,2584896.96,1798851.94
1985-02-13,183.35,2.79,1.54,183.35,0.0,True,1,14317,-183.35,-786228.37,2625021.95,1838793.58
1985-02-14,182.41,-0.94,-0.51,183.35,-0.51,True,1,14318,-182.41,-786410.78,2611746.38,1825335.6
1985-02-15,181.6,-0.81,-0.44,183.35,-0.95,True,1,14319,-181.6,-786592.38,2600330.4,1813738.02
1985-02-19,181.33,-0.27,-0.15,183.35,-1.1,True,1,14320,-181.33,-786773.71,2596645.6,1809871.89
1985-02-20,181.18,-0.15,-0.08,183.35,-1.18,True,1,14321,-181.18,-786954.89,2594678.78,1807723.89
1985-02-21,180.19,-0.99,-0.55,183.35,-1.72,True,1,14322,-180.19,-787135.08,2580681.18,1793546.1
1985-02-22,179.36,-0.83,-0.46,183.35,-2.18,True,1,14323,-179.36,-787314.44,2568973.28,1781658.84
1985-02-25,179.23,-0.13,-0.07,183.35,-2.25,True,1,14324,-179.23,-787493.67,2567290.52,1779796.85
1985-02-26,181.17,1.94,1.08,183.35,-1.19,True,1,14325,-181.17,-787674.84,2595260.25,1807585.41
1985-02-27,180.71,-0.46,-0.25,183.35,-1.44,True,1,14326,-180.71,-787855.55,2588851.46,1800995.91
1985-02-28,181.18,0.47,0.26,183.35,-1.18,True,1,14327,-181.18,-788036.73,2595765.86,1807729.13
1985-03-01,183.23,2.05,1.13,183.35,-0.06,True,1,14328,-183.23,-788219.96,2625319.44,1837099.48
1985-03-04,182.06,-1.17,-0.64,183.35,-0.7,True,1,14329,-182.06,-788402.02,2608737.74,1820335.72
1985-03-05,182.23,0.17,0.09,183.35,-0.61,True,1,14330,-182.23,-788584.25,2611355.9,1822771.65
1985-03-06,180.65,-1.58,-0.87,183.35,-1.47,True,1,14331,-180.65,-788764.9,2588895.15,1800130.25
1985-03-07,179.51,-1.14,-0.63,183.35,-2.09,True,1,14332,-179.51,-788944.41,2572737.32,1783792.91
1985-03-08,179.1,-0.41,-0.23,183.35,-2.32,True,1,14333,-179.1,-789123.51,2567040.3,1777916.79
1985-03-11,178.79,-0.31,-0.17,183.35,-2.49,True,1,14334,-178.79,-789302.3,2562775.86,1773473.56
1985-03-12,179.66,0.87,0.49,183.35,-2.01,True,1,14335,-179.66,-789481.96,2575426.1,1785944.14
1985-03-13,178.19,-1.47,-0.82,183.35,-2.81,True,1,14336,-178.19,-789660.15,2554531.84,1764871.69
1985-03-14,177.84,-0.35,-0.2,183.35,-3.0,True,1,14337,-177.84,-789837.99,2549692.08,1759854.09
1985-03-15,176.53,-1.31,-0.74,183.35,-3.72,True,1,14338,-176.53,-790014.52,2531087.14,1741072.62
1985-03-18,176.88,0.35,0.2,183.35,-3.53,True,1,14339,-176.88,-790191.4,2536282.32,1746090.92
1985-03-19,179.54,2.66,1.5,183.35,-2.08,True,1,14340,-179.54,-790370.94,2574603.6,1784232.66
1985-03-20,179.08,-0.46,-0.26,183.35,-2.33,True,1,14341,-179.08,-790550.02,2568186.28,1777636.26
1985-03-21,179.35,0.27,0.15,183.35,-2.18,True,1,14342,-179.35,-790729.37,2572237.7,1781508.33
1985-03-22,179.04,-0.31,-0.17,183.35,-2.35,True,1,14343,-179.04,-790908.41,2567970.72,1777062.31
1985-03-25,177.97,-1.07,-0.6,183.35,-2.93,True,1,14344,-177.97,-791086.38,2552801.68,1761715.3
1985-03-26,178.43,0.46,0.26,183.35,-2.68,True,1,14345,-178.43,-791264.81,2559578.35,1768313.54
1985-03-27,179.54,1.11,0.62,183.35,-2.08,True,1,14346,-179.54,-791444.35,2575680.84,1784236.49
1985-03-28,179.54,0.0,0.0,183.35,-2.08,True,1,14347,-179.54,-791623.89,2575860.38,1784236.49
1985-03-29,180.66,1.12,0.62,183.35,-1.47,True,1,14348,-180.66,-791804.55,2592109.68,1800305.13
1985-04-01,181.27,0.61,0.34,183.35,-1.13,True,1,14349,-181.27,-791985.82,2601043.23,1809057.41
1985-04-02,180.53,-0.74,-0.41,183.35,-1.54,True,1,14350,-180.53,-792166.35,2590605.5,1798439.15
1985-04-03,179.11,-1.42,-0.79,183.35,-2.31,True,1,14351,-179.11,-792345.46,2570407.61,1778062.15
1985-04-04,179.03,-0.08,-0.04,183.35,-2.36,True,1,14352,-179.03,-792524.49,2569438.56,1776914.07
1985-04-08,178.03,-1.0,-0.56,183.35,-2.9,True,1,14353,-178.03,-792702.52,2555264.59,1762562.07
1985-04-09,178.21,0.18,0.1,183.35,-2.8,True,1,14354,-178.21,-792880.73,2558026.34,1765145.61
1985-04-10,179.42,1.21,0.68,183.35,-2.14,True,1,14355,-179.42,-793060.15,2575574.1,1782513.95
1985-04-11,180.19,0.77,0.43,183.35,-1.72,True,1,14356,-180.19,-793240.34,2586807.64,1793567.3
1985-04-12,180.54,0.35,0.19,183.35,-1.53,True,1,14357,-180.54,-793420.88,2592012.78,1798591.9
1985-04-15,180.92,0.38,0.21,183.35,-1.32,True,1,14358,-180.92,-793601.8,2597649.36,1804047.56
1985-04-16,181.2,0.28,0.16,183.35,-1.17,True,1,14359,-181.2,-793783.0,2601850.8,1808067.8
1985-04-17,181.68,0.48,0.26,183.35,-0.91,True,1,14360,-181.68,-793964.68,2608924.8,1814960.12
1985-04-18,180.84,-0.84,-0.46,183.35,-1.37,True,1,14361,-180.84,-794145.52,2597043.24,1802897.72
1985-04-19,181.11,0.27,0.15,183.35,-1.22,True,1,14362,-181.11,-794326.63,2601101.82,1806775.19
1985-04-22,180.7,-0.41,-0.23,183.35,-1.44,True,1,14363,-180.7,-794507.33,2595394.1,1800886.77
1985-04-23,181.88,1.18,0.65,183.35,-0.8,True,1,14364,-181.88,-794689.21,2612524.32,1817835.11
1985-04-24,182.26,0.38,0.21,183.35,-0.59,True,1,14365,-182.26,-794871.47,2618164.9,1823293.43
1985-04-25,183.43,1.17,0.64,183.43,0.0,True,1,14366,-183.43,-795054.9,2635155.38,1840100.48
1985-04-26,182.18,-1.25,-0.68,183.43,-0.68,True,1,14367,-182.18,-795237.08,2617380.06,1822142.98
1985-04-29,180.63,-1.55,-0.85,183.43,-1.53,True,1,14368,-180.63,-795417.71,2595291.84,1799874.13
1985-04-30,179.83,-0.8,-0.44,183.43,-1.96,True,1,14369,-179.83,-795597.54,2583977.27,1788379.73
1985-05-01,178.37,-1.46,-0.81,183.43,-2.76,True,1,14370,-178.37,-795775.91,2563176.9,1767400.99
1985-05-02,179.01,0.64,0.36,183.43,-2.41,True,1,14371,-179.01,-795954.92,2572552.71,1776597.79
1985-05-03,180.08,1.07,0.6,183.43,-1.83,True,1,14372,-180.08,-796135.0,2588109.76,1791974.76
1985-05-06,179.99,-0.09,-0.05,183.43,-1.88,True,1,14373,-179.99,-796314.99,2586996.27,1790681.28
1985-05-07,180.76,0.77,0.43,183.43,-1.46,True,1,14374,-180.76,-796495.75,2598244.24,1801748.49
1985-05-08,180.62,-0.14,-0.08,183.43,-1.53,True,1,14375,-180.62,-796676.37,2596412.5,1799736.13
1985-05-09,181.92,1.3,0.72,183.43,-0.82,True,1,14376,-181.92,-796858.29,2615281.92,1818423.63
1985-05-10,184.28,2.36,1.3,184.28,0.0,True,1,14377,-184.28,-797042.57,2649393.56,1852350.99
1985-05-13,184.61,0.33,0.18,184.61,0.0,True,1,14378,-184.61,-797227.18,2654322.58,1857095.4
1985-05-14,183.87,-0.74,-0.4,184.61,-0.4,True,1,14379,-183.87,-797411.05,2643866.73,1846455.68
1985-05-15,184.54,0.67,0.36,184.61,-0.04,True,1,14380,-184.54,-797595.59,2653685.2,1856089.61
1985-05-16,185.66,1.12,0.61,185.66,0.0,True,1,14381,-185.66,-797781.25,2669976.46,1872195.21
1985-05-17,187.42,1.76,0.95,187.42,0.0,True,1,14382,-187.42,-797968.67,2695474.44,1897505.77
1985-05-20,189.72,2.3,1.23,189.72,0.0,True,1,14383,-189.72,-798158.39,2728742.76,1930584.37
1985-05-21,189.64,-0.08,-0.04,189.72,-0.04,True,1,14384,-189.64,-798348.03,2727781.76,1929433.73
1985-05-22,188.56,-1.08,-0.57,189.72,-0.61,True,1,14385,-188.56,-798536.59,2712435.6,1913899.01
1985-05-23,187.6,-0.96,-0.51,189.72,-1.12,True,1,14386,-187.6,-798724.19,2698813.6,1900089.41
1985-05-24,188.29,0.69,0.37,189.72,-0.75,True,1,14387,-188.29,-798912.48,2708928.23,1910015.75
1985-05-28,187.86,-0.43,-0.23,189.72,-0.98,True,1,14388,-187.86,-799100.34,2702929.68,1903829.34
1985-05-29,187.68,-0.18,-0.1,189.72,-1.08,True,1,14389,-187.68,-799288.02,2700527.52,1901239.5
1985-05-30,187.75,0.07,0.04,189.72,-1.04,True,1,14390,-187.75,-799475.77,2701722.5,1902246.73
1985-05-31,189.55,1.8,0.96,189.72,-0.09,True,1,14391,-189.55,-799665.32,2727814.05,1928148.73
1985-06-03,189.32,-0.23,-0.12,189.72,-0.21,True,1,14392,-189.32,-799854.64,2724693.44,1924838.8
1985-06-04,190.04,0.72,0.38,190.04,0.0,True,1,14393,-190.04,-800044.68,2735245.72,1935201.04
1985-06-05,190.16,0.12,0.06,190.16,0.0,True,1,14394,-190.16,-800234.84,2737163.04,1936928.2
1985-06-06,191.06,0.9,0.47,191.06,0.0,True,1,14395,-191.06,-800425.9,2750308.7,1949882.8
1985-06-07,189.68,-1.38,-0.72,191.06,-0.72,True,1,14396,-189.68,-800615.58,2730633.28,1930017.7
1985-06-10,189.51,-0.17,-0.09,191.06,-0.81,True,1,14397,-189.51,-800805.09,2728375.47,1927570.38
1985-06-11,189.04,-0.47,-0.25,191.06,-1.06,True,1,14398,-189.04,-800994.13,2721797.92,1920803.79
1985-06-12,187.61,-1.43,-0.76,191.06,-1.81,True,1,14399,-187.61,-801181.74,2701396.39,1900214.65
1985-06-13,185.33,-2.28,-1.22,191.06,-3.0,True,1,14400,-185.33,-801367.07,2668752.0,1867384.93
1985-06-14,187.1,1.77,0.96,191.06,-2.07,True,1,14401,-187.1,-801554.17,2694427.1,1892872.93
1985-06-17,186.53,-0.57,-0.3,191.06,-2.37,True,1,14402,-186.53,-801740.7,2686405.06,1884664.36
1985-06-18,187.34,0.81,0.43,191.06,-1.95,True,1,14403,-187.34,-801928.04,2698258.02,1896329.98
1985-06-19,186.63,-0.71,-0.38,191.06,-2.32,True,1,14404,-186.63,-802114.67,2688218.52,1886103.85
1985-06-20,186.73,0.1,0.05,191.06,-2.27,True,1,14405,-186.73,-802301.4,2689845.65,1887544.25
1985-06-21,189.61,2.88,1.54,191.06,-0.76,True,1,14406,-189.61,-802491.01,2731521.66,1929030.65
1985-06-24,189.15,-0.46,-0.24,191.06,-1.0,True,1,14407,-189.15,-802680.16,2725084.05,1922403.89
1985-06-25,189.74,0.59,0.31,191.06,-0.69,True,1,14408,-189.74,-802869.9,2733773.92,1930904.02
1985-06-26,190.06,0.32,0.17,191.06,-0.52,True,1,14409,-190.06,-803059.96,2738574.54,1935514.58
1985-06-27,191.23,1.17,0.62,191.23,0.0,True,1,14410,-191.23,-803251.19,2755624.3,1952373.11
1985-06-28,191.85,0.62,0.32,191.85,0.0,True,1,14411,-191.85,-803443.04,2764750.35,1961307.31
1985-07-01,192.43,0.58,0.3,192.43,0.0,True,1,14412,-192.43,-803635.47,2773301.16,1969665.69
1985-07-02,192.01,-0.42,-0.22,192.43,-0.22,True,1,14413,-192.01,-803827.48,2767440.13,1963612.65
1985-07-03,191.45,-0.56,-0.29,192.43,-0.51,True,1,14414,-191.45,-804018.93,2759560.3,1955541.37
1985-07-05,192.52,1.07,0.56,192.52,0.0,True,1,14415,-192.52,-804211.45,2775175.8,1970964.35
1985-07-08,191.93,-0.59,-0.31,192.52,-0.31,True,1,14416,-191.93,-804403.38,2766862.88,1962459.5
1985-07-09,191.05,-0.88,-0.46,192.52,-0.76,True,1,14417,-191.05,-804594.43,2754367.85,1949773.42
1985-07-10,192.37,1.32,0.69,192.52,-0.08,True,1,14418,-192.37,-804786.8,2773590.66,1968803.86
1985-07-11,192.94,0.57,0.3,192.94,0.0,True,1,14419,-192.94,-804979.74,2782001.86,1977022.12
1985-07-12,193.29,0.35,0.18,193.29,0.0,True,1,14420,-193.29,-805173.03,2787241.8,1982068.77
1985-07-15,192.72,-0.57,-0.3,193.29,-0.3,True,1,14421,-192.72,-805365.75,2779215.12,1973849.37
1985-07-16,194.72,2.0,1.04,194.72,0.0,True,1,14422,-194.72,-805560.47,2808251.84,2002691.37
1985-07-17,195.65,0.93,0.48,195.65,0.0,True,1,14423,-195.65,-805756.12,2821859.95,2016103.83
1985-07-18,194.38,-1.27,-0.65,195.65,-0.65,True,1,14424,-194.38,-805950.5,2803737.12,1997786.62
1985-07-19,195.13,0.75,0.39,195.65,-0.27,True,1,14425,-195.13,-806145.63,2814750.25,2008604.62
1985-07-22,194.35,-0.78,-0.4,195.65,-0.66,True,1,14426,-194.35,-806339.98,2803693.1,1997353.12
1985-07-23,192.55,-1.8,-0.93,195.65,-1.58,True,1,14427,-192.55,-806532.53,2777918.85,1971386.32
1985-07-24,191.58,-0.97,-0.5,195.65,-2.08,True,1,14428,-191.58,-806724.11,2764116.24,1957392.13
1985-07-25,192.06,0.48,0.25,195.65,-1.84,True,1,14429,-192.06,-806916.17,2771233.74,1964317.57
1985-07-26,192.4,0.34,0.18,195.65,-1.66,True,1,14430,-192.4,-807108.57,2776332.0,1969223.43
1985-07-29,189.6,-2.8,-1.46,195.65,-3.09,True,1,14431,-189.6,-807298.17,2736117.6,1928819.43
1985-07-30,189.93,0.33,0.17,195.65,-2.92,True,1,14432,-189.93,-807488.1,2741069.76,1933581.66
1985-07-31,190.92,0.99,0.52,195.65,-2.42,True,1,14433,-190.92,-807679.02,2755548.36,1947869.34
1985-08-01,192.11,1.19,0.62,195.65,-1.81,True,1,14434,-192.11,-807871.13,2772915.74,1965044.61
1985-08-02,191.48,-0.63,-0.33,195.65,-2.13,True,1,14435,-191.48,-808062.61,2764013.8,1955951.19
1985-08-05,190.62,-0.86,-0.45,195.65,-2.57,True,1,14436,-190.62,-808253.23,2751790.32,1943537.09
1985-08-06,187.93,-2.69,-1.41,195.65,-3.95,True,1,14437,-187.93,-808441.16,2713145.41,1904704.25
1985-08-07,187.68,-0.25,-0.13,195.65,-4.07,True,1,14438,-187.68,-808628.84,2709723.84,1901095.0
1985-08-08,188.95,1.27,0.68,195.65,-3.42,True,1,14439,-188.95,-808817.79,2728249.05,1919431.26
1985-08-09,188.32,-0.63,-0.33,195.65,-3.75,True,1,14440,-188.32,-809006.11,2719340.8,1910334.69
1985-08-12,187.63,-0.69,-0.37,195.65,-4.1,True,1,14441,-187.63,-809193.74,2709564.83,1900371.09
1985-08-13,187.3,-0.33,-0.18,195.65,-4.27,True,1,14442,-187.3,-809381.04,2704986.6,1895605.56
1985-08-14,187.41,0.11,0.06,195.65,-4.21,True,1,14443,-187.41,-809568.45,2706762.63,1897194.18
1985-08-15,187.26,-0.15,-0.08,195.65,-4.29,True,1,14444,-187.26,-809755.71,2704783.44,1895027.73
1985-08-16,186.1,-1.16,-0.62,195.65,-4.88,True,1,14445,-186.1,-809941.81,2688214.5,1878272.69
1985-08-19,186.38,0.28,0.15,195.65,-4.74,True,1,14446,-186.38,-810128.19,2692445.48,1882317.29
1985-08-20,188.08,1.7,0.91,195.65,-3.87,True,1,14447,-188.08,-810316.27,2717191.76,1906875.49
1985-08-21,189.16,1.08,0.57,195.65,-3.32,True,1,14448,-189.16,-810505.43,2732983.68,1922478.25
1985-08-22,187.36,-1.8,-0.95,195.65,-4.24,True,1,14449,-187.36,-810692.79,2707164.64,1896471.85
1985-08-23,187.17,-0.19,-0.1,195.65,-4.33,True,1,14450,-187.17,-810879.96,2704606.5,1893726.54
1985-08-26,187.31,0.14,0.08,195.65,-4.26,True,1,14451,-187.31,-811067.27,2706816.81,1895749.54
1985-08-27,188.1,0.79,0.42,195.65,-3.86,True,1,14452,-188.1,-811255.37,2718421.2,1907165.83
1985-08-28,188.83,0.73,0.39,195.65,-3.49,True,1,14453,-188.83,-811444.2,2729159.99,1917715.79
1985-08-29,188.93,0.1,0.05,195.65,-3.44,True,1,14454,-188.93,-811633.13,2730794.22,1919161.09
1985-08-30,188.63,-0.3,-0.16,195.65,-3.59,True,1,14455,-188.63,-811821.76,2726646.65,1914824.89
1985-09-03,187.91,-0.72,-0.38,195.65,-3.96,True,1,14456,-187.91,-812009.67,2716426.96,1904417.29
1985-09-04,187.37,-0.54,-0.29,195.65,-4.23,True,1,14457,-187.37,-812197.04,2708808.09,1896611.05
1985-09-05,187.27,-0.1,-0.05,195.65,-4.28,True,1,14458,-187.27,-812384.31,2707549.66,1895165.35
1985-09-06,188.24,0.97,0.52,195.65,-3.79,True,1,14459,-188.24,-812572.55,2721762.16,1909189.61
1985-09-09,188.25,0.01,0.0,195.65,-3.78,True,1,14460,-188.25,-812760.8,2722095.0,1909334.2
1985-09-10,186.9,-1.35,-0.72,195.65,-4.47,True,1,14461,-186.9,-812947.7,2702760.9,1889813.2
1985-09-11,185.03,-1.87,-1.0,195.65,-5.43,True,1,14462,-185.03,-813132.73,2675903.86,1862771.13
1985-09-12,183.69,-1.34,-0.72,195.65,-6.11,True,1,14463,-183.69,-813316.42,2656708.47,1843392.05
1985-09-13,182.91,-0.78,-0.42,195.65,-6.51,True,1,14464,-182.91,-813499.33,2645610.24,1832110.91
1985-09-16,182.88,-0.03,-0.02,195.65,-6.53,True,1,14465,-182.88,-813682.21,2645359.2,1831676.99
1985-09-17,181.36,-1.52,-0.83,195.65,-7.3,True,1,14466,-181.36,-813863.57,2623553.76,1809690.19
1985-09-18,181.71,0.35,0.19,195.65,-7.12,True,1,14467,-181.71,-814045.28,2628798.57,1814753.29
1985-09-19,183.39,1.68,0.92,195.65,-6.27,True,1,14468,-183.39,-814228.67,2653286.52,1839057.85
1985-09-20,182.05,-1.34,-0.73,195.65,-6.95,True,1,14469,-182.05,-814410.72,2634081.45,1819670.73
1985-09-23,184.3,2.25,1.24,195.65,-5.8,True,1,14470,-184.3,-814595.02,2666821.0,1852225.98
1985-09-24,182.62,-1.68,-0.91,195.65,-6.66,True,1,14471,-182.62,-814777.64,2642694.02,1827916.38
1985-09-25,180.66,-1.96,-1.07,195.65,-7.66,True,1,14472,-180.66,-814958.3,2614511.52,1799553.22
1985-09-26,181.29,0.63,0.35,195.65,-7.34,True,1,14473,-181.29,-815139.59,2623810.17,1808670.58
1985-09-30,182.08,0.79,0.44,195.65,-6.94,True,1,14474,-182.08,-815321.67,2635425.92,1820104.25
1985-10-01,185.07,2.99,1.64,195.65,-5.41,True,1,14475,-185.07,-815506.74,2678888.25,1863381.51
1985-10-02,184.06,-1.01,-0.55,195.65,-5.92,True,1,14476,-184.06,-815690.8,2664452.56,1848761.76
1985-10-03,184.36,0.3,0.16,195.65,-5.77,True,1,14477,-184.36,-815875.16,2668979.72,1853104.56
1985-10-04,183.22,-1.14,-0.62,195.65,-6.35,True,1,14478,-183.22,-816058.38,2652659.16,1836600.78
1985-10-07,181.87,-1.35,-0.74,195.65,-7.04,True,1,14479,-181.87,-816240.25,2633295.73,1817055.48
1985-10-08,181.87,0.0,0.0,195.65,-7.04,True,1,14480,-181.87,-816422.12,2633477.6,1817055.48
1985-10-09,182.52,0.65,0.36,195.65,-6.71,True,1,14481,-182.52,-816604.64,2643072.12,1826467.48
1985-10-10,182.78,0.26,0.14,195.65,-6.58,True,1,14482,-182.78,-816787.42,2647019.96,1830232.54
1985-10-11,184.28,1.5,0.82,195.65,-5.81,True,1,14483,-184.28,-816971.7,2668927.24,1851955.54
1985-10-14,186.37,2.09,1.13,195.65,-4.74,True,1,14484,-186.37,-817158.07,2699383.08,1882225.01
1985-10-15,186.08,-0.29,-0.16,195.65,-4.89,True,1,14485,-186.08,-817344.15,2695368.8,1878024.65
1985-10-16,187.98,1.9,1.02,195.65,-3.92,True,1,14486,-187.98,-817532.13,2723078.28,1905546.15
1985-10-17,187.66,-0.32,-0.17,195.65,-4.08,True,1,14487,-187.66,-817719.79,2718630.42,1900910.63
1985-10-18,187.04,-0.62,-0.33,195.65,-4.4,True,1,14488,-187.04,-817906.83,2709835.52,1891928.69
1985-10-21,186.96,-0.08,-0.04,195.65,-4.44,True,1,14489,-186.96,-818093.79,2708863.44,1890769.65
1985-10-22,188.04,1.08,0.58,195.65,-3.89,True,1,14490,-188.04,-818281.83,2724699.6,1906417.77
1985-10-23,189.09,1.05,0.56,195.65,-3.35,True,1,14491,-189.09,-818470.92,2740103.19,1921632.27
1985-10-24,188.5,-0.59,-0.31,195.65,-3.65,True,1,14492,-188.5,-818659.42,2731742.0,1913082.58
1985-10-25,187.52,-0.98,-0.52,195.65,-4.16,True,1,14493,-187.52,-818846.94,2717727.36,1898880.42
1985-10-28,187.76,0.24,0.13,195.65,-4.03,True,1,14494,-187.76,-819034.7,2721393.44,1902358.74
1985-10-29,189.23,1.47,0.78,195.65,-3.28,True,1,14495,-189.23,-819223.93,2742888.85,1923664.92
1985-10-30,190.07,0.84,0.44,195.65,-2.85,True,1,14496,-190.07,-819414.0,2755254.72,1935840.72
1985-10-31,189.82,-0.25,-0.13,195.65,-2.98,True,1,14497,-189.82,-819603.82,2751820.54,1932216.72
1985-11-01,191.53,1.71,0.9,195.65,-2.11,True,1,14498,-191.53,-819795.35,2776801.94,1957006.59
1985-11-04,191.25,-0.28,-0.15,195.65,-2.25,True,1,14499,-191.25,-819986.6,2772933.75,1952947.15
1985-11-05,192.37,1.12,0.59,195.65,-1.68,True,1,14500,-192.37,-820178.97,2789365.0,1969186.03
1985-11-06,192.76,0.39,0.2,195.65,-1.48,True,1,14501,-192.76,-820371.73,2795212.76,1974841.03
1985-11-07,192.62,-0.14,-0.07,195.65,-1.55,True,1,14502,-192.62,-820564.35,2793375.24,1972810.89
1985-11-08,193.72,1.1,0.57,195.65,-0.99,True,1,14503,-193.72,-820758.07,2809521.16,1988763.09
1985-11-11,197.28,3.56,1.84,197.28,0.0,True,1,14504,-197.28,-820955.35,2861349.12,2040393.77
1985-11-12,198.08,0.8,0.41,198.08,0.0,True,1,14505,-198.08,-821153.43,2873150.4,2051996.97
1985-11-13,197.1,-0.98,-0.5,198.08,-0.5,True,1,14506,-197.1,-821350.53,2859132.6,2037782.07
1985-11-14,199.06,1.96,0.99,199.06,0.0,True,1,14507,-199.06,-821549.59,2887763.42,2066213.83
1985-11-15,198.11,-0.95,-0.48,199.06,-0.48,True,1,14508,-198.11,-821747.7,2874179.88,2052432.18
1985-11-18,198.71,0.6,0.3,199.06,-0.18,True,1,14509,-198.71,-821946.41,2883083.39,2061136.98
1985-11-19,198.67,-0.04,-0.02,199.06,-0.2,True,1,14510,-198.67,-822145.08,2882701.7,2060556.62
1985-11-20,198.99,0.32,0.16,199.06,-0.04,True,1,14511,-198.99,-822344.07,2887543.89,2065199.82
1985-11-21,201.41,2.42,1.22,201.41,0.0,True,1,14512,-201.41,-822545.48,2922861.92,2100316.44
1985-11-22,201.52,0.11,0.06,201.52,0.0,True,1,14513,-201.52,-822747.0,2924659.76,2101912.76
1985-11-25,200.35,-1.17,-0.58,201.52,-0.58,True,1,14514,-200.35,-822947.35,2907879.9,2084932.55
1985-11-26,200.67,0.32,0.16,201.52,-0.42,True,1,14515,-200.67,-823148.02,2912725.05,2089577.03
1985-11-27,202.54,1.87,0.93,202.54,0.0,True,1,14516,-202.54,-823350.56,2940070.64,2116720.08
1985-11-29,202.17,-0.37,-0.18,202.54,-0.18,True,1,14517,-202.17,-823552.73,2934901.89,2111349.16
1985-12-02,200.46,-1.71,-0.85,202.54,-1.03,True,1,14518,-200.46,-823753.19,2910278.28,2086525.09
1985-12-03,200.86,0.4,0.2,202.54,-0.83,True,1,14519,-200.86,-823954.05,2916286.34,2092332.29
1985-12-04,204.23,3.37,1.68,204.23,0.0,True,1,14520,-204.23,-824158.28,2965419.6,2141261.32
1985-12-05,203.88,-0.35,-0.17,204.23,-0.17,True,1,14521,-203.88,-824362.16,2960541.48,2136179.32
1985-12-06,202.99,-0.89,-0.44,204.23,-0.61,True,1,14522,-202.99,-824565.15,2947820.78,2123255.63
1985-12-09,204.25,1.26,0.62,204.25,0.0,True,1,14523,-204.25,-824769.4,2966322.75,2141553.35
1985-12-10,204.39,0.14,0.07,204.39,0.0,True,1,14524,-204.39,-824973.79,2968560.36,2143586.57
1985-12-11,206.31,1.92,0.94,206.31,0.0,True,1,14525,-206.31,-825180.1,2996652.75,2171472.65
1985-12-12,206.73,0.42,0.2,206.73,0.0,True,1,14526,-206.73,-825386.83,3002959.98,2177573.15
1985-12-13,209.94,3.21,1.55,209.94,0.0,True,1,14527,-209.94,-825596.77,3049798.38,2224201.61
1985-12-16,212.02,2.08,0.99,212.02,0.0,True,1,14528,-212.02,-825808.79,3080226.56,2254417.77
1985-12-17,210.65,-1.37,-0.65,212.02,-0.65,True,1,14529,-210.65,-826019.44,3060533.85,2234514.41
1985-12-18,209.81,-0.84,-0.4,212.02,-1.04,True,1,14530,-209.81,-826229.25,3048539.3,2222310.05
1985-12-19,210.02,0.21,0.1,212.02,-0.94,True,1,14531,-210.02,-826439.27,3051800.62,2225361.35
1985-12-20,210.94,0.92,0.44,212.02,-0.51,True,1,14532,-210.94,-826650.21,3065380.08,2238729.87
1985-12-23,208.57,-2.37,-1.12,212.02,-1.63,True,1,14533,-208.57,-826858.78,3031147.81,2204289.03
1985-12-24,207.14,-1.43,-0.69,212.02,-2.3,True,1,14534,-207.14,-827065.92,3010572.76,2183506.84
1985-12-26,207.65,0.51,0.25,212.02,-2.06,True,1,14535,-207.65,-827273.57,3018192.75,2190919.18
1985-12-27,209.61,1.96,0.94,212.02,-1.14,True,1,14536,-209.61,-827483.18,3046890.96,2219407.78
1985-12-30,210.68,1.07,0.51,212.02,-0.63,True,1,14537,-210.68,-827693.86,3062655.16,2234961.3
1985-12-31,211.28,0.6,0.28,212.02,-0.35,True,1,14538,-211.28,-827905.14,3071588.64,2243683.5
1986-01-02,209.59,-1.69,-0.8,212.02,-1.15,True,1,14539,-209.59,-828114.73,3047229.01,2219114.28
1986-01-03,210.88,1.29,0.62,212.02,-0.54,True,1,14540,-210.88,-828325.61,3066195.2,2237869.59
1986-01-06,210.65,-0.23,-0.11,212.02,-0.65,True,1,14541,-210.65,-828536.26,3063061.65,2234525.39
1986-01-07,213.8,3.15,1.5,213.8,0.0,True,1,14542,-213.8,-828750.06,3109079.6,2280329.54
1986-01-08,207.97,-5.83,-2.73,213.8,-2.73,True,1,14543,-207.97,-828958.03,3024507.71,2195549.68
1986-01-09,206.11,-1.86,-0.89,213.8,-3.6,True,1,14544,-206.11,-829164.14,2997663.84,2168499.7
1986-01-10,205.96,-0.15,-0.07,213.8,-3.67,True,1,14545,-205.96,-829370.1,2995688.2,2166318.1
1986-01-13,206.72,0.76,0.37,213.8,-3.31,True,1,14546,-206.72,-829576.82,3006949.12,2177372.3
1986-01-14,206.64,-0.08,-0.04,213.8,-3.35,True,1,14547,-206.64,-829783.46,3005992.08,2176208.62
1986-01-15,208.26,1.62,0.78,213.8,-2.59,True,1,14548,-208.26,-829991.72,3029766.48,2199774.76
1986-01-16,209.17,0.91,0.44,213.8,-2.17,True,1,14549,-209.17,-830200.89,3043214.33,2213013.44
1986-01-17,208.43,-0.74,-0.35,213.8,-2.51,True,1,14550,-208.43,-830409.32,3032656.5,2202247.18
1986-01-20,207.53,-0.9,-0.43,213.8,-2.93,True,1,14551,-207.53,-830616.85,3019769.03,2189152.18
1986-01-21,205.79,-1.74,-0.84,213.8,-3.75,True,1,14552,-205.79,-830822.64,2994656.08,2163833.44
1986-01-22,203.49,-2.3,-1.12,213.8,-4.82,True,1,14553,-203.49,-831026.13,2961389.97,2130363.84
1986-01-23,204.25,0.76,0.37,213.8,-4.47,True,1,14554,-204.25,-831230.38,2972654.5,2141424.12
1986-01-24,206.43,2.18,1.07,213.8,-3.45,True,1,14555,-206.43,-831436.81,3004588.65,2173151.84
1986-01-27,207.39,0.96,0.46,213.8,-3.0,True,1,14556,-207.39,-831644.2,3018768.84,2187124.64
1986-01-28,209.81,2.42,1.17,213.8,-1.87,True,1,14557,-209.81,-831854.01,3054204.17,2222350.16
1986-01-29,210.29,0.48,0.23,213.8,-1.64,True,1,14558,-210.29,-832064.3,3061401.82,2229337.52
1986-01-30,209.33,-0.96,-0.46,213.8,-2.09,True,1,14559,-209.33,-832273.63,3047635.47,2215361.84
1986-01-31,211.78,2.45,1.17,213.8,-0.94,True,1,14560,-211.78,-832485.41,3083516.8,2251031.39
1986-02-03,213.96,2.18,1.03,213.96,0.0,True,1,14561,-213.96,-832699.37,3115471.56,2282772.19
1986-02-04,212.79,-1.17,-0.55,213.96,-0.55,True,1,14562,-212.79,-832912.16,3098647.98,2265735.82
1986-02-05,212.96,0.17,0.08,213.96,-0.47,True,1,14563,-212.96,-833125.12,3101336.48,2268211.36
1986-02-06,213.47,0.51,0.24,213.96,-0.23,True,1,14564,-213.47,-833338.59,3108977.08,2275638.49
1986-02-07,214.56,1.09,0.51,214.56,0.0,True,1,14565,-214.56,-833553.15,3125066.4,2291513.25
1986-02-10,216.24,1.68,0.78,216.24,0.0,True,1,14566,-216.24,-833769.39,3149751.84,2315982.45
1986-02-11,215.92,-0.32,-0.15,216.24,-0.15,True,1,14567,-215.92,-833985.31,3145306.64,2311321.33
1986-02-12,215.97,0.05,0.02,216.24,-0.12,True,1,14568,-215.97,-834201.28,3146250.96,2312049.68
1986-02-13,217.4,1.43,0.66,217.4,0.0,True,1,14569,-217.4,-834418.68,3167300.6,2332881.92
1986-02-14,219.76,2.36,1.09,219.76,0.0,True,1,14570,-219.76,-834638.44,3201903.2,2367264.76
1986-02-18,222.45,2.69,1.22,222.45,0.0,True,1,14571,-222.45,-834860.89,3241318.95,2406458.06
1986-02-19,219.76,-2.69,-1.21,222.45,-1.21,True,1,14572,-219.76,-835080.65,3202342.72,2367262.07
1986-02-20,222.22,2.46,1.12,222.45,-0.1,True,1,14573,-222.22,-835302.87,3238412.06,2403109.19
1986-02-21,224.62,2.4,1.08,224.62,0.0,True,1,14574,-224.62,-835527.49,3273611.88,2438084.39
1986-02-24,224.34,-0.28,-0.12,224.62,-0.12,True,1,14575,-224.34,-835751.83,3269755.5,2434003.67
1986-02-25,223.79,-0.55,-0.24,224.62,-0.37,True,1,14576,-223.79,-835975.62,3261963.04,2425987.42
1986-02-26,224.04,0.25,0.11,224.62,-0.26,True,1,14577,-224.04,-836199.66,3265831.08,2429631.42
1986-02-27,226.77,2.73,1.22,226.77,0.0,True,1,14578,-226.77,-836426.43,3305853.06,2469426.63
1986-02-28,226.92,0.15,0.07,226.92,0.0,True,1,14579,-226.92,-836653.35,3308266.68,2471613.33
1986-03-03,225.42,-1.5,-0.66,226.92,-0.66,True,1,14580,-225.42,-836878.77,3286623.6,2449744.83
1986-03-04,224.38,-1.04,-0.46,226.92,-1.12,True,1,14581,-224.38,-837103.15,3271684.78,2434581.63
1986-03-05,224.34,-0.04,-0.02,226.92,-1.14,True,1,14582,-224.34,-837327.49,3271325.88,2433998.39
1986-03-06,225.13,0.79,0.35,226.92,-0.79,True,1,14583,-225.13,-837552.62,3283070.79,2445518.17
1986-03-07,225.57,0.44,0.2,226.92,-0.6,True,1,14584,-225.57,-837778.19,3289712.88,2451934.69
1986-03-10,226.58,1.01,0.45,226.92,-0.15,True,1,14585,-226.58,-838004.77,3304669.3,2466664.53
1986-03-11,231.69,5.11,2.26,231.69,0.0,True,1,14586,-231.69,-838236.46,3379430.34,2541193.88
1986-03-12,232.54,0.85,0.37,232.54,0.0,True,1,14587,-232.54,-838469.0,3392060.98,2553591.98
1986-03-13,233.19,0.65,0.28,233.19,0.0,True,1,14588,-233.19,-838702.19,3401775.72,2563073.53
1986-03-14,236.55,3.36,1.44,236.55,0.0,True,1,14589,-236.55,-838938.74,3451027.95,2612089.21
1986-03-17,234.67,-1.88,-0.8,236.55,-0.8,True,1,14590,-234.67,-839173.41,3423835.3,2584661.89
1986-03-18,235.78,1.11,0.47,236.55,-0.33,True,1,14591,-235.78,-839409.19,3440265.98,2600856.79
1986-03-19,235.6,-0.18,-0.08,236.55,-0.4,True,1,14592,-235.6,-839644.79,3437875.2,2598230.41
1986-03-20,236.54,0.94,0.4,236.55,-0.0,True,1,14593,-236.54,-839881.33,3451828.22,2611946.89
1986-03-21,233.34,-3.2,-1.35,236.55,-1.36,True,1,14594,-233.34,-840114.67,3405363.96,2565249.29
1986-03-24,235.33,1.99,0.85,236.55,-0.52,True,1,14595,-235.33,-840350.0,3434641.35,2594291.35
1986-03-25,234.72,-0.61,-0.26,236.55,-0.77,True,1,14596,-234.72,-840584.72,3425973.12,2585388.4
1986-03-26,237.3,2.58,1.1,237.3,0.0,True,1,14597,-237.3,-840822.02,3463868.1,2623046.08
1986-03-27,238.97,1.67,0.7,238.97,0.0,True,1,14598,-238.97,-841060.99,3488484.06,2647423.07
1986-03-31,238.9,-0.07,-0.03,238.97,-0.03,True,1,14599,-238.9,-841299.89,3487701.1,2646401.21
1986-04-01,235.14,-3.76,-1.57,238.97,-1.6,True,1,14600,-235.14,-841535.03,3433044.0,2591508.97
1986-04-02,235.71,0.57,0.24,238.97,-1.36,True,1,14601,-235.71,-841770.74,3441601.71,2599830.97
1986-04-03,232.47,-3.24,-1.38,238.97,-2.72,True,1,14602,-232.47,-842003.21,3394526.94,2552523.73
1986-04-04,228.69,-3.78,-1.63,238.97,-4.3,True,1,14603,-228.69,-842231.9,3339560.07,2497328.17
1986-04-07,228.63,-0.06,-0.03,238.97,-4.33,True,1,14604,-228.63,-842460.53,3338912.52,2496451.99
1986-04-08,233.52,4.89,2.14,238.97,-2.28,True,1,14605,-233.52,-842694.05,3410559.6,2567865.55
1986-04-09,233.75,0.23,0.1,238.97,-2.18,True,1,14606,-233.75,-842927.8,3414152.5,2571224.7
1986-04-10,236.44,2.69,1.15,238.97,-1.06,True,1,14607,-236.44,-843164.24,3453679.08,2610514.84
1986-04-11,235.97,-0.47,-0.2,238.97,-1.25,True,1,14608,-235.97,-843400.21,3447049.76,2603649.55
1986-04-14,237.28,1.31,0.56,238.97,-0.71,True,1,14609,-237.28,-843637.49,3466423.52,2622786.03
1986-04-15,237.73,0.45,0.19,238.97,-0.52,True,1,14610,-237.73,-843875.22,3473235.3,2629360.08
1986-04-16,242.22,4.49,1.89,242.22,0.0,True,1,14611,-242.22,-844117.44,3539076.42,2694958.98
1986-04-17,243.03,0.81,0.33,243.03,0.0,True,1,14612,-243.03,-844360.47,3551154.36,2706793.89
1986-04-18,242.38,-0.65,-0.27,243.03,-0.27,True,1,14613,-242.38,-844602.85,3541898.94,2697296.09
1986-04-21,244.74,2.36,0.97,244.74,0.0,True,1,14614,-244.74,-844847.59,3576630.36,2731782.77
1986-04-22,242.42,-2.32,-0.95,244.74,-0.95,True,1,14615,-242.42,-845090.01,3542968.3,2697878.29
1986-04-23,241.75,-0.67,-0.28,244.74,-1.22,True,1,14616,-241.75,-845331.76,3533418.0,2688086.24
1986-04-24,242.02,0.27,0.11,244.74,-1.11,True,1,14617,-242.02,-845573.78,3537606.34,2692032.56
1986-04-25,242.29,0.27,0.11,244.74,-1.0,True,1,14618,-242.29,-845816.07,3541795.22,2695979.15
1986-04-28,243.08,0.79,0.33,244.74,-0.68,True,1,14619,-243.08,-846059.15,3553586.52,2707527.37
1986-04-29,240.51,-2.57,-1.06,244.74,-1.73,True,1,14620,-240.51,-846299.66,3516256.2,2669956.54
1986-04-30,235.52,-4.99,-2.08,244.74,-3.77,True,1,14621,-235.52,-846535.18,3443537.92,2597002.74
1986-05-01,235.16,-0.36,-0.15,244.74,-3.91,True,1,14622,-235.16,-846770.34,3438509.52,2591739.18
1986-05-02,234.79,-0.37,-0.16,244.74,-4.07,True,1,14623,-234.79,-847005.13,3433334.17,2586329.04
1986-05-05,237.73,2.94,1.25,244.74,-2.86,True,1,14624,-237.73,-847242.86,3476563.52,2629320.66
1986-05-06,237.24,-0.49,-0.21,244.74,-3.06,True,1,14625,-237.24,-847480.1,3469635.0,2622154.9
1986-05-07,236.08,-1.16,-0.49,244.74,-3.54,True,1,14626,-236.08,-847716.18,3452906.08,2605189.9
1986-05-08,237.13,1.05,0.44,244.74,-3.11,True,1,14627,-237.13,-847953.31,3468500.51,2620547.2
1986-05-09,237.85,0.72,0.3,244.74,-2.82,True,1,14628,-237.85,-848191.16,3479269.8,2631078.64
1986-05-12,237.58,-0.27,-0.11,244.74,-2.93,True,1,14629,-237.58,-848428.74,3475557.82,2627129.08
1986-05-13,236.41,-1.17,-0.49,244.74,-3.4,True,1,14630,-236.41,-848665.15,3458678.3,2610013.15
1986-05-14,237.54,1.13,0.48,244.74,-2.94,True,1,14631,-237.54,-848902.69,3475447.74,2626545.05
1986-05-15,234.43,-3.11,-1.31,244.74,-4.21,True,1,14632,-234.43,-849137.12,3430179.76,2581042.64
1986-05-16,232.76,-1.67,-0.71,244.74,-4.89,True,1,14633,-232.76,-849369.88,3405977.08,2556607.2
1986-05-19,233.2,0.44,0.19,244.74,-4.72,True,1,14634,-233.2,-849603.08,3412648.8,2563045.72
1986-05-20,236.11,2.91,1.25,244.74,-3.53,True,1,14635,-236.11,-849839.19,3455469.85,2605630.66
1986-05-21,235.45,-0.66,-0.28,244.74,-3.8,True,1,14636,-235.45,-850074.64,3446046.2,2595971.56
1986-05-22,240.12,4.67,1.98,244.74,-1.89,True,1,14637,-240.12,-850314.76,3514636.44,2664321.68
1986-05-23,241.35,1.23,0.51,244.74,-1.38,True,1,14638,-241.35,-850556.11,3532881.3,2682325.19
1986-05-27,244.75,3.4,1.41,244.75,0.0,True,1,14639,-244.75,-850800.86,3582895.25,2732094.39
1986-05-28,246.63,1.88,0.77,246.63,0.0,True,1,14640,-246.63,-851047.49,3610663.2,2759615.71
1986-05-29,247.98,1.35,0.55,247.98,0.0,True,1,14641,-247.98,-851295.47,3630675.18,2779379.71
1986-05-30,247.35,-0.63,-0.25,247.98,-0.25,True,1,14642,-247.35,-851542.82,3621698.7,2770155.88
1986-06-02,245.04,-2.31,-0.93,247.98,-1.19,True,1,14643,-245.04,-851787.86,3588120.72,2736332.86
1986-06-03,245.51,0.47,0.19,247.98,-1.0,True,1,14644,-245.51,-852033.37,3595248.44,2743215.07
1986-06-04,243.94,-1.57,-0.64,247.98,-1.63,True,1,14645,-243.94,-852277.31,3572501.3,2720223.99
1986-06-05,245.65,1.71,0.7,247.98,-0.94,True,1,14646,-245.65,-852522.96,3597789.9,2745266.94
1986-06-06,245.67,0.02,0.01,247.98,-0.93,True,1,14647,-245.67,-852768.63,3598328.49,2745559.86
1986-06-09,239.96,-5.71,-2.32,247.98,-3.23,True,1,14648,-239.96,-853008.59,3514934.08,2661925.49
1986-06-10,239.58,-0.38,-0.16,247.98,-3.39,True,1,14649,-239.58,-853248.17,3509607.42,2656359.25
1986-06-11,241.13,1.55,0.65,247.98,-2.76,True,1,14650,-241.13,-853489.3,3532554.5,2679065.2
1986-06-12,241.49,0.36,0.15,247.98,-2.62,True,1,14651,-241.49,-853730.79,3538069.99,2684339.2
1986-06-13,245.73,4.24,1.76,247.98,-0.91,True,1,14652,-245.73,-853976.52,3600435.96,2746459.44
1986-06-16,246.13,0.4,0.16,247.98,-0.75,True,1,14653,-246.13,-854222.65,3606542.89,2752320.24
1986-06-17,244.35,-1.78,-0.72,247.98,-1.46,True,1,14654,-244.35,-854467.0,3580704.9,2726237.9
1986-06-18,244.99,0.64,0.26,247.98,-1.21,True,1,14655,-244.99,-854711.99,3590328.45,2735616.46
1986-06-19,244.06,-0.93,-0.38,247.98,-1.58,True,1,14656,-244.06,-854956.05,3576943.36,2721987.31
1986-06-20,247.58,3.52,1.44,247.98,-0.16,True,1,14657,-247.58,-855203.63,3628780.06,2773576.43
1986-06-23,245.26,-2.32,-0.94,247.98,-1.1,True,1,14658,-245.26,-855448.89,3595021.08,2739572.19
1986-06-24,247.03,1.77,0.72,247.98,-0.38,True,1,14659,-247.03,-855695.92,3621212.77,2765516.85
1986-06-25,248.93,1.9,0.77,248.93,0.0,True,1,14660,-248.93,-855944.85,3649313.8,2793368.95
1986-06-26,248.74,-0.19,-0.08,248.93,-0.08,True,1,14661,-248.74,-856193.59,3646777.14,2790583.55
1986-06-27,249.6,0.86,0.35,249.6,0.0,True,1,14662,-249.6,-856443.19,3659635.2,2803192.01
1986-06-30,250.84,1.24,0.5,250.84,0.0,True,1,14663,-250.84,-856694.03,3678066.92,2821372.89
1986-07-01,252.04,1.2,0.48,252.04,0.0,True,1,14664,-252.04,-856946.07,3695914.56,2838968.49
1986-07-02,252.7,0.66,0.26,252.7,0.0,True,1,14665,-252.7,-857198.77,3705845.5,2848646.73
1986-07-03,251.79,-0.91,-0.36,252.7,-0.36,True,1,14666,-251.79,-857450.56,3692752.14,2835301.58
1986-07-07,244.05,-7.74,-3.07,252.7,-3.42,True,1,14667,-244.05,-857694.61,3579481.35,2721786.74
1986-07-08,241.59,-2.46,-1.01,252.7,-4.4,True,1,14668,-241.59,-857936.2,3543642.12,2685705.92
1986-07-09,242.82,1.23,0.51,252.7,-3.91,True,1,14669,-242.82,-858179.02,3561926.58,2703747.56
1986-07-10,243.01,0.19,0.08,252.7,-3.84,True,1,14670,-243.01,-858422.03,3564956.7,2706534.67
1986-07-11,242.22,-0.79,-0.32,252.7,-4.15,True,1,14671,-242.22,-858664.25,3553609.62,2694945.37
1986-07-14,238.11,-4.11,-1.7,252.7,-5.77,True,1,14672,-238.11,-858902.36,3493549.92,2634647.56
1986-07-15,233.66,-4.45,-1.87,252.7,-7.54,True,1,14673,-233.66,-859136.02,3428493.18,2569357.16
1986-07-16,235.01,1.35,0.58,252.7,-7.0,True,1,14674,-235.01,-859371.03,3448536.74,2589165.71
1986-07-17,236.07,1.06,0.45,252.7,-6.58,True,1,14675,-236.07,-859607.1,3464327.25,2604720.15
1986-07-18,236.36,0.29,0.12,252.7,-6.47,True,1,14676,-236.36,-859843.46,3468819.36,2608975.9
1986-07-21,236.24,-0.12,-0.05,252.7,-6.51,True,1,14677,-236.24,-860079.7,3467294.48,2607214.78
1986-07-22,238.18,1.94,0.82,252.7,-5.75,True,1,14678,-238.18,-860317.88,3496006.04,2635688.16
1986-07-23,238.67,0.49,0.21,252.7,-5.55,True,1,14679,-238.67,-860556.55,3503436.93,2642880.38
1986-07-24,237.95,-0.72,-0.3,252.7,-5.84,True,1,14680,-237.95,-860794.5,3493106.0,2632311.5
1986-07-25,240.22,2.27,0.95,252.7,-4.94,True,1,14681,-240.22,-861034.72,3526669.82,2665635.1
1986-07-28,236.01,-4.21,-1.75,252.7,-6.6,True,1,14682,-236.01,-861270.73,3465098.82,2603828.09
1986-07-29,234.55,-1.46,-0.62,252.7,-7.18,True,1,14683,-234.55,-861505.28,3443897.65,2582392.37
1986-07-30,236.59,2.04,0.87,252.7,-6.38,True,1,14684,-236.59,-861741.87,3474087.56,2612345.69
1986-07-31,236.12,-0.47,-0.2,252.7,-6.56,True,1,14685,-236.12,-861977.99,3467422.2,2605444.21
1986-08-01,234.91,-1.21,-0.51,252.7,-7.04,True,1,14686,-234.91,-862212.9,3449888.26,2587675.36
1986-08-04,235.99,1.08,0.46,252.7,-6.61,True,1,14687,-235.99,-862448.89,3465985.13,2603536.24
1986-08-05,237.03,1.04,0.44,252.7,-6.2,True,1,14688,-237.03,-862685.92,3481496.64,2618810.72
1986-08-06,236.84,-0.19,-0.08,252.7,-6.28,True,1,14689,-236.84,-862922.76,3478942.76,2616020.0
1986-08-07,237.04,0.2,0.08,252.7,-6.2,True,1,14690,-237.04,-863159.8,3482117.6,2618957.8
1986-08-08,236.88,-0.16,-0.07,252.7,-6.26,True,1,14691,-236.88,-863396.68,3480004.08,2616607.4
1986-08-11,240.68,3.8,1.6,252.7,-4.76,True,1,14692,-240.68,-863637.36,3536070.56,2672433.2
1986-08-12,243.34,2.66,1.1,252.7,-3.7,True,1,14693,-243.34,-863880.7,3575394.62,2711513.92
1986-08-13,245.67,2.33,0.96,252.7,-2.78,True,1,14694,-245.67,-864126.37,3609874.98,2745748.61
1986-08-14,246.25,0.58,0.24,252.7,-2.55,True,1,14695,-246.25,-864372.62,3618643.75,2754271.13
1986-08-15,247.15,0.9,0.36,252.7,-2.2,True,1,14696,-247.15,-864619.77,3632116.4,2767496.63
1986-08-18,247.38,0.23,0.09,252.7,-2.1,True,1,14697,-247.38,-864867.15,3635743.86,2770876.71
1986-08-19,246.51,-0.87,-0.35,252.7,-2.45,True,1,14698,-246.51,-865113.66,3623203.98,2758090.32
1986-08-20,249.77,3.26,1.32,252.7,-1.16,True,1,14699,-249.77,-865363.43,3671369.23,2806005.8
1986-08-21,249.67,-0.1,-0.04,252.7,-1.2,True,1,14700,-249.67,-865613.1,3670149.0,2804535.9
1986-08-22,250.19,0.52,0.21,252.7,-0.99,True,1,14701,-250.19,-865863.29,3678043.19,2812179.9
1986-08-25,247.81,-2.38,-0.95,252.7,-1.94,True,1,14702,-247.81,-866111.1,3643302.62,2777191.52
1986-08-26,252.84,5.03,2.03,252.84,0.0,True,1,14703,-252.84,-866363.94,3717506.52,2851142.58
1986-08-27,253.3,0.46,0.18,253.3,0.0,True,1,14704,-253.3,-866617.24,3724523.2,2857905.96
1986-08-28,252.84,-0.46,-0.18,253.3,-0.18,True,1,14705,-252.84,-866870.08,3718012.2,2851142.12
1986-08-29,252.93,0.09,0.04,253.3,-0.15,True,1,14706,-252.93,-867123.01,3719588.58,2852465.57
1986-09-02,248.52,-4.41,-1.74,253.3,-1.89,True,1,14707,-248.52,-867371.53,3654983.64,2787612.11
1986-09-03,250.08,1.56,0.63,253.3,-1.27,True,1,14708,-250.08,-867621.61,3678176.64,2810555.03
1986-09-04,253.83,3.75,1.5,253.83,0.0,True,1,14709,-253.83,-867875.44,3733585.47,2865710.03
1986-09-05,250.47,-3.36,-1.32,253.83,-1.32,True,1,14710,-250.47,-868125.91,3684413.7,2816287.79
1986-09-08,248.14,-2.33,-0.93,253.83,-2.24,True,1,14711,-248.14,-868374.05,3650387.54,2782013.49
1986-09-09,247.67,-0.47,-0.19,253.83,-2.43,True,1,14712,-247.67,-868621.72,3643721.04,2775099.32
1986-09-10,247.06,-0.61,-0.25,253.83,-2.67,True,1,14713,-247.06,-868868.78,3634993.78,2766125.0
1986-09-11,235.18,-11.88,-4.81,253.83,-7.35,True,1,14714,-235.18,-869103.96,3460438.52,2591334.56
1986-09-12,230.67,-4.51,-1.92,253.83,-9.12,True,1,14715,-230.67,-869334.63,3394309.05,2524974.42
1986-09-15,231.94,1.27,0.55,253.83,-8.62,True,1,14716,-231.94,-869566.57,3413229.04,2543662.47
1986-09-16,231.72,-0.22,-0.1,253.83,-8.71,True,1,14717,-231.72,-869798.29,3410223.24,2540424.95
1986-09-17,231.68,-0.04,-0.02,253.83,-8.73,True,1,14718,-231.68,-870029.97,3409866.24,2539836.27
1986-09-18,232.31,0.63,0.27,253.83,-8.48,True,1,14719,-232.31,-870262.28,3419370.89,2549108.61
1986-09-19,232.21,-0.1,-0.04,253.83,-8.52,True,1,14720,-232.21,-870494.49,3418131.2,2547636.71
1986-09-22,234.93,2.72,1.17,253.83,-7.45,True,1,14721,-234.93,-870729.42,3458404.53,2587675.11
1986-09-23,235.67,0.74,0.32,253.83,-7.15,True,1,14722,-235.67,-870965.09,3469533.74,2598568.65
1986-09-24,236.28,0.61,0.26,253.83,-6.91,True,1,14723,-236.28,-871201.37,3478750.44,2607549.07
1986-09-25,231.83,-4.45,-1.88,253.83,-8.67,True,1,14724,-231.83,-871433.2,3413464.92,2542031.72
1986-09-26,232.23,0.4,0.17,253.83,-8.51,True,1,14725,-232.23,-871665.43,3419586.75,2547921.32
1986-09-29,229.91,-2.32,-1.0,253.83,-9.42,True,1,14726,-229.91,-871895.34,3385654.66,2513759.32
1986-09-30,231.32,1.41,0.61,253.83,-8.87,True,1,14727,-231.32,-872126.66,3406649.64,2534522.98
1986-10-01,233.6,2.28,0.99,253.83,-7.97,True,1,14728,-233.6,-872360.26,3440460.8,2568100.54
1986-10-02,233.92,0.32,0.14,253.83,-7.84,True,1,14729,-233.92,-872594.18,3445407.68,2572813.5
1986-10-03,233.71,-0.21,-0.09,253.83,-7.93,True,1,14730,-233.71,-872827.89,3442548.3,2569720.41
1986-10-06,234.78,1.07,0.46,253.83,-7.5,True,1,14731,-234.78,-873062.67,3458544.18,2585481.51
1986-10-07,234.41,-0.37,-0.16,253.83,-7.65,True,1,14732,-234.41,-873297.08,3453328.12,2580031.04
1986-10-08,236.68,2.27,0.97,253.83,-6.76,True,1,14733,-236.68,-873533.76,3487006.44,2613472.68
1986-10-09,235.85,-0.83,-0.35,253.83,-7.08,True,1,14734,-235.85,-873769.61,3475013.9,2601244.29
1986-10-10,235.48,-0.37,-0.16,253.83,-7.23,True,1,14735,-235.48,-874005.09,3469797.8,2595792.71
1986-10-13,235.91,0.43,0.18,253.83,-7.06,True,1,14736,-235.91,-874241.0,3476369.76,2602128.76
1986-10-14,235.37,-0.54,-0.23,253.83,-7.27,True,1,14737,-235.37,-874476.37,3468647.69,2594171.32
1986-10-15,238.8,3.43,1.46,253.83,-5.92,True,1,14738,-238.8,-874715.17,3519434.4,2644719.23
1986-10-16,239.53,0.73,0.31,253.83,-5.63,True,1,14739,-239.53,-874954.7,3530432.67,2655477.97
1986-10-17,238.84,-0.69,-0.29,253.83,-5.91,True,1,14740,-238.84,-875193.54,3520501.6,2645308.06
1986-10-20,235.97,-2.87,-1.2,253.83,-7.04,True,1,14741,-235.97,-875429.51,3478433.77,2603004.26
1986-10-21,235.88,-0.09,-0.04,253.83,-7.07,True,1,14742,-235.88,-875665.39,3477342.96,2601677.57
1986-10-22,236.26,0.38,0.16,253.83,-6.92,True,1,14743,-236.26,-875901.65,3483181.18,2607279.53
1986-10-23,239.28,3.02,1.28,253.83,-5.73,True,1,14744,-239.28,-876140.93,3527944.32,2651803.39
1986-10-24,238.26,-1.02,-0.43,253.83,-6.13,True,1,14745,-238.26,-876379.19,3513143.7,2636764.51
1986-10-27,238.77,0.51,0.21,253.83,-5.93,True,1,14746,-238.77,-876617.96,3520902.42,2644284.46
1986-10-28,239.26,0.49,0.2,253.83,-5.74,True,1,14747,-239.26,-876857.22,3528367.22,2651510.0
1986-10-29,240.94,1.68,0.7,253.83,-5.08,True,1,14748,-240.94,-877098.16,3553383.12,2676284.96
1986-10-30,243.71,2.77,1.15,253.83,-3.99,True,1,14749,-243.71,-877341.87,3594478.79,2717136.92
1986-10-31,243.98,0.27,0.11,253.83,-3.88,True,1,14750,-243.98,-877585.85,3598705.0,2721119.15
1986-11-03,245.8,1.82,0.75,253.83,-3.16,True,1,14751,-245.8,-877831.65,3625795.8,2747964.15
1986-11-04,246.2,0.4,0.16,253.83,-3.01,True,1,14752,-246.2,-878077.85,3631942.4,2753864.55
1986-11-05,246.58,0.38,0.15,253.83,-2.86,True,1,14753,-246.58,-878324.43,3637794.74,2759470.31
1986-11-06,245.87,-0.71,-0.29,253.83,-3.14,True,1,14754,-245.87,-878570.3,3627565.98,2748995.68
1986-11-07,245.77,-0.1,-0.04,253.83,-3.18,True,1,14755,-245.77,-878816.07,3626336.35,2747520.28
1986-11-10,246.13,0.36,0.15,253.83,-3.03,True,1,14756,-246.13,-879062.2,3631894.28,2752832.08
1986-11-11,247.08,0.95,0.39,253.83,-2.66,True,1,14757,-247.08,-879309.28,3646159.56,2766850.28
1986-11-12,246.64,-0.44,-0.18,253.83,-2.83,True,1,14758,-246.64,-879555.92,3639913.12,2760357.2
1986-11-13,243.02,-3.62,-1.47,253.83,-4.26,True,1,14759,-243.02,-879798.94,3586732.18,2706933.24
1986-11-14,244.5,1.48,0.61,253.83,-3.68,True,1,14760,-244.5,-880043.44,3608820.0,2728776.56
1986-11-17,243.21,-1.29,-0.53,253.83,-4.18,True,1,14761,-243.21,-880286.65,3590022.81,2709736.16
1986-11-18,236.78,-6.43,-2.64,253.83,-6.72,True,1,14762,-236.78,-880523.43,3495346.36,2614822.93
1986-11-19,237.66,0.88,0.37,253.83,-6.37,True,1,14763,-237.66,-880761.09,3508574.58,2627813.49
1986-11-20,242.05,4.39,1.85,253.83,-4.64,True,1,14764,-242.05,-881003.14,3573626.2,2692623.06
1986-11-21,245.86,3.81,1.57,253.83,-3.14,True,1,14765,-245.86,-881249.0,3630122.9,2748873.9
1986-11-24,247.45,1.59,0.65,253.83,-2.51,True,1,14766,-247.45,-881496.45,3653846.7,2772350.25
1986-11-25,248.17,0.72,0.29,253.83,-2.23,True,1,14767,-248.17,-881744.62,3664726.39,2782981.77
1986-11-26,248.77,0.6,0.24,253.83,-1.99,True,1,14768,-248.77,-881993.39,3673835.36,2791841.97
1986-11-28,249.22,0.45,0.18,253.83,-1.82,True,1,14769,-249.22,-882242.61,3680730.18,2798487.57
1986-12-01,249.05,-0.17,-0.07,253.83,-1.88,True,1,14770,-249.05,-882491.66,3678468.5,2795976.84
1986-12-02,254.0,4.95,1.99,254.0,0.0,True,1,14771,-254.0,-882745.66,3751834.0,2869088.34
1986-12-03,253.85,-0.15,-0.06,254.0,-0.06,True,1,14772,-253.85,-882999.51,3749872.2,2866872.69
1986-12-04,253.04,-0.81,-0.32,254.0,-0.38,True,1,14773,-253.04,-883252.55,3738159.92,2854907.37
1986-12-05,251.17,-1.87,-0.74,254.0,-1.11,True,1,14774,-251.17,-883503.72,3710785.58,2827281.86
1986-12-08,251.16,-0.01,-0.0,254.0,-1.12,True,1,14775,-251.16,-883754.88,3710889.0,2827134.12
1986-12-09,249.28,-1.88,-0.75,254.0,-1.86,True,1,14776,-249.28,-884004.16,3683361.28,2799357.12
1986-12-10,250.96,1.68,0.67,254.0,-1.2,True,1,14777,-250.96,-884255.12,3708435.92,2824180.8
1986-12-11,248.17,-2.79,-1.11,254.0,-2.3,True,1,14778,-248.17,-884503.29,3667456.26,2782952.97
1986-12-12,247.35,-0.82,-0.33,254.0,-2.62,True,1,14779,-247.35,-884750.64,3655585.65,2770835.01
1986-12-15,248.21,0.86,0.35,254.0,-2.28,True,1,14780,-248.21,-884998.85,3668543.8,2783544.95
1986-12-16,250.04,1.83,0.74,254.0,-1.56,True,1,14781,-250.04,-885248.89,3695841.24,2810592.35
1986-12-17,247.56,-2.48,-0.99,254.0,-2.54,True,1,14782,-247.56,-885496.45,3659431.92,2773935.47
1986-12-18,246.78,-0.78,-0.32,254.0,-2.84,True,1,14783,-246.78,-885743.23,3648148.74,2762405.51
1986-12-19,249.73,2.95,1.2,254.0,-1.68,True,1,14784,-249.73,-885992.96,3692008.32,2806015.36
1986-12-22,248.75,-0.98,-0.39,254.0,-2.07,True,1,14785,-248.75,-886241.71,3677768.75,2791527.04
1986-12-23,246.34,-2.41,-0.97,254.0,-3.02,True,1,14786,-246.34,-886488.05,3642383.24,2755895.19
1986-12-24,246.75,0.41,0.17,254.0,-2.85,True,1,14787,-246.75,-886734.8,3648692.25,2761957.45
1986-12-26,246.92,0.17,0.07,254.0,-2.79,True,1,14788,-246.92,-886981.72,3651452.96,2764471.24
1986-12-29,244.67,-2.25,-0.91,254.0,-3.67,True,1,14789,-244.67,-887226.39,3618424.63,2731198.24
1986-12-30,243.37,-1.3,-0.53,254.0,-4.18,True,1,14790,-243.37,-887469.76,3599442.3,2711972.54
1986-12-31,242.17,-1.2,-0.49,254.0,-4.66,True,1,14791,-242.17,-887711.93,3581936.47,2694224.54
1987-01-02,246.45,4.28,1.77,254.0,-2.97,True,1,14792,-246.45,-887958.38,3645488.4,2757530.02
1987-01-05,252.19,5.74,2.33,254.0,-0.71,True,1,14793,-252.19,-888210.57,3730646.67,2842436.1
1987-01-06,252.78,0.59,0.23,254.0,-0.48,True,1,14794,-252.78,-888463.35,3739627.32,2851163.97
1987-01-07,255.33,2.55,1.01,255.33,0.0,True,1,14795,-255.33,-888718.68,3777607.35,2888888.67
1987-01-08,257.28,1.95,0.76,257.28,0.0,True,1,14796,-257.28,-888975.96,3806714.88,2917738.92
1987-01-09,258.73,1.45,0.56,258.73,0.0,True,1,14797,-258.73,-889234.69,3828427.81,2939193.12
1987-01-12,260.3,1.57,0.61,260.3,0.0,True,1,14798,-260.3,-889494.99,3851919.4,2962424.41
1987-01-13,259.95,-0.35,-0.13,260.3,-0.13,True,1,14799,-259.95,-889754.94,3847000.05,2957245.11
1987-01-14,262.64,2.69,1.03,262.64,0.0,True,1,14800,-262.64,-890017.58,3887072.0,2997054.42
1987-01-15,265.49,2.85,1.08,265.49,0.0,True,1,14801,-265.49,-890283.07,3929517.49,3039234.42
1987-01-16,266.28,0.79,0.3,266.28,0.0,True,1,14802,-266.28,-890549.35,3941476.56,3050927.21
1987-01-19,269.34,3.06,1.15,269.34,0.0,True,1,14803,-269.34,-890818.69,3987040.02,3096221.33
1987-01-20,269.04,-0.3,-0.11,269.34,-0.11,True,1,14804,-269.04,-891087.73,3982868.16,3091780.43
1987-01-21,267.84,-1.2,-0.45,269.34,-0.56,True,1,14805,-267.84,-891355.57,3965371.2,3074015.63
1987-01-22,273.91,6.07,2.27,273.91,0.0,True,1,14806,-273.91,-891629.48,4055511.46,3163881.98
1987-01-23,270.1,-3.81,-1.39,273.91,-1.39,True,1,14807,-270.1,-891899.58,3999370.7,3107471.12
1987-01-26,269.61,-0.49,-0.18,273.91,-1.57,True,1,14808,-269.61,-892169.19,3992384.88,3100215.69
1987-01-27,273.75,4.14,1.54,273.91,-0.06,True,1,14809,-273.75,-892442.94,4053963.75,3161520.81
1987-01-28,275.4,1.65,0.6,275.4,0.0,True,1,14810,-275.4,-892718.34,4078674.0,3185955.66
1987-01-29,274.24,-1.16,-0.42,275.4,-0.42,True,1,14811,-274.24,-892992.58,4061768.64,3168776.06
1987-01-30,274.08,-0.16,-0.06,275.4,-0.48,True,1,14812,-274.08,-893266.66,4059672.96,3166406.3
1987-02-02,276.45,2.37,0.86,276.45,0.0,True,1,14813,-276.45,-893543.11,4095053.85,3201510.74
1987-02-03,275.99,-0.46,-0.17,276.45,-0.17,True,1,14814,-275.99,-893819.1,4088515.86,3194696.76
1987-02-04,279.64,3.65,1.32,279.64,0.0,True,1,14815,-279.64,-894098.74,4142866.6,3248767.86
1987-02-05,281.16,1.52,0.54,281.16,0.0,True,1,14816,-281.16,-894379.9,4165666.56,3271286.66
1987-02-06,280.04,-1.12,-0.4,281.16,-0.4,True,1,14817,-280.04,-894659.94,4149352.68,3254692.74
1987-02-09,278.16,-1.88,-0.67,281.16,-1.07,True,1,14818,-278.16,-894938.1,4121774.88,3226836.78
1987-02-10,275.07,-3.09,-1.11,281.16,-2.17,True,1,14819,-275.07,-895213.17,4076262.33,3181049.16
1987-02-11,277.54,2.47,0.9,281.16,-1.29,True,1,14820,-277.54,-895490.71,4113142.8,3217652.09
1987-02-12,275.62,-1.92,-0.69,281.16,-1.97,True,1,14821,-275.62,-895766.33,4084964.02,3189197.69
1987-02-13,279.7,4.08,1.48,281.16,-0.52,True,1,14822,-279.7,-896046.03,4145713.4,3249667.37
1987-02-17,285.49,5.79,2.07,285.49,0.0,True,1,14823,-285.49,-896331.52,4231818.27,3335486.75
1987-02-18,285.42,-0.07,-0.02,285.49,-0.02,True,1,14824,-285.42,-896616.94,4231066.08,3334449.14
1987-02-19,285.57,0.15,0.05,285.57,0.0,True,1,14825,-285.57,-896902.51,4233575.25,3336672.74
1987-02-20,285.48,-0.09,-0.03,285.57,-0.03,True,1,14826,-285.48,-897187.99,4232526.48,3335338.49
1987-02-23,282.38,-3.1,-1.09,285.57,-1.12,True,1,14827,-282.38,-897470.37,4186848.26,3289377.89
1987-02-24,282.88,0.5,0.18,285.57,-0.94,True,1,14828,-282.88,-897753.25,4194544.64,3296791.39
1987-02-25,284.0,1.12,0.4,285.57,-0.55,True,1,14829,-284.0,-898037.25,4211436.0,3313398.75
1987-02-26,282.96,-1.04,-0.37,285.57,-0.91,True,1,14830,-282.96,-898320.21,4196296.8,3297976.59
1987-02-27,284.2,1.24,0.44,285.57,-0.48,True,1,14831,-284.2,-898604.41,4214970.2,3316365.79
1987-03-02,283.0,-1.2,-0.42,285.57,-0.9,True,1,14832,-283.0,-898887.41,4197456.0,3298568.59
1987-03-03,284.12,1.12,0.4,285.57,-0.51,True,1,14833,-284.12,-899171.53,4214351.96,3315180.43
1987-03-04,288.62,4.5,1.58,288.62,0.0,True,1,14834,-288.62,-899460.15,4281389.08,3381928.93
1987-03-05,290.52,1.9,0.66,290.52,0.0,True,1,14835,-290.52,-899750.67,4309864.2,3410113.53
1987-03-06,290.66,0.14,0.05,290.66,0.0,True,1,14836,-290.66,-900041.33,4312231.76,3412190.43
1987-03-09,288.3,-2.36,-0.81,290.66,-0.81,True,1,14837,-288.3,-900329.63,4277507.1,3377177.47
1987-03-10,290.86,2.56,0.89,290.86,0.0,True,1,14838,-290.86,-900620.49,4315780.68,3415160.19
1987-03-11,290.31,-0.55,-0.19,290.86,-0.19,True,1,14839,-290.31,-900910.8,4307910.09,3406999.29
1987-03-12,291.22,0.91,0.31,291.22,0.0,True,1,14840,-291.22,-901202.02,4321704.8,3420502.78
1987-03-13,289.89,-1.33,-0.46,291.22,-0.46,True,1,14841,-289.89,-901491.91,4302257.49,3400765.58
1987-03-16,288.23,-1.66,-0.57,291.22,-1.03,True,1,14842,-288.23,-901780.14,4277909.66,3376129.52
1987-03-17,292.47,4.24,1.47,292.47,0.0,True,1,14843,-292.47,-902072.61,4341132.21,3439059.6
1987-03-18,292.78,0.31,0.11,292.78,0.0,True,1,14844,-292.78,-902365.39,4346026.32,3443660.93
1987-03-19,294.08,1.3,0.44,294.08,0.0,True,1,14845,-294.08,-902659.47,4365617.6,3462958.13
1987-03-20,298.17,4.09,1.39,298.17,0.0,True,1,14846,-298.17,-902957.64,4426631.82,3523674.18
1987-03-23,301.16,2.99,1.0,301.16,0.0,True,1,14847,-301.16,-903258.8,4471322.52,3568063.72
1987-03-24,301.64,0.48,0.16,301.64,0.0,True,1,14848,-301.64,-903560.44,4478750.72,3575190.28
1987-03-25,300.38,-1.26,-0.42,301.64,-0.42,True,1,14849,-300.38,-903860.82,4460342.62,3556481.8
1987-03-26,300.93,0.55,0.18,301.64,-0.24,True,1,14850,-300.93,-904161.75,4468810.5,3564648.75
1987-03-27,296.13,-4.8,-1.6,301.64,-1.83,True,1,14851,-296.13,-904457.88,4397826.63,3493368.75
1987-03-30,289.2,-6.93,-2.34,301.64,-4.12,True,1,14852,-289.2,-904747.08,4295198.4,3390451.32
1987-03-31,291.7,2.5,0.86,301.64,-3.3,True,1,14853,-291.7,-905038.78,4332620.1,3427581.32
1987-04-01,292.38,0.68,0.23,301.64,-3.07,True,1,14854,-292.38,-905331.16,4343012.52,3437681.36
1987-04-02,293.63,1.25,0.43,301.64,-2.66,True,1,14855,-293.63,-905624.79,4361873.65,3456248.86
1987-04-03,300.41,6.78,2.31,301.64,-0.41,True,1,14856,-300.41,-905925.2,4462890.96,3556965.76
1987-04-06,301.95,1.54,0.51,301.95,0.0,True,1,14857,-301.95,-906227.15,4486071.15,3579844.0
1987-04-07,296.69,-5.26,-1.74,301.95,-1.74,True,1,14858,-296.69,-906523.84,4408220.02,3501696.18
1987-04-08,297.26,0.57,0.19,301.95,-1.55,True,1,14859,-297.26,-906821.1,4416986.34,3510165.24
1987-04-09,292.86,-4.4,-1.48,301.95,-3.01,True,1,14860,-292.86,-907113.96,4351899.6,3444785.64
1987-04-10,292.49,-0.37,-0.13,301.95,-3.13,True,1,14861,-292.49,-907406.45,4346693.89,3439287.44
1987-04-13,285.62,-6.87,-2.35,301.95,-5.41,True,1,14862,-285.62,-907692.07,4244884.44,3337192.37
1987-04-14,279.16,-6.46,-2.26,301.95,-7.55,True,1,14863,-279.16,-907971.23,4149155.08,3241183.85
1987-04-15,284.44,5.28,1.89,301.95,-5.8,True,1,14864,-284.44,-908255.67,4227916.16,3319660.49
1987-04-16,286.91,2.47,0.87,301.95,-4.98,True,1,14865,-286.91,-908542.58,4264917.15,3356374.57
1987-04-20,286.09,-0.82,-0.29,301.95,-5.25,True,1,14866,-286.09,-908828.67,4253013.94,3344185.27
1987-04-21,293.07,6.98,2.44,301.95,-2.94,True,1,14867,-293.07,-909121.74,4357071.69,3447949.95
1987-04-22,287.19,-5.88,-2.01,301.95,-4.89,True,1,14868,-287.19,-909408.93,4269940.92,3360531.99
1987-04-23,286.82,-0.37,-0.13,301.95,-5.01,True,1,14869,-286.82,-909695.75,4264726.58,3355030.83
1987-04-24,281.52,-5.3,-1.85,301.95,-6.77,True,1,14870,-281.52,-909977.27,4186202.4,3276225.13
1987-04-27,281.83,0.31,0.11,301.95,-6.66,True,1,14871,-281.83,-910259.1,4191093.93,3280834.83
1987-04-28,282.51,0.68,0.24,301.95,-6.44,True,1,14872,-282.51,-910541.61,4201488.72,3290947.11
1987-04-29,284.57,2.06,0.73,301.95,-5.76,True,1,14873,-284.57,-910826.18,4232409.61,3321583.43
1987-04-30,288.36,3.79,1.33,301.95,-4.5,True,1,14874,-288.36,-911114.54,4289066.64,3377952.1
1987-05-01,288.03,-0.33,-0.11,301.95,-4.61,True,1,14875,-288.03,-911402.57,4284446.25,3373043.68
1987-05-04,289.36,1.33,0.46,301.95,-4.17,True,1,14876,-289.36,-911691.93,4304519.36,3392827.43
1987-05-05,295.34,5.98,2.07,301.95,-2.19,True,1,14877,-295.34,-911987.27,4393773.18,3481785.91
1987-05-06,295.47,0.13,0.04,301.95,-2.15,True,1,14878,-295.47,-912282.74,4396002.66,3483719.92
1987-05-07,294.71,-0.76,-0.26,301.95,-2.4,True,1,14879,-294.71,-912577.45,4384990.09,3472412.64
1987-05-08,293.37,-1.34,-0.46,301.95,-2.84,True,1,14880,-293.37,-912870.82,4365345.6,3452474.78
1987-05-11,291.57,-1.8,-0.61,301.95,-3.44,True,1,14881,-291.57,-913162.39,4338853.17,3425690.78
1987-05-12,293.3,1.73,0.59,301.95,-2.86,True,1,14882,-293.3,-913455.69,4364890.6,3451434.91
1987-05-13,293.98,0.68,0.23,301.95,-2.64,True,1,14883,-293.98,-913749.67,4375304.34,3461554.67
1987-05-14,294.24,0.26,0.09,301.95,-2.55,True,1,14884,-294.24,-914043.91,4379468.16,3465424.25
1987-05-15,287.43,-6.81,-2.31,301.95,-4.81,True,1,14885,-287.43,-914331.34,4278395.55,3364064.21
1987-05-18,286.65,-0.78,-0.27,301.95,-5.07,True,1,14886,-286.65,-914617.99,4267071.9,3352453.91
1987-05-19,279.62,-7.03,-2.45,301.95,-7.4,True,1,14887,-279.62,-914897.61,4162702.94,3247805.33
1987-05-20,278.21,-1.41,-0.5,301.95,-7.86,True,1,14888,-278.21,-915175.82,4141990.48,3226814.66
1987-05-21,280.17,1.96,0.7,301.95,-7.21,True,1,14889,-280.17,-915455.99,4171451.13,3255995.14
1987-05-22,282.16,1.99,0.71,301.95,-6.55,True,1,14890,-282.16,-915738.15,4201362.4,3285624.25
1987-05-26,289.11,6.95,2.46,301.95,-4.25,True,1,14891,-289.11,-916027.26,4305137.01,3389109.75
1987-05-27,288.73,-0.38,-0.13,301.95,-4.38,True,1,14892,-288.73,-916315.99,4299767.16,3383451.17
1987-05-28,290.76,2.03,0.7,301.95,-3.71,True,1,14893,-290.76,-916606.75,4330288.68,3413681.93
1987-05-29,290.1,-0.66,-0.23,301.95,-3.92,True,1,14894,-290.1,-916896.85,4320749.4,3403852.55
1987-06-01,289.83,-0.27,-0.09,301.95,-4.01,True,1,14895,-289.83,-917186.68,4317017.85,3399831.17
1987-06-02,288.46,-1.37,-0.47,301.95,-4.47,True,1,14896,-288.46,-917475.14,4296900.16,3379425.02
1987-06-03,293.47,5.01,1.74,301.95,-2.81,True,1,14897,-293.47,-917768.61,4371822.59,3454053.98
1987-06-04,295.09,1.62,0.55,301.95,-2.27,True,1,14898,-295.09,-918063.7,4396250.82,3478187.12
1987-06-05,293.45,-1.64,-0.56,301.95,-2.82,True,1,14899,-293.45,-918357.15,4372111.55,3453754.4
1987-06-08,296.72,3.27,1.11,301.95,-1.73,True,1,14900,-296.72,-918653.87,4421128.0,3502474.13
1987-06-09,297.28,0.56,0.19,301.95,-1.55,True,1,14901,-297.28,-918951.15,4429769.28,3510818.13
1987-06-10,297.47,0.19,0.06,301.95,-1.48,True,1,14902,-297.47,-919248.62,4432897.94,3513649.32
1987-06-11,298.73,1.26,0.42,301.95,-1.07,True,1,14903,-298.73,-919547.35,4451973.19,3532425.84
1987-06-12,301.62,2.89,0.97,301.95,-0.11,True,1,14904,-301.62,-919848.97,4495344.48,3575495.51
1987-06-15,303.14,1.52,0.5,303.14,0.0,True,1,14905,-303.14,-920152.11,4518301.7,3598149.59
1987-06-16,304.76,1.62,0.53,304.76,0.0,True,1,14906,-304.76,-920456.87,4542752.56,3622295.69
1987-06-17,304.81,0.05,0.02,304.81,0.0,True,1,14907,-304.81,-920761.68,4543802.67,3623040.99
1987-06-18,305.69,0.88,0.29,305.69,0.0,True,1,14908,-305.69,-921067.37,4557226.52,3636159.15
1987-06-19,306.97,1.28,0.42,306.97,0.0,True,1,14909,-306.97,-921374.34,4576615.73,3655241.39
1987-06-22,309.65,2.68,0.87,309.65,0.0,True,1,14910,-309.65,-921683.99,4616881.5,3695197.51
1987-06-23,308.43,-1.22,-0.39,309.65,-0.39,True,1,14911,-308.43,-921992.42,4598999.73,3677007.31
1987-06-24,306.86,-1.57,-0.51,309.65,-0.9,True,1,14912,-306.86,-922299.28,4575896.32,3653597.04
1987-06-25,308.96,2.1,0.68,309.65,-0.22,True,1,14913,-308.96,-922608.24,4607520.48,3684912.24
1987-06-26,307.16,-1.8,-0.58,309.65,-0.8,True,1,14914,-307.16,-922915.4,4580984.24,3658068.84
1987-06-29,307.9,0.74,0.24,309.65,-0.56,True,1,14915,-307.9,-923223.3,4592328.5,3669105.2
1987-06-30,304.0,-3.9,-1.27,309.65,-1.82,True,1,14916,-304.0,-923527.3,4534464.0,3610936.7
1987-07-01,302.94,-1.06,-0.35,309.65,-2.17,True,1,14917,-302.94,-923830.24,4518955.98,3595125.74
1987-07-02,305.63,2.69,0.89,309.65,-1.3,True,1,14918,-305.63,-924135.87,4559388.34,3635252.47
1987-07-06,304.92,-0.71,-0.23,309.65,-1.53,True,1,14919,-304.92,-924440.79,4549101.48,3624660.69
1987-07-07,307.4,2.48,0.81,309.65,-0.73,True,1,14920,-307.4,-924748.19,4586408.0,3661659.81
1987-07-08,308.29,0.89,0.29,309.65,-0.44,True,1,14921,-308.29,-925056.48,4599995.09,3674938.61
1987-07-09,307.52,-0.77,-0.25,309.65,-0.69,True,1,14922,-307.52,-925364.0,4588813.44,3663449.44
1987-07-10,308.37,0.85,0.28,309.65,-0.41,True,1,14923,-308.37,-925672.37,4601805.51,3676133.14
1987-07-13,307.63,-0.74,-0.24,309.65,-0.65,True,1,14924,-307.63,-925980.0,4591070.12,3665090.12
1987-07-14,310.68,3.05,0.99,310.68,0.0,True,1,14925,-310.68,-926290.68,4636899.0,3710608.32
1987-07-15,310.42,-0.26,-0.08,310.68,-0.08,True,1,14926,-310.42,-926601.1,4633328.92,3706727.82
1987-07-16,312.7,2.28,0.73,312.7,0.0,True,1,14927,-312.7,-926913.8,4667672.9,3740759.1
1987-07-17,314.59,1.89,0.6,314.59,0.0,True,1,14928,-314.59,-927228.39,4696199.52,3768971.13
1987-07-20,311.39,-3.2,-1.02,314.59,-1.02,True,1,14929,-311.39,-927539.78,4648741.31,3721201.53
1987-07-21,308.55,-2.84,-0.91,314.59,-1.92,True,1,14930,-308.55,-927848.33,4606651.5,3678803.17
1987-07-22,308.47,-0.08,-0.03,314.59,-1.94,True,1,14931,-308.47,-928156.8,4605765.57,3677608.77
1987-07-23,307.81,-0.66,-0.21,314.59,-2.15,True,1,14932,-307.81,-928464.61,4596218.92,3667754.31
1987-07-24,309.27,1.46,0.47,314.59,-1.69,True,1,14933,-309.27,-928773.88,4618328.91,3689555.03
1987-07-27,310.65,1.38,0.45,314.59,-1.25,True,1,14934,-310.65,-929084.53,4639247.1,3710162.57
1987-07-28,312.33,1.68,0.54,314.59,-0.72,True,1,14935,-312.33,-929396.86,4664648.55,3735251.69
1987-07-29,315.65,3.32,1.06,315.65,0.0,True,1,14936,-315.65,-929712.51,4714548.4,3784835.89
1987-07-30,318.05,2.4,0.76,318.05,0.0,True,1,14937,-318.05,-930030.56,4750712.85,3820682.29
1987-07-31,318.66,0.61,0.19,318.66,0.0,True,1,14938,-318.66,-930349.22,4760143.08,3829793.86
1987-08-03,317.57,-1.09,-0.34,318.66,-0.34,True,1,14939,-317.57,-930666.79,4744178.23,3813511.44
1987-08-04,316.23,-1.34,-0.42,318.66,-0.76,True,1,14940,-316.23,-930983.02,4724476.2,3793493.18
1987-08-05,318.45,2.22,0.7,318.66,-0.07,True,1,14941,-318.45,-931301.47,4757961.45,3826659.98
1987-08-06,322.09,3.64,1.14,322.09,0.0,True,1,14942,-322.09,-931623.56,4812668.78,3881045.22
1987-08-07,323.0,0.91,0.28,323.0,0.0,True,1,14943,-323.0,-931946.56,4826589.0,3894642.44
1987-08-10,328.0,5.0,1.55,328.0,0.0,True,1,14944,-328.0,-932274.56,4901632.0,3969357.44
1987-08-11,333.33,5.33,1.62,333.33,0.0,True,1,14945,-333.33,-932607.89,4981616.85,4049008.96
1987-08-12,332.39,-0.94,-0.28,333.33,-0.28,True,1,14946,-332.39,-932940.28,4967900.94,4034960.66
1987-08-13,334.65,2.26,0.68,334.65,0.0,True,1,14947,-334.65,-933274.93,5002013.55,4068738.62
1987-08-14,333.99,-0.66,-0.2,334.65,-0.2,True,1,14948,-333.99,-933608.92,4992482.52,4058873.6
1987-08-17,334.11,0.12,0.04,334.65,-0.16,True,1,14949,-334.11,-933943.03,4994610.39,4060667.36
1987-08-18,329.25,-4.86,-1.46,334.65,-1.61,True,1,14950,-329.25,-934272.28,4922287.5,3988015.22
1987-08-19,329.83,0.58,0.18,334.65,-1.44,True,1,14951,-329.83,-934602.11,4931288.33,3996686.22
1987-08-20,334.84,5.01,1.52,334.84,0.0,True,1,14952,-334.84,-934936.95,5006527.68,4071590.73
1987-08-21,335.9,1.06,0.32,335.9,0.0,True,1,14953,-335.9,-935272.85,5022712.7,4087439.85
1987-08-24,333.33,-2.57,-0.76,335.9,-0.76,True,1,14954,-333.33,-935606.18,4984616.82,4049010.64
1987-08-25,336.77,3.44,1.03,336.77,0.0,True,1,14955,-336.77,-935942.95,5036395.35,4100452.4
1987-08-26,334.57,-2.2,-0.65,336.77,-0.65,True,1,14956,-334.57,-936277.52,5003828.92,4067551.4
1987-08-27,331.38,-3.19,-0.95,336.77,-1.6,True,1,14957,-331.38,-936608.9,4956450.66,4019841.76
1987-08-28,327.04,-4.34,-1.31,336.77,-2.89,True,1,14958,-327.04,-936935.94,4891864.32,3954928.38
1987-08-31,329.8,2.76,0.84,336.77,-2.07,True,1,14959,-329.8,-937265.74,4933478.2,3996212.46
1987-09-01,323.4,-6.4,-1.94,336.77,-3.97,True,1,14960,-323.4,-937589.14,4838064.0,3900474.86
1987-09-02,321.68,-1.72,-0.53,336.77,-4.48,True,1,14961,-321.68,-937910.82,4812654.48,3874743.66
1987-09-03,320.21,-1.47,-0.46,336.77,-4.92,True,1,14962,-320.21,-938231.03,4790982.02,3852750.99
1987-09-04,316.7,-3.51,-1.1,336.77,-5.96,True,1,14963,-316.7,-938547.73,4738782.1,3800234.37
1987-09-08,313.56,-3.14,-0.99,336.77,-6.89,True,1,14964,-313.56,-938861.29,4692111.84,3753250.55
1987-09-09,313.92,0.36,0.12,336.77,-6.78,True,1,14965,-313.92,-939175.21,4697812.8,3758637.59
1987-09-10,317.13,3.21,1.02,336.77,-5.83,True,1,14966,-317.13,-939492.34,4746167.58,3806675.24
1987-09-11,321.98,4.85,1.53,336.77,-4.39,True,1,14967,-321.98,-939814.32,4819074.66,3879260.34
1987-09-14,323.08,1.1,0.34,336.77,-4.07,True,1,14968,-323.08,-940137.4,4835861.44,3895724.04
1987-09-15,317.74,-5.34,-1.65,336.77,-5.65,True,1,14969,-317.74,-940455.14,4756250.06,3815794.92
1987-09-16,314.86,-2.88,-0.91,336.77,-6.51,True,1,14970,-314.86,-940770.0,4713454.2,3772684.2
1987-09-17,314.93,0.07,0.02,336.77,-6.48,True,1,14971,-314.93,-941084.93,4714817.03,3773732.1
1987-09-18,314.86,-0.07,-0.02,336.77,-6.51,True,1,14972,-314.86,-941399.79,4714083.92,3772684.13
1987-09-21,310.54,-4.32,-1.37,336.77,-7.79,True,1,14973,-310.54,-941710.33,4649715.42,3708005.09
1987-09-22,319.5,8.96,2.88,336.77,-5.13,True,1,14974,-319.5,-942029.83,4784193.0,3842163.17
1987-09-23,321.19,1.69,0.53,336.77,-4.63,True,1,14975,-321.19,-942351.02,4809820.25,3867469.23
1987-09-24,319.72,-1.47,-0.46,336.77,-5.06,True,1,14976,-319.72,-942670.74,4788126.72,3845455.98
1987-09-25,320.16,0.44,0.14,336.77,-4.93,True,1,14977,-320.16,-942990.9,4795036.32,3852045.42
1987-09-28,323.2,3.04,0.95,336.77,-4.03,True,1,14978,-323.2,-943314.1,4840889.6,3897575.5
1987-09-29,321.69,-1.51,-0.47,336.77,-4.48,True,1,14979,-321.69,-943635.79,4818594.51,3874958.72
1987-09-30,321.83,0.14,0.04,336.77,-4.44,True,1,14980,-321.83,-943957.62,4821013.4,3877055.78
1987-10-01,327.33,5.5,1.71,336.77,-2.8,True,1,14981,-327.33,-944284.95,4903730.73,3959445.78
1987-10-02,328.07,0.74,0.23,336.77,-2.58,True,1,14982,-328.07,-944613.02,4915144.74,3970531.72
1987-10-05,328.08,0.01,0.0,336.77,-2.58,True,1,14983,-328.08,-944941.1,4915622.64,3970681.54
1987-10-06,319.22,-8.86,-2.7,336.77,-5.21,True,1,14984,-319.22,-945260.32,4783192.48,3837932.16
1987-10-07,318.54,-0.68,-0.21,336.77,-5.41,True,1,14985,-318.54,-945578.86,4773321.9,3827743.04
1987-10-08,314.16,-4.38,-1.38,336.77,-6.71,True,1,14986,-314.16,-945893.02,4708001.76,3762108.74
1987-10-09,311.07,-3.09,-0.98,336.77,-7.63,True,1,14987,-311.07,-946204.09,4662006.09,3715802.0
1987-10-12,309.39,-1.68,-0.54,336.77,-8.13,True,1,14988,-309.39,-946513.48,4637137.32,3690623.84
1987-10-13,314.52,5.13,1.66,336.77,-6.61,True,1,14989,-314.52,-946828.0,4714340.28,3767512.28
1987-10-14,305.23,-9.29,-2.95,336.77,-9.36,True,1,14990,-305.23,-947133.23,4575397.7,3628264.47
1987-10-15,298.08,-7.15,-2.34,336.77,-11.49,True,1,14991,-298.08,-947431.31,4468517.28,3521085.97
1987-10-16,282.7,-15.38,-5.16,336.77,-16.06,True,1,14992,-282.7,-947714.01,4238238.4,3290524.39
1987-10-19,224.84,-57.86,-20.47,336.77,-33.24,True,1,14993,-224.84,-947938.85,3371026.12,2423087.27
1987-10-20,236.83,11.99,5.33,336.77,-29.68,True,1,14994,-236.83,-948175.68,3551029.02,2602853.34
1987-10-21,258.38,21.55,9.1,336.77,-23.28,True,1,14995,-258.38,-948434.06,3874408.1,2925974.04
1987-10-22,248.25,-10.13,-3.92,336.77,-26.28,True,1,14996,-248.25,-948682.31,3722757.0,2774074.69
1987-10-23,248.22,-0.03,-0.01,336.77,-26.29,True,1,14997,-248.22,-948930.53,3722555.34,2773624.81
1987-10-26,227.67,-20.55,-8.28,336.77,-32.4,True,1,14998,-227.67,-949158.2,3414594.66,2465436.46
1987-10-27,233.19,5.52,2.42,336.77,-30.76,True,1,14999,-233.19,-949391.39,3497616.81,2548225.42
1987-10-28,233.28,0.09,0.04,336.77,-30.73,True,1,15000,-233.28,-949624.67,3499200.0,2549575.33
1987-10-29,244.77,11.49,4.92,336.77,-27.32,True,1,15001,-244.77,-949869.44,3671794.77,2721925.33
1987-10-30,251.79,7.02,2.87,336.77,-25.23,True,1,15002,-251.79,-950121.23,3777353.58,2827232.35
1987-11-02,255.75,3.96,1.57,336.77,-24.06,True,1,15003,-255.75,-950376.98,3837017.25,2886640.27
1987-11-03,250.82,-4.93,-1.93,336.77,-25.52,True,1,15004,-250.82,-950627.8,3763303.28,2812675.48
1987-11-04,248.96,-1.86,-0.74,336.77,-26.07,True,1,15005,-248.96,-950876.76,3735644.8,2784768.04
1987-11-05,254.48,5.52,2.22,336.77,-24.44,True,1,15006,-254.48,-951131.24,3818726.88,2867595.64
1987-11-06,250.41,-4.07,-1.6,336.77,-25.64,True,1,15007,-250.41,-951381.65,3757902.87,2806521.22
1987-11-09,243.17,-7.24,-2.89,336.77,-27.79,True,1,15008,-243.17,-951624.82,3649495.36,2697870.54
1987-11-10,239.0,-4.17,-1.72,336.77,-29.03,True,1,15009,-239.0,-951863.82,3587151.0,2635287.18
1987-11-11,241.9,2.9,1.21,336.77,-28.17,True,1,15010,-241.9,-952105.72,3630919.0,2678813.28
1987-11-12,248.52,6.62,2.74,336.77,-26.2,True,1,15011,-248.52,-952354.24,3730533.72,2778179.48
1987-11-13,245.64,-2.88,-1.16,336.77,-27.06,True,1,15012,-245.64,-952599.88,3687547.68,2734947.8
1987-11-16,246.76,1.12,0.46,336.77,-26.73,True,1,15013,-246.76,-952846.64,3704607.88,2751761.24
1987-11-17,243.04,-3.72,-1.51,336.77,-27.83,True,1,15014,-243.04,-953089.68,3649002.56,2695912.88
1987-11-18,245.55,2.51,1.03,336.77,-27.09,True,1,15015,-245.55,-953335.23,3686933.25,2733598.02
1987-11-19,240.05,-5.5,-2.24,336.77,-28.72,True,1,15016,-240.05,-953575.28,3604590.8,2651015.52
1987-11-20,242.0,1.95,0.81,336.77,-28.14,True,1,15017,-242.0,-953817.28,3634114.0,2680296.72
1987-11-23,242.99,0.99,0.41,336.77,-27.85,True,1,15018,-242.99,-954060.27,3649223.82,2695163.55
1987-11-24,246.39,3.4,1.4,336.77,-26.84,True,1,15019,-246.39,-954306.66,3700531.41,2746224.75
1987-11-25,244.1,-2.29,-0.93,336.77,-27.52,True,1,15020,-244.1,-954550.76,3666382.0,2711831.24
1987-11-27,240.34,-3.76,-1.54,336.77,-28.63,True,1,15021,-240.34,-954791.1,3610147.14,2655356.04
1987-11-30,230.3,-10.04,-4.18,336.77,-31.62,True,1,15022,-230.3,-955021.4,3459566.6,2504545.2
1987-12-01,232.0,1.7,0.74,336.77,-31.11,True,1,15023,-232.0,-955253.4,3485336.0,2530082.6
1987-12-02,233.45,1.45,0.62,336.77,-30.68,True,1,15024,-233.45,-955486.85,3507352.8,2551865.95
1987-12-03,225.21,-8.24,-3.53,336.77,-33.13,True,1,15025,-225.21,-955712.06,3383780.25,2428068.19
1987-12-04,223.92,-1.29,-0.57,336.77,-33.51,True,1,15026,-223.92,-955935.98,3364621.92,2408685.94
1987-12-07,228.76,4.84,2.16,336.77,-32.07,True,1,15027,-228.76,-956164.74,3437576.52,2481411.78
1987-12-08,234.91,6.15,2.69,336.77,-30.25,True,1,15028,-234.91,-956399.65,3530227.48,2573827.83
1987-12-09,238.89,3.98,1.69,336.77,-29.06,True,1,15029,-238.89,-956638.54,3590277.81,2633639.27
1987-12-10,233.57,-5.32,-2.23,336.77,-30.64,True,1,15030,-233.57,-956872.11,3510557.1,2553684.99
1987-12-11,235.32,1.75,0.75,336.77,-30.12,True,1,15031,-235.32,-957107.43,3537094.92,2579987.49
1987-12-14,242.19,6.87,2.92,336.77,-28.08,True,1,15032,-242.19,-957349.62,3640600.08,2683250.46
1987-12-15,242.81,0.62,0.26,336.77,-27.9,True,1,15033,-242.81,-957592.43,3650162.73,2692570.3
1987-12-16,248.08,5.27,2.17,336.77,-26.34,True,1,15034,-248.08,-957840.51,3729634.72,2771794.21
1987-12-17,242.98,-5.1,-2.06,336.77,-27.85,True,1,15035,-242.98,-958083.49,3653204.3,2695120.81
1987-12-18,249.16,6.18,2.54,336.77,-26.02,True,1,15036,-249.16,-958332.65,3746369.76,2788037.11
1987-12-21,249.54,0.38,0.15,336.77,-25.9,True,1,15037,-249.54,-958582.19,3752332.98,2793750.79
1987-12-22,249.95,0.41,0.16,336.77,-25.78,True,1,15038,-249.95,-958832.14,3758748.1,2799915.96
1987-12-23,253.16,3.21,1.28,336.77,-24.83,True,1,15039,-253.16,-959085.3,3807273.24,2848187.94
1987-12-24,252.03,-1.13,-0.45,336.77,-25.16,True,1,15040,-252.03,-959337.33,3790531.2,2831193.87
1987-12-28,245.57,-6.46,-2.56,336.77,-27.08,True,1,15041,-245.57,-959582.9,3693618.37,2734035.47
1987-12-29,244.59,-0.98,-0.4,336.77,-27.37,True,1,15042,-244.59,-959827.49,3679122.78,2719295.29
1987-12-30,247.86,3.27,1.34,336.77,-26.4,True,1,15043,-247.86,-960075.35,3728557.98,2768482.63
1987-12-31,247.08,-0.78,-0.32,336.77,-26.63,True,1,15044,-247.08,-960322.43,3717071.52,2756749.09
1988-01-04,255.94,8.86,3.59,336.77,-24.0,True,1,15045,-255.94,-960578.37,3850617.3,2890038.93
1988-01-05,258.63,2.69,1.05,336.77,-23.2,True,1,15046,-258.63,-960837.0,3891346.98,2930509.98
1988-01-06,258.89,0.26,0.1,336.77,-23.13,True,1,15047,-258.89,-961095.89,3895517.83,2934421.94
1988-01-07,261.07,2.18,0.84,336.77,-22.48,True,1,15048,-261.07,-961356.96,3928581.36,2967224.4
1988-01-08,243.4,-17.67,-6.77,336.77,-27.72,True,1,15049,-243.4,-961600.36,3662926.6,2701326.24
1988-01-11,247.49,4.09,1.68,336.77,-26.51,True,1,15050,-247.49,-961847.85,3724724.5,2762876.65
1988-01-12,245.42,-2.07,-0.84,336.77,-27.12,True,1,15051,-245.42,-962093.27,3693816.42,2731723.15
1988-01-13,245.81,0.39,0.16,336.77,-27.01,True,1,15052,-245.81,-962339.08,3699932.12,2737593.04
1988-01-14,245.88,0.07,0.03,336.77,-26.99,True,1,15053,-245.88,-962584.96,3701231.64,2738646.68
1988-01-15,252.05,6.17,2.51,336.77,-25.16,True,1,15054,-252.05,-962837.01,3794360.7,2831523.69
1988-01-18,251.88,-0.17,-0.07,336.77,-25.21,True,1,15055,-251.88,-963088.89,3792053.4,2828964.51
1988-01-19,249.32,-2.56,-1.02,336.77,-25.97,True,1,15056,-249.32,-963338.21,3753761.92,2790423.71
1988-01-20,242.63,-6.69,-2.68,336.77,-27.95,True,1,15057,-242.63,-963580.84,3653279.91,2689699.07
1988-01-21,243.14,0.51,0.21,336.77,-27.8,True,1,15058,-243.14,-963823.98,3661202.12,2697378.14
1988-01-22,246.5,3.36,1.38,336.77,-26.8,True,1,15059,-246.5,-964070.48,3712043.5,2747973.02
1988-01-25,252.17,5.67,2.3,336.77,-25.12,True,1,15060,-252.17,-964322.65,3797680.2,2833357.55
1988-01-26,249.57,-2.6,-1.03,336.77,-25.89,True,1,15061,-249.57,-964572.22,3758773.77,2794201.55
1988-01-27,249.38,-0.19,-0.08,336.77,-25.95,True,1,15062,-249.38,-964821.6,3756161.56,2791339.96
1988-01-28,253.29,3.91,1.57,336.77,-24.79,True,1,15063,-253.29,-965074.89,3815307.27,2850232.38
1988-01-29,257.07,3.78,1.49,336.77,-23.67,True,1,15064,-257.07,-965331.96,3872502.48,2907170.52
1988-02-01,255.04,-2.03,-0.79,336.77,-24.27,True,1,15065,-255.04,-965587.0,3842177.6,2876590.6
1988-02-02,255.57,0.53,0.21,336.77,-24.11,True,1,15066,-255.57,-965842.57,3850417.62,2884575.05
1988-02-03,252.21,-3.36,-1.32,336.77,-25.11,True,1,15067,-252.21,-966094.78,3800048.07,2833953.29
1988-02-04,252.21,0.0,0.0,336.77,-25.11,True,1,15068,-252.21,-966346.99,3800300.28,2833953.29
1988-02-05,250.96,-1.25,-0.5,336.77,-25.48,True,1,15069,-250.96,-966597.95,3781716.24,2815118.29
1988-02-08,249.1,-1.86,-0.74,336.77,-26.03,True,1,15070,-249.1,-966847.05,3753937.0,2787089.95
1988-02-09,251.72,2.62,1.05,336.77,-25.26,True,1,15071,-251.72,-967098.77,3793672.12,2826573.35
1988-02-10,256.66,4.94,1.96,336.77,-23.79,True,1,15072,-256.66,-967355.43,3868379.52,2901024.09
1988-02-11,255.95,-0.71,-0.28,336.77,-24.0,True,1,15073,-255.95,-967611.38,3857934.35,2890322.97
1988-02-12,257.63,1.68,0.66,336.77,-23.5,True,1,15074,-257.63,-967869.01,3883514.62,2915645.61
1988-02-16,259.83,2.2,0.85,336.77,-22.85,True,1,15075,-259.83,-968128.84,3916937.25,2948808.41
1988-02-17,259.21,-0.62,-0.24,336.77,-23.03,True,1,15076,-259.21,-968388.05,3907849.96,2939461.91
1988-02-18,257.91,-1.3,-0.5,336.77,-23.42,True,1,15077,-257.91,-968645.96,3888509.07,2919863.11
1988-02-19,261.61,3.7,1.44,336.77,-22.32,True,1,15078,-261.61,-968907.57,3944555.58,2975648.01
1988-02-22,265.64,4.03,1.54,336.77,-21.12,True,1,15079,-265.64,-969173.21,4005585.56,3036412.35
1988-02-23,265.02,-0.62,-0.23,336.77,-21.3,True,1,15080,-265.02,-969438.23,3996501.6,3027063.37
1988-02-24,264.43,-0.59,-0.22,336.77,-21.48,True,1,15081,-264.43,-969702.66,3987868.83,3018166.17
1988-02-25,261.58,-2.85,-1.08,336.77,-22.33,True,1,15082,-261.58,-969964.24,3945149.56,2975185.32
1988-02-26,262.46,0.88,0.34,336.77,-22.07,True,1,15083,-262.46,-970226.7,3958684.18,2988457.48
1988-02-29,267.82,5.36,2.04,336.77,-20.47,True,1,15084,-267.82,-970494.52,4039796.88,3069302.36
1988-03-01,267.22,-0.6,-0.22,336.77,-20.65,True,1,15085,-267.22,-970761.74,4031013.7,3060251.96
1988-03-02,267.98,0.76,0.28,336.77,-20.43,True,1,15086,-267.98,-971029.72,4042746.28,3071716.56
1988-03-03,267.88,-0.1,-0.04,336.77,-20.46,True,1,15087,-267.88,-971297.6,4041505.56,3070207.96
1988-03-04,267.3,-0.58,-0.22,336.77,-20.63,True,1,15088,-267.3,-971564.9,4033022.4,3061457.5
1988-03-07,267.38,0.08,0.03,336.77,-20.6,True,1,15089,-267.38,-971832.28,4034496.82,3062664.54
1988-03-08,269.43,2.05,0.77,336.77,-20.0,True,1,15090,-269.43,-972101.71,4065698.7,3093596.99
1988-03-09,269.06,-0.37,-0.14,336.77,-20.11,True,1,15091,-269.06,-972370.77,4060384.46,3088013.69
1988-03-10,263.84,-5.22,-1.94,336.77,-21.66,True,1,15092,-263.84,-972634.61,3981873.28,3009238.67
1988-03-11,264.94,1.1,0.42,336.77,-21.33,True,1,15093,-264.94,-972899.55,3998739.42,3025839.87
1988-03-14,266.37,1.43,0.54,336.77,-20.9,True,1,15094,-266.37,-973165.92,4020588.78,3047422.86
1988-03-15,266.13,-0.24,-0.09,336.77,-20.98,True,1,15095,-266.13,-973432.05,4017232.35,3043800.3
1988-03-16,268.65,2.52,0.95,336.77,-20.23,True,1,15096,-268.65,-973700.7,4055540.4,3081839.7
1988-03-17,271.22,2.57,0.96,336.77,-19.46,True,1,15097,-271.22,-973971.92,4094608.34,3120636.42
1988-03-18,271.12,-0.1,-0.04,336.77,-19.49,True,1,15098,-271.12,-974243.04,4093369.76,3119126.72
1988-03-21,268.74,-2.38,-0.88,336.77,-20.2,True,1,15099,-268.74,-974511.78,4057705.26,3083193.48
1988-03-22,268.84,0.1,0.04,336.77,-20.17,True,1,15100,-268.84,-974780.62,4059484.0,3084703.38
1988-03-23,268.91,0.07,0.03,336.77,-20.15,True,1,15101,-268.91,-975049.53,4060809.91,3085760.38
1988-03-24,263.35,-5.56,-2.07,336.77,-21.8,True,1,15102,-263.35,-975312.88,3977111.7,3001798.82
1988-03-25,258.51,-4.84,-1.84,336.77,-23.24,True,1,15103,-258.51,-975571.39,3904276.53,2928705.14
1988-03-28,258.06,-0.45,-0.17,336.77,-23.37,True,1,15104,-258.06,-975829.45,3897738.24,2921908.79
1988-03-29,260.07,2.01,0.78,336.77,-22.78,True,1,15105,-260.07,-976089.52,3928357.35,2952267.83
1988-03-30,258.07,-2.0,-0.77,336.77,-23.37,True,1,15106,-258.07,-976347.59,3898405.42,2922057.83
1988-03-31,258.89,0.82,0.32,336.77,-23.13,True,1,15107,-258.89,-976606.48,3911051.23,2934444.75
1988-04-04,256.09,-2.8,-1.08,336.77,-23.96,True,1,15108,-256.09,-976862.57,3869007.72,2892145.15
1988-04-05,258.51,2.42,0.94,336.77,-23.24,True,1,15109,-258.51,-977121.08,3905827.59,2928706.51
1988-04-06,265.49,6.98,2.7,336.77,-21.17,True,1,15110,-265.49,-977386.57,4011553.9,3034167.33
1988-04-07,266.16,0.67,0.25,336.77,-20.97,True,1,15111,-266.16,-977652.73,4021943.76,3044291.03
1988-04-08,269.43,3.27,1.23,336.77,-20.0,True,1,15112,-269.43,-977922.16,4071626.16,3093704.0
1988-04-11,270.16,0.73,0.27,336.77,-19.78,True,1,15113,-270.16,-978192.32,4082928.08,3104735.76
1988-04-12,271.37,1.21,0.45,336.77,-19.42,True,1,15114,-271.37,-978463.69,4101486.18,3123022.49
1988-04-13,271.58,0.21,0.08,336.77,-19.36,True,1,15115,-271.58,-978735.27,4104931.7,3126196.43
1988-04-14,259.75,-11.83,-4.36,336.77,-22.87,True,1,15116,-259.75,-978995.02,3926381.0,2947385.98
1988-04-15,259.77,0.02,0.01,336.77,-22.86,True,1,15117,-259.77,-979254.79,3926943.09,2947688.3
1988-04-18,259.21,-0.56,-0.22,336.77,-23.03,True,1,15118,-259.21,-979514.0,3918736.78,2939222.78
1988-04-19,257.92,-1.29,-0.5,336.77,-23.41,True,1,15119,-257.92,-979771.92,3899492.48,2919720.56
1988-04-20,256.13,-1.79,-0.69,336.77,-23.94,True,1,15120,-256.13,-980028.05,3872685.6,2892657.55
1988-04-21,256.42,0.29,0.11,336.77,-23.86,True,1,15121,-256.42,-980284.47,3877326.82,2897042.35
1988-04-22,260.14,3.72,1.45,336.77,-22.75,True,1,15122,-260.14,-980544.61,3933837.08,2953292.47
1988-04-25,262.51,2.37,0.91,336.77,-22.05,True,1,15123,-262.51,-980807.12,3969938.73,2989131.61
1988-04-26,263.93,1.42,0.54,336.77,-21.63,True,1,15124,-263.93,-981071.05,3991677.32,3010606.27
1988-04-27,263.8,-0.13,-0.05,336.77,-21.67,True,1,15125,-263.8,-981334.85,3989975.0,3008640.15
1988-04-28,262.61,-1.19,-0.45,336.77,-22.02,True,1,15126,-262.61,-981597.46,3972238.86,2990641.4
1988-04-29,261.33,-1.28,-0.49,336.77,-22.4,True,1,15127,-261.33,-981858.79,3953138.91,2971280.12
1988-05-02,261.56,0.23,0.09,336.77,-22.33,True,1,15128,-261.56,-982120.35,3956879.68,2974759.33
1988-05-03,263.0,1.44,0.55,336.77,-21.9,True,1,15129,-263.0,-982383.35,3978927.0,2996543.65
1988-05-04,260.32,-2.68,-1.02,336.77,-22.7,True,1,15130,-260.32,-982643.67,3938641.6,2955997.93
1988-05-05,258.79,-1.53,-0.59,336.77,-23.16,True,1,15131,-258.79,-982902.46,3915751.49,2932849.03
1988-05-06,257.48,-1.31,-0.51,336.77,-23.54,True,1,15132,-257.48,-983159.94,3896187.36,2913027.42
1988-05-09,256.54,-0.94,-0.36,336.77,-23.82,True,1,15133,-256.54,-983416.48,3882219.82,2898803.34
1988-05-10,257.62,1.08,0.42,336.77,-23.5,True,1,15134,-257.62,-983674.1,3898821.08,2915146.98
1988-05-11,253.31,-4.31,-1.67,336.77,-24.78,True,1,15135,-253.31,-983927.41,3833846.85,2849919.44
1988-05-12,253.85,0.54,0.21,336.77,-24.62,True,1,15136,-253.85,-984181.26,3842273.6,2858092.34
1988-05-13,256.78,2.93,1.15,336.77,-23.75,True,1,15137,-256.78,-984438.04,3886878.86,2902440.82
1988-05-16,258.71,1.93,0.75,336.77,-23.18,True,1,15138,-258.71,-984696.75,3916351.98,2931655.23
1988-05-17,255.39,-3.32,-1.28,336.77,-24.16,True,1,15139,-255.39,-984952.14,3866349.21,2881397.07
1988-05-18,251.35,-4.04,-1.58,336.77,-25.36,True,1,15140,-251.35,-985203.49,3805439.0,2820235.51
1988-05-19,252.57,1.22,0.48,336.77,-25.0,True,1,15141,-252.57,-985456.06,3824162.37,2838706.31
1988-05-20,253.02,0.45,0.18,336.77,-24.87,True,1,15142,-253.02,-985709.08,3831228.84,2845519.76
1988-05-23,250.83,-2.19,-0.87,336.77,-25.52,True,1,15143,-250.83,-985959.91,3798318.69,2812358.78
1988-05-24,253.51,2.68,1.07,336.77,-24.72,True,1,15144,-253.51,-986213.42,3839155.44,2852942.02
1988-05-25,253.76,0.25,0.1,336.77,-24.65,True,1,15145,-253.76,-986467.18,3843195.2,2856728.02
1988-05-26,254.63,0.87,0.34,336.77,-24.39,True,1,15146,-254.63,-986721.81,3856625.98,2869904.17
1988-05-27,253.42,-1.21,-0.48,336.77,-24.75,True,1,15147,-253.42,-986975.23,3838552.74,2851577.51
1988-05-31,262.16,8.74,3.45,336.77,-22.16,True,1,15148,-262.16,-987237.39,3971199.68,2983962.29
1988-06-01,266.69,4.53,1.73,336.77,-20.81,True,1,15149,-266.69,-987504.08,4040086.81,3052582.73
1988-06-02,265.33,-1.36,-0.51,336.77,-21.21,True,1,15150,-265.33,-987769.41,4019749.5,3031980.09
1988-06-03,266.45,1.12,0.42,336.77,-20.88,True,1,15151,-266.45,-988035.86,4036983.95,3048948.09
1988-06-06,267.05,0.6,0.22,336.77,-20.7,True,1,15152,-267.05,-988302.91,4046341.6,3058038.69
1988-06-07,265.17,-1.88,-0.7,336.77,-21.26,True,1,15153,-265.17,-988568.08,4018121.01,3029552.93
1988-06-08,271.52,6.35,2.4,336.77,-19.38,True,1,15154,-271.52,-988839.6,4114614.08,3125774.48
1988-06-09,270.2,-1.32,-0.49,336.77,-19.77,True,1,15155,-270.2,-989109.8,4094881.0,3105771.2
1988-06-10,271.26,1.06,0.39,336.77,-19.45,True,1,15156,-271.26,-989381.06,4111216.56,3121835.5
1988-06-13,271.43,0.17,0.06,336.77,-19.4,True,1,15157,-271.43,-989652.49,4114064.51,3124412.02
1988-06-14,274.3,2.87,1.06,336.77,-18.55,True,1,15158,-274.3,-989926.79,4157839.4,3167912.61
1988-06-15,274.45,0.15,0.06,336.77,-18.5,True,1,15159,-274.45,-990201.24,4160387.55,3170186.31
1988-06-16,269.77,-4.68,-1.7,336.77,-19.9,True,1,15160,-269.77,-990471.01,4089713.2,3099242.19
1988-06-17,270.68,0.91,0.34,336.77,-19.62,True,1,15161,-270.68,-990741.69,4103779.48,3113037.79
1988-06-20,268.94,-1.74,-0.64,336.77,-20.14,True,1,15162,-268.94,-991010.63,4077668.28,3086657.65
1988-06-21,271.67,2.73,1.01,336.77,-19.33,True,1,15163,-271.67,-991282.3,4119332.21,3128049.91
1988-06-22,275.66,3.99,1.47,336.77,-18.15,True,1,15164,-275.66,-991557.96,4180108.24,3188550.28
1988-06-23,274.82,-0.84,-0.3,336.77,-18.4,True,1,15165,-274.82,-991832.78,4167645.3,3175812.52
1988-06-24,273.78,-1.04,-0.38,336.77,-18.7,True,1,15166,-273.78,-992106.56,4152147.48,3160040.92
1988-06-27,269.06,-4.72,-1.72,336.77,-20.11,True,1,15167,-269.06,-992375.62,4080833.02,3088457.4
1988-06-28,272.31,3.25,1.21,336.77,-19.14,True,1,15168,-272.31,-992647.93,4130398.08,3137750.15
1988-06-29,270.98,-1.33,-0.49,336.77,-19.54,True,1,15169,-270.98,-992918.91,4110495.62,3117576.71
1988-06-30,273.5,2.52,0.93,336.77,-18.79,True,1,15170,-273.5,-993192.41,4148995.0,3155802.59
1988-07-01,271.78,-1.72,-0.63,336.77,-19.3,True,1,15171,-271.78,-993464.19,4123174.38,3129710.19
1988-07-05,275.81,4.03,1.48,336.77,-18.1,True,1,15172,-275.81,-993740.0,4184589.32,3190849.32
1988-07-06,272.02,-3.79,-1.37,336.77,-19.23,True,1,15173,-272.02,-994012.02,4127359.46,3133347.44
1988-07-07,271.78,-0.24,-0.09,336.77,-19.3,True,1,15174,-271.78,-994283.8,4123989.72,3129705.92
1988-07-08,270.02,-1.76,-0.65,336.77,-19.82,True,1,15175,-270.02,-994553.82,4097553.5,3102999.68
1988-07-11,270.55,0.53,0.2,336.77,-19.66,True,1,15176,-270.55,-994824.37,4105866.8,3111042.43
1988-07-12,267.85,-2.7,-1.0,336.77,-20.46,True,1,15177,-267.85,-995092.22,4065159.45,3070067.23
1988-07-13,269.32,1.47,0.55,336.77,-20.03,True,1,15178,-269.32,-995361.54,4087738.96,3092377.42
1988-07-14,270.26,0.94,0.35,336.77,-19.75,True,1,15179,-270.26,-995631.8,4102276.54,3106644.74
1988-07-15,272.05,1.79,0.66,336.77,-19.22,True,1,15180,-272.05,-995903.85,4129719.0,3133815.15
1988-07-18,270.51,-1.54,-0.57,336.77,-19.68,True,1,15181,-270.51,-996174.36,4106612.31,3110437.95
1988-07-19,268.47,-2.04,-0.75,336.77,-20.28,True,1,15182,-268.47,-996442.83,4075911.54,3079468.71
1988-07-20,270.0,1.53,0.57,336.77,-19.83,True,1,15183,-270.0,-996712.83,4099410.0,3102697.17
1988-07-21,266.66,-3.34,-1.24,336.77,-20.82,True,1,15184,-266.66,-996979.49,4048965.44,3051985.95
1988-07-22,263.5,-3.16,-1.18,336.77,-21.76,True,1,15185,-263.5,-997242.99,4001247.5,3004004.51
1988-07-25,264.68,1.18,0.45,336.77,-21.41,True,1,15186,-264.68,-997507.67,4019430.48,3021922.81
1988-07-26,265.19,0.51,0.19,336.77,-21.26,True,1,15187,-265.19,-997772.86,4027440.53,3029667.67
1988-07-27,262.5,-2.69,-1.01,336.77,-22.05,True,1,15188,-262.5,-998035.36,3986850.0,2988814.64
1988-07-28,266.02,3.52,1.34,336.77,-21.01,True,1,15189,-266.02,-998301.38,4040577.78,3042276.4
1988-07-29,272.02,6.0,2.26,336.77,-19.23,True,1,15190,-272.02,-998573.4,4131983.8,3133410.4
1988-08-01,272.21,0.19,0.07,336.77,-19.17,True,1,15191,-272.21,-998845.61,4135142.11,3136296.5
1988-08-02,272.06,-0.15,-0.06,336.77,-19.22,True,1,15192,-272.06,-999117.67,4133135.52,3134017.85
1988-08-03,272.98,0.92,0.34,336.77,-18.94,True,1,15193,-272.98,-999390.65,4147385.14,3147994.49
1988-08-04,271.93,-1.05,-0.38,336.77,-19.25,True,1,15194,-271.93,-999662.58,4131704.42,3132041.84
1988-08-05,271.15,-0.78,-0.29,336.77,-19.48,True,1,15195,-271.15,-999933.73,4120124.25,3120190.52
1988-08-08,269.98,-1.17,-0.43,336.77,-19.83,True,1,15196,-269.98,-1000203.71,4102616.08,3102412.37
1988-08-09,266.49,-3.49,-1.29,336.77,-20.87,True,1,15197,-266.49,-1000470.2,4049848.53,3049378.33
1988-08-10,261.9,-4.59,-1.72,336.77,-22.23,True,1,15198,-261.9,-1000732.1,3980356.2,2979624.1
1988-08-11,262.75,0.85,0.32,336.77,-21.98,True,1,15199,-262.75,-1000994.85,3993537.25,2992542.4
1988-08-12,262.55,-0.2,-0.08,336.77,-22.04,True,1,15200,-262.55,-1001257.4,3990760.0,2989502.6
1988-08-15,258.69,-3.86,-1.47,336.77,-23.18,True,1,15201,-258.69,-1001516.09,3932346.69,2930830.6
1988-08-16,260.56,1.87,0.72,336.77,-22.63,True,1,15202,-260.56,-1001776.65,3961033.12,2959256.47
1988-08-17,260.77,0.21,0.08,336.77,-22.57,True,1,15203,-260.77,-1002037.42,3964486.31,2962448.89
1988-08-18,261.03,0.26,0.1,336.77,-22.49,True,1,15204,-261.03,-1002298.45,3968700.12,2966401.67
1988-08-19,260.24,-0.79,-0.3,336.77,-22.72,True,1,15205,-260.24,-1002558.69,3956949.2,2954390.51
1988-08-22,256.98,-3.26,-1.25,336.77,-23.69,True,1,15206,-256.98,-1002815.67,3907637.88,2904822.21
1988-08-23,257.09,0.11,0.04,336.77,-23.66,True,1,15207,-257.09,-1003072.76,3909567.63,2906494.87
1988-08-24,261.13,4.04,1.57,336.77,-22.46,True,1,15208,-261.13,-1003333.89,3971265.04,2967931.15
1988-08-25,259.18,-1.95,-0.75,336.77,-23.04,True,1,15209,-259.18,-1003593.07,3941868.62,2938275.55
1988-08-26,259.68,0.5,0.19,336.77,-22.89,True,1,15210,-259.68,-1003852.75,3949732.8,2945880.05
1988-08-29,262.33,2.65,1.02,336.77,-22.1,True,1,15211,-262.33,-1004115.08,3990301.63,2986186.55
1988-08-30,262.51,0.18,0.07,336.77,-22.05,True,1,15212,-262.51,-1004377.59,3993302.12,2988924.53
1988-08-31,261.52,-0.99,-0.38,336.77,-22.34,True,1,15213,-261.52,-1004639.11,3978503.76,2973864.65
1988-09-01,258.35,-3.17,-1.21,336.77,-23.29,True,1,15214,-258.35,-1004897.46,3930536.9,2925639.44
1988-09-02,264.48,6.13,2.37,336.77,-21.47,True,1,15215,-264.48,-1005161.94,4024063.2,3018901.26
1988-09-06,265.59,1.11,0.42,336.77,-21.14,True,1,15216,-265.59,-1005427.53,4041217.44,3035789.91
1988-09-07,265.87,0.28,0.1,336.77,-21.05,True,1,15217,-265.87,-1005693.4,4045743.79,3040050.39
1988-09-08,265.88,0.01,0.0,336.77,-21.05,True,1,15218,-265.88,-1005959.28,4046161.84,3040202.56
1988-09-09,266.84,0.96,0.36,336.77,-20.76,True,1,15219,-266.84,-1006226.12,4061037.96,3054811.84
1988-09-12,266.47,-0.37,-0.14,336.77,-20.88,True,1,15220,-266.47,-1006492.59,4055673.4,3049180.81
1988-09-13,267.43,0.96,0.36,336.77,-20.59,True,1,15221,-267.43,-1006760.02,4070552.03,3063792.01
1988-09-14,269.31,1.88,0.7,336.77,-20.03,True,1,15222,-269.31,-1007029.33,4099436.82,3092407.49
1988-09-15,268.13,-1.18,-0.44,336.77,-20.38,True,1,15223,-268.13,-1007297.46,4081742.99,3074445.53
1988-09-16,270.65,2.52,0.94,336.77,-19.63,True,1,15224,-270.65,-1007568.11,4120375.6,3112807.49
1988-09-19,268.82,-1.83,-0.68,336.77,-20.18,True,1,15225,-268.82,-1007836.93,4092784.5,3084947.57
1988-09-20,269.73,0.91,0.34,336.77,-19.91,True,1,15226,-269.73,-1008106.66,4106908.98,3098802.32
1988-09-21,270.16,0.43,0.16,336.77,-19.78,True,1,15227,-270.16,-1008376.82,4113726.32,3105349.5
1988-09-22,269.18,-0.98,-0.36,336.77,-20.07,True,1,15228,-269.18,-1008646.0,4099073.04,3090427.04
1988-09-23,269.76,0.58,0.22,336.77,-19.9,True,1,15229,-269.76,-1008915.76,4108175.04,3099259.28
1988-09-26,268.88,-0.88,-0.33,336.77,-20.16,True,1,15230,-268.88,-1009184.64,4095042.4,3085857.76
1988-09-27,268.26,-0.62,-0.23,336.77,-20.34,True,1,15231,-268.26,-1009452.9,4085868.06,3076415.16
1988-09-28,269.08,0.82,0.31,336.77,-20.1,True,1,15232,-269.08,-1009721.98,4098626.56,3088904.58
1988-09-29,272.59,3.51,1.3,336.77,-19.06,True,1,15233,-272.59,-1009994.57,4152363.47,3142368.9
1988-09-30,271.91,-0.68,-0.25,336.77,-19.26,True,1,15234,-271.91,-1010266.48,4142276.94,3132010.46
1988-10-03,271.38,-0.53,-0.2,336.77,-19.42,True,1,15235,-271.38,-1010537.86,4134474.3,3123936.44
1988-10-04,270.62,-0.76,-0.28,336.77,-19.64,True,1,15236,-270.62,-1010808.48,4123166.32,3112357.84
1988-10-05,271.86,1.24,0.46,336.77,-19.27,True,1,15237,-271.86,-1011080.34,4142330.82,3131250.48
1988-10-06,272.39,0.53,0.2,336.77,-19.12,True,1,15238,-272.39,-1011352.73,4150678.82,3139326.09
1988-10-07,278.07,5.68,2.08,336.77,-17.43,True,1,15239,-278.07,-1011630.8,4237508.73,3225877.93
1988-10-10,278.24,0.17,0.06,336.77,-17.38,True,1,15240,-278.24,-1011909.04,4240377.6,3228468.56
1988-10-11,277.93,-0.31,-0.11,336.77,-17.47,True,1,15241,-277.93,-1012186.97,4235931.13,3223744.16
1988-10-12,273.98,-3.95,-1.42,336.77,-18.64,True,1,15242,-273.98,-1012460.95,4176003.16,3163542.21
1988-10-13,275.22,1.24,0.45,336.77,-18.28,True,1,15243,-275.22,-1012736.17,4195178.46,3182442.29
1988-10-14,275.5,0.28,0.1,336.77,-18.19,True,1,15244,-275.5,-1013011.67,4199722.0,3186710.33
1988-10-17,276.41,0.91,0.33,336.77,-17.92,True,1,15245,-276.41,-1013288.08,4213870.45,3200582.37
1988-10-18,279.38,2.97,1.07,336.77,-17.04,True,1,15246,-279.38,-1013567.46,4259427.48,3245860.02
1988-10-19,276.97,-2.41,-0.86,336.77,-17.76,True,1,15247,-276.97,-1013844.43,4222961.59,3209117.16
1988-10-20,282.88,5.91,2.13,336.77,-16.0,True,1,15248,-282.88,-1014127.31,4313354.24,3299226.93
1988-10-21,283.66,0.78,0.28,336.77,-15.77,True,1,15249,-283.66,-1014410.97,4325531.34,3311120.37
1988-10-24,282.28,-1.38,-0.49,336.77,-16.18,True,1,15250,-282.28,-1014693.25,4304770.0,3290076.75
1988-10-25,282.38,0.1,0.04,336.77,-16.15,True,1,15251,-282.38,-1014975.63,4306577.38,3291601.75
1988-10-26,281.38,-1.0,-0.35,336.77,-16.45,True,1,15252,-281.38,-1015257.01,4291607.76,3276350.75
1988-10-27,277.28,-4.1,-1.46,336.77,-17.66,True,1,15253,-277.28,-1015534.29,4229351.84,3213817.55
1988-10-28,278.53,1.25,0.45,336.77,-17.29,True,1,15254,-278.53,-1015812.82,4248696.62,3232883.8
1988-10-31,278.97,0.44,0.16,336.77,-17.16,True,1,15255,-278.97,-1016091.79,4255687.35,3239595.56
1988-11-01,279.06,0.09,0.03,336.77,-17.14,True,1,15256,-279.06,-1016370.85,4257339.36,3240968.51
1988-11-02,279.06,0.0,0.0,336.77,-17.14,True,1,15257,-279.06,-1016649.91,4257618.42,3240968.51
1988-11-03,279.2,0.14,0.05,336.77,-17.1,True,1,15258,-279.2,-1016929.11,4260033.6,3243104.49
1988-11-04,276.31,-2.89,-1.03,336.77,-17.95,True,1,15259,-276.31,-1017205.42,4216214.29,3199008.87
1988-11-07,273.93,-2.38,-0.86,336.77,-18.66,True,1,15260,-273.93,-1017479.35,4180171.8,3162692.45
1988-11-08,275.15,1.22,0.44,336.77,-18.3,True,1,15261,-275.15,-1017754.5,4199064.15,3181309.65
1988-11-09,273.33,-1.82,-0.66,336.77,-18.84,True,1,15262,-273.33,-1018027.83,4171562.46,3153534.63
1988-11-10,273.69,0.36,0.13,336.77,-18.73,True,1,15263,-273.69,-1018301.52,4177330.47,3159028.95
1988-11-11,267.92,-5.77,-2.11,336.77,-20.44,True,1,15264,-267.92,-1018569.44,4089530.88,3070961.44
1988-11-14,267.72,-0.2,-0.08,336.77,-20.5,True,1,15265,-267.72,-1018837.16,4086745.8,3067908.64
1988-11-15,268.34,0.62,0.23,336.77,-20.32,True,1,15266,-268.34,-1019105.5,4096478.44,3077372.94
1988-11-16,263.82,-4.52,-1.68,336.77,-21.66,True,1,15267,-263.82,-1019369.32,4027739.94,3008370.62
1988-11-17,264.6,0.78,0.3,336.77,-21.43,True,1,15268,-264.6,-1019633.92,4039912.8,3020278.88
1988-11-18,266.47,1.87,0.71,336.77,-20.88,True,1,15269,-266.47,-1019900.39,4068730.43,3048830.04
1988-11-21,266.22,-0.25,-0.09,336.77,-20.95,True,1,15270,-266.22,-1020166.61,4065179.4,3045012.79
1988-11-22,267.21,0.99,0.37,336.77,-20.66,True,1,15271,-267.21,-1020433.82,4080563.91,3060130.09
1988-11-23,269.0,1.79,0.67,336.77,-20.12,True,1,15272,-269.0,-1020702.82,4108168.0,3087465.18
1988-11-25,267.23,-1.77,-0.66,336.77,-20.65,True,1,15273,-267.23,-1020970.05,4081403.79,3060433.74
1988-11-28,268.64,1.41,0.53,336.77,-20.23,True,1,15274,-268.64,-1021238.69,4103207.36,3081968.67
1988-11-29,270.91,2.27,0.84,336.77,-19.56,True,1,15275,-270.91,-1021509.6,4138150.25,3116640.65
1988-11-30,273.7,2.79,1.03,336.77,-18.73,True,1,15276,-273.7,-1021783.3,4181041.2,3159257.9
1988-12-01,272.49,-1.21,-0.44,336.77,-19.09,True,1,15277,-272.49,-1022055.79,4162829.73,3140773.94
1988-12-02,271.81,-0.68,-0.25,336.77,-19.29,True,1,15278,-271.81,-1022327.6,4152713.18,3130385.58
1988-12-05,274.93,3.12,1.15,336.77,-18.36,True,1,15279,-274.93,-1022602.53,4200655.47,3178052.94
1988-12-06,277.59,2.66,0.97,336.77,-17.57,True,1,15280,-277.59,-1022880.12,4241575.2,3218695.08
1988-12-07,278.13,0.54,0.2,336.77,-17.41,True,1,15281,-278.13,-1023158.25,4250104.53,3226946.28
1988-12-08,276.59,-1.54,-0.55,336.77,-17.87,True,1,15282,-276.59,-1023434.84,4226848.38,3203413.54
1988-12-09,277.03,0.44,0.16,336.77,-17.74,True,1,15283,-277.03,-1023711.87,4233849.49,3210137.62
1988-12-12,276.52,-0.51,-0.18,336.77,-17.89,True,1,15284,-276.52,-1023988.39,4226331.68,3202343.29
1988-12-13,276.31,-0.21,-0.08,336.77,-17.95,True,1,15285,-276.31,-1024264.7,4223398.35,3199133.65
1988-12-14,275.31,-1.0,-0.36,336.77,-18.25,True,1,15286,-275.31,-1024540.01,4208388.66,3183848.65
1988-12-15,274.28,-1.03,-0.37,336.77,-18.56,True,1,15287,-274.28,-1024814.29,4192918.36,3168104.07
1988-12-16,276.29,2.01,0.73,336.77,-17.96,True,1,15288,-276.29,-1025090.58,4223921.52,3198830.94
1988-12-19,278.91,2.62,0.95,336.77,-17.18,True,1,15289,-278.91,-1025369.49,4264254.99,3238885.5
1988-12-20,277.47,-1.44,-0.52,336.77,-17.61,True,1,15290,-277.47,-1025646.96,4242516.3,3216869.34
1988-12-21,277.38,-0.09,-0.03,336.77,-17.64,True,1,15291,-277.38,-1025924.34,4241417.58,3215493.24
1988-12-22,276.87,-0.51,-0.18,336.77,-17.79,True,1,15292,-276.87,-1026201.21,4233896.04,3207694.83
1988-12-23,277.87,1.0,0.36,336.77,-17.49,True,1,15293,-277.87,-1026479.08,4249465.91,3222986.83
1988-12-27,276.83,-1.04,-0.37,336.77,-17.8,True,1,15294,-276.83,-1026755.91,4233838.02,3207082.11
1988-12-28,277.08,0.25,0.09,336.77,-17.72,True,1,15295,-277.08,-1027032.99,4237938.6,3210905.61
1988-12-29,279.4,2.32,0.84,336.77,-17.04,True,1,15296,-279.4,-1027312.39,4273702.4,3246390.01
1988-12-30,277.72,-1.68,-0.6,336.77,-17.53,True,1,15297,-277.72,-1027590.11,4248282.84,3220692.73
1989-01-03,275.31,-2.41,-0.87,336.77,-18.25,True,1,15298,-275.31,-1027865.42,4211692.38,3183826.96
1989-01-04,279.43,4.12,1.5,336.77,-17.03,True,1,15299,-279.43,-1028144.85,4274999.57,3246854.72
1989-01-05,280.01,0.58,0.21,336.77,-16.85,True,1,15300,-280.01,-1028424.86,4284153.0,3255728.14
1989-01-06,280.67,0.66,0.24,336.77,-16.66,True,1,15301,-280.67,-1028705.53,4294531.67,3265826.14
1989-01-09,280.98,0.31,0.11,336.77,-16.57,True,1,15302,-280.98,-1028986.51,4299555.96,3270569.45
1989-01-10,280.38,-0.6,-0.21,336.77,-16.74,True,1,15303,-280.38,-1029266.89,4290655.14,3261388.25
1989-01-11,282.01,1.63,0.58,336.77,-16.26,True,1,15304,-282.01,-1029548.9,4315881.04,3286332.14
1989-01-12,283.17,1.16,0.41,336.77,-15.92,True,1,15305,-283.17,-1029832.07,4333916.85,3304084.78
1989-01-13,283.87,0.7,0.25,336.77,-15.71,True,1,15306,-283.87,-1030115.94,4344914.22,3314798.28
1989-01-16,284.14,0.27,0.1,336.77,-15.63,True,1,15307,-284.14,-1030400.08,4349330.98,3318930.9
1989-01-17,283.55,-0.59,-0.21,336.77,-15.8,True,1,15308,-283.55,-1030683.63,4340583.4,3309899.77
1989-01-18,286.53,2.98,1.05,336.77,-14.92,True,1,15309,-286.53,-1030970.16,4386487.77,3355517.61
1989-01-19,286.91,0.38,0.13,336.77,-14.8,True,1,15310,-286.91,-1031257.07,4392592.1,3361335.03
1989-01-20,286.63,-0.28,-0.1,336.77,-14.89,True,1,15311,-286.63,-1031543.7,4388591.93,3357048.23
1989-01-23,284.5,-2.13,-0.74,336.77,-15.52,True,1,15312,-284.5,-1031828.2,4356264.0,3324435.8
1989-01-24,288.49,3.99,1.4,336.77,-14.34,True,1,15313,-288.49,-1032116.69,4417647.37,3385530.68
1989-01-25,289.14,0.65,0.22,336.77,-14.14,True,1,15314,-289.14,-1032405.83,4427889.96,3395484.13
1989-01-26,291.69,2.55,0.88,336.77,-13.39,True,1,15315,-291.69,-1032697.52,4467232.35,3434534.83
1989-01-27,293.82,2.13,0.73,336.77,-12.75,True,1,15316,-293.82,-1032991.34,4500147.12,3467155.78
1989-01-30,294.99,1.17,0.4,336.77,-12.41,True,1,15317,-294.99,-1033286.33,4518361.83,3485075.5
1989-01-31,297.47,2.48,0.84,336.77,-11.67,True,1,15318,-297.47,-1033583.8,4556645.46,3523061.66
1989-02-01,297.09,-0.38,-0.13,336.77,-11.78,True,1,15319,-297.09,-1033880.89,4551121.71,3517240.82
1989-02-02,296.84,-0.25,-0.08,336.77,-11.86,True,1,15320,-296.84,-1034177.73,4547588.8,3513411.07
1989-02-03,296.97,0.13,0.04,336.77,-11.82,True,1,15321,-296.97,-1034474.7,4549877.37,3515402.67
1989-02-06,296.04,-0.93,-0.31,336.77,-12.09,True,1,15322,-296.04,-1034770.74,4535924.88,3501154.14
1989-02-07,299.63,3.59,1.21,336.77,-11.03,True,1,15323,-299.63,-1035070.37,4591230.49,3556160.12
1989-02-08,298.65,-0.98,-0.33,336.77,-11.32,True,1,15324,-298.65,-1035369.02,4576512.6,3541143.58
1989-02-09,296.06,-2.59,-0.87,336.77,-12.09,True,1,15325,-296.06,-1035665.08,4537119.5,3501454.42
1989-02-10,292.02,-4.04,-1.36,336.77,-13.29,True,1,15326,-292.02,-1035957.1,4475498.52,3439541.42
1989-02-13,292.54,0.52,0.18,336.77,-13.13,True,1,15327,-292.54,-1036249.64,4483760.58,3447510.94
1989-02-14,291.81,-0.73,-0.25,336.77,-13.35,True,1,15328,-291.81,-1036541.45,4472863.68,3436322.23
1989-02-15,294.24,2.43,0.83,336.77,-12.63,True,1,15329,-294.24,-1036835.69,4510404.96,3473569.27
1989-02-16,294.81,0.57,0.19,336.77,-12.46,True,1,15330,-294.81,-1037130.5,4519437.3,3482306.8
1989-02-17,296.76,1.95,0.66,336.77,-11.88,True,1,15331,-296.76,-1037427.26,4549627.56,3512200.3
1989-02-21,295.98,-0.78,-0.26,336.77,-12.11,True,1,15332,-295.98,-1037723.24,4537965.36,3500242.12
1989-02-22,290.91,-5.07,-1.71,336.77,-13.62,True,1,15333,-290.91,-1038014.15,4460523.03,3422508.88
1989-02-23,292.05,1.14,0.39,336.77,-13.28,True,1,15334,-292.05,-1038306.2,4478294.7,3439988.5
1989-02-24,287.13,-4.92,-1.68,336.77,-14.74,True,1,15335,-287.13,-1038593.33,4403138.55,3364545.22
1989-02-27,287.82,0.69,0.24,336.77,-14.54,True,1,15336,-287.82,-1038881.15,4414007.52,3375126.37
1989-02-28,288.86,1.04,0.36,336.77,-14.23,True,1,15337,-288.86,-1039170.01,4430245.82,3391075.81
1989-03-01,287.11,-1.75,-0.61,336.77,-14.75,True,1,15338,-287.11,-1039457.12,4403693.18,3364236.06
1989-03-02,289.95,2.84,0.99,336.77,-13.9,True,1,15339,-289.95,-1039747.07,4447543.05,3407795.98
1989-03-03,291.18,1.23,0.42,336.77,-13.54,True,1,15340,-291.18,-1040038.25,4466701.2,3426662.95
1989-03-06,294.81,3.63,1.25,336.77,-12.46,True,1,15341,-294.81,-1040333.06,4522680.21,3482347.15
1989-03-07,293.87,-0.94,-0.32,336.77,-12.74,True,1,15342,-293.87,-1040626.93,4508553.54,3467926.61
1989-03-08,294.08,0.21,0.07,336.77,-12.68,True,1,15343,-294.08,-1040921.01,4512069.44,3471148.43
1989-03-09,293.93,-0.15,-0.05,336.77,-12.72,True,1,15344,-293.93,-1041214.94,4510061.92,3468846.98
1989-03-10,292.88,-1.05,-0.36,336.77,-13.03,True,1,15345,-292.88,-1041507.82,4494243.6,3452735.78
1989-03-13,295.32,2.44,0.83,336.77,-12.31,True,1,15346,-295.32,-1041803.14,4531980.72,3490177.58
1989-03-14,295.14,-0.18,-0.06,336.77,-12.36,True,1,15347,-295.14,-1042098.28,4529513.58,3487415.3
1989-03-15,296.67,1.53,0.52,336.77,-11.91,True,1,15348,-296.67,-1042394.95,4553291.16,3510896.21
1989-03-16,299.44,2.77,0.93,336.77,-11.08,True,1,15349,-299.44,-1042694.39,4596104.56,3553410.17
1989-03-17,292.69,-6.75,-2.25,336.77,-13.09,True,1,15350,-292.69,-1042987.08,4492791.5,3449804.42
1989-03-20,289.92,-2.77,-0.95,336.77,-13.91,True,1,15351,-289.92,-1043277.0,4450561.92,3407284.92
1989-03-21,291.33,1.41,0.49,336.77,-13.49,True,1,15352,-291.33,-1043568.33,4472498.16,3428929.83
1989-03-22,290.49,-0.84,-0.29,336.77,-13.74,True,1,15353,-290.49,-1043858.82,4459892.97,3416034.15
1989-03-23,288.98,-1.51,-0.52,336.77,-14.19,True,1,15354,-288.98,-1044147.8,4436998.92,3392851.12
1989-03-27,290.57,1.59,0.55,336.77,-13.72,True,1,15355,-290.57,-1044438.37,4461702.35,3417263.98
1989-03-28,291.59,1.02,0.35,336.77,-13.42,True,1,15356,-291.59,-1044729.96,4477656.04,3432926.08
1989-03-29,292.35,0.76,0.26,336.77,-13.19,True,1,15357,-292.35,-1045022.31,4489618.95,3444596.64
1989-03-30,292.52,0.17,0.06,336.77,-13.14,True,1,15358,-292.52,-1045314.83,4492522.16,3447207.33
1989-03-31,294.87,2.35,0.8,336.77,-12.44,True,1,15359,-294.87,-1045609.7,4528908.33,3483298.63
1989-04-03,296.39,1.52,0.52,336.77,-11.99,True,1,15360,-296.39,-1045906.09,4552550.4,3506644.31
1989-04-04,295.31,-1.08,-0.36,336.77,-12.31,True,1,15361,-295.31,-1046201.4,4536256.91,3490055.51
1989-04-05,296.24,0.93,0.32,336.77,-12.04,True,1,15362,-296.24,-1046497.64,4550838.88,3504341.24
1989-04-06,295.29,-0.95,-0.32,336.77,-12.32,True,1,15363,-295.29,-1046792.93,4536540.27,3489747.34
1989-04-07,297.16,1.87,0.63,336.77,-11.76,True,1,15364,-297.16,-1047090.09,4565566.24,3518476.15
1989-04-10,297.11,-0.05,-0.02,336.77,-11.78,True,1,15365,-297.11,-1047387.2,4565095.15,3517707.95
1989-04-11,298.49,1.38,0.46,336.77,-11.37,True,1,15366,-298.49,-1047685.69,4586597.34,3538911.65
1989-04-12,298.99,0.5,0.17,336.77,-11.22,True,1,15367,-298.99,-1047984.68,4594579.33,3546594.65
1989-04-13,296.4,-2.59,-0.87,336.77,-11.99,True,1,15368,-296.4,-1048281.08,4555075.2,3506794.12
1989-04-14,301.36,4.96,1.67,336.77,-10.52,True,1,15369,-301.36,-1048582.44,4631601.84,3583019.4
1989-04-17,301.72,0.36,0.12,336.77,-10.41,True,1,15370,-301.72,-1048884.16,4637436.4,3588552.24
1989-04-18,306.02,4.3,1.42,336.77,-9.13,True,1,15371,-306.02,-1049190.18,4703833.42,3654643.24
1989-04-19,307.15,1.13,0.37,336.77,-8.8,True,1,15372,-307.15,-1049497.33,4721509.8,3672012.47
1989-04-20,306.19,-0.96,-0.31,336.77,-9.08,True,1,15373,-306.19,-1049803.52,4707058.87,3657255.35
1989-04-21,309.61,3.42,1.12,336.77,-8.06,True,1,15374,-309.61,-1050113.13,4759944.14,3709831.01
1989-04-24,308.69,-0.92,-0.3,336.77,-8.34,True,1,15375,-308.69,-1050421.82,4746108.75,3695686.93
1989-04-25,306.75,-1.94,-0.63,336.77,-8.91,True,1,15376,-306.75,-1050728.57,4716588.0,3665859.43
1989-04-26,306.93,0.18,0.06,336.77,-8.86,True,1,15377,-306.93,-1051035.5,4719662.61,3668627.11
1989-04-27,309.58,2.65,0.86,336.77,-8.07,True,1,15378,-309.58,-1051345.08,4760721.24,3709376.16
1989-04-28,309.64,0.06,0.02,336.77,-8.06,True,1,15379,-309.64,-1051654.72,4761953.56,3710298.84
1989-05-01,309.12,-0.52,-0.17,336.77,-8.21,True,1,15380,-309.12,-1051963.84,4754265.6,3702301.76
1989-05-02,308.12,-1.0,-0.32,336.77,-8.51,True,1,15381,-308.12,-1052271.96,4739193.72,3686921.76
1989-05-03,308.16,0.04,0.01,336.77,-8.49,True,1,15382,-308.16,-1052580.12,4740117.12,3687537.0
1989-05-04,307.77,-0.39,-0.13,336.77,-8.61,True,1,15383,-307.77,-1052887.89,4734425.91,3681538.02
1989-05-05,307.61,-0.16,-0.05,336.77,-8.66,True,1,15384,-307.61,-1053195.5,4732272.24,3679076.74
1989-05-08,306.0,-1.61,-0.52,336.77,-9.14,True,1,15385,-306.0,-1053501.5,4707810.0,3654308.5
1989-05-09,305.19,-0.81,-0.26,336.77,-9.38,True,1,15386,-305.19,-1053806.69,4695653.34,3641846.65
1989-05-10,305.8,0.61,0.2,336.77,-9.2,True,1,15387,-305.8,-1054112.49,4705344.6,3651232.11
1989-05-11,306.95,1.15,0.38,336.77,-8.86,True,1,15388,-306.95,-1054419.44,4723346.6,3668927.16
1989-05-12,313.84,6.89,2.24,336.77,-6.81,True,1,15389,-313.84,-1054733.28,4829683.76,3774950.48
1989-05-15,316.16,2.32,0.74,336.77,-6.12,True,1,15390,-316.16,-1055049.44,4865702.4,3810652.96
1989-05-16,315.28,-0.88,-0.28,336.77,-6.38,True,1,15391,-315.28,-1055364.72,4852474.48,3797109.76
1989-05-17,317.48,2.2,0.7,336.77,-5.73,True,1,15392,-317.48,-1055682.2,4886652.16,3830969.96
1989-05-18,317.97,0.49,0.15,336.77,-5.58,True,1,15393,-317.97,-1056000.17,4894512.21,3838512.04
1989-05-19,321.24,3.27,1.03,336.77,-4.61,True,1,15394,-321.24,-1056321.41,4945168.56,3888847.15
1989-05-22,321.98,0.74,0.23,336.77,-4.39,True,1,15395,-321.98,-1056643.39,4956882.1,3900238.71
1989-05-23,318.32,-3.66,-1.14,336.77,-5.48,True,1,15396,-318.32,-1056961.71,4900854.72,3843893.01
1989-05-24,319.14,0.82,0.26,336.77,-5.24,True,1,15397,-319.14,-1057280.85,4913798.58,3856517.73
1989-05-25,319.17,0.03,0.01,336.77,-5.23,True,1,15398,-319.17,-1057600.02,4914579.66,3856979.64
1989-05-26,321.59,2.42,0.76,336.77,-4.51,True,1,15399,-321.59,-1057921.61,4952164.41,3894242.8
1989-05-30,319.05,-2.54,-0.79,336.77,-5.26,True,1,15400,-319.05,-1058240.66,4913370.0,3855129.34
1989-05-31,320.52,1.47,0.46,336.77,-4.82,True,1,15401,-320.52,-1058561.18,4936328.52,3877767.34
1989-06-01,321.97,1.45,0.45,336.77,-4.39,True,1,15402,-321.97,-1058883.15,4958981.94,3900098.79
1989-06-02,325.52,3.55,1.1,336.77,-3.34,True,1,15403,-325.52,-1059208.67,5013984.56,3954775.89
1989-06-05,322.03,-3.49,-1.07,336.77,-4.38,True,1,15404,-322.03,-1059530.7,4960550.12,3901019.42
1989-06-06,324.24,2.21,0.69,336.77,-3.72,True,1,15405,-324.24,-1059854.94,4994917.2,3935062.26
1989-06-07,326.95,2.71,0.84,336.77,-2.92,True,1,15406,-326.95,-1060181.89,5036991.7,3976809.81
1989-06-08,326.75,-0.2,-0.06,336.77,-2.98,True,1,15407,-326.75,-1060508.64,5034237.25,3973728.61
1989-06-09,326.69,-0.06,-0.02,336.77,-2.99,True,1,15408,-326.69,-1060835.33,5033639.52,3972804.19
1989-06-12,326.24,-0.45,-0.14,336.77,-3.13,True,1,15409,-326.24,-1061161.57,5027032.16,3965870.59
1989-06-13,323.91,-2.33,-0.71,336.77,-3.82,True,1,15410,-323.91,-1061485.48,4991453.1,3929967.62
1989-06-14,323.83,-0.08,-0.02,336.77,-3.84,True,1,15411,-323.83,-1061809.31,4990544.13,3928734.82
1989-06-15,320.08,-3.75,-1.16,336.77,-4.96,True,1,15412,-320.08,-1062129.39,4933072.96,3870943.57
1989-06-16,321.35,1.27,0.4,336.77,-4.58,True,1,15413,-321.35,-1062450.74,4952967.55,3890516.81
1989-06-19,321.89,0.54,0.17,336.77,-4.42,True,1,15414,-321.89,-1062772.63,4961612.46,3898839.83
1989-06-20,321.25,-0.64,-0.2,336.77,-4.61,True,1,15415,-321.25,-1063093.88,4952068.75,3888974.87
1989-06-21,320.48,-0.77,-0.24,336.77,-4.84,True,1,15416,-320.48,-1063414.36,4940519.68,3877105.32
1989-06-22,322.32,1.84,0.57,336.77,-4.29,True,1,15417,-322.32,-1063736.68,4969207.44,3905470.76
1989-06-23,328.0,5.68,1.76,336.77,-2.6,True,1,15418,-328.0,-1064064.68,5057104.0,3993039.32
1989-06-26,326.6,-1.4,-0.43,336.77,-3.02,True,1,15419,-326.6,-1064391.28,5035845.4,3971454.12
1989-06-27,328.44,1.84,0.56,336.77,-2.47,True,1,15420,-328.44,-1064719.72,5064544.8,3999825.08
1989-06-28,325.81,-2.63,-0.8,336.77,-3.25,True,1,15421,-325.81,-1065045.53,5024316.01,3959270.48
1989-06-29,319.68,-6.13,-1.88,336.77,-5.08,True,1,15422,-319.68,-1065365.21,4930104.96,3864739.75
1989-06-30,317.98,-1.7,-0.53,336.77,-5.58,True,1,15423,-317.98,-1065683.19,4904205.54,3838522.35
1989-07-03,319.23,1.25,0.39,336.77,-5.21,True,1,15424,-319.23,-1066002.42,4923803.52,3857801.1
1989-07-05,320.64,1.41,0.44,336.77,-4.79,True,1,15425,-320.64,-1066323.06,4945872.0,3879548.94
1989-07-06,321.55,0.91,0.28,336.77,-4.52,True,1,15426,-321.55,-1066644.61,4960230.3,3893585.69
1989-07-07,324.91,3.36,1.04,336.77,-3.52,True,1,15427,-324.91,-1066969.52,5012386.57,3945417.05
1989-07-10,327.07,2.16,0.66,336.77,-2.88,True,1,15428,-327.07,-1067296.59,5046035.96,3978739.37
1989-07-11,328.78,1.71,0.52,336.77,-2.37,True,1,15429,-328.78,-1067625.37,5072746.62,4005121.25
1989-07-12,329.81,1.03,0.31,336.77,-2.07,True,1,15430,-329.81,-1067955.18,5088968.3,4021013.12
1989-07-13,329.95,0.14,0.04,336.77,-2.02,True,1,15431,-329.95,-1068285.13,5091458.45,4023173.32
1989-07-14,331.84,1.89,0.57,336.77,-1.46,True,1,15432,-331.84,-1068616.97,5120954.88,4052337.91
1989-07-17,332.44,0.6,0.18,336.77,-1.29,True,1,15433,-332.44,-1068949.41,5130546.52,4061597.11
1989-07-18,331.35,-1.09,-0.33,336.77,-1.61,True,1,15434,-331.35,-1069280.76,5114055.9,4044775.14
1989-07-19,335.73,4.38,1.32,336.77,-0.31,True,1,15435,-335.73,-1069616.49,5181992.55,4112376.06
1989-07-20,333.51,-2.22,-0.66,336.77,-0.97,True,1,15436,-333.51,-1069950.0,5148060.36,4078110.36
1989-07-21,335.9,2.39,0.72,336.77,-0.26,True,1,15437,-335.9,-1070285.9,5185288.3,4115002.4
1989-07-24,333.67,-2.23,-0.66,336.77,-0.92,True,1,15438,-333.67,-1070619.57,5151197.46,4080577.89
1989-07-25,333.88,0.21,0.06,336.77,-0.86,True,1,15439,-333.88,-1070953.45,5154773.32,4083819.87
1989-07-26,338.05,4.17,1.25,338.05,0.0,True,1,15440,-338.05,-1071291.5,5219492.0,4148200.5
1989-07-27,341.99,3.94,1.17,341.99,0.0,True,1,15441,-341.99,-1071633.49,5280667.59,4209034.1
1989-07-28,342.15,0.16,0.05,342.15,0.0,True,1,15442,-342.15,-1071975.64,5283480.3,4211504.66
1989-07-31,346.08,3.93,1.15,346.08,0.0,True,1,15443,-346.08,-1072321.72,5344513.44,4272191.72
1989-08-01,343.75,-2.33,-0.67,346.08,-0.67,True,1,15444,-343.75,-1072665.47,5308875.0,4236209.53
1989-08-02,344.34,0.59,0.17,346.08,-0.5,True,1,15445,-344.34,-1073009.81,5318331.3,4245321.49
1989-08-03,344.74,0.4,0.12,346.08,-0.39,True,1,15446,-344.74,-1073354.55,5324854.04,4251499.49
1989-08-04,343.92,-0.82,-0.24,346.08,-0.62,True,1,15447,-343.92,-1073698.47,5312532.24,4238833.77
1989-08-07,349.41,5.49,1.6,349.41,0.0,True,1,15448,-349.41,-1074047.88,5397685.68,4323637.8
1989-08-08,349.35,-0.06,-0.02,349.41,-0.02,True,1,15449,-349.35,-1074397.23,5397108.15,4322710.92
1989-08-09,346.94,-2.41,-0.69,349.41,-0.71,True,1,15450,-346.94,-1074744.17,5360223.0,4285478.83
1989-08-10,348.25,1.31,0.38,349.41,-0.33,True,1,15451,-348.25,-1075092.42,5380810.75,4305718.33
1989-08-11,344.74,-3.51,-1.01,349.41,-1.34,True,1,15452,-344.74,-1075437.16,5326922.48,4251485.32
1989-08-14,343.06,-1.68,-0.49,349.41,-1.82,True,1,15453,-343.06,-1075780.22,5301306.18,4225525.96
1989-08-15,344.71,1.65,0.48,349.41,-1.34,True,1,15454,-344.71,-1076124.93,5327148.34,4251023.41
1989-08-16,345.66,0.95,0.28,349.41,-1.07,True,1,15455,-345.66,-1076470.59,5342175.3,4265704.71
1989-08-17,344.45,-1.21,-0.35,349.41,-1.42,True,1,15456,-344.45,-1076815.04,5323819.2,4247004.16
1989-08-18,346.03,1.58,0.46,349.41,-0.97,True,1,15457,-346.03,-1077161.07,5348585.71,4271424.64
1989-08-21,340.67,-5.36,-1.55,349.41,-2.5,True,1,15458,-340.67,-1077501.74,5266076.86,4188575.12
1989-08-22,341.19,0.52,0.15,349.41,-2.35,True,1,15459,-341.19,-1077842.93,5274456.21,4196613.28
1989-08-23,344.7,3.51,1.03,349.41,-1.35,True,1,15460,-344.7,-1078187.63,5329062.0,4250874.37
1989-08-24,351.52,6.82,1.98,351.52,0.0,True,1,15461,-351.52,-1078539.15,5434850.72,4356311.57
1989-08-25,350.52,-1.0,-0.28,351.52,-0.28,True,1,15462,-350.52,-1078889.67,5419740.24,4340850.57
1989-08-28,352.09,1.57,0.45,352.09,0.0,True,1,15463,-352.09,-1079241.76,5444367.67,4365125.91
1989-08-29,349.84,-2.25,-0.64,352.09,-0.64,True,1,15464,-349.84,-1079591.6,5409925.76,4330334.16
1989-08-30,350.65,0.81,0.23,352.09,-0.41,True,1,15465,-350.65,-1079942.25,5422802.25,4342860.0
1989-08-31,351.45,0.8,0.23,352.09,-0.18,True,1,15466,-351.45,-1080293.7,5435525.7,4355232.0
1989-09-01,353.73,2.28,0.65,353.73,0.0,True,1,15467,-353.73,-1080647.43,5471141.91,4390494.48
1989-09-05,352.56,-1.17,-0.33,353.73,-0.33,True,1,15468,-352.56,-1080999.99,5453398.08,4372398.09
1989-09-06,349.24,-3.32,-0.94,353.73,-1.27,True,1,15469,-349.24,-1081349.23,5402393.56,4321044.33
1989-09-07,348.35,-0.89,-0.26,353.73,-1.52,True,1,15470,-348.35,-1081697.58,5388974.5,4307276.92
1989-09-08,348.76,0.41,0.12,353.73,-1.4,True,1,15471,-348.76,-1082046.34,5395665.96,4313619.62
1989-09-11,347.66,-1.1,-0.32,353.73,-1.72,True,1,15472,-347.66,-1082394.0,5378995.52,4296601.52
1989-09-12,348.7,1.04,0.3,353.73,-1.42,True,1,15473,-348.7,-1082742.7,5395435.1,4312692.4
1989-09-13,345.46,-3.24,-0.93,353.73,-2.34,True,1,15474,-345.46,-1083088.16,5345648.04,4262559.88
1989-09-14,343.16,-2.3,-0.67,353.73,-2.99,True,1,15475,-343.16,-1083431.32,5310401.0,4226969.68
1989-09-15,345.06,1.9,0.55,353.73,-2.45,True,1,15476,-345.06,-1083776.38,5340148.56,4256372.18
1989-09-18,346.73,1.67,0.48,353.73,-1.98,True,1,15477,-346.73,-1084123.11,5366340.21,4282217.1
1989-09-19,346.55,-0.18,-0.05,353.73,-2.03,True,1,15478,-346.55,-1084469.66,5363900.9,4279431.24
1989-09-20,346.47,-0.08,-0.02,353.73,-2.05,True,1,15479,-346.47,-1084816.13,5363009.13,4278193.0
1989-09-21,345.7,-0.77,-0.22,353.73,-2.27,True,1,15480,-345.7,-1085161.83,5351436.0,4266274.17
1989-09-22,347.05,1.35,0.39,353.73,-1.89,True,1,15481,-347.05,-1085508.88,5372681.05,4287172.17
1989-09-25,344.23,-2.82,-0.81,353.73,-2.69,True,1,15482,-344.23,-1085853.11,5329368.86,4243515.75
1989-09-26,344.33,0.1,0.03,353.73,-2.66,True,1,15483,-344.33,-1086197.44,5331261.39,4245063.95
1989-09-27,345.1,0.77,0.22,353.73,-2.44,True,1,15484,-345.1,-1086542.54,5343528.4,4256985.86
1989-09-28,348.6,3.5,1.01,353.73,-1.45,True,1,15485,-348.6,-1086891.14,5398071.0,4311179.86
1989-09-29,349.15,0.55,0.16,353.73,-1.3,True,1,15486,-349.15,-1087240.29,5406936.9,4319696.61
1989-10-02,350.87,1.72,0.49,353.73,-0.81,True,1,15487,-350.87,-1087591.16,5433923.69,4346332.53
1989-10-03,354.71,3.84,1.09,354.71,0.0,True,1,15488,-354.71,-1087945.87,5493748.48,4405802.61
1989-10-04,356.94,2.23,0.63,356.94,0.0,True,1,15489,-356.94,-1088302.81,5528643.66,4440340.85
1989-10-05,356.97,0.03,0.01,356.97,0.0,True,1,15490,-356.97,-1088659.78,5529465.3,4440805.52
1989-10-06,358.78,1.81,0.51,358.78,0.0,True,1,15491,-358.78,-1089018.56,5557860.98,4468842.42
1989-10-09,359.8,1.02,0.28,359.8,0.0,True,1,15492,-359.8,-1089378.36,5574021.6,4484643.24
1989-10-10,359.13,-0.67,-0.19,359.8,-0.19,True,1,15493,-359.13,-1089737.49,5564001.09,4474263.6
1989-10-11,356.99,-2.14,-0.6,359.8,-0.78,True,1,15494,-356.99,-1090094.48,5531203.06,4441108.58
1989-10-12,355.39,-1.6,-0.45,359.8,-1.23,True,1,15495,-355.39,-1090449.87,5506768.05,4416318.18
1989-10-13,333.65,-21.74,-6.12,359.8,-7.27,True,1,15496,-333.65,-1090783.52,5170240.4,4079456.88
1989-10-16,342.85,9.2,2.76,359.8,-4.71,True,1,15497,-342.85,-1091126.37,5313146.45,4222020.08
1989-10-17,341.16,-1.69,-0.49,359.8,-5.18,True,1,15498,-341.16,-1091467.53,5287297.68,4195830.15
1989-10-18,341.76,0.6,0.18,359.8,-5.01,True,1,15499,-341.76,-1091809.29,5296938.24,4205128.95
1989-10-19,347.13,5.37,1.57,359.8,-3.52,True,1,15500,-347.13,-1092156.42,5380515.0,4288358.58
1989-10-20,347.16,0.03,0.01,359.8,-3.51,True,1,15501,-347.16,-1092503.58,5381327.16,4288823.58
1989-10-23,344.83,-2.33,-0.67,359.8,-4.16,True,1,15502,-344.83,-1092848.41,5345554.66,4252706.25
1989-10-24,343.7,-1.13,-0.33,359.8,-4.47,True,1,15503,-343.7,-1093192.11,5328381.1,4235188.99
1989-10-25,342.5,-1.2,-0.35,359.8,-4.81,True,1,15504,-342.5,-1093534.61,5310120.0,4216585.39
1989-10-26,337.93,-4.57,-1.33,359.8,-6.08,True,1,15505,-337.93,-1093872.54,5239604.65,4145732.11
1989-10-27,335.06,-2.87,-0.85,359.8,-6.88,True,1,15506,-335.06,-1094207.6,5195440.36,4101232.76
1989-10-30,335.07,0.01,0.0,359.8,-6.87,True,1,15507,-335.07,-1094542.67,5195930.49,4101387.82
1989-10-31,340.36,5.29,1.58,359.8,-5.4,True,1,15508,-340.36,-1094883.03,5278302.88,4183419.85
1989-11-01,341.2,0.84,0.25,359.8,-5.17,True,1,15509,-341.2,-1095224.23,5291670.8,4196446.57
1989-11-02,338.48,-2.72,-0.8,359.8,-5.93,True,1,15510,-338.48,-1095562.71,5249824.8,4154262.09
1989-11-03,337.62,-0.86,-0.25,359.8,-6.16,True,1,15511,-337.62,-1095900.33,5236823.82,4140923.49
1989-11-06,332.61,-5.01,-1.48,359.8,-7.56,True,1,15512,-332.61,-1096232.94,5159446.32,4063213.38
1989-11-07,334.81,2.2,0.66,359.8,-6.95,True,1,15513,-334.81,-1096567.75,5193907.53,4097339.78
1989-11-08,338.15,3.34,1.0,359.8,-6.02,True,1,15514,-338.15,-1096905.9,5246059.1,4149153.2
1989-11-09,336.57,-1.58,-0.47,359.8,-6.46,True,1,15515,-336.57,-1097242.47,5221883.55,4124641.08
1989-11-10,339.1,2.53,0.75,359.8,-5.75,True,1,15516,-339.1,-1097581.57,5261475.6,4163894.03
1989-11-13,339.55,0.45,0.13,359.8,-5.63,True,1,15517,-339.55,-1097921.12,5268797.35,4170876.23
1989-11-14,337.99,-1.56,-0.46,359.8,-6.06,True,1,15518,-337.99,-1098259.11,5244928.82,4146669.71
1989-11-15,340.54,2.55,0.75,359.8,-5.35,True,1,15519,-340.54,-1098599.65,5284840.26,4186240.61
1989-11-16,340.58,0.04,0.01,359.8,-5.34,True,1,15520,-340.58,-1098940.23,5285801.6,4186861.37
1989-11-17,341.61,1.03,0.3,359.8,-5.06,True,1,15521,-341.61,-1099281.84,5302128.81,4202846.97
1989-11-20,339.35,-2.26,-0.66,359.8,-5.68,True,1,15522,-339.35,-1099621.19,5267390.7,4167769.51
1989-11-21,339.59,0.24,0.07,359.8,-5.62,True,1,15523,-339.59,-1099960.78,5271455.57,4171494.79
1989-11-22,341.91,2.32,0.68,359.8,-4.97,True,1,15524,-341.91,-1100302.69,5307810.84,4207508.15
1989-11-24,343.97,2.06,0.6,359.8,-4.4,True,1,15525,-343.97,-1100646.66,5340134.25,4239487.59
1989-11-27,345.61,1.64,0.48,359.8,-3.94,True,1,15526,-345.61,-1100992.27,5365940.86,4264948.59
1989-11-28,345.77,0.16,0.05,359.8,-3.9,True,1,15527,-345.77,-1101338.04,5368770.79,4267432.75
1989-11-29,343.6,-2.17,-0.63,359.8,-4.5,True,1,15528,-343.6,-1101681.64,5335420.8,4233739.16
1989-11-30,345.99,2.39,0.7,359.8,-3.84,True,1,15529,-345.99,-1102027.63,5372878.71,4270851.08
1989-12-01,350.63,4.64,1.34,359.8,-2.55,True,1,15530,-350.63,-1102378.26,5445283.9,4342905.64
1989-12-04,351.41,0.78,0.22,359.8,-2.33,True,1,15531,-351.41,-1102729.67,5457748.71,4355019.04
1989-12-05,349.58,-1.83,-0.52,359.8,-2.84,True,1,15532,-349.58,-1103079.25,5429676.56,4326597.31
1989-12-06,348.55,-1.03,-0.3,359.8,-3.13,True,1,15533,-348.55,-1103427.8,5414027.15,4310599.35
1989-12-07,347.59,-0.96,-0.28,359.8,-3.39,True,1,15534,-347.59,-1103775.39,5399463.06,4295687.67
1989-12-08,348.69,1.1,0.32,359.8,-3.09,True,1,15535,-348.69,-1104124.08,5416899.15,4312775.07
1989-12-11,348.56,-0.13,-0.04,359.8,-3.12,True,1,15536,-348.56,-1104472.64,5415228.16,4310755.52
1989-12-12,351.73,3.17,0.91,359.8,-2.24,True,1,15537,-351.73,-1104824.37,5464829.01,4360004.64
1989-12-13,352.75,1.02,0.29,359.8,-1.96,True,1,15538,-352.75,-1105177.12,5481029.5,4375852.38
1989-12-14,350.93,-1.82,-0.52,359.8,-2.46,True,1,15539,-350.93,-1105528.05,5453101.27,4347573.22
1989-12-15,350.14,-0.79,-0.22,359.8,-2.68,True,1,15540,-350.14,-1105878.19,5441175.6,4335297.41
1989-12-18,343.69,-6.45,-1.84,359.8,-4.48,True,1,15541,-343.69,-1106221.88,5341286.29,4235064.41
1989-12-19,342.46,-1.23,-0.36,359.8,-4.82,True,1,15542,-342.46,-1106564.34,5322513.32,4215948.98
1989-12-20,342.84,0.38,0.11,359.8,-4.71,True,1,15543,-342.84,-1106907.18,5328762.12,4221854.94
1989-12-21,344.78,1.94,0.57,359.8,-4.18,True,1,15544,-344.78,-1107251.96,5359260.32,4252008.36
1989-12-22,347.42,2.64,0.77,359.8,-3.44,True,1,15545,-347.42,-1107599.38,5400643.9,4293044.52
1989-12-26,346.81,-0.61,-0.18,359.8,-3.61,True,1,15546,-346.81,-1107946.19,5391508.26,4283562.07
1989-12-27,348.81,2.0,0.58,359.8,-3.05,True,1,15547,-348.81,-1108295.0,5422949.07,4314654.07
1989-12-28,350.67,1.86,0.53,359.8,-2.54,True,1,15548,-350.67,-1108645.67,5452217.16,4343571.49
1989-12-29,353.4,2.73,0.78,359.8,-1.78,True,1,15549,-353.4,-1108999.07,5495016.6,4386017.53
1990-01-02,359.69,6.29,1.78,359.8,-0.03,True,1,15550,-359.69,-1109358.76,5593179.5,4483820.74
1990-01-03,358.76,-0.93,-0.26,359.8,-0.29,True,1,15551,-358.76,-1109717.52,5579076.76,4469359.24
1990-01-04,355.67,-3.09,-0.86,359.8,-1.15,True,1,15552,-355.67,-1110073.19,5531379.84,4421306.65
1990-01-05,352.2,-3.47,-0.98,359.8,-2.11,True,1,15553,-352.2,-1110425.39,5477766.6,4367341.21
1990-01-08,353.79,1.59,0.45,359.8,-1.67,True,1,15554,-353.79,-1110779.18,5502849.66,4392070.48
1990-01-09,349.62,-4.17,-1.18,359.8,-2.83,True,1,15555,-349.62,-1111128.8,5438339.1,4327210.3
1990-01-10,347.31,-2.31,-0.66,359.8,-3.47,True,1,15556,-347.31,-1111476.11,5402754.36,4291278.25
1990-01-11,348.53,1.22,0.35,359.8,-3.13,True,1,15557,-348.53,-1111824.64,5422081.21,4310256.57
1990-01-12,339.93,-8.6,-2.47,359.8,-5.52,True,1,15558,-339.93,-1112164.57,5288630.94,4176466.37
1990-01-15,337.0,-2.93,-0.86,359.8,-6.34,True,1,15559,-337.0,-1112501.57,5243383.0,4130881.43
1990-01-16,340.75,3.75,1.11,359.8,-5.3,True,1,15560,-340.75,-1112842.32,5302070.0,4189227.68
1990-01-17,337.4,-3.35,-0.98,359.8,-6.23,True,1,15561,-337.4,-1113179.72,5250281.4,4137101.68
1990-01-18,338.19,0.79,0.23,359.8,-6.01,True,1,15562,-338.19,-1113517.91,5262912.78,4149394.87
1990-01-19,339.15,0.96,0.28,359.8,-5.74,True,1,15563,-339.15,-1113857.06,5278191.45,4164334.39
1990-01-22,330.38,-8.77,-2.59,359.8,-8.18,True,1,15564,-330.38,-1114187.44,5142034.32,4027846.88
1990-01-23,331.61,1.23,0.37,359.8,-7.84,True,1,15565,-331.61,-1114519.05,5161509.65,4046990.6
1990-01-24,330.26,-1.35,-0.41,359.8,-8.21,True,1,15566,-330.26,-1114849.31,5140827.16,4025977.85
1990-01-25,326.08,-4.18,-1.27,359.8,-9.37,True,1,15567,-326.08,-1115175.39,5076087.36,3960911.97
1990-01-26,325.8,-0.28,-0.09,359.8,-9.45,True,1,15568,-325.8,-1115501.19,5072054.4,3956553.21
1990-01-29,325.2,-0.6,-0.18,359.8,-9.62,True,1,15569,-325.2,-1115826.39,5063038.8,3947212.41
1990-01-30,322.98,-2.22,-0.68,359.8,-10.23,True,1,15570,-322.98,-1116149.37,5028798.6,3912649.23
1990-01-31,329.08,6.1,1.89,359.8,-8.54,True,1,15571,-329.08,-1116478.45,5124104.68,4007626.23
1990-02-01,328.79,-0.29,-0.09,359.8,-8.62,True,1,15572,-328.79,-1116807.24,5119917.88,4003110.64
1990-02-02,330.92,2.13,0.65,359.8,-8.03,True,1,15573,-330.92,-1117138.16,5153417.16,4036279.0
1990-02-05,331.85,0.93,0.28,359.8,-7.77,True,1,15574,-331.85,-1117470.01,5168231.9,4050761.89
1990-02-06,329.66,-2.19,-0.66,359.8,-8.38,True,1,15575,-329.66,-1117799.67,5134454.5,4016654.83
1990-02-07,333.75,4.09,1.24,359.8,-7.24,True,1,15576,-333.75,-1118133.42,5198490.0,4080356.58
1990-02-08,332.96,-0.79,-0.24,359.8,-7.46,True,1,15577,-332.96,-1118466.38,5186517.92,4068051.54
1990-02-09,333.62,0.66,0.2,359.8,-7.28,True,1,15578,-333.62,-1118800.0,5197132.36,4078332.36
1990-02-12,330.08,-3.54,-1.06,359.8,-8.26,True,1,15579,-330.08,-1119130.08,5142316.32,4023186.24
1990-02-13,331.02,0.94,0.28,359.8,-8.0,True,1,15580,-331.02,-1119461.1,5157291.6,4037830.5
1990-02-14,332.01,0.99,0.3,359.8,-7.72,True,1,15581,-332.01,-1119793.11,5173047.81,4053254.7
1990-02-15,334.89,2.88,0.87,359.8,-6.92,True,1,15582,-334.89,-1120128.0,5218255.98,4098127.98
1990-02-16,332.72,-2.17,-0.65,359.8,-7.53,True,1,15583,-332.72,-1120460.72,5184775.76,4064315.04
1990-02-20,327.99,-4.73,-1.42,359.8,-8.84,True,1,15584,-327.99,-1120788.71,5111396.16,3990607.45
1990-02-21,327.67,-0.32,-0.1,359.8,-8.93,True,1,15585,-327.67,-1121116.38,5106736.95,3985620.57
1990-02-22,325.7,-1.97,-0.6,359.8,-9.48,True,1,15586,-325.7,-1121442.08,5076360.2,3954918.12
1990-02-23,324.15,-1.55,-0.48,359.8,-9.91,True,1,15587,-324.15,-1121766.23,5052526.05,3930759.82
1990-02-26,328.67,4.52,1.39,359.8,-8.65,True,1,15588,-328.67,-1122094.9,5123307.96,4001213.06
1990-02-27,330.26,1.59,0.48,359.8,-8.21,True,1,15589,-330.26,-1122425.16,5148423.14,4025997.98
1990-02-28,331.89,1.63,0.49,359.8,-7.76,True,1,15590,-331.89,-1122757.05,5174165.1,4051408.05
1990-03-01,332.74,0.85,0.26,359.8,-7.52,True,1,15591,-332.74,-1123089.79,5187749.34,4064659.55
1990-03-02,335.54,2.8,0.84,359.8,-6.74,True,1,15592,-335.54,-1123425.33,5231739.68,4108314.35
1990-03-05,333.74,-1.8,-0.54,359.8,-7.24,True,1,15593,-333.74,-1123759.07,5204007.82,4080248.75
1990-03-06,337.93,4.19,1.25,359.8,-6.08,True,1,15594,-337.93,-1124097.0,5269680.42,4145583.42
1990-03-07,336.95,-0.98,-0.29,359.8,-6.35,True,1,15595,-336.95,-1124433.95,5254735.25,4130301.3
1990-03-08,340.27,3.32,0.98,359.8,-5.43,True,1,15596,-340.27,-1124774.22,5306850.92,4182076.7
1990-03-09,337.93,-2.34,-0.69,359.8,-6.08,True,1,15597,-337.93,-1125112.15,5270694.21,4145582.06
1990-03-12,338.67,0.74,0.22,359.8,-5.87,True,1,15598,-338.67,-1125450.82,5282574.66,4157123.84
1990-03-13,336.0,-2.67,-0.79,359.8,-6.62,True,1,15599,-336.0,-1125786.82,5241264.0,4115477.18
1990-03-14,336.87,0.87,0.26,359.8,-6.37,True,1,15600,-336.87,-1126123.69,5255172.0,4129048.31
1990-03-15,338.07,1.2,0.36,359.8,-6.04,True,1,15601,-338.07,-1126461.76,5274230.07,4147768.31
1990-03-16,341.91,3.84,1.14,359.8,-4.97,True,1,15602,-341.91,-1126803.67,5334479.82,4207676.15
1990-03-19,343.53,1.62,0.47,359.8,-4.52,True,1,15603,-343.53,-1127147.2,5360098.59,4232951.39
1990-03-20,341.57,-1.96,-0.57,359.8,-5.07,True,1,15604,-341.57,-1127488.77,5329858.28,4202369.51
1990-03-21,339.74,-1.83,-0.54,359.8,-5.58,True,1,15605,-339.74,-1127828.51,5301642.7,4173814.19
1990-03-22,335.69,-4.05,-1.19,359.8,-6.7,True,1,15606,-335.69,-1128164.2,5238778.14,4110613.94
1990-03-23,337.22,1.53,0.46,359.8,-6.28,True,1,15607,-337.22,-1128501.42,5262992.54,4134491.12
1990-03-26,337.63,0.41,0.12,359.8,-6.16,True,1,15608,-337.63,-1128839.05,5269729.04,4140889.99
1990-03-27,341.5,3.87,1.15,359.8,-5.09,True,1,15609,-341.5,-1129180.55,5330473.5,4201292.95
1990-03-28,342.0,0.5,0.15,359.8,-4.95,True,1,15610,-342.0,-1129522.55,5338620.0,4209097.45
1990-03-29,340.79,-1.21,-0.35,359.8,-5.28,True,1,15611,-340.79,-1129863.34,5320072.69,4190209.35
1990-03-30,339.94,-0.85,-0.25,359.8,-5.52,True,1,15612,-339.94,-1130203.28,5307143.28,4176940.0
1990-04-02,338.7,-1.24,-0.36,359.8,-5.86,True,1,15613,-338.7,-1130541.98,5288123.1,4157581.12
1990-04-03,343.64,4.94,1.46,359.8,-4.49,True,1,15614,-343.64,-1130885.62,5365594.96,4234709.34
1990-04-04,341.09,-2.55,-0.74,359.8,-5.2,True,1,15615,-341.09,-1131226.71,5326120.35,4194893.64
1990-04-05,340.73,-0.36,-0.11,359.8,-5.3,True,1,15616,-340.73,-1131567.44,5320839.68,4189272.24
1990-04-06,340.08,-0.65,-0.19,359.8,-5.48,True,1,15617,-340.08,-1131907.52,5311029.36,4179121.84
1990-04-09,341.37,1.29,0.38,359.8,-5.12,True,1,15618,-341.37,-1132248.89,5331516.66,4199267.77
1990-04-10,342.07,0.7,0.2,359.8,-4.93,True,1,15619,-342.07,-1132590.96,5342791.33,4210200.37
1990-04-11,341.92,-0.15,-0.04,359.8,-4.97,True,1,15620,-341.92,-1132932.88,5340790.4,4207857.52
1990-04-12,344.34,2.42,0.71,359.8,-4.3,True,1,15621,-344.34,-1133277.22,5378935.14,4245657.92
1990-04-16,344.74,0.4,0.12,359.8,-4.19,True,1,15622,-344.74,-1133621.96,5385528.28,4251906.32
1990-04-17,344.68,-0.06,-0.02,359.8,-4.2,True,1,15623,-344.68,-1133966.64,5384935.64,4250969.0
1990-04-18,340.72,-3.96,-1.15,359.8,-5.3,True,1,15624,-340.72,-1134307.36,5323409.28,4189101.92
1990-04-19,338.09,-2.63,-0.77,359.8,-6.03,True,1,15625,-338.09,-1134645.45,5282656.25,4148010.8
1990-04-20,335.12,-2.97,-0.88,359.8,-6.86,True,1,15626,-335.12,-1134980.57,5236585.12,4101604.55
1990-04-23,331.05,-4.07,-1.21,359.8,-7.99,True,1,15627,-331.05,-1135311.62,5173318.35,4038006.73
1990-04-24,330.36,-0.69,-0.21,359.8,-8.18,True,1,15628,-330.36,-1135641.98,5162866.08,4027224.1
1990-04-25,332.03,1.67,0.51,359.8,-7.72,True,1,15629,-332.03,-1135974.01,5189296.87,4053322.86
1990-04-26,332.92,0.89,0.27,359.8,-7.47,True,1,15630,-332.92,-1136306.93,5203539.6,4067232.67
1990-04-27,329.11,-3.81,-1.14,359.8,-8.53,True,1,15631,-329.11,-1136636.04,5144318.41,4007682.37
1990-04-30,330.8,1.69,0.51,359.8,-8.06,True,1,15632,-330.8,-1136966.84,5171065.6,4034098.76
1990-05-01,332.25,1.45,0.44,359.8,-7.66,True,1,15633,-332.25,-1137299.09,5194064.25,4056765.16
1990-05-02,334.48,2.23,0.67,359.8,-7.04,True,1,15634,-334.48,-1137633.57,5229260.32,4091626.75
1990-05-03,335.57,1.09,0.33,359.8,-6.73,True,1,15635,-335.57,-1137969.14,5246636.95,4108667.81
1990-05-04,338.39,2.82,0.84,359.8,-5.95,True,1,15636,-338.39,-1138307.53,5291066.04,4152758.51
1990-05-07,340.53,2.14,0.63,359.8,-5.36,True,1,15637,-340.53,-1138648.06,5324867.61,4186219.55
1990-05-08,342.01,1.48,0.44,359.8,-4.94,True,1,15638,-342.01,-1138990.07,5348352.38,4209362.31
1990-05-09,342.86,0.85,0.25,359.8,-4.71,True,1,15639,-342.86,-1139332.93,5361987.54,4222654.61
1990-05-10,343.82,0.96,0.28,359.8,-4.44,True,1,15640,-343.82,-1139676.75,5377344.8,4237668.05
1990-05-11,352.0,8.18,2.38,359.8,-2.17,True,1,15641,-352.0,-1140028.75,5505632.0,4365603.25
1990-05-14,354.75,2.75,0.78,359.8,-1.4,True,1,15642,-354.75,-1140383.5,5548999.5,4408616.0
1990-05-15,354.28,-0.47,-0.13,359.8,-1.53,True,1,15643,-354.28,-1140737.78,5542002.04,4401264.26
1990-05-16,354.0,-0.28,-0.08,359.8,-1.61,True,1,15644,-354.0,-1141091.78,5537976.0,4396884.22
1990-05-17,354.47,0.47,0.13,359.8,-1.48,True,1,15645,-354.47,-1141446.25,5545683.15,4404236.9
1990-05-18,354.64,0.17,0.05,359.8,-1.43,True,1,15646,-354.64,-1141800.89,5548697.44,4406896.55
1990-05-21,358.0,3.36,0.95,359.8,-0.5,True,1,15647,-358.0,-1142158.89,5601626.0,4459467.11
1990-05-22,358.43,0.43,0.12,359.8,-0.38,True,1,15648,-358.43,-1142517.32,5608712.64,4466195.32
1990-05-23,359.29,0.86,0.24,359.8,-0.14,True,1,15649,-359.29,-1142876.61,5622529.21,4479652.6
1990-05-24,358.41,-0.88,-0.24,359.8,-0.39,True,1,15650,-358.41,-1143235.02,5609116.5,4465881.48
1990-05-25,354.58,-3.83,-1.07,359.8,-1.45,True,1,15651,-354.58,-1143589.6,5549531.58,4405941.98
1990-05-29,360.65,6.07,1.71,360.65,0.0,True,1,15652,-360.65,-1143950.25,5644893.8,4500943.55
1990-05-30,360.86,0.21,0.06,360.86,0.0,True,1,15653,-360.86,-1144311.11,5648541.58,4504230.47
1990-05-31,361.23,0.37,0.1,361.23,0.0,True,1,15654,-361.23,-1144672.34,5654694.42,4510022.08
1990-06-01,363.16,1.93,0.53,363.16,0.0,True,1,15655,-363.16,-1145035.5,5685269.8,4540234.3
1990-06-04,367.4,4.24,1.17,367.4,0.0,True,1,15656,-367.4,-1145402.9,5752014.4,4606611.5
1990-06-05,366.64,-0.76,-0.21,367.4,-0.21,True,1,15657,-366.64,-1145769.54,5740482.48,4594712.94
1990-06-06,364.96,-1.68,-0.46,367.4,-0.66,True,1,15658,-364.96,-1146134.5,5714543.68,4568409.18
1990-06-07,363.15,-1.81,-0.5,367.4,-1.16,True,1,15659,-363.15,-1146497.65,5686565.85,4540068.2
1990-06-08,358.71,-4.44,-1.22,367.4,-2.37,True,1,15660,-358.71,-1146856.36,5617398.6,4470542.24
1990-06-11,361.63,2.92,0.81,367.4,-1.57,True,1,15661,-361.63,-1147217.99,5663487.43,4516269.44
1990-06-12,366.25,4.62,1.28,367.4,-0.31,True,1,15662,-366.25,-1147584.24,5736207.5,4588623.26
1990-06-13,364.9,-1.35,-0.37,367.4,-0.68,True,1,15663,-364.9,-1147949.14,5715428.7,4567479.56
1990-06-14,362.9,-2.0,-0.55,367.4,-1.23,True,1,15664,-362.9,-1148312.04,5684465.6,4536153.56
1990-06-15,362.91,0.01,0.0,367.4,-1.22,True,1,15665,-362.91,-1148674.95,5684985.15,4536310.2
1990-06-18,356.88,-6.03,-1.66,367.4,-2.86,True,1,15666,-356.88,-1149031.83,5590882.08,4441850.25
1990-06-19,358.47,1.59,0.45,367.4,-2.43,True,1,15667,-358.47,-1149390.3,5616149.49,4466759.19
1990-06-20,359.1,0.63,0.18,367.4,-2.26,True,1,15668,-359.1,-1149749.4,5626378.8,4476629.4
1990-06-21,360.47,1.37,0.38,367.4,-1.89,True,1,15669,-360.47,-1150109.87,5648204.43,4498094.56
1990-06-22,355.43,-5.04,-1.4,367.4,-3.26,True,1,15670,-355.43,-1150465.3,5569588.1,4419122.8
1990-06-25,352.31,-3.12,-0.88,367.4,-4.11,True,1,15671,-352.31,-1150817.61,5521050.01,4370232.4
1990-06-26,352.06,-0.25,-0.07,367.4,-4.18,True,1,15672,-352.06,-1151169.67,5517484.32,4366314.65
1990-06-27,355.14,3.08,0.88,367.4,-3.34,True,1,15673,-355.14,-1151524.81,5566109.22,4414584.41
1990-06-28,357.63,2.49,0.7,367.4,-2.66,True,1,15674,-357.63,-1151882.44,5605492.62,4453610.18
1990-06-29,358.02,0.39,0.11,367.4,-2.55,True,1,15675,-358.02,-1152240.46,5611963.5,4459723.04
1990-07-02,359.54,1.52,0.42,367.4,-2.14,True,1,15676,-359.54,-1152600.0,5636149.04,4483549.04
1990-07-03,360.16,0.62,0.17,367.4,-1.97,True,1,15677,-360.16,-1152960.16,5646228.32,4493268.16
1990-07-05,355.68,-4.48,-1.24,367.4,-3.19,True,1,15678,-355.68,-1153315.84,5576351.04,4423035.2
1990-07-06,358.42,2.74,0.77,367.4,-2.44,True,1,15679,-358.42,-1153674.26,5619667.18,4465992.92
1990-07-09,359.52,1.1,0.31,367.4,-2.14,True,1,15680,-359.52,-1154033.78,5637273.6,4483239.82
1990-07-10,356.49,-3.03,-0.84,367.4,-2.97,True,1,15681,-356.49,-1154390.27,5590119.69,4435729.42
1990-07-11,361.23,4.74,1.33,367.4,-1.68,True,1,15682,-361.23,-1154751.5,5664808.86,4510057.36
1990-07-12,365.44,4.21,1.16,367.4,-0.53,True,1,15683,-365.44,-1155116.94,5731195.52,4576078.58
1990-07-13,367.31,1.87,0.51,367.4,-0.02,True,1,15684,-367.31,-1155484.25,5760890.04,4605405.79
1990-07-16,368.95,1.64,0.45,368.95,0.0,True,1,15685,-368.95,-1155853.2,5786980.75,4631127.55
1990-07-17,367.52,-1.43,-0.39,368.95,-0.39,True,1,15686,-367.52,-1156220.72,5764918.72,4608698.0
1990-07-18,364.22,-3.3,-0.9,368.95,-1.28,True,1,15687,-364.22,-1156584.94,5713519.14,4556934.2
1990-07-19,365.32,1.1,0.3,368.95,-0.98,True,1,15688,-365.32,-1156950.26,5731140.16,4574189.9
1990-07-20,361.61,-3.71,-1.02,368.95,-1.99,True,1,15689,-361.61,-1157311.87,5673299.29,4515987.42
1990-07-23,355.31,-6.3,-1.74,368.95,-3.7,True,1,15690,-355.31,-1157667.18,5574813.9,4417146.72
1990-07-24,355.79,0.48,0.14,368.95,-3.57,True,1,15691,-355.79,-1158022.97,5582700.89,4424677.92
1990-07-25,357.09,1.3,0.36,368.95,-3.22,True,1,15692,-357.09,-1158380.06,5603456.28,4445076.22
1990-07-26,355.91,-1.18,-0.33,368.95,-3.53,True,1,15693,-355.91,-1158735.97,5585295.63,4426559.66
1990-07-27,353.44,-2.47,-0.69,368.95,-4.2,True,1,15694,-353.44,-1159089.41,5546887.36,4387797.95
1990-07-30,355.55,2.11,0.6,368.95,-3.63,True,1,15695,-355.55,-1159444.96,5580357.25,4420912.29
1990-07-31,356.15,0.6,0.17,368.95,-3.47,True,1,15696,-356.15,-1159801.11,5590130.4,4430329.29
1990-08-01,355.52,-0.63,-0.18,368.95,-3.64,True,1,15697,-355.52,-1160156.63,5580597.44,4420440.81
1990-08-02,351.48,-4.04,-1.14,368.95,-4.74,True,1,15698,-351.48,-1160508.11,5517533.04,4357024.93
1990-08-03,344.86,-6.62,-1.88,368.95,-6.53,True,1,15699,-344.86,-1160852.97,5413957.14,4253104.17
1990-08-06,334.43,-10.43,-3.02,368.95,-9.36,True,1,15700,-334.43,-1161187.4,5250551.0,4089363.6
1990-08-07,334.83,0.4,0.12,368.95,-9.25,True,1,15701,-334.83,-1161522.23,5257165.83,4095643.6
1990-08-08,338.35,3.52,1.05,368.95,-8.29,True,1,15702,-338.35,-1161860.58,5312771.7,4150911.12
1990-08-09,339.94,1.59,0.47,368.95,-7.86,True,1,15703,-339.94,-1162200.52,5338077.82,4175877.3
1990-08-10,335.52,-4.42,-1.3,368.95,-9.06,True,1,15704,-335.52,-1162536.04,5269006.08,4106470.04
1990-08-13,338.84,3.32,0.99,368.95,-8.16,True,1,15705,-338.84,-1162874.88,5321482.2,4158607.32
1990-08-14,339.39,0.55,0.16,368.95,-8.01,True,1,15706,-339.39,-1163214.27,5330459.34,4167245.07
1990-08-15,340.06,0.67,0.2,368.95,-7.83,True,1,15707,-340.06,-1163554.33,5341322.42,4177768.09
1990-08-16,332.39,-7.67,-2.26,368.95,-9.91,True,1,15708,-332.39,-1163886.72,5221182.12,4057295.4
1990-08-17,327.83,-4.56,-1.37,368.95,-11.14,True,1,15709,-327.83,-1164214.55,5149881.47,3985666.92
1990-08-20,328.51,0.68,0.21,368.95,-10.96,True,1,15710,-328.51,-1164543.06,5160892.1,3996349.04
1990-08-21,321.86,-6.65,-2.02,368.95,-12.76,True,1,15711,-321.86,-1164864.92,5056742.46,3891877.54
1990-08-22,316.55,-5.31,-1.65,368.95,-14.2,True,1,15712,-316.55,-1165181.47,4973633.6,3808452.13
1990-08-23,307.06,-9.49,-3.0,368.95,-16.77,True,1,15713,-307.06,-1165488.53,4824833.78,3659345.25
1990-08-24,311.51,4.45,1.45,368.95,-15.57,True,1,15714,-311.51,-1165800.04,4895068.14,3729268.1
1990-08-27,321.44,9.93,3.19,368.95,-12.88,True,1,15715,-321.44,-1166121.48,5051429.6,3885308.12
1990-08-28,321.34,-0.1,-0.03,368.95,-12.9,True,1,15716,-321.34,-1166442.82,5050179.44,3883736.62
1990-08-29,324.19,2.85,0.89,368.95,-12.13,True,1,15717,-324.19,-1166767.01,5095294.23,3928527.22
1990-08-30,318.71,-5.48,-1.69,368.95,-13.62,True,1,15718,-318.71,-1167085.72,5009483.78,3842398.06
1990-08-31,322.56,3.85,1.21,368.95,-12.57,True,1,15719,-322.56,-1167408.28,5070320.64,3902912.36
1990-09-04,323.09,0.53,0.16,368.95,-12.43,True,1,15720,-323.09,-1167731.37,5078974.8,3911243.43
1990-09-05,324.39,1.3,0.4,368.95,-12.08,True,1,15721,-324.39,-1168055.76,5099735.19,3931679.43
1990-09-06,320.46,-3.93,-1.21,368.95,-13.14,True,1,15722,-320.46,-1168376.22,5038272.12,3869895.9
1990-09-07,323.4,2.94,0.92,368.95,-12.35,True,1,15723,-323.4,-1168699.62,5084818.2,3916118.58
1990-09-10,321.63,-1.77,-0.55,368.95,-12.83,True,1,15724,-321.63,-1169021.25,5057310.12,3888288.87
1990-09-11,321.04,-0.59,-0.18,368.95,-12.98,True,1,15725,-321.04,-1169342.29,5048354.0,3879011.71
1990-09-12,322.54,1.5,0.47,368.95,-12.58,True,1,15726,-322.54,-1169664.83,5072264.04,3902599.21
1990-09-13,318.65,-3.89,-1.21,368.95,-13.63,True,1,15727,-318.65,-1169983.48,5011408.55,3841425.07
1990-09-14,316.83,-1.82,-0.57,368.95,-14.13,True,1,15728,-316.83,-1170300.31,4983102.24,3812801.93
1990-09-17,317.77,0.94,0.3,368.95,-13.87,True,1,15729,-317.77,-1170618.08,4998204.33,3827586.25
1990-09-18,318.6,0.83,0.26,368.95,-13.65,True,1,15730,-318.6,-1170936.68,5011578.0,3840641.32
1990-09-19,316.6,-2.0,-0.63,368.95,-14.19,True,1,15731,-316.6,-1171253.28,4980434.6,3809181.32
1990-09-20,311.48,-5.12,-1.62,368.95,-15.58,True,1,15732,-311.48,-1171564.76,4900203.36,3728638.6
1990-09-21,311.32,-0.16,-0.05,368.95,-15.62,True,1,15733,-311.32,-1171876.08,4897997.56,3726121.48
1990-09-24,304.59,-6.73,-2.16,368.95,-17.44,True,1,15734,-304.59,-1172180.67,4792419.06,3620238.39
1990-09-25,308.26,3.67,1.2,368.95,-16.45,True,1,15735,-308.26,-1172488.93,4850471.1,3677982.17
1990-09-26,305.06,-3.2,-1.04,368.95,-17.32,True,1,15736,-305.06,-1172793.99,4800424.16,3627630.17
1990-09-27,300.97,-4.09,-1.34,368.95,-18.42,True,1,15737,-300.97,-1173094.96,4736364.89,3563269.93
1990-09-28,306.05,5.08,1.69,368.95,-17.05,True,1,15738,-306.05,-1173401.01,4816614.9,3643213.89
1990-10-01,314.94,8.89,2.9,368.95,-14.64,True,1,15739,-314.94,-1173715.95,4956840.66,3783124.71
1990-10-02,315.21,0.27,0.09,368.95,-14.57,True,1,15740,-315.21,-1174031.16,4961405.4,3787374.24
1990-10-03,311.4,-3.81,-1.21,368.95,-15.6,True,1,15741,-311.4,-1174342.56,4901747.4,3727404.84
1990-10-04,312.69,1.29,0.41,368.95,-15.25,True,1,15742,-312.69,-1174655.25,4922365.98,3747710.73
1990-10-05,311.5,-1.19,-0.38,368.95,-15.57,True,1,15743,-311.5,-1174966.75,4903944.5,3728977.75
1990-10-08,313.48,1.98,0.64,368.95,-15.04,True,1,15744,-313.48,-1175280.23,4935429.12,3760148.89
1990-10-09,305.1,-8.38,-2.67,368.95,-17.31,True,1,15745,-305.1,-1175585.33,4803799.5,3628214.17
1990-10-10,300.39,-4.71,-1.54,368.95,-18.58,True,1,15746,-300.39,-1175885.72,4729940.94,3554055.22
1990-10-11,295.46,-4.93,-1.64,368.95,-19.92,True,1,15747,-295.46,-1176181.18,4652608.62,3476427.44
1990-10-12,300.03,4.57,1.55,368.95,-18.68,True,1,15748,-300.03,-1176481.21,4724872.44,3548391.23
1990-10-15,303.23,3.2,1.07,368.95,-17.81,True,1,15749,-303.23,-1176784.44,4775569.27,3598784.83
1990-10-16,298.92,-4.31,-1.42,368.95,-18.98,True,1,15750,-298.92,-1177083.36,4707990.0,3530906.64
1990-10-17,298.76,-0.16,-0.05,368.95,-19.02,True,1,15751,-298.76,-1177382.12,4705768.76,3528386.64
1990-10-18,305.74,6.98,2.34,368.95,-17.13,True,1,15752,-305.74,-1177687.86,4816016.48,3638328.62
1990-10-19,312.48,6.74,2.2,368.95,-15.31,True,1,15753,-312.48,-1178000.34,4922497.44,3744497.1
1990-10-22,314.76,2.28,0.73,368.95,-14.69,True,1,15754,-314.76,-1178315.1,4958729.04,3780413.94
1990-10-23,312.36,-2.4,-0.76,368.95,-15.34,True,1,15755,-312.36,-1178627.46,4921231.8,3742604.34
1990-10-24,312.6,0.24,0.08,368.95,-15.27,True,1,15756,-312.6,-1178940.06,4925325.6,3746385.54
1990-10-25,310.17,-2.43,-0.78,368.95,-15.93,True,1,15757,-310.17,-1179250.23,4887348.69,3708098.46
1990-10-26,304.71,-5.46,-1.76,368.95,-17.41,True,1,15758,-304.71,-1179554.94,4801620.18,3622065.24
1990-10-29,301.88,-2.83,-0.93,368.95,-18.18,True,1,15759,-301.88,-1179856.82,4757326.92,3577470.1
1990-10-30,304.06,2.18,0.72,368.95,-17.59,True,1,15760,-304.06,-1180160.88,4791985.6,3611824.72
1990-10-31,304.0,-0.06,-0.02,368.95,-17.6,True,1,15761,-304.0,-1180464.88,4791344.0,3610879.12
1990-11-01,307.02,3.02,0.99,368.95,-16.78,True,1,15762,-307.02,-1180771.9,4839249.24,3658477.34
1990-11-02,311.85,4.83,1.57,368.95,-15.48,True,1,15763,-311.85,-1181083.75,4915691.55,3734607.8
1990-11-05,314.59,2.74,0.88,368.95,-14.73,True,1,15764,-314.59,-1181398.34,4959196.76,3777798.42
1990-11-06,311.62,-2.97,-0.94,368.95,-15.54,True,1,15765,-311.62,-1181709.96,4912689.3,3730979.34
1990-11-07,306.01,-5.61,-1.8,368.95,-17.06,True,1,15766,-306.01,-1182015.97,4824553.66,3642537.69
1990-11-08,307.61,1.6,0.52,368.95,-16.63,True,1,15767,-307.61,-1182323.58,4850086.87,3667763.29
1990-11-09,313.74,6.13,1.99,368.95,-14.96,True,1,15768,-313.74,-1182637.32,4947052.32,3764415.0
1990-11-12,319.48,5.74,1.83,368.95,-13.41,True,1,15769,-319.48,-1182956.8,5037880.12,3854923.32
1990-11-13,317.67,-1.81,-0.57,368.95,-13.9,True,1,15770,-317.67,-1183274.47,5009655.9,3826381.43
1990-11-14,320.4,2.73,0.86,368.95,-13.16,True,1,15771,-320.4,-1183594.87,5053028.4,3869433.53
1990-11-15,317.02,-3.38,-1.06,368.95,-14.08,True,1,15772,-317.02,-1183911.89,5000039.44,3816127.55
1990-11-16,317.12,0.1,0.03,368.95,-14.05,True,1,15773,-317.12,-1184229.01,5001933.76,3817704.75
1990-11-19,319.34,2.22,0.7,368.95,-13.45,True,1,15774,-319.34,-1184548.35,5037269.16,3852720.81
1990-11-20,315.31,-4.03,-1.26,368.95,-14.54,True,1,15775,-315.31,-1184863.66,4974015.25,3789151.59
1990-11-21,316.03,0.72,0.23,368.95,-14.34,True,1,15776,-316.03,-1185179.69,4985689.28,3800509.59
1990-11-23,315.1,-0.93,-0.29,368.95,-14.6,True,1,15777,-315.1,-1185494.79,4971332.7,3785837.91
1990-11-26,316.51,1.41,0.45,368.95,-14.21,True,1,15778,-316.51,-1185811.3,4993894.78,3808083.48
1990-11-27,318.1,1.59,0.5,368.95,-13.78,True,1,15779,-318.1,-1186129.4,5019299.9,3833170.5
1990-11-28,317.95,-0.15,-0.05,368.95,-13.82,True,1,15780,-317.95,-1186447.35,5017251.0,3830803.65
1990-11-29,316.42,-1.53,-0.48,368.95,-14.24,True,1,15781,-316.42,-1186763.77,4993424.02,3806660.25
1990-11-30,322.22,5.8,1.83,368.95,-12.67,True,1,15782,-322.22,-1187085.99,5085276.04,3898190.05
1990-12-03,324.1,1.88,0.58,368.95,-12.16,True,1,15783,-324.1,-1187410.09,5115270.3,3927860.21
1990-12-04,326.35,2.25,0.69,368.95,-11.55,True,1,15784,-326.35,-1187736.44,5151108.4,3963371.96
1990-12-05,329.92,3.57,1.09,368.95,-10.58,True,1,15785,-329.92,-1188066.36,5207787.2,4019720.84
1990-12-06,329.07,-0.85,-0.26,368.95,-10.81,True,1,15786,-329.07,-1188395.43,5194699.02,4006303.59
1990-12-07,327.75,-1.32,-0.4,368.95,-11.17,True,1,15787,-327.75,-1188723.18,5174189.25,3985466.07
1990-12-10,328.89,1.14,0.35,368.95,-10.86,True,1,15788,-328.89,-1189052.07,5192515.32,4003463.25
1990-12-11,326.44,-2.45,-0.74,368.95,-11.52,True,1,15789,-326.44,-1189378.51,5154161.16,3964782.65
1990-12-12,330.19,3.75,1.15,368.95,-10.5,True,1,15790,-330.19,-1189708.7,5213700.1,4023991.4
1990-12-13,329.34,-0.85,-0.26,368.95,-10.74,True,1,15791,-329.34,-1190038.04,5200607.94,4010569.9
1990-12-14,326.82,-2.52,-0.76,368.95,-11.42,True,1,15792,-326.82,-1190364.86,5161141.44,3970776.58
1990-12-17,326.02,-0.8,-0.24,368.95,-11.64,True,1,15793,-326.02,-1190690.88,5148833.86,3958142.98
1990-12-18,330.05,4.03,1.24,368.95,-10.54,True,1,15794,-330.05,-1191020.93,5212809.7,4021788.77
1990-12-19,330.2,0.15,0.04,368.95,-10.5,True,1,15795,-330.2,-1191351.13,5215509.0,4024157.87
1990-12-20,330.12,-0.08,-0.02,368.95,-10.52,True,1,15796,-330.12,-1191681.25,5214575.52,4022894.27
1990-12-21,331.75,1.63,0.49,368.95,-10.08,True,1,15797,-331.75,-1192013.0,5240654.75,4048641.75
1990-12-24,329.9,-1.85,-0.56,368.95,-10.58,True,1,15798,-329.9,-1192342.9,5211760.2,4019417.3
1990-12-26,330.85,0.95,0.29,368.95,-10.33,True,1,15799,-330.85,-1192673.75,5227099.15,4034425.4
1990-12-27,328.29,-2.56,-0.77,368.95,-11.02,True,1,15800,-328.29,-1193002.04,5186982.0,3993979.96
1990-12-28,328.72,0.43,0.13,368.95,-10.9,True,1,15801,-328.72,-1193330.76,5194104.72,4000773.96
1990-12-31,330.22,1.5,0.46,368.95,-10.5,True,1,15802,-330.22,-1193660.98,5218136.44,4024475.46
1991-01-02,326.45,-3.77,-1.14,368.95,-11.52,True,1,15803,-326.45,-1193987.43,5158889.35,3964901.92
1991-01-03,321.91,-4.54,-1.39,368.95,-12.75,True,1,15804,-321.91,-1194309.34,5087465.64,3893156.3
1991-01-04,321.0,-0.91,-0.28,368.95,-13.0,True,1,15805,-321.0,-1194630.34,5073405.0,3878774.66
1991-01-07,315.44,-5.56,-1.73,368.95,-14.5,True,1,15806,-315.44,-1194945.78,4985844.64,3790898.86
1991-01-08,314.9,-0.54,-0.17,368.95,-14.65,True,1,15807,-314.9,-1195260.68,4977624.3,3782363.62
1991-01-09,311.49,-3.41,-1.08,368.95,-15.57,True,1,15808,-311.49,-1195572.17,4924033.92,3728461.75
1991-01-10,314.53,3.04,0.98,368.95,-14.75,True,1,15809,-314.53,-1195886.7,4972404.77,3776518.07
1991-01-11,315.23,0.7,0.22,368.95,-14.56,True,1,15810,-315.23,-1196201.93,4983786.3,3787584.37
1991-01-14,312.49,-2.74,-0.87,368.95,-15.3,True,1,15811,-312.49,-1196514.42,4940779.39,3744264.97
1991-01-15,313.73,1.24,0.4,368.95,-14.97,True,1,15812,-313.73,-1196828.15,4960698.76,3763870.61
1991-01-16,316.17,2.44,0.78,368.95,-14.3,True,1,15813,-316.17,-1197144.32,4999596.21,3802451.89
1991-01-17,327.97,11.8,3.73,368.95,-11.11,True,1,15814,-327.97,-1197472.29,5186517.58,3989045.29
1991-01-18,332.23,4.26,1.3,368.95,-9.95,True,1,15815,-332.23,-1197804.52,5254217.45,4056412.93
1991-01-21,331.06,-1.17,-0.35,368.95,-10.27,True,1,15816,-331.06,-1198135.58,5236044.96,4037909.38
1991-01-22,328.31,-2.75,-0.83,368.95,-11.02,True,1,15817,-328.31,-1198463.89,5192879.27,3994415.38
1991-01-23,330.21,1.9,0.58,368.95,-10.5,True,1,15818,-330.21,-1198794.1,5223261.78,4024467.68
1991-01-24,334.78,4.57,1.38,368.95,-9.26,True,1,15819,-334.78,-1199128.88,5295884.82,4096755.94
1991-01-25,336.07,1.29,0.38,368.95,-8.91,True,1,15820,-336.07,-1199464.95,5316627.4,4117162.45
1991-01-28,336.03,-0.04,-0.01,368.95,-8.92,True,1,15821,-336.03,-1199800.98,5316330.63,4116529.65
1991-01-29,335.84,-0.19,-0.06,368.95,-8.97,True,1,15822,-335.84,-1200136.82,5313660.48,4113523.66
1991-01-30,340.91,5.07,1.51,368.95,-7.6,True,1,15823,-340.91,-1200477.73,5394218.93,4193741.2
1991-01-31,343.93,3.02,0.89,368.95,-6.78,True,1,15824,-343.93,-1200821.66,5442348.32,4241526.66
1991-02-01,343.05,-0.88,-0.26,368.95,-7.02,True,1,15825,-343.05,-1201164.71,5428766.25,4227601.54
1991-02-04,348.34,5.29,1.54,368.95,-5.59,True,1,15826,-348.34,-1201513.05,5512828.84,4311315.79
1991-02-05,351.26,2.92,0.84,368.95,-4.8,True,1,15827,-351.26,-1201864.31,5559392.02,4357527.71
1991-02-06,358.07,6.81,1.94,368.95,-2.95,True,1,15828,-358.07,-1202222.38,5667531.96,4465309.58
1991-02-07,356.52,-1.55,-0.43,368.95,-3.37,True,1,15829,-356.52,-1202578.9,5643355.08,4440776.18
1991-02-08,359.35,2.83,0.79,368.95,-2.6,True,1,15830,-359.35,-1202938.25,5688510.5,4485572.25
1991-02-11,368.58,9.23,2.57,368.95,-0.1,True,1,15831,-368.58,-1203306.83,5834989.98,4631683.15
1991-02-12,365.5,-3.08,-0.84,368.95,-0.94,True,1,15832,-365.5,-1203672.33,5786596.0,4582923.67
1991-02-13,369.02,3.52,0.96,369.02,0.0,True,1,15833,-369.02,-1204041.35,5842693.66,4638652.31
1991-02-14,364.22,-4.8,-1.3,369.02,-1.3,True,1,15834,-364.22,-1204405.57,5767059.48,4562653.91
1991-02-15,369.06,4.84,1.33,369.06,0.0,True,1,15835,-369.06,-1204774.63,5844065.1,4639290.47
1991-02-19,369.39,0.33,0.09,369.39,0.0,True,1,15836,-369.39,-1205144.02,5849660.04,4644516.02
1991-02-20,365.14,-4.25,-1.15,369.39,-1.15,True,1,15837,-365.14,-1205509.16,5782722.18,4577213.02
1991-02-21,364.97,-0.17,-0.05,369.39,-1.2,True,1,15838,-364.97,-1205874.13,5780394.86,4574520.73
1991-02-22,365.65,0.68,0.19,369.39,-1.01,True,1,15839,-365.65,-1206239.78,5791530.35,4585290.57
1991-02-25,367.26,1.61,0.44,369.39,-0.58,True,1,15840,-367.26,-1206607.04,5817398.4,4610791.36
1991-02-26,362.81,-4.45,-1.21,369.39,-1.78,True,1,15841,-362.81,-1206969.85,5747273.21,4540303.36
1991-02-27,367.74,4.93,1.36,369.39,-0.45,True,1,15842,-367.74,-1207337.59,5825737.08,4618399.49
1991-02-28,367.07,-0.67,-0.18,369.39,-0.63,True,1,15843,-367.07,-1207704.66,5815490.01,4607785.35
1991-03-01,370.47,3.4,0.93,370.47,0.0,True,1,15844,-370.47,-1208075.13,5869726.68,4661651.55
1991-03-04,369.33,-1.14,-0.31,370.47,-0.31,True,1,15845,-369.33,-1208444.46,5852033.85,4643589.39
1991-03-05,376.72,7.39,2.0,376.72,0.0,True,1,15846,-376.72,-1208821.18,5969505.12,4760683.94
1991-03-06,376.17,-0.55,-0.15,376.72,-0.15,True,1,15847,-376.17,-1209197.35,5961165.99,4751968.64
1991-03-07,375.91,-0.26,-0.07,376.72,-0.22,True,1,15848,-375.91,-1209573.26,5957421.68,4747848.42
1991-03-08,374.95,-0.96,-0.26,376.72,-0.47,True,1,15849,-374.95,-1209948.21,5942582.55,4732634.34
1991-03-11,372.96,-1.99,-0.53,376.72,-1.0,True,1,15850,-372.96,-1210321.17,5911416.0,4701094.83
1991-03-12,370.03,-2.93,-0.79,376.72,-1.78,True,1,15851,-370.03,-1210691.2,5865345.53,4654654.33
1991-03-13,374.57,4.54,1.23,376.72,-0.57,True,1,15852,-374.57,-1211065.77,5937683.64,4726617.87
1991-03-14,373.5,-1.07,-0.29,376.72,-0.86,True,1,15853,-373.5,-1211439.27,5921095.5,4709656.23
1991-03-15,373.59,0.09,0.02,376.72,-0.83,True,1,15854,-373.59,-1211812.86,5922895.86,4711083.0
1991-03-18,372.11,-1.48,-0.4,376.72,-1.22,True,1,15855,-372.11,-1212184.97,5899804.05,4687619.08
1991-03-19,366.59,-5.52,-1.48,376.72,-2.69,True,1,15856,-366.59,-1212551.56,5812651.04,4600099.48
1991-03-20,367.92,1.33,0.36,376.72,-2.34,True,1,15857,-367.92,-1212919.48,5834107.44,4621187.96
1991-03-21,366.58,-1.34,-0.36,376.72,-2.69,True,1,15858,-366.58,-1213286.06,5813225.64,4599939.58
1991-03-22,367.48,0.9,0.25,376.72,-2.45,True,1,15859,-367.48,-1213653.54,5827865.32,4614211.78
1991-03-25,369.83,2.35,0.64,376.72,-1.83,True,1,15860,-369.83,-1214023.37,5865503.8,4651480.43
1991-03-26,376.3,6.47,1.75,376.72,-0.11,True,1,15861,-376.3,-1214399.67,5968494.3,4754094.63
1991-03-27,375.35,-0.95,-0.25,376.72,-0.36,True,1,15862,-375.35,-1214775.02,5953801.7,4739026.68
1991-03-28,375.22,-0.13,-0.04,376.72,-0.4,True,1,15863,-375.22,-1215150.24,5952114.86,4736964.62
1991-04-01,371.3,-3.92,-1.04,376.72,-1.44,True,1,15864,-371.3,-1215521.54,5890303.2,4674781.66
1991-04-02,379.5,8.2,2.21,379.5,0.0,True,1,15865,-379.5,-1215901.04,6020767.5,4804866.46
1991-04-03,378.94,-0.56,-0.15,379.5,-0.15,True,1,15866,-378.94,-1216279.98,6012262.04,4795982.06
1991-04-04,379.77,0.83,0.22,379.77,0.0,True,1,15867,-379.77,-1216659.75,6025810.59,4809150.84
1991-04-05,375.36,-4.41,-1.16,379.77,-1.16,True,1,15868,-375.36,-1217035.11,5956212.48,4739177.37
1991-04-08,378.66,3.3,0.88,379.77,-0.29,True,1,15869,-378.66,-1217413.77,6008955.54,4791541.77
1991-04-09,373.56,-5.1,-1.35,379.77,-1.64,True,1,15870,-373.56,-1217787.33,5928397.2,4710609.87
1991-04-10,373.15,-0.41,-0.11,379.77,-1.74,True,1,15871,-373.15,-1218160.48,5922263.65,4704103.17
1991-04-11,377.63,4.48,1.2,379.77,-0.56,True,1,15872,-377.63,-1218538.11,5993743.36,4775205.25
1991-04-12,380.4,2.77,0.73,380.4,0.0,True,1,15873,-380.4,-1218918.51,6038089.2,4819170.69
1991-04-15,381.19,0.79,0.21,381.19,0.0,True,1,15874,-381.19,-1219299.7,6051010.06,4831710.36
1991-04-16,387.62,6.43,1.69,387.62,0.0,True,1,15875,-387.62,-1219687.32,6153467.5,4933780.18
1991-04-17,390.45,2.83,0.73,390.45,0.0,True,1,15876,-390.45,-1220077.77,6198784.2,4978706.43
1991-04-18,388.46,-1.99,-0.51,390.45,-0.51,True,1,15877,-388.46,-1220466.23,6167579.42,4947113.19
1991-04-19,384.2,-4.26,-1.1,390.45,-1.6,True,1,15878,-384.2,-1220850.43,6100327.6,4879477.17
1991-04-22,380.95,-3.25,-0.85,390.45,-2.43,True,1,15879,-380.95,-1221231.38,6049105.05,4827873.67
1991-04-23,381.76,0.81,0.21,390.45,-2.23,True,1,15880,-381.76,-1221613.14,6062348.8,4840735.66
1991-04-24,382.76,1.0,0.26,390.45,-1.97,True,1,15881,-382.76,-1221995.9,6078611.56,4856615.66
1991-04-25,379.25,-3.51,-0.92,390.45,-2.87,True,1,15882,-379.25,-1222375.15,6023248.5,4800873.35
1991-04-26,379.02,-0.23,-0.06,390.45,-2.93,True,1,15883,-379.02,-1222754.17,6019974.66,4797220.49
1991-04-29,373.66,-5.36,-1.41,390.45,-4.3,True,1,15884,-373.66,-1223127.83,5935215.44,4712087.61
1991-04-30,375.34,1.68,0.45,390.45,-3.87,True,1,15885,-375.34,-1223503.17,5962275.9,4738772.73
1991-05-01,380.29,4.95,1.32,390.45,-2.6,True,1,15886,-380.29,-1223883.46,6041286.94,4817403.48
1991-05-02,380.52,0.23,0.06,390.45,-2.54,True,1,15887,-380.52,-1224263.98,6045321.24,4821057.26
1991-05-03,380.8,0.28,0.07,390.45,-2.47,True,1,15888,-380.8,-1224644.78,6050150.4,4825505.62
1991-05-06,380.08,-0.72,-0.19,390.45,-2.66,True,1,15889,-380.08,-1225024.86,6039091.12,4814066.26
1991-05-07,377.32,-2.76,-0.73,390.45,-3.36,True,1,15890,-377.32,-1225402.18,5995614.8,4770212.62
1991-05-08,378.51,1.19,0.32,390.45,-3.06,True,1,15891,-378.51,-1225780.69,6014902.41,4789121.72
1991-05-09,383.25,4.74,1.25,390.45,-1.84,True,1,15892,-383.25,-1226163.94,6090609.0,4864445.06
1991-05-10,375.74,-7.51,-1.96,390.45,-3.77,True,1,15893,-375.74,-1226539.68,5971635.82,4745096.14
1991-05-13,376.76,1.02,0.27,390.45,-3.51,True,1,15894,-376.76,-1226916.44,5988223.44,4761307.0
1991-05-14,371.62,-5.14,-1.36,390.45,-4.82,True,1,15895,-371.62,-1227288.06,5906899.9,4679611.84
1991-05-15,368.57,-3.05,-0.82,390.45,-5.6,True,1,15896,-368.57,-1227656.63,5858788.72,4631132.09
1991-05-16,372.19,3.62,0.98,390.45,-4.68,True,1,15897,-372.19,-1228028.82,5916704.43,4688675.61
1991-05-17,372.39,0.2,0.05,390.45,-4.62,True,1,15898,-372.39,-1228401.21,5920256.22,4691855.01
1991-05-20,372.28,-0.11,-0.03,390.45,-4.65,True,1,15899,-372.28,-1228773.49,5918879.72,4690106.23
1991-05-21,375.35,3.07,0.82,390.45,-3.87,True,1,15900,-375.35,-1229148.84,5968065.0,4738916.16
1991-05-22,376.19,0.84,0.22,390.45,-3.65,True,1,15901,-376.19,-1229525.03,5981797.19,4752272.16
1991-05-23,374.96,-1.23,-0.33,390.45,-3.97,True,1,15902,-374.96,-1229899.99,5962613.92,4732713.93
1991-05-24,377.49,2.53,0.68,390.45,-3.32,True,1,15903,-377.49,-1230277.48,6003223.47,4772945.99
1991-05-28,381.94,4.45,1.18,390.45,-2.18,True,1,15904,-381.94,-1230659.42,6074373.76,4843714.34
1991-05-29,382.79,0.85,0.22,390.45,-1.96,True,1,15905,-382.79,-1231042.21,6088274.95,4857232.74
1991-05-30,386.96,4.17,1.09,390.45,-0.89,True,1,15906,-386.96,-1231429.17,6154985.76,4923556.59
1991-05-31,389.83,2.87,0.74,390.45,-0.16,True,1,15907,-389.83,-1231819.0,6201025.81,4969206.81
1991-06-03,388.06,-1.77,-0.45,390.45,-0.61,True,1,15908,-388.06,-1232207.06,6173258.48,4941051.42
1991-06-04,387.74,-0.32,-0.08,390.45,-0.69,True,1,15909,-387.74,-1232594.8,6168555.66,4935960.86
1991-06-05,385.09,-2.65,-0.68,390.45,-1.37,True,1,15910,-385.09,-1232979.89,6126781.9,4893802.01
1991-06-06,383.63,-1.46,-0.38,390.45,-1.75,True,1,15911,-383.63,-1233363.52,6103936.93,4870573.41
1991-06-07,379.43,-4.2,-1.1,390.45,-2.82,True,1,15912,-379.43,-1233742.95,6037490.16,4803747.21
1991-06-10,378.57,-0.86,-0.23,390.45,-3.04,True,1,15913,-378.57,-1234121.52,6024184.41,4790062.89
1991-06-11,381.05,2.48,0.66,390.45,-2.41,True,1,15914,-381.05,-1234502.57,6064029.7,4829527.13
1991-06-12,376.65,-4.4,-1.16,390.45,-3.53,True,1,15915,-376.65,-1234879.22,5994384.75,4759505.53
1991-06-13,377.63,0.98,0.26,390.45,-3.28,True,1,15916,-377.63,-1235256.85,6010359.08,4775102.23
1991-06-14,382.29,4.66,1.23,390.45,-2.09,True,1,15917,-382.29,-1235639.14,6084909.93,4849270.79
1991-06-17,380.13,-2.16,-0.56,390.45,-2.64,True,1,15918,-380.13,-1236019.27,6050909.34,4814890.07
1991-06-18,378.59,-1.54,-0.4,390.45,-3.04,True,1,15919,-378.59,-1236397.86,6026774.21,4790376.35
1991-06-19,375.09,-3.5,-0.92,390.45,-3.93,True,1,15920,-375.09,-1236772.95,5971432.8,4734659.85
1991-06-20,375.42,0.33,0.09,390.45,-3.85,True,1,15921,-375.42,-1237148.37,5977061.82,4739913.45
1991-06-21,377.75,2.33,0.62,390.45,-3.25,True,1,15922,-377.75,-1237526.12,6014535.5,4777009.38
1991-06-24,370.94,-6.81,-1.8,390.45,-5.0,True,1,15923,-370.94,-1237897.06,5906477.62,4668580.56
1991-06-25,370.65,-0.29,-0.08,390.45,-5.07,True,1,15924,-370.65,-1238267.71,5902230.6,4663962.89
1991-06-26,371.59,0.94,0.25,390.45,-4.83,True,1,15925,-371.59,-1238639.3,5917570.75,4678931.45
1991-06-27,374.4,2.81,0.76,390.45,-4.11,True,1,15926,-374.4,-1239013.7,5962694.4,4723680.7
1991-06-28,371.16,-3.24,-0.86,390.45,-4.94,True,1,15927,-371.16,-1239384.86,5911465.32,4672080.46
1991-07-01,377.92,6.76,1.82,390.45,-3.21,True,1,15928,-377.92,-1239762.78,6019509.76,4779746.98
1991-07-02,377.47,-0.45,-0.12,390.45,-3.32,True,1,15929,-377.47,-1240140.25,6012719.63,4772579.38
1991-07-03,373.33,-4.14,-1.1,390.45,-4.38,True,1,15930,-373.33,-1240513.58,5947146.9,4706633.32
1991-07-05,374.08,0.75,0.2,390.45,-4.19,True,1,15931,-374.08,-1240887.66,5959468.48,4718580.82
1991-07-08,377.94,3.86,1.03,390.45,-3.2,True,1,15932,-377.94,-1241265.6,6021340.08,4780074.48
1991-07-09,376.11,-1.83,-0.48,390.45,-3.67,True,1,15933,-376.11,-1241641.71,5992560.63,4750918.92
1991-07-10,375.74,-0.37,-0.1,390.45,-3.77,True,1,15934,-375.74,-1242017.45,5987041.16,4745023.71
1991-07-11,376.97,1.23,0.33,390.45,-3.45,True,1,15935,-376.97,-1242394.42,6007016.95,4764622.53
1991-07-12,380.25,3.28,0.87,390.45,-2.61,True,1,15936,-380.25,-1242774.67,6059664.0,4816889.33
1991-07-15,382.39,2.14,0.56,390.45,-2.06,True,1,15937,-382.39,-1243157.06,6094149.43,4850992.37
1991-07-16,381.54,-0.85,-0.22,390.45,-2.28,True,1,15938,-381.54,-1243538.6,6080984.52,4837445.92
1991-07-17,381.18,-0.36,-0.09,390.45,-2.37,True,1,15939,-381.18,-1243919.78,6075628.02,4831708.24
1991-07-18,385.37,4.19,1.1,390.45,-1.3,True,1,15940,-385.37,-1244305.15,6142797.8,4898492.65
1991-07-19,384.22,-1.15,-0.3,390.45,-1.6,True,1,15941,-384.22,-1244689.37,6124851.02,4880161.65
1991-07-22,382.88,-1.34,-0.35,390.45,-1.94,True,1,15942,-382.88,-1245072.25,6103872.96,4858800.71
1991-07-23,379.42,-3.46,-0.9,390.45,-2.82,True,1,15943,-379.42,-1245451.67,6049093.06,4803641.39
1991-07-24,378.64,-0.78,-0.21,390.45,-3.02,True,1,15944,-378.64,-1245830.31,6037036.16,4791205.85
1991-07-25,380.96,2.32,0.61,390.45,-2.43,True,1,15945,-380.96,-1246211.27,6074407.2,4828195.93
1991-07-26,380.93,-0.03,-0.01,390.45,-2.44,True,1,15946,-380.93,-1246592.2,6074309.78,4827717.58
1991-07-29,383.15,2.22,0.58,390.45,-1.87,True,1,15947,-383.15,-1246975.35,6110093.05,4863117.7
1991-07-30,386.69,3.54,0.92,390.45,-0.96,True,1,15948,-386.69,-1247362.04,6166932.12,4919570.08
1991-07-31,387.81,1.12,0.29,390.45,-0.68,True,1,15949,-387.81,-1247749.85,6185181.69,4937431.84
1991-08-01,387.12,-0.69,-0.18,390.45,-0.85,True,1,15950,-387.12,-1248136.97,6174564.0,4926427.03
1991-08-02,387.18,0.06,0.02,390.45,-0.84,True,1,15951,-387.18,-1248524.15,6175908.18,4927384.03
1991-08-05,385.06,-2.12,-0.55,390.45,-1.38,True,1,15952,-385.06,-1248909.21,6142477.12,4893567.91
1991-08-06,390.62,5.56,1.44,390.62,0.0,True,1,15953,-390.62,-1249299.83,6231560.86,4982261.03
1991-08-07,390.56,-0.06,-0.02,390.62,-0.02,True,1,15954,-390.56,-1249690.39,6230994.24,4981303.85
1991-08-08,389.32,-1.24,-0.32,390.62,-0.33,True,1,15955,-389.32,-1250079.71,6211600.6,4961520.89
1991-08-09,387.12,-2.2,-0.56,390.62,-0.9,True,1,15956,-387.12,-1250466.83,6176886.72,4926419.89
1991-08-12,388.02,0.9,0.23,390.62,-0.67,True,1,15957,-388.02,-1250854.85,6191635.14,4940780.29
1991-08-13,389.62,1.6,0.41,390.62,-0.26,True,1,15958,-389.62,-1251244.47,6217555.96,4966311.49
1991-08-14,389.9,0.28,0.07,390.62,-0.18,True,1,15959,-389.9,-1251634.37,6222414.1,4970779.73
1991-08-15,389.33,-0.57,-0.15,390.62,-0.33,True,1,15960,-389.33,-1252023.7,6213706.8,4961683.1
1991-08-16,385.58,-3.75,-0.96,390.62,-1.29,True,1,15961,-385.58,-1252409.28,6154242.38,4901833.1
1991-08-19,376.47,-9.11,-2.36,390.62,-3.62,True,1,15962,-376.47,-1252785.75,6009214.14,4756428.39
1991-08-20,379.43,2.96,0.79,390.62,-2.86,True,1,15963,-379.43,-1253165.18,6056841.09,4803675.91
1991-08-21,390.59,11.16,2.94,390.62,-0.01,True,1,15964,-390.59,-1253555.77,6235378.76,4981822.99
1991-08-22,391.33,0.74,0.19,391.33,0.0,True,1,15965,-391.33,-1253947.1,6247583.45,4993636.35
1991-08-23,394.17,2.84,0.73,394.17,0.0,True,1,15966,-394.17,-1254341.27,6293318.22,5038976.95
1991-08-26,393.85,-0.32,-0.08,394.17,-0.08,True,1,15967,-393.85,-1254735.12,6288602.95,5033867.83
1991-08-27,393.06,-0.79,-0.2,394.17,-0.28,True,1,15968,-393.06,-1255128.18,6276382.08,5021253.9
1991-08-28,396.64,3.58,0.91,396.64,0.0,True,1,15969,-396.64,-1255524.82,6333944.16,5078419.34
1991-08-29,396.47,-0.17,-0.04,396.64,-0.04,True,1,15970,-396.47,-1255921.29,6331625.9,5075704.61
1991-08-30,395.43,-1.04,-0.26,396.64,-0.3,True,1,15971,-395.43,-1256316.72,6315412.53,5059095.81
1991-09-03,392.15,-3.28,-0.83,396.64,-1.13,True,1,15972,-392.15,-1256708.87,6263419.8,5006710.93
1991-09-04,389.97,-2.18,-0.56,396.64,-1.68,True,1,15973,-389.97,-1257098.84,6228990.81,4971891.97
1991-09-05,389.14,-0.83,-0.21,396.64,-1.89,True,1,15974,-389.14,-1257487.98,6216122.36,4958634.38
1991-09-06,389.1,-0.04,-0.01,396.64,-1.9,True,1,15975,-389.1,-1257877.08,6215872.5,4957995.42
1991-09-09,388.57,-0.53,-0.14,396.64,-2.04,True,1,15976,-388.57,-1258265.65,6207794.32,4949528.67
1991-09-10,384.56,-4.01,-1.03,396.64,-3.05,True,1,15977,-384.56,-1258650.21,6144115.12,4885464.91
1991-09-11,385.09,0.53,0.14,396.64,-2.91,True,1,15978,-385.09,-1259035.3,6152968.02,4893932.72
1991-09-12,387.34,2.25,0.58,396.64,-2.35,True,1,15979,-387.34,-1259422.64,6189305.86,4929883.22
1991-09-13,383.59,-3.75,-0.97,396.64,-3.29,True,1,15980,-383.59,-1259806.23,6129768.2,4869961.97
1991-09-16,385.78,2.19,0.57,396.64,-2.74,True,1,15981,-385.78,-1260192.01,6165150.18,4904958.17
1991-09-17,385.5,-0.28,-0.07,396.64,-2.81,True,1,15982,-385.5,-1260577.51,6161061.0,4900483.49
1991-09-18,386.94,1.44,0.37,396.64,-2.45,True,1,15983,-386.94,-1260964.45,6184462.02,4923497.57
1991-09-19,387.56,0.62,0.16,396.64,-2.29,True,1,15984,-387.56,-1261352.01,6194759.04,4933407.03
1991-09-20,387.92,0.36,0.09,396.64,-2.2,True,1,15985,-387.92,-1261739.93,6200901.2,4939161.27
1991-09-23,385.92,-2.0,-0.52,396.64,-2.7,True,1,15986,-385.92,-1262125.85,6169317.12,4907191.27
1991-09-24,387.71,1.79,0.46,396.64,-2.25,True,1,15987,-387.71,-1262513.56,6198319.77,4935806.21
1991-09-25,386.88,-0.83,-0.21,396.64,-2.46,True,1,15988,-386.88,-1262900.44,6185437.44,4922537.0
1991-09-26,386.49,-0.39,-0.1,396.64,-2.56,True,1,15989,-386.49,-1263286.93,6179588.61,4916301.68
1991-09-27,385.9,-0.59,-0.15,396.64,-2.71,True,1,15990,-385.9,-1263672.83,6170541.0,4906868.17
1991-09-30,387.86,1.96,0.51,396.64,-2.21,True,1,15991,-387.86,-1264060.69,6202269.26,4938208.57
1991-10-01,389.2,1.34,0.34,396.64,-1.88,True,1,15992,-389.2,-1264449.89,6224086.4,4959636.51
1991-10-02,388.26,-0.94,-0.24,396.64,-2.11,True,1,15993,-388.26,-1264838.15,6209442.18,4944604.03
1991-10-03,384.47,-3.79,-0.98,396.64,-3.07,True,1,15994,-384.47,-1265222.62,6149213.18,4883990.56
1991-10-04,381.25,-3.22,-0.84,396.64,-3.88,True,1,15995,-381.25,-1265603.87,6098093.75,4832489.88
1991-10-07,379.5,-1.75,-0.46,396.64,-4.32,True,1,15996,-379.5,-1265983.37,6070482.0,4804498.63
1991-10-08,380.67,1.17,0.31,396.64,-4.03,True,1,15997,-380.67,-1266364.04,6089577.99,4823213.95
1991-10-09,376.8,-3.87,-1.02,396.64,-5.0,True,1,15998,-376.8,-1266740.84,6028046.4,4761305.56
1991-10-10,380.55,3.75,1.0,396.64,-4.06,True,1,15999,-380.55,-1267121.39,6088419.45,4821298.06
1991-10-11,381.45,0.9,0.24,396.64,-3.83,True,1,16000,-381.45,-1267502.84,6103200.0,4835697.16
1991-10-14,386.47,5.02,1.32,396.64,-2.56,True,1,16001,-386.47,-1267889.31,6183906.47,4916017.16
1991-10-15,391.01,4.54,1.18,396.64,-1.42,True,1,16002,-391.01,-1268280.32,6256942.02,4988661.7
1991-10-16,392.8,1.79,0.46,396.64,-0.97,True,1,16003,-392.8,-1268673.12,6285978.4,5017305.28
1991-10-17,391.92,-0.88,-0.22,396.64,-1.19,True,1,16004,-391.92,-1269065.04,6272287.68,5003222.64
1991-10-18,392.5,0.58,0.15,396.64,-1.04,True,1,16005,-392.5,-1269457.54,6281962.5,5012504.96
1991-10-21,390.02,-2.48,-0.63,396.64,-1.67,True,1,16006,-390.02,-1269847.56,6242660.12,4972812.56
1991-10-22,387.83,-2.19,-0.56,396.64,-2.22,True,1,16007,-387.83,-1270235.39,6207994.81,4937759.42
1991-10-23,387.94,0.11,0.03,396.64,-2.19,True,1,16008,-387.94,-1270623.33,6210143.52,4939520.19
1991-10-24,385.07,-2.87,-0.74,396.64,-2.92,True,1,16009,-385.07,-1271008.4,6164585.63,4893577.23
1991-10-25,384.2,-0.87,-0.23,396.64,-3.14,True,1,16010,-384.2,-1271392.6,6151042.0,4879649.4
1991-10-28,389.52,5.32,1.38,396.64,-1.8,True,1,16011,-389.52,-1271782.12,6236604.72,4964822.6
1991-10-29,391.48,1.96,0.5,396.64,-1.3,True,1,16012,-391.48,-1272173.6,6268377.76,4996204.16
1991-10-30,392.96,1.48,0.38,396.64,-0.93,True,1,16013,-392.96,-1272566.56,6292468.48,5019901.92
1991-10-31,392.45,-0.51,-0.13,396.64,-1.06,True,1,16014,-392.45,-1272959.01,6284694.3,5011735.29
1991-11-01,391.32,-1.13,-0.29,396.64,-1.34,True,1,16015,-391.32,-1273350.33,6266989.8,4993639.47
1991-11-04,390.28,-1.04,-0.27,396.64,-1.6,True,1,16016,-390.28,-1273740.61,6250724.48,4976983.87
1991-11-05,388.71,-1.57,-0.4,396.64,-2.0,True,1,16017,-388.71,-1274129.32,6225968.07,4951838.75
1991-11-06,389.97,1.26,0.32,396.64,-1.68,True,1,16018,-389.97,-1274519.29,6246539.46,4972020.17
1991-11-07,393.72,3.75,0.96,396.64,-0.74,True,1,16019,-393.72,-1274913.01,6307000.68,5032087.67
1991-11-08,392.89,-0.83,-0.21,396.64,-0.94,True,1,16020,-392.89,-1275305.9,6294097.8,5018791.9
1991-11-11,393.12,0.23,0.06,396.64,-0.89,True,1,16021,-393.12,-1275699.02,6298175.52,5022476.5
1991-11-12,396.74,3.62,0.92,396.74,0.0,True,1,16022,-396.74,-1276095.76,6356568.28,5080472.52
1991-11-13,397.41,0.67,0.17,397.41,0.0,True,1,16023,-397.41,-1276493.17,6367700.43,5091207.26
1991-11-14,397.15,-0.26,-0.06,397.41,-0.06,True,1,16024,-397.15,-1276890.32,6363931.6,5087041.28
1991-11-15,382.62,-14.53,-3.66,397.41,-3.72,True,1,16025,-382.62,-1277272.94,6131485.5,4854212.56
1991-11-18,385.24,2.62,0.68,397.41,-3.06,True,1,16026,-385.24,-1277658.18,6173856.24,4896198.06
1991-11-19,379.42,-5.82,-1.51,397.41,-4.53,True,1,16027,-379.42,-1278037.6,6080964.34,4802926.74
1991-11-20,378.53,-0.89,-0.24,397.41,-4.75,True,1,16028,-378.53,-1278416.13,6067078.84,4788662.71
1991-11-21,380.06,1.53,0.4,397.41,-4.37,True,1,16029,-380.06,-1278796.19,6091981.74,4813185.55
1991-11-22,376.14,-3.92,-1.03,397.41,-5.35,True,1,16030,-376.14,-1279172.33,6029524.2,4750351.87
1991-11-25,375.34,-0.8,-0.21,397.41,-5.55,True,1,16031,-375.34,-1279547.67,6017075.54,4737527.87
1991-11-26,377.96,2.62,0.7,397.41,-4.89,True,1,16032,-377.96,-1279925.63,6059454.72,4779529.09
1991-11-27,376.55,-1.41,-0.37,397.41,-5.25,True,1,16033,-376.55,-1280302.18,6037226.15,4756923.97
1991-11-29,375.22,-1.33,-0.35,397.41,-5.58,True,1,16034,-375.22,-1280677.4,6016277.48,4735600.08
1991-12-02,381.4,6.18,1.65,397.41,-4.03,True,1,16035,-381.4,-1281058.8,6115749.0,4834690.2
1991-12-03,380.96,-0.44,-0.12,397.41,-4.14,True,1,16036,-380.96,-1281439.76,6109074.56,4827634.8
1991-12-04,380.07,-0.89,-0.23,397.41,-4.36,True,1,16037,-380.07,-1281819.83,6095182.59,4813362.76
1991-12-05,377.39,-2.68,-0.7,397.41,-5.04,True,1,16038,-377.39,-1282197.22,6052580.82,4770383.6
1991-12-06,379.1,1.71,0.45,397.41,-4.61,True,1,16039,-379.1,-1282576.32,6080384.9,4797808.58
1991-12-09,378.26,-0.84,-0.22,397.41,-4.82,True,1,16040,-378.26,-1282954.58,6067290.4,4784335.82
1991-12-10,377.9,-0.36,-0.1,397.41,-4.91,True,1,16041,-377.9,-1283332.48,6061893.9,4778561.42
1991-12-11,377.7,-0.2,-0.05,397.41,-4.96,True,1,16042,-377.7,-1283710.18,6059063.4,4775353.22
1991-12-12,381.55,3.85,1.02,397.41,-3.99,True,1,16043,-381.55,-1284091.73,6121206.65,4837114.92
1991-12-13,384.47,2.92,0.76,397.41,-3.26,True,1,16044,-384.47,-1284476.2,6168436.68,4883960.48
1991-12-16,384.46,-0.01,-0.0,397.41,-3.26,True,1,16045,-384.46,-1284860.66,6168660.7,4883800.04
1991-12-17,382.74,-1.72,-0.45,397.41,-3.69,True,1,16046,-382.74,-1285243.4,6141446.04,4856202.64
1991-12-18,383.48,0.74,0.19,397.41,-3.5,True,1,16047,-383.48,-1285626.88,6153703.56,4868076.68
1991-12-19,382.52,-0.96,-0.25,397.41,-3.75,True,1,16048,-382.52,-1286009.4,6138680.96,4852671.56
1991-12-20,387.04,4.52,1.18,397.41,-2.61,True,1,16049,-387.04,-1286396.44,6211604.96,4925208.52
1991-12-23,396.82,9.78,2.53,397.41,-0.15,True,1,16050,-396.82,-1286793.26,6368961.0,5082167.74
1991-12-24,399.33,2.51,0.63,399.33,0.0,True,1,16051,-399.33,-1287192.59,6409645.83,5122453.24
1991-12-26,404.84,5.51,1.38,404.84,0.0,True,1,16052,-404.84,-1287597.43,6498491.68,5210894.25
1991-12-27,406.46,1.62,0.4,406.46,0.0,True,1,16053,-406.46,-1288003.89,6524902.38,5236898.49
1991-12-30,415.14,8.68,2.14,415.14,0.0,True,1,16054,-415.14,-1288419.03,6664657.56,5376238.53
1991-12-31,417.09,1.95,0.47,417.09,0.0,True,1,16055,-417.09,-1288836.12,6696379.95,5407543.83
1992-01-02,417.26,0.17,0.04,417.26,0.0,True,1,16056,-417.26,-1289253.38,6699526.56,5410273.18
1992-01-03,419.34,2.08,0.5,419.34,0.0,True,1,16057,-419.34,-1289672.72,6733342.38,5443669.66
1992-01-06,417.96,-1.38,-0.33,419.34,-0.33,True,1,16058,-417.96,-1290090.68,6711601.68,5421511.0
1992-01-07,417.4,-0.56,-0.13,419.34,-0.46,True,1,16059,-417.4,-1290508.08,6703026.6,5412518.52
1992-01-08,418.1,0.7,0.17,419.34,-0.3,True,1,16060,-418.1,-1290926.18,6714686.0,5423759.82
1992-01-09,417.61,-0.49,-0.12,419.34,-0.41,True,1,16061,-417.61,-1291343.79,6707234.21,5415890.42
1992-01-10,415.1,-2.51,-0.6,419.34,-1.01,True,1,16062,-415.1,-1291758.89,6667336.2,5375577.31
1992-01-13,414.34,-0.76,-0.18,419.34,-1.19,True,1,16063,-414.34,-1292173.23,6655543.42,5363370.19
1992-01-14,420.44,6.1,1.47,420.44,0.0,True,1,16064,-420.44,-1292593.67,6753948.16,5461354.49
1992-01-15,420.77,0.33,0.08,420.77,0.0,True,1,16065,-420.77,-1293014.44,6759670.05,5466655.61
1992-01-16,418.21,-2.56,-0.61,420.77,-0.61,True,1,16066,-418.21,-1293432.65,6718961.86,5425529.21
1992-01-17,418.86,0.65,0.16,420.77,-0.45,True,1,16067,-418.86,-1293851.51,6729823.62,5435972.11
1992-01-20,416.36,-2.5,-0.6,420.77,-1.05,True,1,16068,-416.36,-1294267.87,6690072.48,5395804.61
1992-01-21,412.64,-3.72,-0.89,420.77,-1.93,True,1,16069,-412.64,-1294680.51,6630712.16,5336031.65
1992-01-22,418.13,5.49,1.33,420.77,-0.63,True,1,16070,-418.13,-1295098.64,6719349.1,5424250.46
1992-01-23,414.96,-3.17,-0.76,420.77,-1.38,True,1,16071,-414.96,-1295513.6,6668822.16,5373308.56
1992-01-24,415.48,0.52,0.12,420.77,-1.26,True,1,16072,-415.48,-1295929.08,6677594.56,5381665.48
1992-01-27,414.99,-0.49,-0.12,420.77,-1.37,True,1,16073,-414.99,-1296344.07,6670134.27,5373790.2
1992-01-28,414.96,-0.03,-0.01,420.77,-1.38,True,1,16074,-414.96,-1296759.03,6670067.04,5373308.01
1992-01-29,410.34,-4.62,-1.11,420.77,-2.48,True,1,16075,-410.34,-1297169.37,6596215.5,5299046.13
1992-01-30,411.62,1.28,0.31,420.77,-2.17,True,1,16076,-411.62,-1297580.99,6617203.12,5319622.13
1992-01-31,408.78,-2.84,-0.69,420.77,-2.85,True,1,16077,-408.78,-1297989.77,6571956.06,5273966.29
1992-02-03,409.53,0.75,0.18,420.77,-2.67,True,1,16078,-409.53,-1298399.3,6584423.34,5286024.04
1992-02-04,413.85,4.32,1.06,420.77,-1.64,True,1,16079,-413.85,-1298813.15,6654294.15,5355481.0
1992-02-05,413.84,-0.01,-0.0,420.77,-1.65,True,1,16080,-413.84,-1299226.99,6654547.2,5355320.21
1992-02-06,413.82,-0.02,-0.0,420.77,-1.65,True,1,16081,-413.82,-1299640.81,6654639.42,5354998.61
1992-02-07,411.09,-2.73,-0.66,420.77,-2.3,True,1,16082,-411.09,-1300051.9,6611149.38,5311097.48
1992-02-10,413.77,2.68,0.65,420.77,-1.66,True,1,16083,-413.77,-1300465.67,6654662.91,5354197.24
1992-02-11,413.76,-0.01,-0.0,420.77,-1.67,True,1,16084,-413.76,-1300879.43,6654915.84,5354036.41
1992-02-12,417.13,3.37,0.81,420.77,-0.86,True,1,16085,-417.13,-1301296.56,6709536.05,5408239.49
1992-02-13,413.69,-3.44,-0.82,420.77,-1.68,True,1,16086,-413.69,-1301710.25,6654617.34,5352907.09
1992-02-14,412.48,-1.21,-0.29,420.77,-1.97,True,1,16087,-412.48,-1302122.73,6635565.76,5333443.03
1992-02-18,407.38,-5.1,-1.24,420.77,-3.18,True,1,16088,-407.38,-1302530.11,6553929.44,5251399.33
1992-02-19,408.26,0.88,0.22,420.77,-2.97,True,1,16089,-408.26,-1302938.37,6568495.14,5265556.77
1992-02-20,413.9,5.64,1.38,420.77,-1.63,True,1,16090,-413.9,-1303352.27,6659651.0,5356298.73
1992-02-21,411.43,-2.47,-0.6,420.77,-2.22,True,1,16091,-411.43,-1303763.7,6620320.13,5316556.43
1992-02-24,412.27,0.84,0.2,420.77,-2.02,True,1,16092,-412.27,-1304175.97,6634248.84,5330072.87
1992-02-25,410.45,-1.82,-0.44,420.77,-2.45,True,1,16093,-410.45,-1304586.42,6605371.85,5300785.43
1992-02-26,415.35,4.9,1.19,420.77,-1.29,True,1,16094,-415.35,-1305001.77,6684642.9,5379641.13
1992-02-27,413.86,-1.49,-0.36,420.77,-1.64,True,1,16095,-413.86,-1305415.63,6661076.7,5355661.07
1992-02-28,412.7,-1.16,-0.28,420.77,-1.92,True,1,16096,-412.7,-1305828.33,6642819.2,5336990.87
1992-03-02,412.45,-0.25,-0.06,420.77,-1.98,True,1,16097,-412.45,-1306240.78,6639207.65,5332966.87
1992-03-03,412.85,0.4,0.1,420.77,-1.88,True,1,16098,-412.85,-1306653.63,6646059.3,5339405.67
1992-03-04,409.33,-3.52,-0.85,420.77,-2.72,True,1,16099,-409.33,-1307062.96,6589803.67,5282740.71
1992-03-05,406.51,-2.82,-0.69,420.77,-3.39,True,1,16100,-406.51,-1307469.47,6544811.0,5237341.53
1992-03-06,404.44,-2.07,-0.51,420.77,-3.88,True,1,16101,-404.44,-1307873.91,6511888.44,5204014.53
1992-03-09,405.21,0.77,0.19,420.77,-3.7,True,1,16102,-405.21,-1308279.12,6524691.42,5216412.3
1992-03-10,406.89,1.68,0.42,420.77,-3.3,True,1,16103,-406.89,-1308686.01,6552149.67,5243463.66
1992-03-11,404.03,-2.86,-0.7,420.77,-3.98,True,1,16104,-404.03,-1309090.04,6506499.12,5197409.08
1992-03-12,403.89,-0.14,-0.04,420.77,-4.01,True,1,16105,-403.89,-1309493.93,6504648.45,5195154.52
1992-03-13,405.84,1.95,0.48,420.77,-3.55,True,1,16106,-405.84,-1309899.77,6536459.04,5226559.27
1992-03-16,406.39,0.55,0.14,420.77,-3.42,True,1,16107,-406.39,-1310306.16,6545723.73,5235417.57
1992-03-17,409.58,3.19,0.78,420.77,-2.66,True,1,16108,-409.58,-1310715.74,6597514.64,5286798.9
1992-03-18,409.15,-0.43,-0.1,420.77,-2.76,True,1,16109,-409.15,-1311124.89,6590997.35,5279872.46
1992-03-19,409.8,0.65,0.16,420.77,-2.61,True,1,16110,-409.8,-1311534.69,6601878.0,5290343.31
1992-03-20,411.3,1.5,0.37,420.77,-2.25,True,1,16111,-411.3,-1311945.99,6626454.3,5314508.31
1992-03-23,409.91,-1.39,-0.34,420.77,-2.58,True,1,16112,-409.91,-1312355.9,6604469.92,5292114.02
1992-03-24,408.88,-1.03,-0.25,420.77,-2.83,True,1,16113,-408.88,-1312764.78,6588283.44,5275518.66
1992-03-25,407.52,-1.36,-0.33,420.77,-3.15,True,1,16114,-407.52,-1313172.3,6566777.28,5253604.98
1992-03-26,407.86,0.34,0.08,420.77,-3.07,True,1,16115,-407.86,-1313580.16,6572663.9,5259083.74
1992-03-27,403.5,-4.36,-1.07,420.77,-4.1,True,1,16116,-403.5,-1313983.66,6502806.0,5188822.34
1992-03-30,403.0,-0.5,-0.12,420.77,-4.22,True,1,16117,-403.0,-1314386.66,6495151.0,5180764.34
1992-03-31,403.69,0.69,0.17,420.77,-4.06,True,1,16118,-403.69,-1314790.35,6506675.42,5191885.07
1992-04-01,404.23,0.54,0.13,420.77,-3.93,True,1,16119,-404.23,-1315194.58,6515783.37,5200588.79
1992-04-02,400.5,-3.73,-0.92,420.77,-4.82,True,1,16120,-400.5,-1315595.08,6456060.0,5140464.92
1992-04-03,401.55,1.05,0.26,420.77,-4.57,True,1,16121,-401.55,-1315996.63,6473387.55,5157390.92
1992-04-06,405.59,4.04,1.01,420.77,-3.61,True,1,16122,-405.59,-1316402.22,6538921.98,5222519.76
1992-04-07,398.06,-7.53,-1.86,420.77,-5.4,True,1,16123,-398.06,-1316800.28,6417921.38,5101121.1
1992-04-08,394.5,-3.56,-0.89,420.77,-6.24,True,1,16124,-394.5,-1317194.78,6360918.0,5043723.22
1992-04-09,400.64,6.14,1.56,420.77,-4.78,True,1,16125,-400.64,-1317595.42,6460320.0,5142724.58
1992-04-10,404.29,3.65,0.91,420.77,-3.92,True,1,16126,-404.29,-1317999.71,6519580.54,5201580.83
1992-04-13,406.08,1.79,0.44,420.77,-3.49,True,1,16127,-406.08,-1318405.79,6548852.16,5230446.37
1992-04-14,412.39,6.31,1.55,420.77,-1.99,True,1,16128,-412.39,-1318818.18,6651025.92,5332207.74
1992-04-15,416.28,3.89,0.94,420.77,-1.07,True,1,16129,-416.28,-1319234.46,6714180.12,5394945.66
1992-04-16,416.04,-0.24,-0.06,420.77,-1.12,True,1,16130,-416.04,-1319650.5,6710725.2,5391074.7
1992-04-20,410.18,-5.86,-1.41,420.77,-2.52,True,1,16131,-410.18,-1320060.68,6616613.58,5296552.9
1992-04-21,410.26,0.08,0.02,420.77,-2.5,True,1,16132,-410.26,-1320470.94,6618314.32,5297843.38
1992-04-22,409.81,-0.45,-0.11,420.77,-2.6,True,1,16133,-409.81,-1320880.75,6611464.73,5290583.98
1992-04-23,411.6,1.79,0.44,420.77,-2.18,True,1,16134,-411.6,-1321292.35,6640754.4,5319462.05
1992-04-24,409.02,-2.58,-0.63,420.77,-2.79,True,1,16135,-409.02,-1321701.37,6599537.7,5277836.33
1992-04-27,408.45,-0.57,-0.14,420.77,-2.93,True,1,16136,-408.45,-1322109.82,6590749.2,5268639.38
1992-04-28,409.11,0.66,0.16,420.77,-2.77,True,1,16137,-409.11,-1322518.93,6601808.07,5279289.14
1992-04-29,412.02,2.91,0.71,420.77,-2.08,True,1,16138,-412.02,-1322930.95,6649178.76,5326247.81
1992-04-30,414.95,2.93,0.71,420.77,-1.38,True,1,16139,-414.95,-1323345.9,6696878.05,5373532.15
1992-05-01,412.53,-2.42,-0.58,420.77,-1.96,True,1,16140,-412.53,-1323758.43,6658234.2,5334475.77
1992-05-04,416.91,4.38,1.06,420.77,-0.92,True,1,16141,-416.91,-1324175.34,6729344.31,5405168.97
1992-05-05,416.84,-0.07,-0.02,420.77,-0.93,True,1,16142,-416.84,-1324592.18,6728631.28,5404039.1
1992-05-06,416.79,-0.05,-0.01,420.77,-0.95,True,1,16143,-416.79,-1325008.97,6728240.97,5403232.0
1992-05-07,415.85,-0.94,-0.23,420.77,-1.17,True,1,16144,-415.85,-1325424.82,6713482.4,5388057.58
1992-05-08,416.05,0.2,0.05,420.77,-1.12,True,1,16145,-416.05,-1325840.87,6717127.25,5391286.38
1992-05-11,418.49,2.44,0.59,420.77,-0.54,True,1,16146,-418.49,-1326259.36,6756939.54,5430680.18
1992-05-12,416.29,-2.2,-0.53,420.77,-1.06,True,1,16147,-416.29,-1326675.65,6721834.63,5395158.98
1992-05-13,416.45,0.16,0.04,420.77,-1.03,True,1,16148,-416.45,-1327092.1,6724834.6,5397742.5
1992-05-14,413.14,-3.31,-0.8,420.77,-1.81,True,1,16149,-413.14,-1327505.24,6671797.86,5344292.62
1992-05-15,410.09,-3.05,-0.74,420.77,-2.54,True,1,16150,-410.09,-1327915.33,6622953.5,5295038.17
1992-05-18,412.81,2.72,0.66,420.77,-1.89,True,1,16151,-412.81,-1328328.14,6667294.31,5338966.17
1992-05-19,416.37,3.56,0.86,420.77,-1.05,True,1,16152,-416.37,-1328744.51,6725208.24,5396463.73
1992-05-20,415.39,-0.98,-0.24,420.77,-1.28,True,1,16153,-415.39,-1329159.9,6709794.67,5380634.77
1992-05-21,412.6,-2.79,-0.67,420.77,-1.94,True,1,16154,-412.6,-1329572.5,6665140.4,5335567.9
1992-05-22,414.02,1.42,0.34,420.77,-1.6,True,1,16155,-414.02,-1329986.52,6688493.1,5358506.58
1992-05-26,411.41,-2.61,-0.63,420.77,-2.22,True,1,16156,-411.41,-1330397.93,6646739.96,5316342.03
1992-05-27,412.17,0.76,0.18,420.77,-2.04,True,1,16157,-412.17,-1330810.1,6659430.69,5328620.59
1992-05-28,416.74,4.57,1.11,420.77,-0.96,True,1,16158,-416.74,-1331226.84,6733684.92,5402458.08
1992-05-29,415.35,-1.39,-0.33,420.77,-1.29,True,1,16159,-415.35,-1331642.19,6711640.65,5379998.46
1992-06-01,417.3,1.95,0.47,420.77,-0.82,True,1,16160,-417.3,-1332059.49,6743568.0,5411508.51
1992-06-02,413.5,-3.8,-0.91,420.77,-1.73,True,1,16161,-413.5,-1332472.99,6682573.5,5350100.51
1992-06-03,414.59,1.09,0.26,420.77,-1.47,True,1,16162,-414.59,-1332887.58,6700603.58,5367716.0
1992-06-04,413.26,-1.33,-0.32,420.77,-1.78,True,1,16163,-413.26,-1333300.84,6679521.38,5346220.54
1992-06-05,413.48,0.22,0.05,420.77,-1.73,True,1,16164,-413.48,-1333714.32,6683490.72,5349776.4
1992-06-08,413.36,-0.12,-0.03,420.77,-1.76,True,1,16165,-413.36,-1334127.68,6681964.4,5347836.72
1992-06-09,410.06,-3.3,-0.8,420.77,-2.54,True,1,16166,-410.06,-1334537.74,6629029.96,5294492.22
1992-06-10,407.25,-2.81,-0.68,420.77,-3.21,True,1,16167,-407.25,-1334944.99,6584010.75,5249065.76
1992-06-11,409.05,1.8,0.44,420.77,-2.78,True,1,16168,-409.05,-1335354.04,6613520.4,5278166.36
1992-06-12,409.76,0.71,0.17,420.77,-2.62,True,1,16169,-409.76,-1335763.8,6625409.44,5289645.64
1992-06-15,410.29,0.53,0.13,420.77,-2.49,True,1,16170,-410.29,-1336174.09,6634389.3,5298215.21
1992-06-16,408.32,-1.97,-0.48,420.77,-2.96,True,1,16171,-408.32,-1336582.41,6602942.72,5266360.31
1992-06-17,402.26,-6.06,-1.48,420.77,-4.4,True,1,16172,-402.26,-1336984.67,6505348.72,5168364.05
1992-06-18,400.96,-1.3,-0.32,420.77,-4.71,True,1,16173,-400.96,-1337385.63,6484726.08,5147340.45
1992-06-19,403.67,2.71,0.68,420.77,-4.06,True,1,16174,-403.67,-1337789.3,6528958.58,5191169.28
1992-06-22,403.4,-0.27,-0.07,420.77,-4.13,True,1,16175,-403.4,-1338192.7,6524995.0,5186802.3
1992-06-23,404.04,0.64,0.16,420.77,-3.98,True,1,16176,-404.04,-1338596.74,6535751.04,5197154.3
1992-06-24,403.84,-0.2,-0.05,420.77,-4.02,True,1,16177,-403.84,-1339000.58,6532919.68,5193919.1
1992-06-25,403.12,-0.72,-0.18,420.77,-4.2,True,1,16178,-403.12,-1339403.7,6521675.36,5182271.66
1992-06-26,403.45,0.33,0.08,420.77,-4.12,True,1,16179,-403.45,-1339807.15,6527417.55,5187610.4
1992-06-29,408.94,5.49,1.36,420.77,-2.81,True,1,16180,-408.94,-1340216.09,6616649.2,5276433.11
1992-06-30,408.14,-0.8,-0.2,420.77,-3.0,True,1,16181,-408.14,-1340624.23,6604113.34,5263489.11
1992-07-01,412.88,4.74,1.16,420.77,-1.88,True,1,16182,-412.88,-1341037.11,6681224.16,5340187.05
1992-07-02,411.77,-1.11,-0.27,420.77,-2.14,True,1,16183,-411.77,-1341448.88,6663673.91,5322225.03
1992-07-06,413.84,2.07,0.5,420.77,-1.65,True,1,16184,-413.84,-1341862.72,6697586.56,5355723.84
1992-07-07,409.16,-4.68,-1.13,420.77,-2.76,True,1,16185,-409.16,-1342271.88,6622254.6,5279982.72
1992-07-08,410.28,1.12,0.27,420.77,-2.49,True,1,16186,-410.28,-1342682.16,6640792.08,5298109.92
1992-07-09,414.23,3.95,0.96,420.77,-1.55,True,1,16187,-414.23,-1343096.39,6705141.01,5362044.62
1992-07-10,414.62,0.39,0.09,420.77,-1.46,True,1,16188,-414.62,-1343511.01,6711868.56,5368357.55
1992-07-13,414.87,0.25,0.06,420.77,-1.4,True,1,16189,-414.87,-1343925.88,6716330.43,5372404.55
1992-07-14,417.68,2.81,0.68,420.77,-0.73,True,1,16190,-417.68,-1344343.56,6762239.2,5417895.64
1992-07-15,417.1,-0.58,-0.14,420.77,-0.87,True,1,16191,-417.1,-1344760.66,6753266.1,5408505.44
1992-07-16,417.54,0.44,0.1,420.77,-0.77,True,1,16192,-417.54,-1345178.2,6760807.68,5415629.48
1992-07-17,415.62,-1.92,-0.46,420.77,-1.22,True,1,16193,-415.62,-1345593.82,6730134.66,5384540.84
1992-07-20,413.75,-1.87,-0.45,420.77,-1.67,True,1,16194,-413.75,-1346007.57,6700267.5,5354259.93
1992-07-21,413.76,0.01,0.0,420.77,-1.67,True,1,16195,-413.76,-1346421.33,6700843.2,5354421.87
1992-07-22,410.93,-2.83,-0.68,420.77,-2.34,True,1,16196,-410.93,-1346832.26,6655422.28,5308590.02
1992-07-23,412.08,1.15,0.28,420.77,-2.06,True,1,16197,-412.08,-1347244.34,6674459.76,5327215.42
1992-07-24,411.6,-0.48,-0.12,420.77,-2.18,True,1,16198,-411.6,-1347655.94,6667096.8,5319440.86
1992-07-27,411.54,-0.06,-0.02,420.77,-2.19,True,1,16199,-411.54,-1348067.48,6666536.46,5318468.98
1992-07-28,417.52,5.98,1.45,420.77,-0.77,True,1,16200,-417.52,-1348485.0,6763824.0,5415339.0
1992-07-29,422.23,4.71,1.13,422.23,0.0,True,1,16201,-422.23,-1348907.23,6840548.23,5491641.0
1992-07-30,423.92,1.69,0.4,423.92,0.0,True,1,16202,-423.92,-1349331.15,6868351.84,5519020.69
1992-07-31,424.21,0.29,0.07,424.21,0.0,True,1,16203,-424.21,-1349755.36,6873474.63,5523719.27
1992-08-03,425.09,0.88,0.21,425.09,0.0,True,1,16204,-425.09,-1350180.45,6888158.36,5537977.91
1992-08-04,424.36,-0.73,-0.17,425.09,-0.17,True,1,16205,-424.36,-1350604.81,6876753.8,5526148.99
1992-08-05,422.19,-2.17,-0.51,425.09,-0.68,True,1,16206,-422.19,-1351027.0,6842011.14,5490984.14
1992-08-06,420.59,-1.6,-0.38,425.09,-1.06,True,1,16207,-420.59,-1351447.59,6816502.13,5465054.54
1992-08-07,418.88,-1.71,-0.41,425.09,-1.46,True,1,16208,-418.88,-1351866.47,6789207.04,5437340.57
1992-08-10,419.42,0.54,0.13,425.09,-1.33,True,1,16209,-419.42,-1352285.89,6798378.78,5446092.89
1992-08-11,418.9,-0.52,-0.12,425.09,-1.46,True,1,16210,-418.9,-1352704.79,6790369.0,5437664.21
1992-08-12,417.78,-1.12,-0.27,425.09,-1.72,True,1,16211,-417.78,-1353122.57,6772631.58,5419509.01
1992-08-13,417.73,-0.05,-0.01,425.09,-1.73,True,1,16212,-417.73,-1353540.3,6772238.76,5418698.46
1992-08-14,419.91,2.18,0.52,425.09,-1.22,True,1,16213,-419.91,-1353960.21,6808000.83,5454040.62
1992-08-17,420.74,0.83,0.2,425.09,-1.02,True,1,16214,-420.74,-1354380.95,6821878.36,5467497.41
1992-08-18,421.34,0.6,0.14,425.09,-0.88,True,1,16215,-421.34,-1354802.29,6832028.1,5477225.81
1992-08-19,418.19,-3.15,-0.75,425.09,-1.62,True,1,16216,-418.19,-1355220.48,6781369.04,5426148.56
1992-08-20,418.26,0.07,0.02,425.09,-1.61,True,1,16217,-418.26,-1355638.74,6782922.42,5427283.68
1992-08-21,414.85,-3.41,-0.82,425.09,-2.41,True,1,16218,-414.85,-1356053.59,6728037.3,5371983.71
1992-08-24,410.72,-4.13,-1.0,425.09,-3.38,True,1,16219,-410.72,-1356464.31,6661467.68,5305003.37
1992-08-25,411.61,0.89,0.22,425.09,-3.17,True,1,16220,-411.61,-1356875.92,6676314.2,5319438.28
1992-08-26,413.51,1.9,0.46,425.09,-2.72,True,1,16221,-413.51,-1357289.43,6707545.71,5350256.28
1992-08-27,413.53,0.02,0.0,425.09,-2.72,True,1,16222,-413.53,-1357702.96,6708283.66,5350580.7
1992-08-28,414.84,1.31,0.32,425.09,-2.41,True,1,16223,-414.84,-1358117.8,6729949.32,5371831.52
1992-08-31,414.03,-0.81,-0.2,425.09,-2.6,True,1,16224,-414.03,-1358531.83,6717222.72,5358690.89
1992-09-01,416.07,2.04,0.49,425.09,-2.12,True,1,16225,-416.07,-1358947.9,6750735.75,5391787.85
1992-09-02,417.98,1.91,0.46,425.09,-1.67,True,1,16226,-417.98,-1359365.88,6782143.48,5422777.6
1992-09-03,417.98,0.0,0.0,425.09,-1.67,True,1,16227,-417.98,-1359783.86,6782561.46,5422777.6
1992-09-04,417.08,-0.9,-0.22,425.09,-1.88,True,1,16228,-417.08,-1360200.94,6768374.24,5408173.3
1992-09-08,414.44,-2.64,-0.63,425.09,-2.5,True,1,16229,-414.44,-1360615.38,6725946.76,5365331.38
1992-09-09,416.36,1.92,0.46,425.09,-2.05,True,1,16230,-416.36,-1361031.74,6757522.8,5396491.06
1992-09-10,419.95,3.59,0.86,425.09,-1.21,True,1,16231,-419.95,-1361451.69,6816208.45,5454756.76
1992-09-11,419.58,-0.37,-0.09,425.09,-1.3,True,1,16232,-419.58,-1361871.27,6810622.56,5448751.29
1992-09-14,425.27,5.69,1.36,425.27,0.0,True,1,16233,-425.27,-1362296.54,6903407.91,5541111.37
1992-09-15,419.77,-5.5,-1.29,425.27,-1.29,True,1,16234,-419.77,-1362716.31,6814546.18,5451829.87
1992-09-16,419.92,0.15,0.04,425.27,-1.26,True,1,16235,-419.92,-1363136.23,6817401.2,5454264.97
1992-09-17,419.93,0.01,0.0,425.27,-1.26,True,1,16236,-419.93,-1363556.16,6817983.48,5454427.32
1992-09-18,422.93,3.0,0.71,425.27,-0.55,True,1,16237,-422.93,-1363979.09,6867114.41,5503135.32
1992-09-21,422.14,-0.79,-0.19,425.27,-0.74,True,1,16238,-422.14,-1364401.23,6854709.32,5490308.09
1992-09-22,417.14,-5.0,-1.18,425.27,-1.91,True,1,16239,-417.14,-1364818.37,6773936.46,5409118.09
1992-09-23,417.44,0.3,0.07,425.27,-1.84,True,1,16240,-417.44,-1365235.81,6779225.6,5413989.79
1992-09-24,418.47,1.03,0.25,425.27,-1.6,True,1,16241,-418.47,-1365654.28,6796371.27,5430716.99
1992-09-25,414.35,-4.12,-0.98,425.27,-2.57,True,1,16242,-414.35,-1366068.63,6729872.7,5363804.07
1992-09-28,416.62,2.27,0.55,425.27,-2.03,True,1,16243,-416.62,-1366485.25,6767158.66,5400673.41
1992-09-29,416.8,0.18,0.04,425.27,-1.99,True,1,16244,-416.8,-1366902.05,6770499.2,5403597.15
1992-09-30,417.8,1.0,0.24,425.27,-1.76,True,1,16245,-417.8,-1367319.85,6787161.0,5419841.15
1992-10-01,416.29,-1.51,-0.36,425.27,-2.11,True,1,16246,-416.29,-1367736.14,6763047.34,5395311.2
1992-10-02,410.47,-5.82,-1.4,425.27,-3.48,True,1,16247,-410.47,-1368146.61,6668906.09,5300759.48
1992-10-05,407.57,-2.9,-0.71,425.27,-4.16,True,1,16248,-407.57,-1368554.18,6622197.36,5253643.18
1992-10-06,407.18,-0.39,-0.1,425.27,-4.25,True,1,16249,-407.18,-1368961.36,6616267.82,5247306.46
1992-10-07,404.25,-2.93,-0.72,425.27,-4.94,True,1,16250,-404.25,-1369365.61,6569062.5,5199696.89
1992-10-08,407.75,3.5,0.87,425.27,-4.12,True,1,16251,-407.75,-1369773.36,6626345.25,5256571.89
1992-10-09,402.66,-5.09,-1.25,425.27,-5.32,True,1,16252,-402.66,-1370176.02,6544030.32,5173854.3
1992-10-12,407.44,4.78,1.19,425.27,-4.19,True,1,16253,-407.44,-1370583.46,6622122.32,5251538.86
1992-10-13,409.3,1.86,0.46,425.27,-3.76,True,1,16254,-409.3,-1370992.76,6652762.2,5281769.44
1992-10-14,409.37,0.07,0.02,425.27,-3.74,True,1,16255,-409.37,-1371402.13,6654309.35,5282907.22
1992-10-15,409.6,0.23,0.06,425.27,-3.68,True,1,16256,-409.6,-1371811.73,6658457.6,5286645.87
1992-10-16,411.73,2.13,0.52,425.27,-3.18,True,1,16257,-411.73,-1372223.46,6693494.61,5321271.15
1992-10-19,414.98,3.25,0.79,425.27,-2.42,True,1,16258,-414.98,-1372638.44,6746744.84,5374106.4
1992-10-20,415.48,0.5,0.12,425.27,-2.3,True,1,16259,-415.48,-1373053.92,6755289.32,5382235.4
1992-10-21,415.67,0.19,0.05,425.27,-2.26,True,1,16260,-415.67,-1373469.59,6758794.2,5385324.61
1992-10-22,414.9,-0.77,-0.18,425.27,-2.44,True,1,16261,-414.9,-1373884.49,6746688.9,5372804.41
1992-10-23,414.1,-0.8,-0.19,425.27,-2.63,True,1,16262,-414.1,-1374298.59,6734094.2,5359795.61
1992-10-26,418.16,4.06,0.98,425.27,-1.67,True,1,16263,-418.16,-1374716.75,6800536.08,5425819.33
1992-10-27,418.49,0.33,0.08,425.27,-1.59,True,1,16264,-418.49,-1375135.24,6806321.36,5431186.12
1992-10-28,420.13,1.64,0.39,425.27,-1.21,True,1,16265,-420.13,-1375555.37,6833414.45,5457859.08
1992-10-29,420.86,0.73,0.17,425.27,-1.04,True,1,16266,-420.86,-1375976.23,6845708.76,5469732.53
1992-10-30,418.68,-2.18,-0.52,425.27,-1.55,True,1,16267,-418.68,-1376394.91,6810667.56,5434272.65
1992-11-02,422.75,4.07,0.97,425.27,-0.59,True,1,16268,-422.75,-1376817.66,6877297.0,5500479.34
1992-11-03,419.92,-2.83,-0.67,425.27,-1.26,True,1,16269,-419.92,-1377237.58,6831678.48,5454440.9
1992-11-04,417.11,-2.81,-0.67,425.27,-1.92,True,1,16270,-417.11,-1377654.69,6786379.7,5408725.01
1992-11-05,418.34,1.23,0.3,425.27,-1.63,True,1,16271,-418.34,-1378073.03,6806810.14,5428737.11
1992-11-06,417.58,-0.76,-0.18,425.27,-1.81,True,1,16272,-417.58,-1378490.61,6794861.76,5416371.15
1992-11-09,418.59,1.01,0.24,425.27,-1.57,True,1,16273,-418.59,-1378909.2,6811715.07,5432805.87
1992-11-10,418.62,0.03,0.01,425.27,-1.56,True,1,16274,-418.62,-1379327.82,6812621.88,5433294.06
1992-11-11,422.2,3.58,0.86,425.27,-0.72,True,1,16275,-422.2,-1379750.02,6871305.0,5491554.98
1992-11-12,422.87,0.67,0.16,425.27,-0.56,True,1,16276,-422.87,-1380172.89,6882632.12,5502459.23
1992-11-13,422.43,-0.44,-0.1,425.27,-0.67,True,1,16277,-422.43,-1380595.32,6875893.11,5495297.79
1992-11-16,420.68,-1.75,-0.41,425.27,-1.08,True,1,16278,-420.68,-1381016.0,6847829.04,5466813.04
1992-11-17,419.27,-1.41,-0.34,425.27,-1.41,True,1,16279,-419.27,-1381435.27,6825296.33,5443861.06
1992-11-18,422.85,3.58,0.85,425.27,-0.57,True,1,16280,-422.85,-1381858.12,6883998.0,5502139.88
1992-11-19,423.61,0.76,0.18,425.27,-0.39,True,1,16281,-423.61,-1382281.73,6896794.41,5514512.68
1992-11-20,426.65,3.04,0.72,426.65,0.0,True,1,16282,-426.65,-1382708.38,6946715.3,5564006.92
1992-11-23,425.12,-1.53,-0.36,426.65,-0.36,True,1,16283,-425.12,-1383133.5,6922228.96,5539095.46
1992-11-24,427.59,2.47,0.58,427.59,0.0,True,1,16284,-427.59,-1383561.09,6962875.56,5579314.47
1992-11-25,429.19,1.6,0.37,429.19,0.0,True,1,16285,-429.19,-1383990.28,6989359.15,5605368.87
1992-11-27,430.16,0.97,0.23,430.16,0.0,True,1,16286,-430.16,-1384420.44,7005585.76,5621165.32
1992-11-30,431.35,1.19,0.28,431.35,0.0,True,1,16287,-431.35,-1384851.79,7025397.45,5640545.66
1992-12-01,430.78,-0.57,-0.13,431.35,-0.13,True,1,16288,-430.78,-1385282.57,7016544.64,5631262.07
1992-12-02,429.89,-0.89,-0.21,431.35,-0.34,True,1,16289,-429.89,-1385712.46,7002478.21,5616765.75
1992-12-03,429.91,0.02,0.0,431.35,-0.33,True,1,16290,-429.91,-1386142.37,7003233.9,5617091.53
1992-12-04,432.06,2.15,0.5,432.06,0.0,True,1,16291,-432.06,-1386574.43,7038689.46,5652115.03
1992-12-07,435.31,3.25,0.75,435.31,0.0,True,1,16292,-435.31,-1387009.74,7092070.52,5705060.78
1992-12-08,436.99,1.68,0.39,436.99,0.0,True,1,16293,-436.99,-1387446.73,7119878.07,5732431.34
1992-12-09,435.65,-1.34,-0.31,436.99,-0.31,True,1,16294,-435.65,-1387882.38,7098481.1,5710598.72
1992-12-10,434.64,-1.01,-0.23,436.99,-0.54,True,1,16295,-434.64,-1388317.02,7082458.8,5694141.78
1992-12-11,433.73,-0.91,-0.21,436.99,-0.75,True,1,16296,-433.73,-1388750.75,7068064.08,5679313.33
1992-12-14,432.84,-0.89,-0.2,436.99,-0.95,True,1,16297,-432.84,-1389183.59,7053993.48,5664809.89
1992-12-15,432.57,-0.27,-0.06,436.99,-1.01,True,1,16298,-432.57,-1389616.16,7050025.86,5660409.7
1992-12-16,431.52,-1.05,-0.24,436.99,-1.25,True,1,16299,-431.52,-1390047.68,7033344.48,5643296.8
1992-12-17,435.43,3.91,0.91,436.99,-0.36,True,1,16300,-435.43,-1390483.11,7097509.0,5707025.89
1992-12-18,441.28,5.85,1.34,441.28,0.0,True,1,16301,-441.28,-1390924.39,7193305.28,5802380.89
1992-12-21,440.7,-0.58,-0.13,441.28,-0.13,True,1,16302,-440.7,-1391365.09,7184291.4,5792926.31
1992-12-22,440.31,-0.39,-0.09,441.28,-0.22,True,1,16303,-440.31,-1391805.4,7178373.93,5786568.53
1992-12-23,439.03,-1.28,-0.29,441.28,-0.51,True,1,16304,-439.03,-1392244.43,7157945.12,5765700.69
1992-12-24,439.77,0.74,0.17,441.28,-0.34,True,1,16305,-439.77,-1392684.2,7170449.85,5777765.65
1992-12-28,439.15,-0.62,-0.14,441.28,-0.48,True,1,16306,-439.15,-1393123.35,7160779.9,5767656.55
1992-12-29,437.98,-1.17,-0.27,441.28,-0.75,True,1,16307,-437.98,-1393561.33,7142139.86,5748578.53
1992-12-30,438.82,0.84,0.19,441.28,-0.56,True,1,16308,-438.82,-1394000.15,7156276.56,5762276.41
1992-12-31,435.71,-3.11,-0.71,441.28,-1.26,True,1,16309,-435.71,-1394435.86,7105994.39,5711558.53
1993-01-04,435.38,-0.33,-0.08,441.28,-1.34,True,1,16310,-435.38,-1394871.24,7101047.8,5706176.56
1993-01-05,434.34,-1.04,-0.24,441.28,-1.57,True,1,16311,-434.34,-1395305.58,7084519.74,5689214.16
1993-01-06,434.52,0.18,0.04,441.28,-1.53,True,1,16312,-434.52,-1395740.1,7087890.24,5692150.14
1993-01-07,430.73,-3.79,-0.87,441.28,-2.39,True,1,16313,-430.73,-1396170.83,7026498.49,5630327.66
1993-01-08,429.05,-1.68,-0.39,441.28,-2.77,True,1,16314,-429.05,-1396599.88,6999521.7,5602921.82
1993-01-11,430.95,1.9,0.44,441.28,-2.34,True,1,16315,-430.95,-1397030.83,7030949.25,5633918.42
1993-01-12,431.04,0.09,0.02,441.28,-2.32,True,1,16316,-431.04,-1397461.87,7032848.64,5635386.77
1993-01-13,433.03,1.99,0.46,441.28,-1.87,True,1,16317,-433.03,-1397894.9,7065750.51,5667855.61
1993-01-14,435.94,2.91,0.67,441.28,-1.21,True,1,16318,-435.94,-1398330.84,7113668.92,5715338.08
1993-01-15,437.15,1.21,0.28,441.28,-0.94,True,1,16319,-437.15,-1398767.99,7133850.85,5735082.86
1993-01-18,436.84,-0.31,-0.07,441.28,-1.01,True,1,16320,-436.84,-1399204.83,7129228.8,5730023.97
1993-01-19,435.13,-1.71,-0.39,441.28,-1.39,True,1,16321,-435.13,-1399639.96,7101756.73,5702116.77
1993-01-20,433.37,-1.76,-0.4,441.28,-1.79,True,1,16322,-433.37,-1400073.33,7073465.14,5673391.81
1993-01-21,435.49,2.12,0.49,441.28,-1.31,True,1,16323,-435.49,-1400508.82,7108503.27,5707994.45
1993-01-22,436.11,0.62,0.14,441.28,-1.17,True,1,16324,-436.11,-1400944.93,7119059.64,5718114.71
1993-01-25,440.01,3.9,0.89,441.28,-0.29,True,1,16325,-440.01,-1401384.94,7183163.25,5781778.31
1993-01-26,439.95,-0.06,-0.01,441.28,-0.3,True,1,16326,-439.95,-1401824.89,7182623.7,5780798.81
1993-01-27,438.11,-1.84,-0.42,441.28,-0.72,True,1,16327,-438.11,-1402263.0,7153021.97,5750758.97
1993-01-28,438.66,0.55,0.13,441.28,-0.59,True,1,16328,-438.66,-1402701.66,7162440.48,5759738.82
1993-01-29,438.78,0.12,0.03,441.28,-0.57,True,1,16329,-438.78,-1403140.44,7164838.62,5761698.18
1993-02-01,442.52,3.74,0.85,442.52,0.0,True,1,16330,-442.52,-1403582.96,7226351.6,5822768.64
1993-02-02,442.55,0.03,0.01,442.55,0.0,True,1,16331,-442.55,-1404025.51,7227284.05,5823258.54
1993-02-03,447.2,4.65,1.05,447.2,0.0,True,1,16332,-447.2,-1404472.71,7303670.4,5899197.69
1993-02-04,449.56,2.36,0.53,449.56,0.0,True,1,16333,-449.56,-1404922.27,7342663.48,5937741.21
1993-02-05,448.93,-0.63,-0.14,449.56,-0.14,True,1,16334,-448.93,-1405371.2,7332822.62,5927451.42
1993-02-08,447.85,-1.08,-0.24,449.56,-0.38,True,1,16335,-447.85,-1405819.05,7315629.75,5909810.7
1993-02-09,445.33,-2.52,-0.56,449.56,-0.94,True,1,16336,-445.33,-1406264.38,7274910.88,5868646.5
1993-02-10,446.23,0.9,0.2,449.56,-0.74,True,1,16337,-446.23,-1406710.61,7290059.51,5883348.9
1993-02-11,447.66,1.43,0.32,449.56,-0.42,True,1,16338,-447.66,-1407158.27,7313869.08,5906710.81
1993-02-12,444.58,-3.08,-0.69,449.56,-1.11,True,1,16339,-444.58,-1407602.85,7263992.62,5856389.77
1993-02-16,433.91,-10.67,-2.4,449.56,-3.48,True,1,16340,-433.91,-1408036.76,7090089.4,5682052.64
1993-02-17,433.3,-0.61,-0.14,449.56,-3.62,True,1,16341,-433.3,-1408470.06,7080555.3,5672085.24
1993-02-18,431.9,-1.4,-0.32,449.56,-3.93,True,1,16342,-431.9,-1408901.96,7058109.8,5649207.84
1993-02-19,434.22,2.32,0.54,449.56,-3.41,True,1,16343,-434.22,-1409336.18,7096457.46,5687121.28
1993-02-22,435.24,1.02,0.24,449.56,-3.18,True,1,16344,-435.24,-1409771.42,7113562.56,5703791.14
1993-02-23,434.8,-0.44,-0.1,449.56,-3.28,True,1,16345,-434.8,-1410206.22,7106806.0,5696599.78
1993-02-24,440.87,6.07,1.4,449.56,-1.93,True,1,16346,-440.87,-1410647.09,7206461.02,5795813.93
1993-02-25,442.34,1.47,0.33,449.56,-1.61,True,1,16347,-442.34,-1411089.43,7230931.98,5819842.55
1993-02-26,443.38,1.04,0.24,449.56,-1.38,True,1,16348,-443.38,-1411532.81,7248376.24,5836843.43
1993-03-01,442.01,-1.37,-0.31,449.56,-1.68,True,1,16349,-442.01,-1411974.82,7226421.49,5814446.67
1993-03-02,447.9,5.89,1.33,449.56,-0.37,True,1,16350,-447.9,-1412422.72,7323165.0,5910742.28
1993-03-03,449.26,1.36,0.3,449.56,-0.07,True,1,16351,-449.26,-1412871.98,7345850.26,5932978.28
1993-03-04,447.34,-1.92,-0.43,449.56,-0.49,True,1,16352,-447.34,-1413319.32,7314903.68,5901584.36
1993-03-05,446.11,-1.23,-0.28,449.56,-0.77,True,1,16353,-446.11,-1413765.43,7295236.83,5881471.4
1993-03-08,454.71,8.6,1.93,454.71,0.0,True,1,16354,-454.71,-1414220.14,7436327.34,6022107.2
1993-03-09,454.4,-0.31,-0.07,454.71,-0.07,True,1,16355,-454.4,-1414674.54,7431712.0,6017037.46
1993-03-10,456.33,1.93,0.42,456.33,0.0,True,1,16356,-456.33,-1415130.87,7463733.48,6048602.61
1993-03-11,453.72,-2.61,-0.57,456.33,-0.57,True,1,16357,-453.72,-1415584.59,7421498.04,6005913.45
1993-03-12,449.83,-3.89,-0.86,456.33,-1.42,True,1,16358,-449.83,-1416034.42,7358319.14,5942284.72
1993-03-15,451.43,1.6,0.36,456.33,-1.07,True,1,16359,-451.43,-1416485.85,7384943.37,5968457.52
1993-03-16,451.37,-0.06,-0.01,456.33,-1.09,True,1,16360,-451.37,-1416937.22,7384413.2,5967475.98
1993-03-17,448.31,-3.06,-0.68,456.33,-1.76,True,1,16361,-448.31,-1417385.53,7334799.91,5917414.38
1993-03-18,451.89,3.58,0.8,456.33,-0.97,True,1,16362,-451.89,-1417837.42,7393824.18,5975986.76
1993-03-19,450.18,-1.71,-0.38,456.33,-1.35,True,1,16363,-450.18,-1418287.6,7366295.34,5948007.74
1993-03-22,448.88,-1.3,-0.29,456.33,-1.63,True,1,16364,-448.88,-1418736.48,7345472.32,5926735.84
1993-03-23,448.76,-0.12,-0.03,456.33,-1.66,True,1,16365,-448.76,-1419185.24,7343957.4,5924772.16
1993-03-24,448.07,-0.69,-0.15,456.33,-1.81,True,1,16366,-448.07,-1419633.31,7333113.62,5913480.31
1993-03-25,450.88,2.81,0.63,456.33,-1.19,True,1,16367,-450.88,-1420084.19,7379552.96,5959468.77
1993-03-26,447.78,-3.1,-0.69,456.33,-1.87,True,1,16368,-447.78,-1420531.97,7329263.04,5908731.07
1993-03-29,450.77,2.99,0.67,456.33,-1.22,True,1,16369,-450.77,-1420982.74,7378654.13,5957671.39
1993-03-30,451.97,1.2,0.27,456.33,-0.96,True,1,16370,-451.97,-1421434.71,7398748.9,5977314.19
1993-03-31,451.67,-0.3,-0.07,456.33,-1.02,True,1,16371,-451.67,-1421886.38,7394289.57,5972403.19
1993-04-01,450.3,-1.37,-0.3,456.33,-1.32,True,1,16372,-450.3,-1422336.68,7372311.6,5949974.92
1993-04-02,441.39,-8.91,-1.98,456.33,-3.27,True,1,16373,-441.39,-1422778.07,7226878.47,5804100.4
1993-04-05,442.29,0.9,0.2,456.33,-3.08,True,1,16374,-442.29,-1423220.36,7242056.46,5818836.1
1993-04-06,441.16,-1.13,-0.26,456.33,-3.32,True,1,16375,-441.16,-1423661.52,7223995.0,5800333.48
1993-04-07,442.73,1.57,0.36,456.33,-2.98,True,1,16376,-442.73,-1424104.25,7250146.48,5826042.23
1993-04-08,441.84,-0.89,-0.2,456.33,-3.18,True,1,16377,-441.84,-1424546.09,7236013.68,5811467.59
1993-04-12,448.37,6.53,1.48,456.33,-1.74,True,1,16378,-448.37,-1424994.46,7343403.86,5918409.4
1993-04-13,449.22,0.85,0.19,456.33,-1.56,True,1,16379,-449.22,-1425443.68,7357774.38,5932330.7
1993-04-14,448.66,-0.56,-0.12,456.33,-1.68,True,1,16380,-448.66,-1425892.34,7349050.8,5923158.46
1993-04-15,448.4,-0.26,-0.06,456.33,-1.74,True,1,16381,-448.4,-1426340.74,7345240.4,5918899.66
1993-04-16,448.94,0.54,0.12,456.33,-1.62,True,1,16382,-448.94,-1426789.68,7354535.08,5927745.4
1993-04-19,447.46,-1.48,-0.33,456.33,-1.94,True,1,16383,-447.46,-1427237.14,7330737.18,5903500.04
1993-04-20,445.1,-2.36,-0.53,456.33,-2.46,True,1,16384,-445.1,-1427682.24,7292518.4,5864836.16
1993-04-21,443.63,-1.47,-0.33,456.33,-2.78,True,1,16385,-443.63,-1428125.87,7268877.55,5840751.68
1993-04-22,439.46,-4.17,-0.94,456.33,-3.7,True,1,16386,-439.46,-1428565.33,7200991.56,5772426.23
1993-04-23,437.03,-2.43,-0.55,456.33,-4.23,True,1,16387,-437.03,-1429002.36,7161610.61,5732608.25
1993-04-26,433.54,-3.49,-0.8,456.33,-4.99,True,1,16388,-433.54,-1429435.9,7104853.52,5675417.62
1993-04-27,438.01,4.47,1.03,456.33,-4.01,True,1,16389,-438.01,-1429873.91,7178545.89,5748671.98
1993-04-28,438.02,0.01,0.0,456.33,-4.01,True,1,16390,-438.02,-1430311.93,7179147.8,5748835.87
1993-04-29,438.89,0.87,0.2,456.33,-3.82,True,1,16391,-438.89,-1430750.82,7193845.99,5763095.17
1993-04-30,440.19,1.3,0.3,456.33,-3.54,True,1,16392,-440.19,-1431191.01,7215594.48,5784403.47
1993-05-03,442.46,2.27,0.52,456.33,-3.04,True,1,16393,-442.46,-1431633.47,7253246.78,5821613.31
1993-05-04,444.05,1.59,0.36,456.33,-2.69,True,1,16394,-444.05,-1432077.52,7279755.7,5847678.18
1993-05-05,444.52,0.47,0.11,456.33,-2.59,True,1,16395,-444.52,-1432522.04,7287905.4,5855383.36
1993-05-06,443.26,-1.26,-0.28,456.33,-2.86,True,1,16396,-443.26,-1432965.3,7267690.96,5834725.66
1993-05-07,442.31,-0.95,-0.21,456.33,-3.07,True,1,16397,-442.31,-1433407.61,7252557.07,5819149.46
1993-05-10,442.8,0.49,0.11,456.33,-2.96,True,1,16398,-442.8,-1433850.41,7261034.4,5827183.99
1993-05-11,444.36,1.56,0.35,456.33,-2.62,True,1,16399,-444.36,-1434294.77,7287059.64,5852764.87
1993-05-12,444.8,0.44,0.1,456.33,-2.53,True,1,16400,-444.8,-1434739.57,7294720.0,5859980.43
1993-05-13,439.23,-5.57,-1.25,456.33,-3.75,True,1,16401,-439.23,-1435178.8,7203811.23,5768632.43
1993-05-14,439.56,0.33,0.08,456.33,-3.68,True,1,16402,-439.56,-1435618.36,7209663.12,5774044.76
1993-05-17,440.37,0.81,0.18,456.33,-3.5,True,1,16403,-440.37,-1436058.73,7223389.11,5787330.38
1993-05-18,440.32,-0.05,-0.01,456.33,-3.51,True,1,16404,-440.32,-1436499.05,7223009.28,5786510.23
1993-05-19,447.57,7.25,1.65,456.33,-1.92,True,1,16405,-447.57,-1436946.62,7342385.85,5905439.23
1993-05-20,450.59,3.02,0.68,456.33,-1.26,True,1,16406,-450.59,-1437397.21,7392379.54,5954982.33
1993-05-21,445.84,-4.75,-1.05,456.33,-2.3,True,1,16407,-445.84,-1437843.05,7314896.88,5877053.83
1993-05-24,448.0,2.16,0.48,456.33,-1.82,True,1,16408,-448.0,-1438291.05,7350784.0,5912492.95
1993-05-25,448.85,0.85,0.19,456.33,-1.64,True,1,16409,-448.85,-1438739.9,7365179.65,5926439.75
1993-05-26,453.44,4.59,1.02,456.33,-0.63,True,1,16410,-453.44,-1439193.34,7440950.4,6001757.06
1993-05-27,452.41,-1.03,-0.23,456.33,-0.86,True,1,16411,-452.41,-1439645.75,7424500.51,5984854.76
1993-05-28,450.19,-2.22,-0.49,456.33,-1.35,True,1,16412,-450.19,-1440095.94,7388518.28,5948422.34
1993-06-01,453.83,3.64,0.81,456.33,-0.55,True,1,16413,-453.83,-1440549.77,7448711.79,6008162.02
1993-06-02,453.85,0.02,0.0,456.33,-0.54,True,1,16414,-453.85,-1441003.62,7449493.9,6008490.28
1993-06-03,452.49,-1.36,-0.3,456.33,-0.84,True,1,16415,-452.49,-1441456.11,7427623.35,5986167.24
1993-06-04,450.06,-2.43,-0.54,456.33,-1.37,True,1,16416,-450.06,-1441906.17,7388184.96,5946278.79
1993-06-07,447.69,-2.37,-0.53,456.33,-1.89,True,1,16417,-447.69,-1442353.86,7349726.73,5907372.87
1993-06-08,444.71,-2.98,-0.67,456.33,-2.55,True,1,16418,-444.71,-1442798.57,7301248.78,5858450.21
1993-06-09,445.78,1.07,0.24,456.33,-2.31,True,1,16419,-445.78,-1443244.35,7319261.82,5876017.47
1993-06-10,445.38,-0.4,-0.09,456.33,-2.4,True,1,16420,-445.38,-1443689.73,7313139.6,5869449.87
1993-06-11,447.26,1.88,0.42,456.33,-1.99,True,1,16421,-447.26,-1444136.99,7344456.46,5900319.47
1993-06-14,447.71,0.45,0.1,456.33,-1.89,True,1,16422,-447.71,-1444584.7,7352293.62,5907708.92
1993-06-15,446.27,-1.44,-0.32,456.33,-2.2,True,1,16423,-446.27,-1445030.97,7329092.21,5884061.24
1993-06-16,447.43,1.16,0.26,456.33,-1.95,True,1,16424,-447.43,-1445478.4,7348590.32,5903111.92
1993-06-17,448.54,1.11,0.25,456.33,-1.71,True,1,16425,-448.54,-1445926.94,7367269.5,5921342.56
1993-06-18,443.68,-4.86,-1.08,456.33,-2.77,True,1,16426,-443.68,-1446370.62,7287887.68,5841517.06
1993-06-21,446.22,2.54,0.57,456.33,-2.22,True,1,16427,-446.22,-1446816.84,7330055.94,5883239.1
1993-06-22,445.93,-0.29,-0.06,456.33,-2.28,True,1,16428,-445.93,-1447262.77,7325738.04,5878475.27
1993-06-23,443.19,-2.74,-0.61,456.33,-2.88,True,1,16429,-443.19,-1447705.96,7281168.51,5833462.55
1993-06-24,446.62,3.43,0.77,456.33,-2.13,True,1,16430,-446.62,-1448152.58,7337966.6,5889814.02
1993-06-25,447.6,0.98,0.22,456.33,-1.91,True,1,16431,-447.6,-1448600.18,7354515.6,5905915.42
1993-06-28,451.85,4.25,0.95,456.33,-0.98,True,1,16432,-451.85,-1449052.03,7424799.2,5975747.17
1993-06-29,450.69,-1.16,-0.26,456.33,-1.24,True,1,16433,-450.69,-1449502.72,7406188.77,5956686.05
1993-06-30,450.53,-0.16,-0.04,456.33,-1.27,True,1,16434,-450.53,-1449953.25,7404010.02,5954056.77
1993-07-01,449.02,-1.51,-0.34,456.33,-1.6,True,1,16435,-449.02,-1450402.27,7379643.7,5929241.43
1993-07-02,445.84,-3.18,-0.71,456.33,-2.3,True,1,16436,-445.84,-1450848.11,7327826.24,5876978.13
1993-07-06,441.43,-4.41,-0.99,456.33,-3.26,True,1,16437,-441.43,-1451289.54,7255784.91,5804495.37
1993-07-07,442.83,1.4,0.32,456.33,-2.96,True,1,16438,-442.83,-1451732.37,7279239.54,5827507.17
1993-07-08,448.64,5.81,1.31,456.33,-1.68,True,1,16439,-448.64,-1452181.01,7375192.96,5923011.95
1993-07-09,448.11,-0.53,-0.12,456.33,-1.8,True,1,16440,-448.11,-1452629.12,7366928.4,5914299.28
1993-07-12,448.98,0.87,0.19,456.33,-1.61,True,1,16441,-448.98,-1453078.1,7381680.18,5928602.08
1993-07-13,448.09,-0.89,-0.2,456.33,-1.81,True,1,16442,-448.09,-1453526.19,7367495.78,5913969.59
1993-07-14,450.08,1.99,0.44,456.33,-1.37,True,1,16443,-450.08,-1453976.27,7400665.44,5946689.17
1993-07-15,449.22,-0.86,-0.19,456.33,-1.56,True,1,16444,-449.22,-1454425.49,7386973.68,5932548.19
1993-07-16,445.75,-3.47,-0.77,456.33,-2.32,True,1,16445,-445.75,-1454871.24,7330358.75,5875487.51
1993-07-19,446.03,0.28,0.06,456.33,-2.26,True,1,16446,-446.03,-1455317.27,7335409.38,5880092.11
1993-07-20,447.31,1.28,0.29,456.33,-1.98,True,1,16447,-447.31,-1455764.58,7356907.57,5901142.99
1993-07-21,447.18,-0.13,-0.03,456.33,-2.0,True,1,16448,-447.18,-1456211.76,7355216.64,5899004.88
1993-07-22,444.51,-2.67,-0.6,456.33,-2.59,True,1,16449,-444.51,-1456656.27,7311744.99,5855088.72
1993-07-23,447.1,2.59,0.58,456.33,-2.02,True,1,16450,-447.1,-1457103.37,7354795.0,5897691.63
1993-07-26,449.09,1.99,0.44,456.33,-1.59,True,1,16451,-449.09,-1457552.46,7387979.59,5930427.13
1993-07-27,448.24,-0.85,-0.19,456.33,-1.77,True,1,16452,-448.24,-1458000.7,7374444.48,5916443.78
1993-07-28,447.19,-1.05,-0.23,456.33,-2.0,True,1,16453,-447.19,-1458447.89,7357617.07,5899169.18
1993-07-29,450.24,3.05,0.68,456.33,-1.34,True,1,16454,-450.24,-1458898.13,7408248.96,5949350.83
1993-07-30,448.13,-2.11,-0.47,456.33,-1.8,True,1,16455,-448.13,-1459346.26,7373979.15,5914632.89
1993-08-02,450.15,2.02,0.45,456.33,-1.35,True,1,16456,-450.15,-1459796.41,7407668.4,5947871.99
1993-08-03,449.27,-0.88,-0.2,456.33,-1.55,True,1,16457,-449.27,-1460245.68,7393636.39,5933390.71
1993-08-04,448.54,-0.73,-0.16,456.33,-1.71,True,1,16458,-448.54,-1460694.22,7382071.32,5921377.1
1993-08-05,448.13,-0.41,-0.09,456.33,-1.8,True,1,16459,-448.13,-1461142.35,7375771.67,5914629.32
1993-08-06,448.68,0.55,0.12,456.33,-1.68,True,1,16460,-448.68,-1461591.03,7385272.8,5923681.77
1993-08-09,450.72,2.04,0.46,456.33,-1.23,True,1,16461,-450.72,-1462041.75,7419301.92,5957260.17
1993-08-10,449.45,-1.27,-0.28,456.33,-1.51,True,1,16462,-449.45,-1462491.2,7398845.9,5936354.7
1993-08-11,450.46,1.01,0.22,456.33,-1.29,True,1,16463,-450.46,-1462941.66,7415922.98,5952981.32
1993-08-12,448.96,-1.5,-0.33,456.33,-1.62,True,1,16464,-448.96,-1463390.62,7391677.44,5928286.82
1993-08-13,450.14,1.18,0.26,456.33,-1.36,True,1,16465,-450.14,-1463840.76,7411555.1,5947714.34
1993-08-16,452.38,2.24,0.5,456.33,-0.87,True,1,16466,-452.38,-1464293.14,7448889.08,5984595.94
1993-08-17,453.13,0.75,0.17,456.33,-0.7,True,1,16467,-453.13,-1464746.27,7461691.71,5996945.44
1993-08-18,456.04,2.91,0.64,456.33,-0.06,True,1,16468,-456.04,-1465202.31,7510066.72,6044864.41
1993-08-19,456.43,0.39,0.09,456.43,0.0,True,1,16469,-456.43,-1465658.74,7516945.67,6051286.93
1993-08-20,456.16,-0.27,-0.06,456.43,-0.06,True,1,16470,-456.16,-1466114.9,7512955.2,6046840.3
1993-08-23,455.23,-0.93,-0.2,456.43,-0.26,True,1,16471,-455.23,-1466570.13,7498093.33,6031523.2
1993-08-24,459.77,4.54,1.0,459.77,0.0,True,1,16472,-459.77,-1467029.9,7573331.44,6106301.54
1993-08-25,460.13,0.36,0.08,460.13,0.0,True,1,16473,-460.13,-1467490.03,7579721.49,6112231.46
1993-08-26,461.04,0.91,0.2,461.04,0.0,True,1,16474,-461.04,-1467951.07,7595172.96,6127221.89
1993-08-27,460.54,-0.5,-0.11,461.04,-0.11,True,1,16475,-460.54,-1468411.61,7587396.5,6118984.89
1993-08-30,461.9,1.36,0.3,461.9,0.0,True,1,16476,-461.9,-1468873.51,7610264.4,6141390.89
1993-08-31,463.56,1.66,0.36,463.56,0.0,True,1,16477,-463.56,-1469337.07,7638078.12,6168741.05
1993-09-01,463.15,-0.41,-0.09,463.56,-0.09,True,1,16478,-463.15,-1469800.22,7631785.7,6161985.48
1993-09-02,461.3,-1.85,-0.4,463.56,-0.49,True,1,16479,-461.3,-1470261.52,7601762.7,6131501.18
1993-09-03,461.34,0.04,0.01,463.56,-0.48,True,1,16480,-461.34,-1470722.86,7602883.2,6132160.34
1993-09-07,458.52,-2.82,-0.61,463.56,-1.09,True,1,16481,-458.52,-1471181.38,7556868.12,6085686.74
1993-09-08,456.65,-1.87,-0.41,463.56,-1.49,True,1,16482,-456.65,-1471638.03,7526505.3,6054867.27
1993-09-09,457.5,0.85,0.19,463.56,-1.31,True,1,16483,-457.5,-1472095.53,7540972.5,6068876.97
1993-09-10,461.72,4.22,0.92,463.56,-0.4,True,1,16484,-461.72,-1472557.25,7610992.48,6138435.23
1993-09-13,462.06,0.34,0.07,463.56,-0.32,True,1,16485,-462.06,-1473019.31,7617059.1,6144039.79
1993-09-14,459.9,-2.16,-0.47,463.56,-0.79,True,1,16486,-459.9,-1473479.21,7581911.4,6108432.19
1993-09-15,461.6,1.7,0.37,463.56,-0.42,True,1,16487,-461.6,-1473940.81,7610399.2,6136458.39
1993-09-16,459.43,-2.17,-0.47,463.56,-0.89,True,1,16488,-459.43,-1474400.24,7575081.84,6100681.6
1993-09-17,458.83,-0.6,-0.13,463.56,-1.02,True,1,16489,-458.83,-1474859.07,7565647.87,6090788.8
1993-09-20,455.05,-3.78,-0.82,463.56,-1.84,True,1,16490,-455.05,-1475314.12,7503774.5,6028460.38
1993-09-21,452.95,-2.1,-0.46,463.56,-2.29,True,1,16491,-452.95,-1475767.07,7469598.45,5993831.38
1993-09-22,456.2,3.25,0.72,463.56,-1.59,True,1,16492,-456.2,-1476223.27,7523650.4,6047427.13
1993-09-23,457.74,1.54,0.34,463.56,-1.26,True,1,16493,-457.74,-1476681.01,7549505.82,6072824.81
1993-09-24,457.63,-0.11,-0.02,463.56,-1.28,True,1,16494,-457.63,-1477138.64,7548149.22,6071010.58
1993-09-27,461.8,4.17,0.91,463.56,-0.38,True,1,16495,-461.8,-1477600.44,7617391.0,6139790.56
1993-09-28,461.53,-0.27,-0.06,463.56,-0.44,True,1,16496,-461.53,-1478061.97,7613398.88,6135336.91
1993-09-29,460.11,-1.42,-0.31,463.56,-0.74,True,1,16497,-460.11,-1478522.08,7590434.67,6111912.59
1993-09-30,458.93,-1.18,-0.26,463.56,-1.0,True,1,16498,-458.93,-1478981.01,7571427.14,6092446.13
1993-10-01,461.28,2.35,0.51,463.56,-0.49,True,1,16499,-461.28,-1479442.29,7610658.72,6131216.43
1993-10-04,461.34,0.06,0.01,463.56,-0.48,True,1,16500,-461.34,-1479903.63,7612110.0,6132206.37
1993-10-05,461.2,-0.14,-0.03,463.56,-0.51,True,1,16501,-461.2,-1480364.83,7610261.2,6129896.37
1993-10-06,460.74,-0.46,-0.1,463.56,-0.61,True,1,16502,-460.74,-1480825.57,7603131.48,6122305.91
1993-10-07,459.18,-1.56,-0.34,463.56,-0.94,True,1,16503,-459.18,-1481284.75,7577847.54,6096562.79
1993-10-08,460.31,1.13,0.25,463.56,-0.7,True,1,16504,-460.31,-1481745.06,7596956.24,6115211.18
1993-10-11,460.88,0.57,0.12,463.56,-0.58,True,1,16505,-460.88,-1482205.94,7606824.4,6124618.46
1993-10-12,461.12,0.24,0.05,463.56,-0.53,True,1,16506,-461.12,-1482667.06,7611246.72,6128579.66
1993-10-13,461.49,0.37,0.08,463.56,-0.45,True,1,16507,-461.49,-1483128.55,7617815.43,6134686.88
1993-10-14,466.83,5.34,1.16,466.83,0.0,True,1,16508,-466.83,-1483595.38,7706429.64,6222834.26
1993-10-15,469.5,2.67,0.57,469.5,0.0,True,1,16509,-469.5,-1484064.88,7750975.5,6266910.62
1993-10-18,468.45,-1.05,-0.22,469.5,-0.22,True,1,16510,-468.45,-1484533.33,7734109.5,6249576.17
1993-10-19,466.21,-2.24,-0.48,469.5,-0.7,True,1,16511,-466.21,-1484999.54,7697593.31,6212593.77
1993-10-20,466.07,-0.14,-0.03,469.5,-0.73,True,1,16512,-466.07,-1485465.61,7695747.84,6210282.23
1993-10-21,465.36,-0.71,-0.15,469.5,-0.88,True,1,16513,-465.36,-1485930.97,7684489.68,6198558.71
1993-10-22,463.27,-2.09,-0.45,469.5,-1.33,True,1,16514,-463.27,-1486394.24,7650440.78,6164046.54
1993-10-25,464.2,0.93,0.2,469.5,-1.13,True,1,16515,-464.2,-1486858.44,7666263.0,6179404.56
1993-10-26,464.3,0.1,0.02,469.5,-1.11,True,1,16516,-464.3,-1487322.74,7668378.8,6181056.06
1993-10-27,464.61,0.31,0.07,469.5,-1.04,True,1,16517,-464.61,-1487787.35,7673963.37,6186176.02
1993-10-28,467.73,3.12,0.67,469.5,-0.38,True,1,16518,-467.73,-1488255.08,7725964.14,6237709.06
1993-10-29,467.83,0.1,0.02,469.5,-0.36,True,1,16519,-467.83,-1488722.91,7728083.77,6239360.86
1993-11-01,469.1,1.27,0.27,469.5,-0.08,True,1,16520,-469.1,-1489192.01,7749532.0,6260339.99
1993-11-02,468.44,-0.66,-0.14,469.5,-0.23,True,1,16521,-468.44,-1489660.45,7739097.24,6249436.79
1993-11-03,463.02,-5.42,-1.16,469.5,-1.38,True,1,16522,-463.02,-1490123.47,7650016.44,6159892.97
1993-11-04,457.49,-5.53,-1.19,469.5,-2.56,True,1,16523,-457.49,-1490580.96,7559107.27,6068526.31
1993-11-05,459.57,2.08,0.46,469.5,-2.12,True,1,16524,-459.57,-1491040.53,7593934.68,6102894.15
1993-11-08,460.21,0.64,0.14,469.5,-1.98,True,1,16525,-460.21,-1491500.74,7604970.25,6113469.51
1993-11-09,460.33,0.12,0.03,469.5,-1.95,True,1,16526,-460.33,-1491961.07,7607413.58,6115452.51
1993-11-10,463.72,3.39,0.74,469.5,-1.23,True,1,16527,-463.72,-1492424.79,7663900.44,6171475.65
1993-11-11,462.64,-1.08,-0.23,469.5,-1.46,True,1,16528,-462.64,-1492887.43,7646513.92,6153626.49
1993-11-12,465.39,2.75,0.59,469.5,-0.88,True,1,16529,-465.39,-1493352.82,7692431.31,6199078.49
1993-11-15,463.75,-1.64,-0.35,469.5,-1.23,True,1,16530,-463.75,-1493816.57,7665787.5,6171970.93
1993-11-16,466.74,2.99,0.64,469.5,-0.59,True,1,16531,-466.74,-1494283.31,7715678.94,6221395.63
1993-11-17,464.81,-1.93,-0.41,469.5,-1.0,True,1,16532,-464.81,-1494748.12,7684238.92,6189490.8
1993-11-18,463.62,-1.19,-0.26,469.5,-1.25,True,1,16533,-463.62,-1495211.74,7665029.46,6169817.72
1993-11-19,462.6,-1.02,-0.22,469.5,-1.47,True,1,16534,-462.6,-1495674.34,7648628.4,6152954.06
1993-11-22,459.13,-3.47,-0.75,469.5,-2.21,True,1,16535,-459.13,-1496133.47,7591714.55,6095581.08
1993-11-23,461.03,1.9,0.41,469.5,-1.8,True,1,16536,-461.03,-1496594.5,7623592.08,6126997.58
1993-11-24,462.36,1.33,0.29,469.5,-1.52,True,1,16537,-462.36,-1497056.86,7646047.32,6148990.46
1993-11-26,463.06,0.7,0.15,469.5,-1.37,True,1,16538,-463.06,-1497519.92,7658086.28,6160566.36
1993-11-29,461.9,-1.16,-0.25,469.5,-1.62,True,1,16539,-461.9,-1497981.82,7639364.1,6141382.28
1993-11-30,461.79,-0.11,-0.02,469.5,-1.64,True,1,16540,-461.79,-1498443.61,7638006.6,6139562.99
1993-12-01,461.89,0.1,0.02,469.5,-1.62,True,1,16541,-461.89,-1498905.5,7640122.49,6141216.99
1993-12-02,463.11,1.22,0.26,469.5,-1.36,True,1,16542,-463.11,-1499368.61,7660765.62,6161397.01
1993-12-03,464.89,1.78,0.38,469.5,-0.98,True,1,16543,-464.89,-1499833.5,7690675.27,6190841.77
1993-12-06,466.43,1.54,0.33,469.5,-0.65,True,1,16544,-466.43,-1500299.93,7716617.92,6216317.99
1993-12-07,466.76,0.33,0.07,469.5,-0.58,True,1,16545,-466.76,-1500766.69,7722544.2,6221777.51
1993-12-08,466.29,-0.47,-0.1,469.5,-0.68,True,1,16546,-466.29,-1501232.98,7715234.34,6214001.36
1993-12-09,464.18,-2.11,-0.45,469.5,-1.13,True,1,16547,-464.18,-1501697.16,7680786.46,6179089.3
1993-12-10,463.93,-0.25,-0.05,469.5,-1.19,True,1,16548,-463.93,-1502161.09,7677113.64,6174952.55
1993-12-13,465.7,1.77,0.38,469.5,-0.81,True,1,16549,-465.7,-1502626.79,7706869.3,6204242.51
1993-12-14,463.06,-2.64,-0.57,469.5,-1.37,True,1,16550,-463.06,-1503089.85,7663643.0,6160553.15
1993-12-15,461.84,-1.22,-0.26,469.5,-1.63,True,1,16551,-461.84,-1503551.69,7643913.84,6140362.15
1993-12-16,463.34,1.5,0.32,469.5,-1.31,True,1,16552,-463.34,-1504015.03,7669203.68,6165188.65
1993-12-17,466.38,3.04,0.66,469.5,-0.66,True,1,16553,-466.38,-1504481.41,7719988.14,6215506.73
1993-12-20,465.85,-0.53,-0.11,469.5,-0.78,True,1,16554,-465.85,-1504947.26,7711680.9,6206733.64
1993-12-21,465.3,-0.55,-0.12,469.5,-0.9,True,1,16555,-465.3,-1505412.56,7703041.5,6197628.94
1993-12-22,467.32,2.02,0.43,469.5,-0.46,True,1,16556,-467.32,-1505879.88,7736949.92,6231070.04
1993-12-23,467.38,0.06,0.01,469.5,-0.45,True,1,16557,-467.38,-1506347.26,7738410.66,6232063.4
1993-12-27,470.54,3.16,0.68,470.54,0.0,True,1,16558,-470.54,-1506817.8,7791201.32,6284383.52
1993-12-28,470.94,0.4,0.08,470.94,0.0,True,1,16559,-470.94,-1507288.74,7798295.46,6291006.72
1993-12-29,470.58,-0.36,-0.08,470.94,-0.08,True,1,16560,-470.58,-1507759.32,7792804.8,6285045.48
1993-12-30,468.64,-1.94,-0.41,470.94,-0.49,True,1,16561,-468.64,-1508227.96,7761147.04,6252919.08
1993-12-31,466.45,-2.19,-0.47,470.94,-0.95,True,1,16562,-466.45,-1508694.41,7725344.9,6216650.49
1994-01-03,465.44,-1.01,-0.22,470.94,-1.17,True,1,16563,-465.44,-1509159.85,7709082.72,6199922.87
1994-01-04,466.89,1.45,0.31,470.94,-0.86,True,1,16564,-466.89,-1509626.74,7733565.96,6223939.22
1994-01-05,467.55,0.66,0.14,470.94,-0.72,True,1,16565,-467.55,-1510094.29,7744965.75,6234871.46
1994-01-06,467.12,-0.43,-0.09,470.94,-0.81,True,1,16566,-467.12,-1510561.41,7738309.92,6227748.51
1994-01-07,469.9,2.78,0.6,470.94,-0.22,True,1,16567,-469.9,-1511031.31,7784833.3,6273801.99
1994-01-10,475.27,5.37,1.14,475.27,0.0,True,1,16568,-475.27,-1511506.58,7874273.36,6362766.78
1994-01-11,474.13,-1.14,-0.24,475.27,-0.24,True,1,16569,-474.13,-1511980.71,7855859.97,6343879.26
1994-01-12,474.17,0.04,0.01,475.27,-0.23,True,1,16570,-474.17,-1512454.88,7856996.9,6344542.02
1994-01-13,472.47,-1.7,-0.36,475.27,-0.59,True,1,16571,-472.47,-1512927.35,7829300.37,6316373.02
1994-01-14,474.91,2.44,0.52,475.27,-0.08,True,1,16572,-474.91,-1513402.26,7870208.52,6356806.26
1994-01-17,473.3,-1.61,-0.34,475.27,-0.42,True,1,16573,-473.3,-1513875.56,7844000.9,6330125.34
1994-01-18,474.25,0.95,0.2,475.27,-0.22,True,1,16574,-474.25,-1514349.81,7860219.5,6345869.69
1994-01-19,474.3,0.05,0.01,475.27,-0.2,True,1,16575,-474.3,-1514824.11,7861522.5,6346698.39
1994-01-20,474.98,0.68,0.14,475.27,-0.06,True,1,16576,-474.98,-1515299.09,7873268.48,6357969.39
1994-01-21,474.72,-0.26,-0.06,475.27,-0.12,True,1,16577,-474.72,-1515773.81,7869433.44,6353659.63
1994-01-24,471.97,-2.75,-0.58,475.27,-0.69,True,1,16578,-471.97,-1516245.78,7824318.66,6308072.88
1994-01-25,470.92,-1.05,-0.22,475.27,-0.92,True,1,16579,-470.92,-1516716.7,7807382.68,6290665.98
1994-01-26,473.2,2.28,0.48,475.27,-0.44,True,1,16580,-473.2,-1517189.9,7845656.0,6328466.1
1994-01-27,477.05,3.85,0.81,477.05,0.0,True,1,16581,-477.05,-1517666.95,7909966.05,6392299.1
1994-01-28,478.7,1.65,0.35,478.7,0.0,True,1,16582,-478.7,-1518145.65,7937803.4,6419657.75
1994-01-31,481.61,2.91,0.61,481.61,0.0,True,1,16583,-481.61,-1518627.26,7986538.63,6467911.37
1994-02-01,479.62,-1.99,-0.41,481.61,-0.41,True,1,16584,-479.62,-1519106.88,7954018.08,6434911.2
1994-02-02,482.0,2.38,0.5,482.0,0.0,True,1,16585,-482.0,-1519588.88,7993970.0,6474381.12
1994-02-03,480.71,-1.29,-0.27,482.0,-0.27,True,1,16586,-480.71,-1520069.59,7973056.06,6452986.47
1994-02-04,469.81,-10.9,-2.27,482.0,-2.53,True,1,16587,-469.81,-1520539.4,7792738.47,6272199.07
1994-02-07,471.76,1.95,0.42,482.0,-2.12,True,1,16588,-471.76,-1521011.16,7825554.88,6304543.72
1994-02-08,471.05,-0.71,-0.15,482.0,-2.27,True,1,16589,-471.05,-1521482.21,7814248.45,6292766.24
1994-02-09,472.77,1.72,0.36,482.0,-1.92,True,1,16590,-472.77,-1521954.98,7843254.3,6321299.32
1994-02-10,468.93,-3.84,-0.81,482.0,-2.71,True,1,16591,-468.93,-1522423.91,7780017.63,6257593.72
1994-02-11,470.18,1.25,0.27,482.0,-2.45,True,1,16592,-470.18,-1522894.09,7801226.56,6278332.47
1994-02-14,470.23,0.05,0.01,482.0,-2.44,True,1,16593,-470.23,-1523364.32,7802526.39,6279162.07
1994-02-15,472.52,2.29,0.49,482.0,-1.97,True,1,16594,-472.52,-1523836.84,7840996.88,6317160.04
1994-02-16,472.79,0.27,0.06,482.0,-1.91,True,1,16595,-472.79,-1524309.63,7845950.05,6321640.42
1994-02-17,470.34,-2.45,-0.52,482.0,-2.42,True,1,16596,-470.34,-1524779.97,7805762.64,6280982.67
1994-02-18,467.69,-2.65,-0.56,482.0,-2.97,True,1,16597,-467.69,-1525247.66,7762250.93,6237003.27
1994-02-22,471.46,3.77,0.81,482.0,-2.19,True,1,16598,-471.46,-1525719.12,7825293.08,6299573.96
1994-02-23,470.69,-0.77,-0.16,482.0,-2.35,True,1,16599,-470.69,-1526189.81,7812983.31,6286793.5
1994-02-24,464.26,-6.43,-1.37,482.0,-3.68,True,1,16600,-464.26,-1526654.07,7706716.0,6180061.93
1994-02-25,466.07,1.81,0.39,482.0,-3.3,True,1,16601,-466.07,-1527120.14,7737228.07,6210107.93
1994-02-28,467.14,1.07,0.23,482.0,-3.08,True,1,16602,-467.14,-1527587.28,7755458.28,6227871.0
1994-03-01,464.44,-2.7,-0.58,482.0,-3.64,True,1,16603,-464.44,-1528051.72,7711097.32,6183045.6
1994-03-02,464.81,0.37,0.08,482.0,-3.57,True,1,16604,-464.81,-1528516.53,7717705.24,6189188.71
1994-03-03,463.01,-1.8,-0.39,482.0,-3.94,True,1,16605,-463.01,-1528979.54,7688281.05,6159301.51
1994-03-04,464.74,1.73,0.37,482.0,-3.58,True,1,16606,-464.74,-1529444.28,7717472.44,6188028.16
1994-03-07,466.91,2.17,0.47,482.0,-3.13,True,1,16607,-466.91,-1529911.19,7753974.37,6224063.18
1994-03-08,465.88,-1.03,-0.22,482.0,-3.34,True,1,16608,-465.88,-1530377.07,7737335.04,6206957.97
1994-03-09,467.06,1.18,0.25,482.0,-3.1,True,1,16609,-467.06,-1530844.13,7757399.54,6226555.41
1994-03-10,463.9,-3.16,-0.68,482.0,-3.76,True,1,16610,-463.9,-1531308.03,7705379.0,6174070.97
1994-03-11,466.44,2.54,0.55,482.0,-3.23,True,1,16611,-466.44,-1531774.47,7748034.84,6216260.37
1994-03-14,467.39,0.95,0.2,482.0,-3.03,True,1,16612,-467.39,-1532241.86,7764282.68,6232040.82
1994-03-15,467.01,-0.38,-0.08,482.0,-3.11,True,1,16613,-467.01,-1532708.87,7758437.13,6225728.26
1994-03-16,469.42,2.41,0.52,482.0,-2.61,True,1,16614,-469.42,-1533178.29,7798943.88,6265765.59
1994-03-17,470.9,1.48,0.32,482.0,-2.3,True,1,16615,-470.9,-1533649.19,7824003.5,6290354.31
1994-03-18,471.06,0.16,0.03,482.0,-2.27,True,1,16616,-471.06,-1534120.25,7827132.96,6293012.71
1994-03-21,468.54,-2.52,-0.54,482.0,-2.79,True,1,16617,-468.54,-1534588.79,7785729.18,6251140.39
1994-03-22,468.8,0.26,0.06,482.0,-2.74,True,1,16618,-468.8,-1535057.59,7790518.4,6255460.81
1994-03-23,468.54,-0.26,-0.06,482.0,-2.79,True,1,16619,-468.54,-1535526.13,7786666.26,6251140.13
1994-03-24,464.35,-4.19,-0.89,482.0,-3.66,True,1,16620,-464.35,-1535990.48,7717497.0,6181506.52
1994-03-25,460.58,-3.77,-0.81,482.0,-4.44,True,1,16621,-460.58,-1536451.06,7655300.18,6118849.12
1994-03-28,460.0,-0.58,-0.13,482.0,-4.56,True,1,16622,-460.0,-1536911.06,7646120.0,6109208.94
1994-03-29,452.48,-7.52,-1.64,482.0,-6.12,True,1,16623,-452.48,-1537363.54,7521575.04,5984211.5
1994-03-30,445.55,-6.93,-1.53,482.0,-7.56,True,1,16624,-445.55,-1537809.09,7406823.2,5869014.11
1994-03-31,445.77,0.22,0.05,482.0,-7.52,True,1,16625,-445.77,-1538254.86,7410926.25,5872671.39
1994-04-04,438.92,-6.85,-1.54,482.0,-8.94,True,1,16626,-438.92,-1538693.78,7297483.92,5758790.14
1994-04-05,448.29,9.37,2.13,482.0,-6.99,True,1,16627,-448.29,-1539142.07,7453717.83,5914575.76
1994-04-06,448.05,-0.24,-0.05,482.0,-7.04,True,1,16628,-448.05,-1539590.12,7450175.4,5910585.28
1994-04-07,450.88,2.83,0.63,482.0,-6.46,True,1,16629,-450.88,-1540041.0,7497683.52,5957642.52
1994-04-08,447.1,-3.78,-0.84,482.0,-7.24,True,1,16630,-447.1,-1540488.1,7435273.0,5894784.9
1994-04-11,449.87,2.77,0.62,482.0,-6.67,True,1,16631,-449.87,-1540937.97,7481787.97,5940850.0
1994-04-12,447.57,-2.3,-0.51,482.0,-7.14,True,1,16632,-447.57,-1541385.54,7443984.24,5902598.7
1994-04-13,446.26,-1.31,-0.29,482.0,-7.42,True,1,16633,-446.26,-1541831.8,7422642.58,5880810.78
1994-04-14,446.38,0.12,0.03,482.0,-7.39,True,1,16634,-446.38,-1542278.18,7425084.92,5882806.74
1994-04-15,446.18,-0.2,-0.04,482.0,-7.43,True,1,16635,-446.18,-1542724.36,7422204.3,5879479.94
1994-04-18,442.46,-3.72,-0.83,482.0,-8.2,True,1,16636,-442.46,-1543166.82,7360764.56,5817597.74
1994-04-19,442.54,0.08,0.02,482.0,-8.19,True,1,16637,-442.54,-1543609.36,7362537.98,5818928.62
1994-04-20,441.96,-0.58,-0.13,482.0,-8.31,True,1,16638,-441.96,-1544051.32,7353330.48,5809279.16
1994-04-21,448.73,6.77,1.53,482.0,-6.9,True,1,16639,-448.73,-1544500.05,7466418.47,5921918.42
1994-04-22,447.63,-1.1,-0.24,482.0,-7.13,True,1,16640,-447.63,-1544947.68,7448563.2,5903615.52
1994-04-25,452.71,5.08,1.14,482.0,-6.08,True,1,16641,-452.71,-1545400.39,7533547.11,5988146.72
1994-04-26,451.87,-0.84,-0.19,482.0,-6.25,True,1,16642,-451.87,-1545852.26,7520020.54,5974168.28
1994-04-28,449.1,-2.77,-0.61,482.0,-6.83,True,1,16643,-449.1,-1546301.36,7474371.3,5928069.94
1994-04-29,450.91,1.81,0.4,482.0,-6.45,True,1,16644,-450.91,-1546752.27,7504946.04,5958193.77
1994-05-02,453.02,2.11,0.47,482.0,-6.01,True,1,16645,-453.02,-1547205.29,7540517.9,5993312.61
1994-05-03,453.03,0.01,0.0,482.0,-6.01,True,1,16646,-453.03,-1547658.32,7541137.38,5993479.06
1994-05-04,451.72,-1.31,-0.29,482.0,-6.28,True,1,16647,-451.72,-1548110.04,7519782.84,5971672.8
1994-05-05,451.38,-0.34,-0.08,482.0,-6.35,True,1,16648,-451.38,-1548561.42,7514574.24,5966012.82
1994-05-06,447.82,-3.56,-0.79,482.0,-7.09,True,1,16649,-447.82,-1549009.24,7455755.18,5906745.94
1994-05-09,442.32,-5.5,-1.23,482.0,-8.23,True,1,16650,-442.32,-1549451.56,7364628.0,5815176.44
1994-05-10,446.01,3.69,0.83,482.0,-7.47,True,1,16651,-446.01,-1549897.57,7426512.51,5876614.94
1994-05-11,441.49,-4.52,-1.01,482.0,-8.4,True,1,16652,-441.49,-1550339.06,7351691.48,5801352.42
1994-05-12,443.75,2.26,0.51,482.0,-7.94,True,1,16653,-443.75,-1550782.81,7389768.75,5838985.94
1994-05-13,444.14,0.39,0.09,482.0,-7.86,True,1,16654,-444.14,-1551226.95,7396707.56,5845480.61
1994-05-16,444.49,0.35,0.08,482.0,-7.78,True,1,16655,-444.49,-1551671.44,7402980.95,5851309.51
1994-05-17,449.37,4.88,1.1,482.0,-6.77,True,1,16656,-449.37,-1552120.81,7484706.72,5932585.91
1994-05-18,453.69,4.32,0.96,482.0,-5.87,True,1,16657,-453.69,-1552574.5,7557114.33,6004539.83
1994-05-19,456.48,2.79,0.62,482.0,-5.3,True,1,16658,-456.48,-1553030.98,7604043.84,6051012.86
1994-05-20,454.92,-1.56,-0.34,482.0,-5.62,True,1,16659,-454.92,-1553485.9,7578512.28,6025026.38
1994-05-23,453.2,-1.72,-0.38,482.0,-5.98,True,1,16660,-453.2,-1553939.1,7550312.0,5996372.9
1994-05-24,454.81,1.61,0.36,482.0,-5.64,True,1,16661,-454.81,-1554393.91,7577589.41,6023195.5
1994-05-25,456.34,1.53,0.34,482.0,-5.32,True,1,16662,-456.34,-1554850.25,7603537.08,6048686.83
1994-05-26,457.06,0.72,0.16,482.0,-5.17,True,1,16663,-457.06,-1555307.31,7615990.78,6060683.47
1994-05-27,457.33,0.27,0.06,482.0,-5.12,True,1,16664,-457.33,-1555764.64,7620947.12,6065182.48
1994-05-31,456.5,-0.83,-0.18,482.0,-5.29,True,1,16665,-456.5,-1556221.14,7607572.5,6051351.36
1994-06-01,457.63,1.13,0.25,482.0,-5.06,True,1,16666,-457.63,-1556678.77,7626861.58,6070182.81
1994-06-02,457.65,0.02,0.0,482.0,-5.05,True,1,16667,-457.65,-1557136.42,7627652.55,6070516.13
1994-06-03,460.13,2.48,0.54,482.0,-4.54,True,1,16668,-460.13,-1557596.55,7669446.84,6111850.29
1994-06-06,458.88,-1.25,-0.27,482.0,-4.8,True,1,16669,-458.88,-1558055.43,7649070.72,6091015.29
1994-06-07,458.21,-0.67,-0.15,482.0,-4.94,True,1,16670,-458.21,-1558513.64,7638360.7,6079847.06
1994-06-08,457.06,-1.15,-0.25,482.0,-5.17,True,1,16671,-457.06,-1558970.7,7619647.26,6060676.56
1994-06-09,457.86,0.8,0.18,482.0,-5.01,True,1,16672,-457.86,-1559428.56,7633441.92,6074013.36
1994-06-10,458.67,0.81,0.18,482.0,-4.84,True,1,16673,-458.67,-1559887.23,7647404.91,6087517.68
1994-06-13,459.1,0.43,0.09,482.0,-4.75,True,1,16674,-459.1,-1560346.33,7655033.4,6094687.07
1994-06-14,462.37,3.27,0.71,482.0,-4.07,True,1,16675,-462.37,-1560808.7,7710019.75,6149211.05
1994-06-15,460.61,-1.76,-0.38,482.0,-4.44,True,1,16676,-460.61,-1561269.31,7681132.36,6119863.05
1994-06-16,461.93,1.32,0.29,482.0,-4.16,True,1,16677,-461.93,-1561731.24,7703606.61,6141875.37
1994-06-17,458.45,-3.48,-0.75,482.0,-4.89,True,1,16678,-458.45,-1562189.69,7646029.1,6083839.41
1994-06-20,455.48,-2.97,-0.65,482.0,-5.5,True,1,16679,-455.48,-1562645.17,7596950.92,6034305.75
1994-06-21,451.34,-4.14,-0.91,482.0,-6.36,True,1,16680,-451.34,-1563096.51,7528351.2,5965254.69
1994-06-22,453.09,1.75,0.39,482.0,-6.0,True,1,16681,-453.09,-1563549.6,7557994.29,5994444.69
1994-06-23,449.63,-3.46,-0.76,482.0,-6.72,True,1,16682,-449.63,-1563999.23,7500727.66,5936728.43
1994-06-24,442.8,-6.83,-1.52,482.0,-8.13,True,1,16683,-442.8,-1564442.03,7387232.4,5822790.37
1994-06-27,447.31,4.51,1.02,482.0,-7.2,True,1,16684,-447.31,-1564889.34,7462920.04,5898030.7
1994-06-28,446.07,-1.24,-0.28,482.0,-7.45,True,1,16685,-446.07,-1565335.41,7442677.95,5877342.54
1994-06-29,447.63,1.56,0.35,482.0,-7.13,True,1,16686,-447.63,-1565783.04,7469154.18,5903371.14
1994-06-30,444.27,-3.36,-0.75,482.0,-7.83,True,1,16687,-444.27,-1566227.31,7413533.49,5847306.18
1994-07-01,446.2,1.93,0.43,482.0,-7.43,True,1,16688,-446.2,-1566673.51,7446185.6,5879512.09
1994-07-05,446.37,0.17,0.04,482.0,-7.39,True,1,16689,-446.37,-1567119.88,7449468.93,5882349.05
1994-07-06,446.13,-0.24,-0.05,482.0,-7.44,True,1,16690,-446.13,-1567566.01,7445909.7,5878343.69
1994-07-07,448.38,2.25,0.5,482.0,-6.98,True,1,16691,-448.38,-1568014.39,7483910.58,5915896.19
1994-07-08,449.55,1.17,0.26,482.0,-6.73,True,1,16692,-449.55,-1568463.94,7503888.6,5935424.66
1994-07-11,448.06,-1.49,-0.33,482.0,-7.04,True,1,16693,-448.06,-1568912.0,7479465.58,5910553.58
1994-07-12,447.95,-0.11,-0.02,482.0,-7.06,True,1,16694,-447.95,-1569359.95,7478077.3,5908717.35
1994-07-13,448.73,0.78,0.17,482.0,-6.9,True,1,16695,-448.73,-1569808.68,7491547.35,5921738.67
1994-07-14,453.41,4.68,1.04,482.0,-5.93,True,1,16696,-453.41,-1570262.09,7570133.36,5999871.27
1994-07-15,454.16,0.75,0.16,482.0,-5.78,True,1,16697,-454.16,-1570716.25,7583109.52,6012393.27
1994-07-18,455.22,1.06,0.23,482.0,-5.56,True,1,16698,-455.22,-1571171.47,7601263.56,6030092.09
1994-07-19,453.86,-1.36,-0.3,482.0,-5.84,True,1,16699,-453.86,-1571625.33,7579008.14,6007382.81
1994-07-20,451.6,-2.26,-0.5,482.0,-6.31,True,1,16700,-451.6,-1572076.93,7541720.0,5969643.07
1994-07-21,452.61,1.01,0.22,482.0,-6.1,True,1,16701,-452.61,-1572529.54,7559039.61,5986510.07
1994-07-22,453.11,0.5,0.11,482.0,-5.99,True,1,16702,-453.11,-1572982.65,7567843.22,5994860.57
1994-07-25,454.25,1.14,0.25,482.0,-5.76,True,1,16703,-454.25,-1573436.9,7587337.75,6013900.85
1994-07-26,453.36,-0.89,-0.2,482.0,-5.94,True,1,16704,-453.36,-1573890.26,7572925.44,5999035.18
1994-07-27,452.57,-0.79,-0.17,482.0,-6.11,True,1,16705,-452.57,-1574342.83,7560181.85,5985839.02
1994-07-28,454.24,1.67,0.37,482.0,-5.76,True,1,16706,-454.24,-1574797.07,7588533.44,6013736.37
1994-07-29,458.26,4.02,0.88,482.0,-4.92,True,1,16707,-458.26,-1575255.33,7656149.82,6080894.49
1994-08-01,461.01,2.75,0.6,482.0,-4.36,True,1,16708,-461.01,-1575716.34,7702555.08,6126838.74
1994-08-02,460.56,-0.45,-0.1,482.0,-4.45,True,1,16709,-460.56,-1576176.9,7695497.04,6119320.14
1994-08-03,461.45,0.89,0.19,482.0,-4.26,True,1,16710,-461.45,-1576638.35,7710829.5,6134191.15
1994-08-04,458.4,-3.05,-0.66,482.0,-4.9,True,1,16711,-458.4,-1577096.75,7660322.4,6083225.65
1994-08-05,457.09,-1.31,-0.29,482.0,-5.17,True,1,16712,-457.09,-1577553.84,7638888.08,6061334.24
1994-08-08,457.89,0.8,0.18,482.0,-5.0,True,1,16713,-457.89,-1578011.73,7652715.57,6074703.84
1994-08-09,457.92,0.03,0.01,482.0,-5.0,True,1,16714,-457.92,-1578469.65,7653674.88,6075205.23
1994-08-10,460.3,2.38,0.52,482.0,-4.5,True,1,16715,-460.3,-1578929.95,7693914.5,6114984.55
1994-08-11,458.88,-1.42,-0.31,482.0,-4.8,True,1,16716,-458.88,-1579388.83,7670638.08,6091249.25
1994-08-12,461.94,3.06,0.67,482.0,-4.16,True,1,16717,-461.94,-1579850.77,7722250.98,6142400.21
1994-08-15,461.23,-0.71,-0.15,482.0,-4.31,True,1,16718,-461.23,-1580312.0,7710843.14,6130531.14
1994-08-16,465.01,3.78,0.82,482.0,-3.52,True,1,16719,-465.01,-1580777.01,7774502.19,6193725.18
1994-08-17,465.17,0.16,0.03,482.0,-3.49,True,1,16720,-465.17,-1581242.18,7777642.4,6196400.22
1994-08-18,463.17,-2.0,-0.43,482.0,-3.91,True,1,16721,-463.17,-1581705.35,7744665.57,6162960.22
1994-08-19,463.68,0.51,0.11,482.0,-3.8,True,1,16722,-463.68,-1582169.03,7753656.96,6171487.93
1994-08-22,462.32,-1.36,-0.29,482.0,-4.08,True,1,16723,-462.32,-1582631.35,7731377.36,6148746.01
1994-08-23,464.51,2.19,0.47,482.0,-3.63,True,1,16724,-464.51,-1583095.86,7768465.24,6185369.38
1994-08-24,469.03,4.52,0.97,482.0,-2.69,True,1,16725,-469.03,-1583564.89,7844526.75,6260961.86
1994-08-25,468.08,-0.95,-0.2,482.0,-2.89,True,1,16726,-468.08,-1584032.97,7829106.08,6245073.11
1994-08-26,473.8,5.72,1.22,482.0,-1.7,True,1,16727,-473.8,-1584506.77,7925252.6,6340745.83
1994-08-29,474.59,0.79,0.17,482.0,-1.54,True,1,16728,-474.59,-1584981.36,7938941.52,6353960.16
1994-08-30,476.07,1.48,0.31,482.0,-1.23,True,1,16729,-476.07,-1585457.43,7964175.03,6378717.6
1994-08-31,475.49,-0.58,-0.12,482.0,-1.35,True,1,16730,-475.49,-1585932.92,7954947.7,6369014.78
1994-09-01,473.17,-2.32,-0.49,482.0,-1.83,True,1,16731,-473.17,-1586406.09,7916607.27,6330201.18
1994-09-02,470.99,-2.18,-0.46,482.0,-2.28,True,1,16732,-470.99,-1586877.08,7880604.68,6293727.6
1994-09-06,471.86,0.87,0.18,482.0,-2.1,True,1,16733,-471.86,-1587348.94,7895633.38,6308284.44
1994-09-07,470.99,-0.87,-0.18,482.0,-2.28,True,1,16734,-470.99,-1587819.93,7881546.66,6293726.73
1994-09-08,473.14,2.15,0.46,482.0,-1.84,True,1,16735,-473.14,-1588293.07,7917997.9,6329704.83
1994-09-09,468.18,-4.96,-1.05,482.0,-2.87,True,1,16736,-468.18,-1588761.25,7835460.48,6246699.23
1994-09-12,466.21,-1.97,-0.42,482.0,-3.28,True,1,16737,-466.21,-1589227.46,7802956.77,6213729.31
1994-09-13,467.51,1.3,0.28,482.0,-3.01,True,1,16738,-467.51,-1589694.97,7825182.38,6235487.41
1994-09-14,468.8,1.29,0.28,482.0,-2.74,True,1,16739,-468.8,-1590163.77,7847243.2,6257079.43
1994-09-15,474.81,6.01,1.28,482.0,-1.49,True,1,16740,-474.81,-1590638.58,7948319.4,6357680.82
1994-09-16,471.19,-3.62,-0.76,482.0,-2.24,True,1,16741,-471.19,-1591109.77,7888191.79,6297082.02
1994-09-19,470.85,-0.34,-0.07,482.0,-2.31,True,1,16742,-470.85,-1591580.62,7882970.7,6291390.08
1994-09-20,463.36,-7.49,-1.59,482.0,-3.87,True,1,16743,-463.36,-1592043.98,7758036.48,6165992.5
1994-09-21,461.46,-1.9,-0.41,482.0,-4.26,True,1,16744,-461.46,-1592505.44,7726686.24,6134180.8
1994-09-22,461.27,-0.19,-0.04,482.0,-4.3,True,1,16745,-461.27,-1592966.71,7723966.15,6130999.44
1994-09-23,459.67,-1.6,-0.35,482.0,-4.63,True,1,16746,-459.67,-1593426.38,7697633.82,6104207.44
1994-09-26,460.82,1.15,0.25,482.0,-4.39,True,1,16747,-460.82,-1593887.2,7717352.54,6123465.34
1994-09-27,462.05,1.23,0.27,482.0,-4.14,True,1,16748,-462.05,-1594349.25,7738413.4,6144064.15
1994-09-28,464.84,2.79,0.6,482.0,-3.56,True,1,16749,-464.84,-1594814.09,7785605.16,6190791.07
1994-09-29,462.24,-2.6,-0.56,482.0,-4.1,True,1,16750,-462.24,-1595276.33,7742520.0,6147243.67
1994-09-30,462.71,0.47,0.1,482.0,-4.0,True,1,16751,-462.71,-1595739.04,7750855.21,6155116.17
1994-10-03,461.74,-0.97,-0.21,482.0,-4.2,True,1,16752,-461.74,-1596200.78,7735068.48,6138867.7
1994-10-04,454.59,-7.15,-1.55,482.0,-5.69,True,1,16753,-454.59,-1596655.37,7615746.27,6019090.9
1994-10-05,453.52,-1.07,-0.24,482.0,-5.91,True,1,16754,-453.52,-1597108.89,7598274.08,6001165.19
1994-10-06,452.36,-1.16,-0.26,482.0,-6.15,True,1,16755,-452.36,-1597561.25,7579291.8,5981730.55
1994-10-07,455.1,2.74,0.61,482.0,-5.58,True,1,16756,-455.1,-1598016.35,7625655.6,6027639.25
1994-10-10,459.04,3.94,0.87,482.0,-4.76,True,1,16757,-459.04,-1598475.39,7692133.28,6093657.89
1994-10-11,465.79,6.75,1.47,482.0,-3.36,True,1,16758,-465.79,-1598941.18,7805708.82,6206767.64
1994-10-12,465.47,-0.32,-0.07,482.0,-3.43,True,1,16759,-465.47,-1599406.65,7800811.73,6201405.08
1994-10-13,467.79,2.32,0.5,482.0,-2.95,True,1,16760,-467.79,-1599874.44,7840160.4,6240285.96
1994-10-14,469.1,1.31,0.28,482.0,-2.68,True,1,16761,-469.1,-1600343.54,7862585.1,6262241.56
1994-10-17,468.96,-0.14,-0.03,482.0,-2.7,True,1,16762,-468.96,-1600812.5,7860707.52,6259895.02
1994-10-18,467.66,-1.3,-0.28,482.0,-2.98,True,1,16763,-467.66,-1601280.16,7839384.58,6238104.42
1994-10-19,470.28,2.62,0.56,482.0,-2.43,True,1,16764,-470.28,-1601750.44,7883773.92,6282023.48
1994-10-20,466.85,-3.43,-0.73,482.0,-3.14,True,1,16765,-466.85,-1602217.29,7826740.25,6224522.96
1994-10-21,464.89,-1.96,-0.42,482.0,-3.55,True,1,16766,-464.89,-1602682.18,7794345.74,6191663.56
1994-10-24,460.83,-4.06,-0.87,482.0,-4.39,True,1,16767,-460.83,-1603143.01,7726736.61,6123593.6
1994-10-25,461.53,0.7,0.15,482.0,-4.25,True,1,16768,-461.53,-1603604.54,7738935.04,6135330.5
1994-10-26,462.62,1.09,0.24,482.0,-4.02,True,1,16769,-462.62,-1604067.16,7757674.78,6153607.62
1994-10-27,465.85,3.23,0.7,482.0,-3.35,True,1,16770,-465.85,-1604533.01,7812304.5,6207771.49
1994-10-28,473.77,7.92,1.7,482.0,-1.71,True,1,16771,-473.77,-1605006.78,7945596.67,6340589.89
1994-10-31,472.35,-1.42,-0.3,482.0,-2.0,True,1,16772,-472.35,-1605479.13,7922254.2,6316775.07
1994-11-01,468.42,-3.93,-0.83,482.0,-2.82,True,1,16773,-468.42,-1605947.55,7856808.66,6250861.11
1994-11-02,466.51,-1.91,-0.41,482.0,-3.21,True,1,16774,-466.51,-1606414.06,7825238.74,6218824.68
1994-11-03,467.91,1.4,0.3,482.0,-2.92,True,1,16775,-467.91,-1606881.97,7849190.25,6242308.28
1994-11-04,462.28,-5.63,-1.2,482.0,-4.09,True,1,16776,-462.28,-1607344.25,7755209.28,6147865.03
1994-11-07,463.07,0.79,0.17,482.0,-3.93,True,1,16777,-463.07,-1607807.32,7768925.39,6161118.07
1994-11-08,465.65,2.58,0.56,482.0,-3.39,True,1,16778,-465.65,-1608272.97,7812675.7,6204402.73
1994-11-09,465.4,-0.25,-0.05,482.0,-3.44,True,1,16779,-465.4,-1608738.37,7808946.6,6200208.23
1994-11-10,464.37,-1.03,-0.22,482.0,-3.66,True,1,16780,-464.37,-1609202.74,7792128.6,6182925.86
1994-11-11,462.35,-2.02,-0.44,482.0,-4.08,True,1,16781,-462.35,-1609665.09,7758695.35,6149030.26
1994-11-14,466.04,3.69,0.8,482.0,-3.31,True,1,16782,-466.04,-1610131.13,7821083.28,6210952.15
1994-11-15,465.03,-1.01,-0.22,482.0,-3.52,True,1,16783,-465.03,-1610596.16,7804598.49,6194002.33
1994-11-16,465.62,0.59,0.13,482.0,-3.4,True,1,16784,-465.62,-1611061.78,7814966.08,6203904.3
1994-11-17,463.57,-2.05,-0.44,482.0,-3.82,True,1,16785,-463.57,-1611525.35,7781022.45,6169497.1
1994-11-18,461.47,-2.1,-0.45,482.0,-4.26,True,1,16786,-461.47,-1611986.82,7746235.42,6134248.6
1994-11-21,458.3,-3.17,-0.69,482.0,-4.92,True,1,16787,-458.3,-1612445.12,7693482.1,6081036.98
1994-11-22,450.09,-8.21,-1.79,482.0,-6.62,True,1,16788,-450.09,-1612895.21,7556110.92,5943215.71
1994-11-23,449.93,-0.16,-0.04,482.0,-6.65,True,1,16789,-449.93,-1613345.14,7553874.77,5940529.63
1994-11-25,452.29,2.36,0.52,482.0,-6.16,True,1,16790,-452.29,-1613797.43,7593949.1,5980151.67
1994-11-28,454.16,1.87,0.41,482.0,-5.78,True,1,16791,-454.16,-1614251.59,7625800.56,6011548.97
1994-11-29,455.17,1.01,0.22,482.0,-5.57,True,1,16792,-455.17,-1614706.76,7643214.64,6028507.88
1994-11-30,453.69,-1.48,-0.32,482.0,-5.87,True,1,16793,-453.69,-1615160.45,7618816.17,6003655.72
1994-12-01,448.92,-4.77,-1.05,482.0,-6.86,True,1,16794,-448.92,-1615609.37,7539162.48,5923553.11
1994-12-02,453.3,4.38,0.98,482.0,-5.95,True,1,16795,-453.3,-1616062.67,7613173.5,5997110.83
1994-12-05,453.32,0.02,0.0,482.0,-5.95,True,1,16796,-453.32,-1616515.99,7613962.72,5997446.73
1994-12-06,453.11,-0.21,-0.05,482.0,-5.99,True,1,16797,-453.11,-1616969.1,7610888.67,5993919.57
1994-12-07,451.23,-1.88,-0.42,482.0,-6.38,True,1,16798,-451.23,-1617420.33,7579761.54,5962341.21
1994-12-08,445.45,-5.78,-1.28,482.0,-7.58,True,1,16799,-445.45,-1617865.78,7483114.55,5865248.77
1994-12-09,446.96,1.51,0.34,482.0,-7.27,True,1,16800,-446.96,-1618312.74,7508928.0,5890615.26
1994-12-12,449.47,2.51,0.56,482.0,-6.75,True,1,16801,-449.47,-1618762.21,7551545.47,5932783.26
1994-12-13,450.15,0.68,0.15,482.0,-6.61,True,1,16802,-450.15,-1619212.36,7563420.3,5944207.94
1994-12-14,454.97,4.82,1.07,482.0,-5.61,True,1,16803,-454.97,-1619667.33,7644860.91,6025193.58
1994-12-15,455.34,0.37,0.08,482.0,-5.53,True,1,16804,-455.34,-1620122.67,7651533.36,6031410.69
1994-12-16,458.8,3.46,0.76,482.0,-4.81,True,1,16805,-458.8,-1620581.47,7710134.0,6089552.53
1994-12-19,457.91,-0.89,-0.19,482.0,-5.0,True,1,16806,-457.91,-1621039.38,7695635.46,6074596.08
1994-12-20,457.1,-0.81,-0.18,482.0,-5.17,True,1,16807,-457.1,-1621496.48,7682479.7,6060983.22
1994-12-21,459.61,2.51,0.55,482.0,-4.64,True,1,16808,-459.61,-1621956.09,7725124.88,6103168.79
1994-12-22,459.68,0.07,0.02,482.0,-4.63,True,1,16809,-459.68,-1622415.77,7726761.12,6104345.35
1994-12-23,459.83,0.15,0.03,482.0,-4.6,True,1,16810,-459.83,-1622875.6,7729742.3,6106866.7
1994-12-27,462.47,2.64,0.57,482.0,-4.05,True,1,16811,-462.47,-1623338.07,7774583.17,6151245.1
1994-12-28,460.86,-1.61,-0.35,482.0,-4.39,True,1,16812,-460.86,-1623798.93,7747978.32,6124179.39
1994-12-29,461.17,0.31,0.07,482.0,-4.32,True,1,16813,-461.17,-1624260.1,7753651.21,6129391.11
1994-12-30,459.27,-1.9,-0.41,482.0,-4.72,True,1,16814,-459.27,-1624719.37,7722165.78,6097446.41
1995-01-03,459.11,-0.16,-0.04,482.0,-4.75,True,1,16815,-459.11,-1625178.48,7719934.65,6094756.17
1995-01-04,460.71,1.6,0.35,482.0,-4.42,True,1,16816,-460.71,-1625639.19,7747299.36,6121660.17
1995-01-05,460.34,-0.37,-0.08,482.0,-4.49,True,1,16817,-460.34,-1626099.53,7741537.78,6115438.25
1995-01-06,460.68,0.34,0.07,482.0,-4.42,True,1,16818,-460.68,-1626560.21,7747716.24,6121156.03
1995-01-09,460.83,0.15,0.03,482.0,-4.39,True,1,16819,-460.83,-1627021.04,7750699.77,6123678.73
1995-01-10,461.68,0.85,0.18,482.0,-4.22,True,1,16820,-461.68,-1627482.72,7765457.6,6137974.88
1995-01-11,461.66,-0.02,-0.0,482.0,-4.22,True,1,16821,-461.66,-1627944.38,7765582.86,6137638.48
1995-01-12,461.64,-0.02,-0.0,482.0,-4.22,True,1,16822,-461.64,-1628406.02,7765708.08,6137302.06
1995-01-13,465.97,4.33,0.94,482.0,-3.33,True,1,16823,-465.97,-1628871.99,7839013.31,6210141.32
1995-01-16,469.38,3.41,0.73,482.0,-2.62,True,1,16824,-469.38,-1629341.37,7896849.12,6267507.75
1995-01-17,470.05,0.67,0.14,482.0,-2.48,True,1,16825,-470.05,-1629811.42,7908591.25,6278779.83
1995-01-18,469.71,-0.34,-0.07,482.0,-2.55,True,1,16826,-469.71,-1630281.13,7903340.46,6273059.33
1995-01-19,466.95,-2.76,-0.59,482.0,-3.12,True,1,16827,-466.95,-1630748.08,7857367.65,6226619.57
1995-01-20,464.78,-2.17,-0.46,482.0,-3.57,True,1,16828,-464.78,-1631212.86,7821317.84,6190104.98
1995-01-23,465.82,1.04,0.22,482.0,-3.36,True,1,16829,-465.82,-1631678.68,7839284.78,6207606.1
1995-01-24,465.86,0.04,0.01,482.0,-3.35,True,1,16830,-465.86,-1632144.54,7840423.8,6208279.26
1995-01-25,467.44,1.58,0.34,482.0,-3.02,True,1,16831,-467.44,-1632611.98,7867482.64,6234870.66
1995-01-26,468.32,0.88,0.19,482.0,-2.84,True,1,16832,-468.32,-1633080.3,7882762.24,6249681.94
1995-01-27,470.39,2.07,0.44,482.0,-2.41,True,1,16833,-470.39,-1633550.69,7918074.87,6284524.18
1995-01-30,468.51,-1.88,-0.4,482.0,-2.8,True,1,16834,-468.51,-1634019.2,7886897.34,6252878.14
1995-01-31,470.42,1.91,0.41,482.0,-2.4,True,1,16835,-470.42,-1634489.62,7919520.7,6285031.08
1995-02-01,470.4,-0.02,-0.0,482.0,-2.41,True,1,16836,-470.4,-1634960.02,7919654.4,6284694.38
1995-02-02,472.79,2.39,0.51,482.0,-1.91,True,1,16837,-472.79,-1635432.81,7960365.23,6324932.42
1995-02-03,478.65,5.86,1.24,482.0,-0.7,True,1,16838,-478.65,-1635911.46,8059508.7,6423597.24
1995-02-06,481.14,2.49,0.52,482.0,-0.18,True,1,16839,-481.14,-1636392.6,8101916.46,6465523.86
1995-02-07,480.81,-0.33,-0.07,482.0,-0.25,True,1,16840,-480.81,-1636873.41,8096840.4,6459966.99
1995-02-08,481.19,0.38,0.08,482.0,-0.17,True,1,16841,-481.19,-1637354.6,8103720.79,6466366.19
1995-02-09,480.19,-1.0,-0.21,482.0,-0.38,True,1,16842,-480.19,-1637834.79,8087359.98,6449525.19
1995-02-10,481.46,1.27,0.26,482.0,-0.11,True,1,16843,-481.46,-1638316.25,8109230.78,6470914.53
1995-02-13,481.65,0.19,0.04,482.0,-0.07,True,1,16844,-481.65,-1638797.9,8112912.6,6474114.7
1995-02-14,482.55,0.9,0.19,482.55,0.0,True,1,16845,-482.55,-1639280.45,8128554.75,6489274.3
1995-02-15,484.54,1.99,0.41,484.54,0.0,True,1,16846,-484.54,-1639764.99,8162560.84,6522795.85
1995-02-16,485.22,0.68,0.14,485.22,0.0,True,1,16847,-485.22,-1640250.21,8174501.34,6534251.13
1995-02-17,481.97,-3.25,-0.67,485.22,-0.67,True,1,16848,-481.97,-1640732.18,8120230.56,6479498.38
1995-02-21,482.72,0.75,0.16,485.22,-0.52,True,1,16849,-482.72,-1641214.9,8133349.28,6492134.38
1995-02-22,485.07,2.35,0.49,485.22,-0.03,True,1,16850,-485.07,-1641699.97,8173429.5,6531729.53
1995-02-23,486.91,1.84,0.38,486.91,0.0,True,1,16851,-486.91,-1642186.88,8204920.41,6562733.53
1995-02-24,488.11,1.2,0.25,488.11,0.0,True,1,16852,-488.11,-1642674.99,8225629.72,6582954.73
1995-02-27,483.81,-4.3,-0.88,488.11,-0.88,True,1,16853,-483.81,-1643158.8,8153649.93,6510491.13
1995-02-28,487.39,3.58,0.74,488.11,-0.15,True,1,16854,-487.39,-1643646.19,8214471.06,6570824.87
1995-03-01,485.65,-1.74,-0.36,488.11,-0.5,True,1,16855,-485.65,-1644131.84,8185630.75,6541498.91
1995-03-02,485.13,-0.52,-0.11,488.11,-0.61,True,1,16856,-485.13,-1644616.97,8177351.28,6532734.31
1995-03-03,485.42,0.29,0.06,488.11,-0.55,True,1,16857,-485.42,-1645102.39,8182724.94,6537622.55
1995-03-06,485.63,0.21,0.04,488.11,-0.51,True,1,16858,-485.63,-1645588.02,8186750.54,6541162.52
1995-03-07,482.12,-3.51,-0.72,488.11,-1.23,True,1,16859,-482.12,-1646070.14,8128061.08,6481990.94
1995-03-08,483.14,1.02,0.21,488.11,-1.02,True,1,16860,-483.14,-1646553.28,8145740.4,6499187.12
1995-03-09,483.16,0.02,0.0,488.11,-1.01,True,1,16861,-483.16,-1647036.44,8146560.76,6499524.32
1995-03-10,489.57,6.41,1.33,489.57,0.0,True,1,16862,-489.57,-1647526.01,8255129.34,6607603.33
1995-03-13,490.05,0.48,0.1,490.05,0.0,True,1,16863,-490.05,-1648016.06,8263713.15,6615697.09
1995-03-14,492.89,2.84,0.58,492.89,0.0,True,1,16864,-492.89,-1648508.95,8312096.96,6663588.01
1995-03-15,491.88,-1.01,-0.2,492.89,-0.2,True,1,16865,-491.88,-1649000.83,8295556.2,6646555.37
1995-03-16,495.41,3.53,0.72,495.41,0.0,True,1,16866,-495.41,-1649496.24,8355585.06,6706088.82
1995-03-17,495.52,0.11,0.02,495.52,0.0,True,1,16867,-495.52,-1649991.76,8357935.84,6707944.08
1995-03-20,496.14,0.62,0.12,496.14,0.0,True,1,16868,-496.14,-1650487.9,8368889.52,6718401.62
1995-03-21,495.07,-1.07,-0.22,496.14,-0.22,True,1,16869,-495.07,-1650982.97,8351335.83,6700352.86
1995-03-22,495.67,0.6,0.12,496.14,-0.1,True,1,16870,-495.67,-1651478.64,8361952.9,6710474.26
1995-03-23,495.95,0.28,0.06,496.14,-0.04,True,1,16871,-495.95,-1651974.59,8367172.45,6715197.86
1995-03-24,500.97,5.02,1.01,500.97,0.0,True,1,16872,-500.97,-1652475.56,8452365.84,6799890.28
1995-03-27,503.2,2.23,0.44,503.2,0.0,True,1,16873,-503.2,-1652978.76,8490493.6,6837514.84
1995-03-28,503.9,0.7,0.14,503.9,0.0,True,1,16874,-503.9,-1653482.66,8502808.6,6849325.94
1995-03-29,503.12,-0.78,-0.16,503.9,-0.16,True,1,16875,-503.12,-1653985.78,8490150.0,6836164.22
1995-03-30,502.22,-0.9,-0.18,503.9,-0.33,True,1,16876,-502.22,-1654488.0,8475464.72,6820976.72
1995-03-31,500.71,-1.51,-0.3,503.9,-0.63,True,1,16877,-500.71,-1654988.71,8450482.67,6795493.96
1995-04-03,501.85,1.14,0.23,503.9,-0.41,True,1,16878,-501.85,-1655490.56,8470224.3,6814733.74
1995-04-04,505.24,3.39,0.68,505.24,0.0,True,1,16879,-505.24,-1655995.8,8527945.96,6871950.16
1995-04-05,505.57,0.33,0.06,505.57,0.0,True,1,16880,-505.57,-1656501.37,8534021.6,6877520.23
1995-04-06,506.08,0.51,0.1,506.08,0.0,True,1,16881,-506.08,-1657007.45,8543136.48,6886129.03
1995-04-07,506.42,0.34,0.07,506.42,0.0,True,1,16882,-506.42,-1657513.87,8549382.44,6891868.57
1995-04-10,507.01,0.59,0.12,507.01,0.0,True,1,16883,-507.01,-1658020.88,8559849.83,6901828.95
1995-04-11,505.53,-1.48,-0.29,507.01,-0.29,True,1,16884,-505.53,-1658526.41,8535368.52,6876842.11
1995-04-12,507.17,1.64,0.32,507.17,0.0,True,1,16885,-507.17,-1659033.58,8563565.45,6904531.87
1995-04-13,509.23,2.06,0.41,509.23,0.0,True,1,16886,-509.23,-1659542.81,8598857.78,6939314.97
1995-04-17,506.13,-3.1,-0.61,509.23,-0.61,True,1,16887,-506.13,-1660048.94,8547017.31,6886968.37
1995-04-18,505.37,-0.76,-0.15,509.23,-0.76,True,1,16888,-505.37,-1660554.31,8534688.56,6874134.25
1995-04-19,504.92,-0.45,-0.09,509.23,-0.85,True,1,16889,-504.92,-1661059.23,8527593.88,6866534.65
1995-04-20,505.29,0.37,0.07,509.23,-0.77,True,1,16890,-505.29,-1661564.52,8534348.1,6872783.58
1995-04-21,508.49,3.2,0.63,509.23,-0.14,True,1,16891,-508.49,-1662073.01,8588904.59,6926831.58
1995-04-24,512.89,4.4,0.86,512.89,0.0,True,1,16892,-512.89,-1662585.9,8663737.88,7001151.98
1995-04-25,512.1,-0.79,-0.15,512.89,-0.15,True,1,16893,-512.1,-1663098.0,8650905.3,6987807.3
1995-04-26,512.66,0.56,0.11,512.89,-0.04,True,1,16894,-512.66,-1663610.66,8660878.04,6997267.38
1995-04-27,513.55,0.89,0.17,513.55,0.0,True,1,16895,-513.55,-1664124.21,8676427.25,7012303.04
1995-04-28,514.71,1.16,0.23,514.71,0.0,True,1,16896,-514.71,-1664638.92,8696540.16,7031901.24
1995-05-01,514.26,-0.45,-0.09,514.71,-0.09,True,1,16897,-514.26,-1665153.18,8689451.22,7024298.04
1995-05-02,514.86,0.6,0.12,514.86,0.0,True,1,16898,-514.86,-1665668.04,8700104.28,7034436.24
1995-05-03,520.48,5.62,1.09,520.48,0.0,True,1,16899,-520.48,-1666188.52,8795591.52,7129403.0
1995-05-04,520.54,0.06,0.01,520.54,0.0,True,1,16900,-520.54,-1666709.06,8797126.0,7130416.94
1995-05-05,520.12,-0.42,-0.08,520.54,-0.08,True,1,16901,-520.12,-1667229.18,8790548.12,7123318.94
1995-05-08,523.96,3.84,0.74,523.96,0.0,True,1,16902,-523.96,-1667753.14,8855971.92,7188218.78
1995-05-09,523.56,-0.4,-0.08,523.96,-0.08,True,1,16903,-523.56,-1668276.7,8849734.68,7181457.98
1995-05-10,524.36,0.8,0.15,524.36,0.0,True,1,16904,-524.36,-1668801.06,8863781.44,7194980.38
1995-05-11,524.37,0.01,0.0,524.37,0.0,True,1,16905,-524.37,-1669325.43,8864474.85,7195149.42
1995-05-12,525.55,1.18,0.22,525.55,0.0,True,1,16906,-525.55,-1669850.98,8884948.3,7215097.32
1995-05-15,527.74,2.19,0.42,527.74,0.0,True,1,16907,-527.74,-1670378.72,8922500.18,7252121.46
1995-05-16,528.19,0.45,0.08,528.19,0.0,True,1,16908,-528.19,-1670906.91,8930636.52,7259729.61
1995-05-17,527.07,-1.12,-0.21,528.19,-0.21,True,1,16909,-527.07,-1671433.98,8912226.63,7240792.65
1995-05-18,519.58,-7.49,-1.42,528.19,-1.63,True,1,16910,-519.58,-1671953.56,8786097.8,7114144.24
1995-05-19,519.19,-0.39,-0.08,528.19,-1.7,True,1,16911,-519.19,-1672472.75,8780022.09,7107549.34
1995-05-22,523.65,4.46,0.86,528.19,-0.86,True,1,16912,-523.65,-1672996.4,8855968.8,7182972.4
1995-05-23,528.59,4.94,0.94,528.59,0.0,True,1,16913,-528.59,-1673524.99,8940042.67,7266517.68
1995-05-24,528.61,0.02,0.0,528.61,0.0,True,1,16914,-528.61,-1674053.6,8940909.54,7266855.94
1995-05-25,528.59,-0.02,-0.0,528.61,-0.0,True,1,16915,-528.59,-1674582.19,8941099.85,7266517.66
1995-05-26,523.65,-4.94,-0.94,528.61,-0.94,True,1,16916,-523.65,-1675105.84,8858063.4,7182957.56
1995-05-30,523.58,-0.07,-0.01,528.61,-0.95,True,1,16917,-523.58,-1675629.42,8857402.86,7181773.44
1995-05-31,533.4,9.82,1.88,533.4,0.0,True,1,16918,-533.4,-1676162.82,9024061.2,7347898.38
1995-06-01,533.49,0.09,0.02,533.49,0.0,True,1,16919,-533.49,-1676696.31,9026117.31,7349421.0
1995-06-02,532.51,-0.98,-0.18,533.49,-0.18,True,1,16920,-532.51,-1677228.82,9010069.2,7332840.38
1995-06-05,535.6,3.09,0.58,535.6,0.0,True,1,16921,-535.6,-1677764.42,9062887.6,7385123.18
1995-06-06,535.55,-0.05,-0.01,535.6,-0.01,True,1,16922,-535.55,-1678299.97,9062577.1,7384277.13
1995-06-07,533.13,-2.42,-0.45,535.6,-0.46,True,1,16923,-533.13,-1678833.1,9022158.99,7343325.89
1995-06-08,532.35,-0.78,-0.15,535.6,-0.61,True,1,16924,-532.35,-1679365.45,9009491.4,7330125.95
1995-06-09,527.94,-4.41,-0.83,535.6,-1.43,True,1,16925,-527.94,-1679893.39,8935384.5,7255491.11
1995-06-12,530.88,2.94,0.56,535.6,-0.88,True,1,16926,-530.88,-1680424.27,8985674.88,7305250.61
1995-06-13,536.05,5.17,0.97,536.05,0.0,True,1,16927,-536.05,-1680960.32,9073718.35,7392758.03
1995-06-14,536.47,0.42,0.08,536.47,0.0,True,1,16928,-536.47,-1681496.79,9081364.16,7399867.37
1995-06-15,537.12,0.65,0.12,537.12,0.0,True,1,16929,-537.12,-1682033.91,9092904.48,7410870.57
1995-06-16,539.83,2.71,0.5,539.83,0.0,True,1,16930,-539.83,-1682573.74,9139321.9,7456748.16
1995-06-19,545.22,5.39,1.0,545.22,0.0,True,1,16931,-545.22,-1683118.96,9231119.82,7548000.86
1995-06-20,544.98,-0.24,-0.04,545.22,-0.04,True,1,16932,-544.98,-1683663.94,9227601.36,7543937.42
1995-06-21,543.98,-1.0,-0.18,545.22,-0.23,True,1,16933,-543.98,-1684207.92,9211213.34,7527005.42
1995-06-22,551.07,7.09,1.3,551.07,0.0,True,1,16934,-551.07,-1684758.99,9331819.38,7647060.39
1995-06-23,549.71,-1.36,-0.25,551.07,-0.25,True,1,16935,-549.71,-1685308.7,9309338.85,7624030.15
1995-06-26,544.13,-5.58,-1.01,551.07,-1.26,True,1,16936,-544.13,-1685852.83,9215385.68,7529532.85
1995-06-27,542.43,-1.7,-0.31,551.07,-1.57,True,1,16937,-542.43,-1686395.26,9187136.91,7500741.65
1995-06-28,544.73,2.3,0.42,551.07,-1.15,True,1,16938,-544.73,-1686939.99,9226636.74,7539696.75
1995-06-29,543.87,-0.86,-0.16,551.07,-1.31,True,1,16939,-543.87,-1687483.86,9212613.93,7525130.07
1995-06-30,544.75,0.88,0.16,551.07,-1.15,True,1,16940,-544.75,-1688028.61,9228065.0,7540036.39
1995-07-03,547.09,2.34,0.43,551.07,-0.72,True,1,16941,-547.09,-1688575.7,9268251.69,7579675.99
1995-07-05,547.26,0.17,0.03,551.07,-0.69,True,1,16942,-547.26,-1689122.96,9271678.92,7582555.96
1995-07-06,553.99,6.73,1.23,553.99,0.0,True,1,16943,-553.99,-1689676.95,9386252.57,7696575.62
1995-07-07,556.37,2.38,0.43,556.37,0.0,True,1,16944,-556.37,-1690233.32,9427133.28,7736899.96
1995-07-10,557.19,0.82,0.15,557.19,0.0,True,1,16945,-557.19,-1690790.51,9441584.55,7750794.04
1995-07-11,554.78,-2.41,-0.43,557.19,-0.43,True,1,16946,-554.78,-1691345.29,9401301.88,7709956.59
1995-07-12,560.89,6.11,1.1,560.89,0.0,True,1,16947,-560.89,-1691906.18,9505402.83,7813496.65
1995-07-13,561.0,0.11,0.02,561.0,0.0,True,1,16948,-561.0,-1692467.18,9507828.0,7815360.82
1995-07-14,559.89,-1.11,-0.2,561.0,-0.2,True,1,16949,-559.89,-1693027.07,9489575.61,7796548.54
1995-07-17,562.72,2.83,0.5,562.72,0.0,True,1,16950,-562.72,-1693589.79,9538104.0,7844514.21
1995-07-18,558.46,-4.26,-0.76,562.72,-0.76,True,1,16951,-558.46,-1694148.25,9466455.46,7772307.21
1995-07-19,550.98,-7.48,-1.34,562.72,-2.09,True,1,16952,-550.98,-1694699.23,9340212.96,7645513.73
1995-07-20,553.54,2.56,0.46,562.72,-1.63,True,1,16953,-553.54,-1695252.77,9384163.62,7688910.85
1995-07-21,553.62,0.08,0.01,562.72,-1.62,True,1,16954,-553.62,-1695806.39,9386073.48,7690267.09
1995-07-24,556.63,3.01,0.54,562.72,-1.08,True,1,16955,-556.63,-1696363.02,9437661.65,7741298.63
1995-07-25,561.1,4.47,0.8,562.72,-0.29,True,1,16956,-561.1,-1696924.12,9514011.6,7817087.48
1995-07-26,561.61,0.51,0.09,562.72,-0.2,True,1,16957,-561.61,-1697485.73,9523220.77,7825735.04
1995-07-27,565.22,3.61,0.64,565.22,0.0,True,1,16958,-565.22,-1698050.95,9585000.76,7886949.81
1995-07-28,562.93,-2.29,-0.4,565.22,-0.4,True,1,16959,-562.93,-1698613.88,9546729.87,7848115.99
1995-07-31,562.06,-0.87,-0.16,565.22,-0.56,True,1,16960,-562.06,-1699175.94,9532537.6,7833361.66
1995-08-01,559.64,-2.42,-0.43,565.22,-0.99,True,1,16961,-559.64,-1699735.58,9492054.04,7792318.46
1995-08-02,558.8,-0.84,-0.15,565.22,-1.14,True,1,16962,-558.8,-1700294.38,9478365.6,7778071.22
1995-08-03,558.75,-0.05,-0.01,565.22,-1.14,True,1,16963,-558.75,-1700853.13,9478076.25,7777223.12
1995-08-04,558.94,0.19,0.03,565.22,-1.11,True,1,16964,-558.94,-1701412.07,9481858.16,7780446.09
1995-08-07,560.03,1.09,0.2,565.22,-0.92,True,1,16965,-560.03,-1701972.1,9500908.95,7798936.85
1995-08-08,560.39,0.36,0.06,565.22,-0.86,True,1,16966,-560.39,-1702532.49,9507576.74,7805044.25
1995-08-09,559.71,-0.68,-0.12,565.22,-0.98,True,1,16967,-559.71,-1703092.2,9496599.57,7793507.37
1995-08-10,557.45,-2.26,-0.4,565.22,-1.38,True,1,16968,-557.45,-1703649.65,9458811.6,7755161.95
1995-08-11,555.11,-2.34,-0.42,565.22,-1.79,True,1,16969,-555.11,-1704204.76,9419661.59,7715456.83
1995-08-14,559.74,4.63,0.83,565.22,-0.97,True,1,16970,-559.74,-1704764.5,9498787.8,7794023.3
1995-08-15,558.57,-1.17,-0.21,565.22,-1.18,True,1,16971,-558.57,-1705323.07,9479491.47,7774168.4
1995-08-16,559.97,1.4,0.25,565.22,-0.93,True,1,16972,-559.97,-1705883.04,9503810.84,7797927.8
1995-08-17,559.04,-0.93,-0.17,565.22,-1.09,True,1,16973,-559.04,-1706442.08,9488585.92,7782143.84
1995-08-18,559.21,0.17,0.03,565.22,-1.06,True,1,16974,-559.21,-1707001.29,9492030.54,7785029.25
1995-08-21,558.11,-1.1,-0.2,565.22,-1.26,True,1,16975,-558.11,-1707559.4,9473917.25,7766357.85
1995-08-22,559.52,1.41,0.25,565.22,-1.01,True,1,16976,-559.52,-1708118.92,9498411.52,7790292.6
1995-08-23,557.14,-2.38,-0.42,565.22,-1.43,True,1,16977,-557.14,-1708676.06,9458565.78,7749889.72
1995-08-24,557.46,0.32,0.06,565.22,-1.37,True,1,16978,-557.46,-1709233.52,9464555.88,7755322.36
1995-08-25,560.1,2.64,0.47,565.22,-0.91,True,1,16979,-560.1,-1709793.62,9509937.9,7800144.28
1995-08-28,559.05,-1.05,-0.19,565.22,-1.09,True,1,16980,-559.05,-1710352.67,9492669.0,7782316.33
1995-08-29,560.0,0.95,0.17,565.22,-0.92,True,1,16981,-560.0,-1710912.67,9509360.0,7798447.33
1995-08-30,560.92,0.92,0.16,565.22,-0.76,True,1,16982,-560.92,-1711473.59,9525543.44,7814069.85
1995-08-31,561.88,0.96,0.17,565.22,-0.59,True,1,16983,-561.88,-1712035.47,9542408.04,7830372.57
1995-09-01,563.84,1.96,0.35,565.22,-0.24,True,1,16984,-563.84,-1712599.31,9576258.56,7863659.25
1995-09-05,569.17,5.33,0.94,569.17,0.0,True,1,16985,-569.17,-1713168.48,9667352.45,7954183.97
1995-09-06,570.17,1.0,0.18,570.17,0.0,True,1,16986,-570.17,-1713738.65,9684907.62,7971168.97
1995-09-07,570.29,0.12,0.02,570.29,0.0,True,1,16987,-570.29,-1714308.94,9687516.23,7973207.29
1995-09-08,572.68,2.39,0.42,572.68,0.0,True,1,16988,-572.68,-1714881.62,9728687.84,8013806.22
1995-09-11,573.91,1.23,0.22,573.91,0.0,True,1,16989,-573.91,-1715455.53,9750156.99,8034701.46
1995-09-12,576.51,2.6,0.45,576.51,0.0,True,1,16990,-576.51,-1716032.04,9794904.9,8078872.86
1995-09-13,578.77,2.26,0.39,578.77,0.0,True,1,16991,-578.77,-1716610.81,9833881.07,8117270.26
1995-09-14,583.61,4.84,0.84,583.61,0.0,True,1,16992,-583.61,-1717194.42,9916701.12,8199506.7
1995-09-15,583.35,-0.26,-0.04,583.61,-0.04,True,1,16993,-583.35,-1717777.77,9912866.55,8195088.78
1995-09-18,582.77,-0.58,-0.1,583.61,-0.14,True,1,16994,-582.77,-1718360.54,9903593.38,8185232.84
1995-09-19,584.2,1.43,0.24,584.2,0.0,True,1,16995,-584.2,-1718944.74,9928479.0,8209534.26
1995-09-20,586.77,2.57,0.44,586.77,0.0,True,1,16996,-586.77,-1719531.51,9972742.92,8253211.41
1995-09-21,583.0,-3.77,-0.64,586.77,-0.64,True,1,16997,-583.0,-1720114.51,9909251.0,8189136.49
1995-09-22,581.73,-1.27,-0.22,586.77,-0.86,True,1,16998,-581.73,-1720696.24,9888246.54,8167550.3
1995-09-25,581.81,0.08,0.01,586.77,-0.84,True,1,16999,-581.81,-1721278.05,9890188.19,8168910.14
1995-09-26,581.41,-0.4,-0.07,586.77,-0.91,True,1,17000,-581.41,-1721859.46,9883970.0,8162110.54
1995-09-27,581.04,-0.37,-0.06,586.77,-0.98,True,1,17001,-581.04,-1722440.5,9878261.04,8155820.54
1995-09-28,585.87,4.83,0.83,586.77,-0.15,True,1,17002,-585.87,-1723026.37,9960961.74,8237935.37
1995-09-29,584.41,-1.46,-0.25,586.77,-0.4,True,1,17003,-584.41,-1723610.78,9936723.23,8213112.45
1995-10-02,581.72,-2.69,-0.46,586.77,-0.86,True,1,17004,-581.72,-1724192.5,9891566.88,8167374.38
1995-10-03,582.34,0.62,0.11,586.77,-0.76,True,1,17005,-582.34,-1724774.84,9902691.7,8177916.86
1995-10-04,581.47,-0.87,-0.15,586.77,-0.9,True,1,17006,-581.47,-1725356.31,9888478.82,8163122.51
1995-10-05,582.63,1.16,0.2,586.77,-0.71,True,1,17007,-582.63,-1725938.94,9908788.41,8182849.47
1995-10-06,582.49,-0.14,-0.02,586.77,-0.73,True,1,17008,-582.49,-1726521.43,9906989.92,8180468.49
1995-10-09,578.37,-4.12,-0.71,586.77,-1.43,True,1,17009,-578.37,-1727099.8,9837495.33,8110395.53
1995-10-10,577.52,-0.85,-0.15,586.77,-1.58,True,1,17010,-577.52,-1727677.32,9823615.2,8095937.88
1995-10-11,579.46,1.94,0.34,586.77,-1.25,True,1,17011,-579.46,-1728256.78,9857194.06,8128937.28
1995-10-12,583.1,3.64,0.63,586.77,-0.62,True,1,17012,-583.1,-1728839.88,9919697.2,8190857.32
1995-10-13,584.5,1.4,0.24,586.77,-0.39,True,1,17013,-584.5,-1729424.38,9944098.5,8214674.12
1995-10-16,583.03,-1.47,-0.25,586.77,-0.64,True,1,17014,-583.03,-1730007.41,9919672.42,8189665.01
1995-10-17,586.78,3.75,0.64,586.78,0.0,True,1,17015,-586.78,-1730594.19,9984061.7,8253467.51
1995-10-18,587.44,0.66,0.11,587.44,0.0,True,1,17016,-587.44,-1731181.63,9995879.04,8264697.41
1995-10-19,590.65,3.21,0.55,590.65,0.0,True,1,17017,-590.65,-1731772.28,10051091.05,8319318.77
1995-10-20,587.46,-3.19,-0.54,590.65,-0.54,True,1,17018,-587.46,-1732359.74,9997394.28,8265034.54
1995-10-23,585.06,-2.4,-0.41,590.65,-0.95,True,1,17019,-585.06,-1732944.8,9957136.14,8224191.34
1995-10-24,586.54,1.48,0.25,590.65,-0.7,True,1,17020,-586.54,-1733531.34,9982910.8,8249379.46
1995-10-25,582.47,-4.07,-0.69,590.65,-1.38,True,1,17021,-582.47,-1734113.81,9914221.87,8180108.06
1995-10-26,576.72,-5.75,-0.99,590.65,-2.36,True,1,17022,-576.72,-1734690.53,9816927.84,8082237.31
1995-10-27,579.7,2.98,0.52,590.65,-1.85,True,1,17023,-579.7,-1735270.23,9868233.1,8132962.87
1995-10-30,583.25,3.55,0.61,590.65,-1.25,True,1,17024,-583.25,-1735853.48,9929248.0,8193394.52
1995-10-31,581.5,-1.75,-0.3,590.65,-1.55,True,1,17025,-581.5,-1736434.98,9900037.5,8163602.52
1995-11-01,584.22,2.72,0.47,590.65,-1.09,True,1,17026,-584.22,-1737019.2,9946929.72,8209910.52
1995-11-02,589.72,5.5,0.94,590.65,-0.16,True,1,17027,-589.72,-1737608.92,10041162.44,8303553.52
1995-11-03,590.57,0.85,0.14,590.65,-0.01,True,1,17028,-590.57,-1738199.49,10056225.96,8318026.47
1995-11-06,588.46,-2.11,-0.36,590.65,-0.37,True,1,17029,-588.46,-1738787.95,10020885.34,8282097.39
1995-11-07,586.32,-2.14,-0.36,590.65,-0.73,True,1,17030,-586.32,-1739374.27,9985029.6,8245655.33
1995-11-08,591.71,5.39,0.92,591.71,0.0,True,1,17031,-591.71,-1739965.98,10077413.01,8337447.03
1995-11-09,593.26,1.55,0.26,593.26,0.0,True,1,17032,-593.26,-1740559.24,10104404.32,8363845.08
1995-11-10,592.72,-0.54,-0.09,593.26,-0.09,True,1,17033,-592.72,-1741151.96,10095799.76,8354647.8
1995-11-13,592.3,-0.42,-0.07,593.26,-0.16,True,1,17034,-592.3,-1741744.26,10089238.2,8347493.94
1995-11-14,589.29,-3.01,-0.51,593.26,-0.67,True,1,17035,-589.29,-1742333.55,10038555.15,8296221.6
1995-11-15,593.96,4.67,0.79,593.96,0.0,True,1,17036,-593.96,-1742927.51,10118702.56,8375775.05
1995-11-16,597.34,3.38,0.57,597.34,0.0,True,1,17037,-597.34,-1743524.85,10176881.58,8433356.73
1995-11-17,600.07,2.73,0.46,600.07,0.0,True,1,17038,-600.07,-1744124.92,10223992.66,8479867.74
1995-11-20,596.85,-3.22,-0.54,600.07,-0.54,True,1,17039,-596.85,-1744721.77,10169727.15,8425005.38
1995-11-21,600.24,3.39,0.57,600.24,0.0,True,1,17040,-600.24,-1745322.01,10228089.6,8482767.59
1995-11-22,598.4,-1.84,-0.31,600.24,-0.31,True,1,17041,-598.4,-1745920.41,10197334.4,8451413.99
1995-11-24,599.97,1.57,0.26,600.24,-0.04,True,1,17042,-599.97,-1746520.38,10224688.74,8478168.36
1995-11-27,601.32,1.35,0.22,601.32,0.0,True,1,17043,-601.32,-1747121.7,10248296.76,8501175.06
1995-11-28,606.45,5.13,0.85,606.45,0.0,True,1,17044,-606.45,-1747728.15,10336333.8,8588605.65
1995-11-29,607.64,1.19,0.2,607.64,0.0,True,1,17045,-607.64,-1748335.79,10357223.8,8608888.01
1995-11-30,605.37,-2.27,-0.37,607.64,-0.37,True,1,17046,-605.37,-1748941.16,10319137.02,8570195.86
1995-12-01,606.98,1.61,0.27,607.64,-0.11,True,1,17047,-606.98,-1749548.14,10347188.06,8597639.92
1995-12-04,613.68,6.7,1.1,613.68,0.0,True,1,17048,-613.68,-1750161.82,10462016.64,8711854.82
1995-12-05,617.68,4.0,0.65,617.68,0.0,True,1,17049,-617.68,-1750779.5,10530826.32,8780046.82
1995-12-06,620.18,2.5,0.4,620.18,0.0,True,1,17050,-620.18,-1751399.68,10574069.0,8822669.32
1995-12-07,616.17,-4.01,-0.65,620.18,-0.65,True,1,17051,-616.17,-1752015.85,10506314.67,8754298.82
1995-12-08,617.48,1.31,0.21,620.18,-0.44,True,1,17052,-617.48,-1752633.33,10529268.96,8776635.63
1995-12-11,619.52,2.04,0.33,620.18,-0.11,True,1,17053,-619.52,-1753252.85,10564674.56,8811421.71
1995-12-12,618.78,-0.74,-0.12,620.18,-0.23,True,1,17054,-618.78,-1753871.63,10552674.12,8798802.49
1995-12-13,621.69,2.91,0.47,621.69,0.0,True,1,17055,-621.69,-1754493.32,10602922.95,8848429.63
1995-12-14,616.92,-4.77,-0.77,621.69,-0.77,True,1,17056,-616.92,-1755110.24,10522187.52,8767077.28
1995-12-15,616.34,-0.58,-0.09,621.69,-0.86,True,1,17057,-616.34,-1755726.58,10512911.38,8757184.8
1995-12-18,606.81,-9.53,-1.55,621.69,-2.39,True,1,17058,-606.81,-1756333.39,10350964.98,8594631.59
1995-12-19,611.93,5.12,0.84,621.69,-1.57,True,1,17059,-611.93,-1756945.32,10438913.87,8681968.55
1995-12-20,605.94,-5.99,-0.98,621.69,-2.53,True,1,17060,-605.94,-1757551.26,10337336.4,8579785.14
1995-12-21,610.49,4.55,0.75,621.69,-1.8,True,1,17061,-610.49,-1758161.75,10415569.89,8657408.14
1995-12-22,611.95,1.46,0.24,621.69,-1.57,True,1,17062,-611.95,-1758773.7,10441090.9,8682317.2
1995-12-26,614.3,2.35,0.38,621.69,-1.19,True,1,17063,-614.3,-1759388.0,10481800.9,8722412.9
1995-12-27,614.53,0.23,0.04,621.69,-1.15,True,1,17064,-614.53,-1760002.53,10486339.92,8726337.39
1995-12-28,614.12,-0.41,-0.07,621.69,-1.22,True,1,17065,-614.12,-1760616.65,10479957.8,8719341.15
1995-12-29,615.93,1.81,0.3,621.69,-0.93,True,1,17066,-615.93,-1761232.58,10511461.38,8750228.8
1996-01-02,620.73,4.8,0.78,621.69,-0.15,True,1,17067,-620.73,-1761853.31,10593998.91,8832145.6
1996-01-03,621.32,0.59,0.1,621.69,-0.06,True,1,17068,-621.32,-1762474.63,10604689.76,8842215.13
1996-01-04,617.7,-3.62,-0.58,621.69,-0.64,True,1,17069,-617.7,-1763092.33,10543521.3,8780428.97
1996-01-05,616.71,-0.99,-0.16,621.69,-0.8,True,1,17070,-616.71,-1763709.04,10527239.7,8763530.66
1996-01-08,618.46,1.75,0.28,621.69,-0.52,True,1,17071,-618.46,-1764327.5,10557730.66,8793403.16
1996-01-09,609.45,-9.01,-1.46,621.69,-1.97,True,1,17072,-609.45,-1764936.95,10404530.4,8639593.45
1996-01-10,598.48,-10.97,-1.8,621.69,-3.73,True,1,17073,-598.48,-1765535.43,10217849.04,8452313.61
1996-01-11,602.69,4.21,0.7,621.69,-3.06,True,1,17074,-602.69,-1766138.12,10290329.06,8524190.94
1996-01-12,601.81,-0.88,-0.15,621.69,-3.2,True,1,17075,-601.81,-1766739.93,10275905.75,8509165.82
1996-01-15,599.82,-1.99,-0.33,621.69,-3.52,True,1,17076,-599.82,-1767339.75,10242526.32,8475186.57
1996-01-16,608.44,8.62,1.44,621.69,-2.13,True,1,17077,-608.44,-1767948.19,10390329.88,8622381.69
1996-01-17,606.37,-2.07,-0.34,621.69,-2.46,True,1,17078,-606.37,-1768554.56,10355586.86,8587032.3
1996-01-18,608.24,1.87,0.31,621.69,-2.16,True,1,17079,-608.24,-1769162.8,10388130.96,8618968.16
1996-01-19,611.83,3.59,0.59,621.69,-1.59,True,1,17080,-611.83,-1769774.63,10450056.4,8680281.77
1996-01-22,613.4,1.57,0.26,621.69,-1.33,True,1,17081,-613.4,-1770388.03,10477485.4,8707097.37
1996-01-23,612.79,-0.61,-0.1,621.69,-1.43,True,1,17082,-612.79,-1771000.82,10467678.78,8696677.96
1996-01-24,619.96,7.17,1.17,621.69,-0.28,True,1,17083,-619.96,-1771620.78,10590776.68,8819155.9
1996-01-25,617.03,-2.93,-0.47,621.69,-0.75,True,1,17084,-617.03,-1772237.81,10541340.52,8769102.71
1996-01-26,621.62,4.59,0.74,621.69,-0.01,True,1,17085,-621.62,-1772859.43,10620377.7,8847518.27
1996-01-29,624.22,2.6,0.42,624.22,0.0,True,1,17086,-624.22,-1773483.65,10665422.92,8891939.27
1996-01-30,630.15,5.93,0.95,630.15,0.0,True,1,17087,-630.15,-1774113.8,10767373.05,8993259.25
1996-01-31,636.02,5.87,0.93,636.02,0.0,True,1,17088,-636.02,-1774749.82,10868309.76,9093559.94
1996-02-01,638.46,2.44,0.38,638.46,0.0,True,1,17089,-638.46,-1775388.28,10910642.94,9135254.66
1996-02-02,635.84,-2.62,-0.41,638.46,-0.41,True,1,17090,-635.84,-1776024.12,10866505.6,9090481.48
1996-02-05,641.43,5.59,0.88,641.43,0.0,True,1,17091,-641.43,-1776665.55,10962680.13,9186014.58
1996-02-06,646.33,4.9,0.76,646.33,0.0,True,1,17092,-646.33,-1777311.88,11047072.36,9269760.48
1996-02-07,649.93,3.6,0.56,649.93,0.0,True,1,17093,-649.93,-1777961.81,11109253.49,9331291.68
1996-02-08,656.07,6.14,0.94,656.07,0.0,True,1,17094,-656.07,-1778617.88,11214860.58,9436242.7
1996-02-09,656.37,0.3,0.05,656.37,0.0,True,1,17095,-656.37,-1779274.25,11220645.15,9441370.9
1996-02-12,661.45,5.08,0.77,661.45,0.0,True,1,17096,-661.45,-1779935.7,11308149.2,9528213.5
1996-02-13,660.51,-0.94,-0.14,661.45,-0.14,True,1,17097,-660.51,-1780596.21,11292739.47,9512143.26
1996-02-14,655.58,-4.93,-0.75,661.45,-0.89,True,1,17098,-655.58,-1781251.79,11209106.84,9427855.05
1996-02-15,651.32,-4.26,-0.65,661.45,-1.53,True,1,17099,-651.32,-1781903.11,11136920.68,9355017.57
1996-02-16,647.98,-3.34,-0.51,661.45,-2.04,True,1,17100,-647.98,-1782551.09,11080458.0,9297906.91
1996-02-20,640.65,-7.33,-1.13,661.45,-3.14,True,1,17101,-640.65,-1783191.74,10955755.65,9172563.91
1996-02-21,648.1,7.45,1.16,661.45,-2.02,True,1,17102,-648.1,-1783839.84,11083806.2,9299966.36
1996-02-22,658.86,10.76,1.66,661.45,-0.39,True,1,17103,-658.86,-1784498.7,11268482.58,9483983.88
1996-02-23,659.08,0.22,0.03,661.45,-0.36,True,1,17104,-659.08,-1785157.78,11272904.32,9487746.54
1996-02-26,650.46,-8.62,-1.31,661.45,-1.66,True,1,17105,-650.46,-1785808.24,11126118.3,9340310.06
1996-02-27,647.24,-3.22,-0.5,661.45,-2.15,True,1,17106,-647.24,-1786455.48,11071687.44,9285231.96
1996-02-28,644.75,-2.49,-0.38,661.45,-2.52,True,1,17107,-644.75,-1787100.23,11029738.25,9242638.02
1996-02-29,640.43,-4.32,-0.67,661.45,-3.18,True,1,17108,-640.43,-1787740.66,10956476.44,9168735.78
1996-03-01,644.37,3.94,0.62,661.45,-2.58,True,1,17109,-644.37,-1788385.03,11024526.33,9236141.3
1996-03-04,650.81,6.44,1.0,661.45,-1.61,True,1,17110,-650.81,-1789035.84,11135359.1,9346323.26
1996-03-05,655.79,4.98,0.76,661.45,-0.86,True,1,17111,-655.79,-1789691.63,11221222.69,9431531.06
1996-03-06,652.0,-3.79,-0.58,661.45,-1.43,True,1,17112,-652.0,-1790343.63,11157024.0,9366680.37
1996-03-07,653.65,1.65,0.25,661.45,-1.18,True,1,17113,-653.65,-1790997.28,11185912.45,9394915.17
1996-03-08,633.5,-20.15,-3.08,661.45,-4.23,True,1,17114,-633.5,-1791630.78,10841719.0,9050088.22
1996-03-11,640.02,6.52,1.03,661.45,-3.24,True,1,17115,-640.02,-1792270.8,10953942.3,9161671.5
1996-03-12,637.09,-2.93,-0.46,661.45,-3.68,True,1,17116,-637.09,-1792907.89,10904432.44,9111524.55
1996-03-13,638.55,1.46,0.23,661.45,-3.46,True,1,17117,-638.55,-1793546.44,10930060.35,9136513.91
1996-03-14,640.87,2.32,0.36,661.45,-3.11,True,1,17118,-640.87,-1794187.31,10970412.66,9176225.35
1996-03-15,641.43,0.56,0.09,661.45,-3.03,True,1,17119,-641.43,-1794828.74,10980640.17,9185811.43
1996-03-18,652.65,11.22,1.75,661.45,-1.33,True,1,17120,-652.65,-1795481.39,11173368.0,9377886.61
1996-03-19,651.69,-0.96,-0.15,661.45,-1.48,True,1,17121,-651.69,-1796133.08,11157584.49,9361451.41
1996-03-20,649.98,-1.71,-0.26,661.45,-1.73,True,1,17122,-649.98,-1796783.06,11128957.56,9332174.5
1996-03-21,649.19,-0.79,-0.12,661.45,-1.85,True,1,17123,-649.19,-1797432.25,11116080.37,9318648.12
1996-03-22,650.62,1.43,0.22,661.45,-1.64,True,1,17124,-650.62,-1798082.87,11141216.88,9343134.01
1996-03-25,650.04,-0.58,-0.09,661.45,-1.72,True,1,17125,-650.04,-1798732.91,11131935.0,9333202.09
1996-03-26,652.97,2.93,0.45,661.45,-1.28,True,1,17126,-652.97,-1799385.88,11182764.22,9383378.34
1996-03-27,648.91,-4.06,-0.62,661.45,-1.9,True,1,17127,-648.91,-1800034.79,11113881.57,9313846.78
1996-03-28,648.94,0.03,0.0,661.45,-1.89,True,1,17128,-648.94,-1800683.73,11115044.32,9314360.59
1996-03-29,645.5,-3.44,-0.53,661.45,-2.41,True,1,17129,-645.5,-1801329.23,11056769.5,9255440.27
1996-04-01,653.73,8.23,1.27,661.45,-1.17,True,1,17130,-653.73,-1801982.96,11198394.9,9396411.94
1996-04-02,655.26,1.53,0.23,661.45,-0.94,True,1,17131,-655.26,-1802638.22,11225259.06,9422620.84
1996-04-03,655.88,0.62,0.1,661.45,-0.84,True,1,17132,-655.88,-1803294.1,11236536.16,9433242.06
1996-04-04,655.86,-0.02,-0.0,661.45,-0.84,True,1,17133,-655.86,-1803949.96,11236849.38,9432899.42
1996-04-08,644.24,-11.62,-1.77,661.45,-2.6,True,1,17134,-644.24,-1804594.2,11038408.16,9233813.96
1996-04-09,642.19,-2.05,-0.32,661.45,-2.91,True,1,17135,-642.19,-1805236.39,11003925.65,9198689.26
1996-04-10,633.5,-8.69,-1.35,661.45,-4.23,True,1,17136,-633.5,-1805869.89,10855656.0,9049786.11
1996-04-11,631.18,-2.32,-0.37,661.45,-4.58,True,1,17137,-631.18,-1806501.07,10816531.66,9010030.59
1996-04-12,636.71,5.53,0.88,661.45,-3.74,True,1,17138,-636.71,-1807137.78,10911935.98,9104798.2
1996-04-15,642.49,5.78,0.91,661.45,-2.87,True,1,17139,-642.49,-1807780.27,11011636.11,9203855.84
1996-04-16,645.0,2.51,0.39,661.45,-2.49,True,1,17140,-645.0,-1808425.27,11055300.0,9246874.73
1996-04-17,641.61,-3.39,-0.53,661.45,-3.0,True,1,17141,-641.61,-1809066.88,10997837.01,9188770.13
1996-04-18,643.61,2.0,0.31,661.45,-2.7,True,1,17142,-643.61,-1809710.49,11032762.62,9223052.13
1996-04-19,645.07,1.46,0.23,661.45,-2.48,True,1,17143,-645.07,-1810355.56,11058435.01,9248079.45
1996-04-22,647.89,2.82,0.44,661.45,-2.05,True,1,17144,-647.89,-1811003.45,11107426.16,9296422.71
1996-04-23,651.58,3.69,0.57,661.45,-1.49,True,1,17145,-651.58,-1811655.03,11171339.1,9359684.07
1996-04-24,650.17,-1.41,-0.22,661.45,-1.7,True,1,17146,-650.17,-1812305.2,11147814.82,9335509.62
1996-04-25,652.87,2.7,0.42,661.45,-1.3,True,1,17147,-652.87,-1812958.07,11194761.89,9381803.82
1996-04-26,653.46,0.59,0.09,661.45,-1.21,True,1,17148,-653.46,-1813611.53,11205532.08,9391920.55
1996-04-29,654.16,0.7,0.11,661.45,-1.1,True,1,17149,-654.16,-1814265.69,11218189.84,9403924.15
1996-04-30,654.17,0.01,0.0,661.45,-1.1,True,1,17150,-654.17,-1814919.86,11219015.5,9404095.64
1996-05-01,654.58,0.41,0.06,661.45,-1.04,True,1,17151,-654.58,-1815574.44,11226701.58,9411127.14
1996-05-02,643.38,-11.2,-1.71,661.45,-2.73,True,1,17152,-643.38,-1816217.82,11035253.76,9219035.94
1996-05-03,641.63,-1.75,-0.27,661.45,-3.0,True,1,17153,-641.63,-1816859.45,11005879.39,9189019.94
1996-05-06,640.81,-0.82,-0.13,661.45,-3.12,True,1,17154,-640.81,-1817500.26,10992454.74,9174954.48
1996-05-07,638.26,-2.55,-0.4,661.45,-3.51,True,1,17155,-638.26,-1818138.52,10949350.3,9131211.78
1996-05-08,644.77,6.51,1.02,661.45,-2.52,True,1,17156,-644.77,-1818783.29,11061674.12,9242890.83
1996-05-09,645.44,0.67,0.1,661.45,-2.42,True,1,17157,-645.44,-1819428.73,11073814.08,9254385.35
1996-05-10,652.09,6.65,1.03,661.45,-1.42,True,1,17158,-652.09,-1820080.82,11188560.22,9368479.4
1996-05-13,661.51,9.42,1.44,661.51,0.0,True,1,17159,-661.51,-1820742.33,11350850.09,9530107.76
1996-05-14,665.6,4.09,0.62,665.6,0.0,True,1,17160,-665.6,-1821407.93,11421696.0,9600288.07
1996-05-15,665.42,-0.18,-0.03,665.6,-0.03,True,1,17161,-665.42,-1822073.35,11419272.62,9597199.27
1996-05-16,664.85,-0.57,-0.09,665.6,-0.11,True,1,17162,-664.85,-1822738.2,11410155.7,9587417.5
1996-05-17,668.91,4.06,0.61,668.91,0.0,True,1,17163,-668.91,-1823407.11,11480502.33,9657095.22
1996-05-20,673.15,4.24,0.63,673.15,0.0,True,1,17164,-673.15,-1824080.26,11553946.6,9729866.34
1996-05-21,672.76,-0.39,-0.06,673.15,-0.06,True,1,17165,-672.76,-1824753.02,11547925.4,9723172.38
1996-05-22,678.42,5.66,0.84,678.42,0.0,True,1,17166,-678.42,-1825431.44,11645757.72,9820326.28
1996-05-23,676.0,-2.42,-0.36,678.42,-0.36,True,1,17167,-676.0,-1826107.44,11604892.0,9778784.56
1996-05-24,678.51,2.51,0.37,678.51,0.0,True,1,17168,-678.51,-1826785.95,11648659.68,9821873.73
1996-05-28,672.23,-6.28,-0.93,678.51,-0.93,True,1,17169,-672.23,-1827458.18,11541516.87,9714058.69
1996-05-29,667.93,-4.3,-0.64,678.51,-1.56,True,1,17170,-667.93,-1828126.11,11468358.1,9640231.99
1996-05-30,671.7,3.77,0.56,678.51,-1.0,True,1,17171,-671.7,-1828797.81,11533760.7,9704962.89
1996-05-31,669.12,-2.58,-0.38,678.51,-1.38,True,1,17172,-669.12,-1829466.93,11490128.64,9660661.71
1996-06-03,667.68,-1.44,-0.22,678.51,-1.6,True,1,17173,-667.68,-1830134.61,11466068.64,9635934.03
1996-06-04,672.56,4.88,0.73,678.51,-0.88,True,1,17174,-672.56,-1830807.17,11550545.44,9719738.27
1996-06-05,678.44,5.88,0.87,678.51,-0.01,True,1,17175,-678.44,-1831485.61,11652207.0,9820721.39
1996-06-06,673.03,-5.41,-0.8,678.51,-0.81,True,1,17176,-673.03,-1832158.64,11559963.28,9727804.64
1996-06-07,673.31,0.28,0.04,678.51,-0.77,True,1,17177,-673.31,-1832831.95,11565445.87,9732613.92
1996-06-10,672.16,-1.15,-0.17,678.51,-0.94,True,1,17178,-672.16,-1833504.11,11546364.48,9712860.37
1996-06-11,670.97,-1.19,-0.18,678.51,-1.11,True,1,17179,-670.97,-1834175.08,11526593.63,9692418.55
1996-06-12,669.04,-1.93,-0.29,678.51,-1.4,True,1,17180,-669.04,-1834844.12,11494107.2,9659263.08
1996-06-13,667.92,-1.12,-0.17,678.51,-1.56,True,1,17181,-667.92,-1835512.04,11475533.52,9640021.48
1996-06-14,665.85,-2.07,-0.31,678.51,-1.87,True,1,17182,-665.85,-1836177.89,11440634.7,9604456.81
1996-06-17,665.16,-0.69,-0.1,678.51,-1.97,True,1,17183,-665.16,-1836843.05,11429444.28,9592601.23
1996-06-18,662.06,-3.1,-0.47,678.51,-2.42,True,1,17184,-662.06,-1837505.11,11376839.04,9539333.93
1996-06-19,661.96,-0.1,-0.02,678.51,-2.44,True,1,17185,-661.96,-1838167.07,11375782.6,9537615.53
1996-06-20,662.1,0.14,0.02,678.51,-2.42,True,1,17186,-662.1,-1838829.17,11378850.6,9540021.43
1996-06-21,666.84,4.74,0.72,678.51,-1.72,True,1,17187,-666.84,-1839496.01,11460979.08,9621483.07
1996-06-24,668.85,2.01,0.3,678.51,-1.42,True,1,17188,-668.85,-1840164.86,11496193.8,9656028.94
1996-06-25,668.48,-0.37,-0.06,678.51,-1.48,True,1,17189,-668.48,-1840833.34,11490502.72,9649669.38
1996-06-26,664.39,-4.09,-0.61,678.51,-2.08,True,1,17190,-664.39,-1841497.73,11420864.1,9579366.37
1996-06-27,668.55,4.16,0.63,678.51,-1.47,True,1,17191,-668.55,-1842166.28,11493043.05,9650876.77
1996-06-28,670.63,2.08,0.31,678.51,-1.16,True,1,17192,-670.63,-1842836.91,11529470.96,9686634.05
1996-07-01,675.88,5.25,0.78,678.51,-0.39,True,1,17193,-675.88,-1843512.79,11620404.84,9776892.05
1996-07-02,673.61,-2.27,-0.34,678.51,-0.72,True,1,17194,-673.61,-1844186.4,11582050.34,9737863.94
1996-07-03,672.4,-1.21,-0.18,678.51,-0.9,True,1,17195,-672.4,-1844858.8,11561918.0,9717059.2
1996-07-05,657.44,-14.96,-2.22,678.51,-3.1,True,1,17196,-657.44,-1845516.24,11305338.24,9459822.0
1996-07-08,652.54,-4.9,-0.74,678.51,-3.83,True,1,17197,-652.54,-1846168.78,11221730.38,9375561.6
1996-07-09,654.75,2.21,0.34,678.51,-3.5,True,1,17198,-654.75,-1846823.53,11260390.5,9413566.97
1996-07-10,656.06,1.31,0.2,678.51,-3.31,True,1,17199,-656.06,-1847479.59,11283575.94,9436096.35
1996-07-11,645.67,-10.39,-1.58,678.51,-4.84,True,1,17200,-645.67,-1848125.26,11105524.0,9257398.74
1996-07-12,646.19,0.52,0.08,678.51,-4.76,True,1,17201,-646.19,-1848771.45,11115114.19,9266342.74
1996-07-15,629.8,-16.39,-2.54,678.51,-7.18,True,1,17202,-629.8,-1849401.25,10833819.6,8984418.35
1996-07-16,628.37,-1.43,-0.23,678.51,-7.39,True,1,17203,-628.37,-1850029.62,10809849.11,8959819.49
1996-07-17,634.07,5.7,0.91,678.51,-6.55,True,1,17204,-634.07,-1850663.69,10908540.28,9057876.59
1996-07-18,643.56,9.49,1.5,678.51,-5.15,True,1,17205,-643.56,-1851307.25,11072449.8,9221142.55
1996-07-19,638.73,-4.83,-0.75,678.51,-5.86,True,1,17206,-638.73,-1851945.98,10989988.38,9138042.4
1996-07-22,633.77,-4.96,-0.78,678.51,-6.59,True,1,17207,-633.77,-1852579.75,10905280.39,9052700.64
1996-07-23,626.87,-6.9,-1.09,678.51,-7.61,True,1,17208,-626.87,-1853206.62,10787178.96,8933972.34
1996-07-24,626.65,-0.22,-0.04,678.51,-7.64,True,1,17209,-626.65,-1853833.27,10784019.85,8930186.58
1996-07-25,631.17,4.52,0.72,678.51,-6.98,True,1,17210,-631.17,-1854464.44,10862435.7,9007971.26
1996-07-26,635.9,4.73,0.75,678.51,-6.28,True,1,17211,-635.9,-1855100.34,10944474.9,9089374.56
1996-07-29,630.91,-4.99,-0.78,678.51,-7.02,True,1,17212,-630.91,-1855731.25,10859222.92,9003491.67
1996-07-30,635.26,4.35,0.69,678.51,-6.37,True,1,17213,-635.26,-1856366.51,10934730.38,9078363.87
1996-07-31,639.95,4.69,0.74,678.51,-5.68,True,1,17214,-639.95,-1857006.46,11016099.3,9159092.84
1996-08-01,650.02,10.07,1.57,678.51,-4.2,True,1,17215,-650.02,-1857656.48,11190094.3,9332437.82
1996-08-02,662.49,12.47,1.92,678.51,-2.36,True,1,17216,-662.49,-1858318.97,11405427.84,9547108.87
1996-08-05,660.23,-2.26,-0.34,678.51,-2.69,True,1,17217,-660.23,-1858979.2,11367179.91,9508200.71
1996-08-06,662.38,2.15,0.33,678.51,-2.38,True,1,17218,-662.38,-1859641.58,11404858.84,9545217.26
1996-08-07,664.16,1.78,0.27,678.51,-2.12,True,1,17219,-664.16,-1860305.74,11436171.04,9575865.3
1996-08-08,662.59,-1.57,-0.24,678.51,-2.35,True,1,17220,-662.59,-1860968.33,11409799.8,9548831.47
1996-08-09,662.1,-0.49,-0.07,678.51,-2.42,True,1,17221,-662.1,-1861630.43,11402024.1,9540393.67
1996-08-12,665.77,3.67,0.55,678.51,-1.88,True,1,17222,-665.77,-1862296.2,11465890.94,9603594.74
1996-08-13,660.2,-5.57,-0.84,678.51,-2.7,True,1,17223,-660.2,-1862956.4,11370624.6,9507668.2
1996-08-14,662.05,1.85,0.28,678.51,-2.43,True,1,17224,-662.05,-1863618.45,11403149.2,9539530.75
1996-08-15,662.28,0.23,0.04,678.51,-2.39,True,1,17225,-662.28,-1864280.73,11407773.0,9543492.27
1996-08-16,665.21,2.93,0.44,678.51,-1.96,True,1,17226,-665.21,-1864945.94,11458907.46,9593961.52
1996-08-19,666.58,1.37,0.21,678.51,-1.76,True,1,17227,-666.58,-1865612.52,11483173.66,9617561.14
1996-08-20,665.69,-0.89,-0.13,678.51,-1.89,True,1,17228,-665.69,-1866278.21,11468507.32,9602229.11
1996-08-21,665.07,-0.62,-0.09,678.51,-1.98,True,1,17229,-665.07,-1866943.28,11458491.03,9591547.75
1996-08-22,670.68,5.61,0.84,678.51,-1.15,True,1,17230,-670.68,-1867613.96,11555816.4,9688202.44
1996-08-23,667.03,-3.65,-0.54,678.51,-1.69,True,1,17231,-667.03,-1868280.99,11493593.93,9625312.94
1996-08-26,663.88,-3.15,-0.47,678.51,-2.16,True,1,17232,-663.88,-1868944.87,11439980.16,9571035.29
1996-08-27,666.4,2.52,0.38,678.51,-1.78,True,1,17233,-666.4,-1869611.27,11484071.2,9614459.93
1996-08-28,664.81,-1.59,-0.24,678.51,-2.02,True,1,17234,-664.81,-1870276.08,11457335.54,9587059.46
1996-08-29,657.4,-7.41,-1.12,678.51,-3.11,True,1,17235,-657.4,-1870933.48,11330289.0,9459355.52
1996-08-30,651.99,-5.41,-0.82,678.51,-3.91,True,1,17236,-651.99,-1871585.47,11237699.64,9366114.17
1996-09-03,654.72,2.73,0.42,678.51,-3.51,True,1,17237,-654.72,-1872240.19,11285408.64,9413168.45
1996-09-04,655.61,0.89,0.14,678.51,-3.38,True,1,17238,-655.61,-1872895.8,11301405.18,9428509.38
1996-09-05,649.44,-6.17,-0.94,678.51,-4.28,True,1,17239,-649.44,-1873545.24,11195696.16,9322150.92
1996-09-06,655.68,6.24,0.96,678.51,-3.36,True,1,17240,-655.68,-1874200.92,11303923.2,9429722.28
1996-09-09,663.76,8.08,1.23,678.51,-2.17,True,1,17241,-663.76,-1874864.68,11443886.16,9569021.48
1996-09-10,663.81,0.05,0.01,678.51,-2.17,True,1,17242,-663.81,-1875528.49,11445412.02,9569883.53
1996-09-11,667.28,3.47,0.52,678.51,-1.66,True,1,17243,-667.28,-1876195.77,11505909.04,9629713.27
1996-09-12,671.15,3.87,0.58,678.51,-1.08,True,1,17244,-671.15,-1876866.92,11573310.6,9696443.68
1996-09-13,680.54,9.39,1.4,680.54,0.0,True,1,17245,-680.54,-1877547.46,11735912.3,9858364.84
1996-09-16,683.98,3.44,0.5,683.98,0.0,True,1,17246,-683.98,-1878231.44,11795919.08,9917687.64
1996-09-17,682.94,-1.04,-0.15,683.98,-0.15,True,1,17247,-682.94,-1878914.38,11778666.18,9899751.8
1996-09-18,681.47,-1.47,-0.22,683.98,-0.37,True,1,17248,-681.47,-1879595.85,11753994.56,9874398.71
1996-09-19,683.0,1.53,0.22,683.98,-0.14,True,1,17249,-683.0,-1880278.85,11781067.0,9900788.15
1996-09-20,687.03,4.03,0.59,687.03,0.0,True,1,17250,-687.03,-1880965.88,11851267.5,9970301.62
1996-09-23,686.48,-0.55,-0.08,687.03,-0.08,True,1,17251,-686.48,-1881652.36,11842466.48,9960814.12
1996-09-24,685.61,-0.87,-0.13,687.03,-0.21,True,1,17252,-685.61,-1882337.97,11828143.72,9945805.75
1996-09-25,685.83,0.22,0.03,687.03,-0.18,True,1,17253,-685.83,-1883023.8,11832624.99,9949601.19
1996-09-26,685.86,0.03,0.0,687.03,-0.17,True,1,17254,-685.86,-1883709.66,11833828.44,9950118.78
1996-09-27,686.19,0.33,0.05,687.03,-0.12,True,1,17255,-686.19,-1884395.85,11840208.45,9955812.6
1996-09-30,687.33,1.14,0.17,687.33,0.0,True,1,17256,-687.33,-1885083.18,11860566.48,9975483.3
1996-10-01,689.08,1.75,0.26,689.08,0.0,True,1,17257,-689.08,-1885772.26,11891453.56,10005681.3
1996-10-02,694.01,4.93,0.72,694.01,0.0,True,1,17258,-694.01,-1886466.27,11977224.58,10090758.31
1996-10-03,692.78,-1.23,-0.18,694.01,-0.18,True,1,17259,-692.78,-1887159.05,11956690.02,10069530.97
1996-10-04,701.46,8.68,1.25,701.46,0.0,True,1,17260,-701.46,-1887860.51,12107199.6,10219339.09
1996-10-07,703.34,1.88,0.27,703.34,0.0,True,1,17261,-703.34,-1888563.85,12140351.74,10251787.89
1996-10-08,700.64,-2.7,-0.38,703.34,-0.38,True,1,17262,-700.64,-1889264.49,12094447.68,10205183.19
1996-10-09,696.74,-3.9,-0.56,703.34,-0.94,True,1,17263,-696.74,-1889961.23,12027822.62,10137861.39
1996-10-10,694.61,-2.13,-0.31,703.34,-1.24,True,1,17264,-694.61,-1890655.84,11991747.04,10101091.2
1996-10-11,700.66,6.05,0.87,703.34,-0.38,True,1,17265,-700.66,-1891356.5,12096894.9,10205538.4
1996-10-14,703.54,2.88,0.41,703.54,0.0,True,1,17266,-703.54,-1892060.04,12147321.64,10255261.6
1996-10-15,702.57,-0.97,-0.14,703.54,-0.14,True,1,17267,-702.57,-1892762.61,12131276.19,10238513.58
1996-10-16,704.41,1.84,0.26,704.41,0.0,True,1,17268,-704.41,-1893467.02,12163751.88,10270284.86
1996-10-17,706.99,2.58,0.37,706.99,0.0,True,1,17269,-706.99,-1894174.01,12209010.31,10314836.3
1996-10-18,710.82,3.83,0.54,710.82,0.0,True,1,17270,-710.82,-1894884.83,12275861.4,10380976.57
1996-10-21,709.85,-0.97,-0.14,710.82,-0.14,True,1,17271,-709.85,-1895594.68,12259819.35,10364224.67
1996-10-22,706.57,-3.28,-0.46,710.82,-0.6,True,1,17272,-706.57,-1896301.25,12203877.04,10307575.79
1996-10-23,707.27,0.7,0.1,710.82,-0.5,True,1,17273,-707.27,-1897008.52,12216674.71,10319666.19
1996-10-24,702.29,-4.98,-0.7,710.82,-1.2,True,1,17274,-702.29,-1897710.81,12131357.46,10233646.65
1996-10-25,700.92,-1.37,-0.2,710.82,-1.39,True,1,17275,-700.92,-1898411.73,12108393.0,10209981.27
1996-10-28,697.26,-3.66,-0.52,710.82,-1.91,True,1,17276,-697.26,-1899108.99,12045863.76,10146754.77
1996-10-29,701.5,4.24,0.61,710.82,-1.31,True,1,17277,-701.5,-1899810.49,12119815.5,10220005.01
1996-10-30,700.9,-0.6,-0.09,710.82,-1.4,True,1,17278,-700.9,-1900511.39,12110150.2,10209638.81
1996-10-31,705.27,4.37,0.62,710.82,-0.78,True,1,17279,-705.27,-1901216.66,12186360.33,10285143.67
1996-11-01,703.77,-1.5,-0.21,710.82,-0.99,True,1,17280,-703.77,-1901920.43,12161145.6,10259225.17
1996-11-04,706.73,2.96,0.42,710.82,-0.57,True,1,17281,-706.73,-1902627.16,12213001.13,10310373.97
1996-11-05,714.14,7.41,1.05,714.14,0.0,True,1,17282,-714.14,-1903341.3,12341767.48,10438426.18
1996-11-06,724.59,10.45,1.46,724.59,0.0,True,1,17283,-724.59,-1904065.89,12523088.97,10619023.08
1996-11-07,727.65,3.06,0.42,727.65,0.0,True,1,17284,-727.65,-1904793.54,12576702.6,10671909.06
1996-11-08,730.82,3.17,0.44,730.82,0.0,True,1,17285,-730.82,-1905524.36,12632223.7,10726699.34
1996-11-11,731.87,1.05,0.14,731.87,0.0,True,1,17286,-731.87,-1906256.23,12651104.82,10744848.59
1996-11-12,729.56,-2.31,-0.32,731.87,-0.32,True,1,17287,-729.56,-1906985.79,12611903.72,10704917.93
1996-11-13,731.13,1.57,0.22,731.87,-0.1,True,1,17288,-731.13,-1907716.92,12639775.44,10732058.52
1996-11-14,735.88,4.75,0.65,735.88,0.0,True,1,17289,-735.88,-1908452.8,12722629.32,10814176.52
1996-11-15,737.62,1.74,0.24,737.62,0.0,True,1,17290,-737.62,-1909190.42,12753449.8,10844259.38
1996-11-18,737.02,-0.6,-0.08,737.62,-0.08,True,1,17291,-737.02,-1909927.44,12743812.82,10833885.38
1996-11-19,742.16,5.14,0.7,742.16,0.0,True,1,17292,-742.16,-1910669.6,12833430.72,10922761.12
1996-11-20,743.95,1.79,0.24,743.95,0.0,True,1,17293,-743.95,-1911413.55,12865127.35,10953713.8
1996-11-21,742.75,-1.2,-0.16,743.95,-0.16,True,1,17294,-742.75,-1912156.3,12845118.5,10932962.2
1996-11-22,748.73,5.98,0.8,748.73,0.0,True,1,17295,-748.73,-1912905.03,12949285.35,11036380.32
1996-11-25,757.03,8.3,1.11,757.03,0.0,True,1,17296,-757.03,-1913662.06,13093590.88,11179928.82
1996-11-26,755.96,-1.07,-0.14,757.03,-0.14,True,1,17297,-755.96,-1914418.02,13075840.12,11161422.1
1996-11-27,755.0,-0.96,-0.13,757.03,-0.27,True,1,17298,-755.0,-1915173.02,13059990.0,11144816.98
1996-11-29,757.02,2.02,0.27,757.03,-0.0,True,1,17299,-757.02,-1915930.04,13095688.98,11179758.94
1996-12-02,756.56,-0.46,-0.06,757.03,-0.06,True,1,17300,-756.56,-1916686.6,13088488.0,11171801.4
1996-12-03,748.28,-8.28,-1.09,757.03,-1.16,True,1,17301,-748.28,-1917434.88,12945992.28,11028557.4
1996-12-04,745.1,-3.18,-0.42,757.03,-1.58,True,1,17302,-745.1,-1918179.98,12891720.2,10973540.22
1996-12-05,744.38,-0.72,-0.1,757.03,-1.67,True,1,17303,-744.38,-1918924.36,12880007.14,10961082.78
1996-12-06,739.6,-4.78,-0.64,757.03,-2.3,True,1,17304,-739.6,-1919663.96,12798038.4,10878374.44
1996-12-09,749.76,10.16,1.37,757.03,-0.96,True,1,17305,-749.76,-1920413.72,12974596.8,11054183.08
1996-12-10,747.54,-2.22,-0.3,757.03,-1.25,True,1,17306,-747.54,-1921161.26,12936927.24,11015765.98
1996-12-11,740.73,-6.81,-0.91,757.03,-2.15,True,1,17307,-740.73,-1921901.99,12819814.11,10897912.12
1996-12-12,729.3,-11.43,-1.54,757.03,-3.66,True,1,17308,-729.3,-1922631.29,12622724.4,10700093.11
1996-12-13,728.64,-0.66,-0.09,757.03,-3.75,True,1,17309,-728.64,-1923359.93,12612029.76,10688669.83
1996-12-16,720.98,-7.66,-1.05,757.03,-4.76,True,1,17310,-720.98,-1924080.91,12480163.8,10556082.89
1996-12-17,726.04,5.06,0.7,757.03,-4.09,True,1,17311,-726.04,-1924806.95,12568478.44,10643671.49
1996-12-18,731.54,5.5,0.76,757.03,-3.37,True,1,17312,-731.54,-1925538.49,12664420.48,10738881.99
1996-12-19,745.76,14.22,1.94,757.03,-1.49,True,1,17313,-745.76,-1926284.25,12911342.88,10985058.63
1996-12-20,748.87,3.11,0.42,757.03,-1.08,True,1,17314,-748.87,-1927033.12,12965935.18,11038902.06
1996-12-23,746.92,-1.95,-0.26,757.03,-1.34,True,1,17315,-746.92,-1927780.04,12932919.8,11005139.76
1996-12-24,751.03,4.11,0.55,757.03,-0.79,True,1,17316,-751.03,-1928531.07,13004835.48,11076304.41
1996-12-26,755.82,4.79,0.64,757.03,-0.16,True,1,17317,-755.82,-1929286.89,13088534.94,11159248.05
1996-12-27,756.79,0.97,0.13,757.03,-0.03,True,1,17318,-756.79,-1930043.68,13106089.22,11176045.54
1996-12-30,753.85,-2.94,-0.39,757.03,-0.42,True,1,17319,-753.85,-1930797.53,13055928.15,11125130.62
1996-12-31,740.74,-13.11,-1.74,757.03,-2.15,True,1,17320,-740.74,-1931538.27,12829616.8,10898078.53
1997-01-02,737.01,-3.73,-0.5,757.03,-2.64,True,1,17321,-737.01,-1932275.28,12765750.21,10833474.93
1997-01-03,748.03,11.02,1.5,757.03,-1.19,True,1,17322,-748.03,-1933023.31,12957375.66,11024352.35
1997-01-06,747.65,-0.38,-0.05,757.03,-1.24,True,1,17323,-747.65,-1933770.96,12951540.95,11017769.99
1997-01-07,753.23,5.58,0.75,757.03,-0.5,True,1,17324,-753.23,-1934524.19,13048956.52,11114432.33
1997-01-08,748.41,-4.82,-0.64,757.03,-1.14,True,1,17325,-748.41,-1935272.6,12966203.25,11030930.65
1997-01-09,754.85,6.44,0.86,757.03,-0.29,True,1,17326,-754.85,-1936027.45,13078531.1,11142503.65
1997-01-10,759.5,4.65,0.62,759.5,0.0,True,1,17327,-759.5,-1936786.95,13159856.5,11223069.55
1997-01-13,759.51,0.01,0.0,759.51,0.0,True,1,17328,-759.51,-1937546.46,13160789.28,11223242.82
1997-01-14,768.86,9.35,1.23,768.86,0.0,True,1,17329,-768.86,-1938315.32,13323574.94,11385259.62
1997-01-15,767.2,-1.66,-0.22,768.86,-0.22,True,1,17330,-767.2,-1939082.52,13295576.0,11356493.48
1997-01-16,769.75,2.55,0.33,769.75,0.0,True,1,17331,-769.75,-1939852.27,13340537.25,11400684.98
1997-01-17,776.17,6.42,0.83,776.17,0.0,True,1,17332,-776.17,-1940628.44,13452578.44,11511950.0
1997-01-20,776.7,0.53,0.07,776.7,0.0,True,1,17333,-776.7,-1941405.14,13462541.1,11521135.96
1997-01-21,782.72,6.02,0.78,782.72,0.0,True,1,17334,-782.72,-1942187.86,13567668.48,11625480.62
1997-01-22,786.23,3.51,0.45,786.23,0.0,True,1,17335,-786.23,-1942974.09,13629297.05,11686322.96
1997-01-23,777.56,-8.67,-1.1,786.23,-1.1,True,1,17336,-777.56,-1943751.65,13479780.16,11536028.51
1997-01-24,770.52,-7.04,-0.9,786.23,-2.0,True,1,17337,-770.52,-1944522.17,13358505.24,11413983.07
1997-01-27,765.02,-5.5,-0.71,786.23,-2.7,True,1,17338,-765.02,-1945287.19,13263916.76,11318629.57
1997-01-28,765.02,0.0,0.0,786.23,-2.7,True,1,17339,-765.02,-1946052.21,13264681.78,11318629.57
1997-01-29,772.5,7.48,0.98,786.23,-1.75,True,1,17340,-772.5,-1946824.71,13395150.0,11448325.29
1997-01-30,784.17,11.67,1.51,786.23,-0.26,True,1,17341,-784.17,-1947608.88,13598291.97,11650683.09
1997-01-31,786.16,1.99,0.25,786.23,-0.01,True,1,17342,-786.16,-1948395.04,13633586.72,11685191.68
1997-02-03,786.73,0.57,0.07,786.73,0.0,True,1,17343,-786.73,-1949181.77,13644258.39,11695076.62
1997-02-04,789.26,2.53,0.32,789.26,0.0,True,1,17344,-789.26,-1949971.03,13688925.44,11738954.41
1997-02-05,778.28,-10.98,-1.39,789.26,-1.39,True,1,17345,-778.28,-1950749.31,13499266.6,11548517.29
1997-02-06,780.15,1.87,0.24,789.26,-1.15,True,1,17346,-780.15,-1951529.46,13532481.9,11580952.44
1997-02-07,789.56,9.41,1.21,789.56,0.0,True,1,17347,-789.56,-1952319.02,13696497.32,11744178.3
1997-02-10,785.43,-4.13,-0.52,789.56,-0.52,True,1,17348,-785.43,-1953104.45,13625639.64,11672535.19
1997-02-11,789.59,4.16,0.53,789.59,0.0,True,1,17349,-789.59,-1953894.04,13698596.91,11744702.87
1997-02-12,802.77,13.18,1.67,802.77,0.0,True,1,17350,-802.77,-1954696.81,13928059.5,11973362.69
1997-02-13,811.82,9.05,1.13,811.82,0.0,True,1,17351,-811.82,-1955508.63,14085888.82,12130380.19
1997-02-14,808.48,-3.34,-0.41,811.82,-0.41,True,1,17352,-808.48,-1956317.11,14028744.96,12072427.85
1997-02-18,816.29,7.81,0.97,816.29,0.0,True,1,17353,-816.29,-1957133.4,14165080.37,12207946.97
1997-02-19,812.49,-3.8,-0.47,816.29,-0.47,True,1,17354,-812.49,-1957945.89,14099951.46,12142005.57
1997-02-20,802.8,-9.69,-1.19,816.29,-1.65,True,1,17355,-802.8,-1958748.69,13932594.0,11973845.31
1997-02-21,801.77,-1.03,-0.13,816.29,-1.78,True,1,17356,-801.77,-1959550.46,13915520.12,11955969.66
1997-02-24,810.28,8.51,1.06,816.29,-0.74,True,1,17357,-810.28,-1960360.74,14064029.96,12103669.22
1997-02-25,812.03,1.75,0.22,816.29,-0.52,True,1,17358,-812.03,-1961172.77,14095216.74,12134043.97
1997-02-26,805.68,-6.35,-0.78,816.29,-1.3,True,1,17359,-805.68,-1961978.45,13985799.12,12023820.67
1997-02-27,795.07,-10.61,-1.32,816.29,-2.6,True,1,17360,-795.07,-1962773.52,13802415.2,11839641.68
1997-02-28,790.82,-4.25,-0.54,816.29,-3.12,True,1,17361,-790.82,-1963564.34,13729426.02,11765861.68
1997-03-03,795.31,4.49,0.57,816.29,-2.57,True,1,17362,-795.31,-1964359.65,13808172.22,11843812.57
1997-03-04,790.95,-4.36,-0.55,816.29,-3.1,True,1,17363,-790.95,-1965150.6,13733264.85,11768114.25
1997-03-05,801.99,11.04,1.4,816.29,-1.75,True,1,17364,-801.99,-1965952.59,13925754.36,11959801.77
1997-03-06,798.56,-3.43,-0.43,816.29,-2.17,True,1,17365,-798.56,-1966751.15,13866994.4,11900243.25
1997-03-07,804.97,6.41,0.8,816.29,-1.39,True,1,17366,-804.97,-1967556.12,13979109.02,12011552.9
1997-03-10,813.65,8.68,1.08,816.29,-0.32,True,1,17367,-813.65,-1968369.77,14130659.55,12162289.78
1997-03-11,811.34,-2.31,-0.28,816.29,-0.61,True,1,17368,-811.34,-1969181.11,14091353.12,12122172.01
1997-03-12,804.26,-7.08,-0.87,816.29,-1.47,True,1,17369,-804.26,-1969985.37,13969191.94,11999206.57
1997-03-13,789.56,-14.7,-1.83,816.29,-3.28,True,1,17370,-789.56,-1970774.93,13714657.2,11743882.27
1997-03-14,793.17,3.61,0.46,816.29,-2.83,True,1,17371,-793.17,-1971568.1,13778156.07,11806587.97
1997-03-17,795.71,2.54,0.32,816.29,-2.52,True,1,17372,-795.71,-1972363.81,13823074.12,11850710.31
1997-03-18,789.66,-6.05,-0.76,816.29,-3.26,True,1,17373,-789.66,-1973153.47,13718763.18,11745609.71
1997-03-19,785.77,-3.89,-0.49,816.29,-3.74,True,1,17374,-785.77,-1973939.24,13651967.98,11678028.74
1997-03-20,782.65,-3.12,-0.4,816.29,-4.12,True,1,17375,-782.65,-1974721.89,13598543.75,11623821.86
1997-03-21,784.1,1.45,0.18,816.29,-3.94,True,1,17376,-784.1,-1975505.99,13624521.6,11649015.61
1997-03-24,790.89,6.79,0.87,816.29,-3.11,True,1,17377,-790.89,-1976296.88,13743295.53,11766998.65
1997-03-25,789.07,-1.82,-0.23,816.29,-3.34,True,1,17378,-789.07,-1977085.95,13712458.46,11735372.51
1997-03-26,790.5,1.43,0.18,816.29,-3.16,True,1,17379,-790.5,-1977876.45,13738099.5,11760223.05
1997-03-27,773.88,-16.62,-2.1,816.29,-5.2,True,1,17380,-773.88,-1978650.33,13450034.4,11471384.07
1997-03-31,757.12,-16.76,-2.17,816.29,-7.25,True,1,17381,-757.12,-1979407.45,13159502.72,11180095.27
1997-04-01,759.64,2.52,0.33,816.29,-6.94,True,1,17382,-759.64,-1980167.09,13204062.48,11223895.39
1997-04-02,750.11,-9.53,-1.25,816.29,-8.11,True,1,17383,-750.11,-1980917.2,13039162.13,11058244.93
1997-04-03,750.32,0.21,0.03,816.29,-8.08,True,1,17384,-750.32,-1981667.52,13043562.88,11061895.36
1997-04-04,757.9,7.58,1.01,816.29,-7.15,True,1,17385,-757.9,-1982425.42,13176091.5,11193666.08
1997-04-07,762.13,4.23,0.56,816.29,-6.64,True,1,17386,-762.13,-1983187.55,13250392.18,11267204.63
1997-04-08,766.12,3.99,0.52,816.29,-6.15,True,1,17387,-766.12,-1983953.67,13320528.44,11336574.77
1997-04-09,760.6,-5.52,-0.72,816.29,-6.82,True,1,17388,-760.6,-1984714.27,13225312.8,11240598.53
1997-04-10,758.34,-2.26,-0.3,816.29,-7.1,True,1,17389,-758.34,-1985472.61,13186774.26,11201301.65
1997-04-11,737.65,-20.69,-2.73,816.29,-9.63,True,1,17390,-737.65,-1986210.26,12827733.5,10841523.24
1997-04-14,743.73,6.08,0.82,816.29,-8.89,True,1,17391,-743.73,-1986953.99,12934208.43,10947254.44
1997-04-15,754.72,10.99,1.48,816.29,-7.54,True,1,17392,-754.72,-1987708.71,13126090.24,11138381.53
1997-04-16,763.53,8.81,1.17,816.29,-6.46,True,1,17393,-763.53,-1988472.24,13280077.29,11291605.05
1997-04-17,761.77,-1.76,-0.23,816.29,-6.68,True,1,17394,-761.77,-1989234.01,13250227.38,11260993.37
1997-04-18,766.34,4.57,0.6,816.29,-6.12,True,1,17395,-766.34,-1990000.35,13330484.3,11340483.95
1997-04-21,760.37,-5.97,-0.78,816.29,-6.85,True,1,17396,-760.37,-1990760.72,13227396.52,11236635.8
1997-04-22,774.61,14.24,1.87,816.29,-5.11,True,1,17397,-774.61,-1991535.33,13475890.17,11484354.84
1997-04-23,773.64,-0.97,-0.12,816.29,-5.22,True,1,17398,-773.64,-1992308.97,13459788.72,11467479.75
1997-04-24,771.18,-2.46,-0.32,816.29,-5.53,True,1,17399,-771.18,-1993080.15,13417760.82,11424680.67
1997-04-25,765.37,-5.81,-0.75,816.29,-6.24,True,1,17400,-765.37,-1993845.52,13317438.0,11323592.48
1997-04-28,772.96,7.59,0.99,816.29,-5.31,True,1,17401,-772.96,-1994618.48,13450276.96,11455658.48
1997-04-29,794.05,21.09,2.73,816.29,-2.72,True,1,17402,-794.05,-1995412.53,13818058.1,11822645.57
1997-04-30,801.34,7.29,0.92,816.29,-1.83,True,1,17403,-801.34,-1996213.87,13945720.02,11949506.15
1997-05-01,798.53,-2.81,-0.35,816.29,-2.18,True,1,17404,-798.53,-1997012.4,13897616.12,11900603.72
1997-05-02,812.97,14.44,1.81,816.29,-0.41,True,1,17405,-812.97,-1997825.37,14149742.85,12151917.48
1997-05-05,830.29,17.32,2.13,830.29,0.0,True,1,17406,-830.29,-1998655.66,14452027.74,12453372.08
1997-05-06,827.76,-2.53,-0.3,830.29,-0.3,True,1,17407,-827.76,-1999483.42,14408818.32,12409334.9
1997-05-07,815.62,-12.14,-1.47,830.29,-1.77,True,1,17408,-815.62,-2000299.04,14198312.96,12198013.92
1997-05-08,820.26,4.64,0.57,830.29,-1.21,True,1,17409,-820.26,-2001119.3,14279906.34,12278787.04
1997-05-09,824.78,4.52,0.55,830.29,-0.66,True,1,17410,-824.78,-2001944.08,14359419.8,12357475.72
1997-05-12,837.66,12.88,1.56,837.66,0.0,True,1,17411,-837.66,-2002781.74,14584498.26,12581716.52
1997-05-13,833.13,-4.53,-0.54,837.66,-0.54,True,1,17412,-833.13,-2003614.87,14506459.56,12502844.69
1997-05-14,836.04,2.91,0.35,837.66,-0.19,True,1,17413,-836.04,-2004450.91,14557964.52,12553513.61
1997-05-15,841.88,5.84,0.7,841.88,0.0,True,1,17414,-841.88,-2005292.79,14660498.32,12655205.53
1997-05-16,829.75,-12.13,-1.44,841.88,-1.44,True,1,17415,-829.75,-2006122.54,14450096.25,12443973.71
1997-05-19,833.27,3.52,0.42,841.88,-1.02,True,1,17416,-833.27,-2006955.81,14512230.32,12505274.51
1997-05-20,841.66,8.39,1.01,841.88,-0.03,True,1,17417,-841.66,-2007797.47,14659192.22,12651394.75
1997-05-21,839.35,-2.31,-0.27,841.88,-0.3,True,1,17418,-839.35,-2008636.82,14619798.3,12611161.48
1997-05-22,835.66,-3.69,-0.44,841.88,-0.74,True,1,17419,-835.66,-2009472.48,14556361.54,12546889.06
1997-05-23,847.03,11.37,1.36,847.03,0.0,True,1,17420,-847.03,-2010319.51,14755262.6,12744943.09
1997-05-27,849.71,2.68,0.32,849.71,0.0,True,1,17421,-849.71,-2011169.22,14802797.91,12791628.69
1997-05-28,847.21,-2.5,-0.29,849.71,-0.29,True,1,17422,-847.21,-2012016.43,14760092.62,12748076.19
1997-05-29,844.08,-3.13,-0.37,849.71,-0.66,True,1,17423,-844.08,-2012860.51,14706405.84,12693545.33
1997-05-30,848.28,4.2,0.5,849.71,-0.17,True,1,17424,-848.28,-2013708.79,14780430.72,12766721.93
1997-06-02,846.36,-1.92,-0.23,849.71,-0.39,True,1,17425,-846.36,-2014555.15,14747823.0,12733267.85
1997-06-03,845.48,-0.88,-0.1,849.71,-0.5,True,1,17426,-845.48,-2015400.63,14733334.48,12717933.85
1997-06-04,840.11,-5.37,-0.64,849.71,-1.13,True,1,17427,-840.11,-2016240.74,14640596.97,12624356.23
1997-06-05,843.43,3.32,0.4,849.71,-0.74,True,1,17428,-843.43,-2017084.17,14699298.04,12682213.87
1997-06-06,858.01,14.58,1.73,858.01,0.0,True,1,17429,-858.01,-2017942.18,14954256.29,12936314.11
1997-06-09,862.91,4.9,0.57,862.91,0.0,True,1,17430,-862.91,-2018805.09,15040521.3,13021716.21
1997-06-10,865.27,2.36,0.27,865.27,0.0,True,1,17431,-865.27,-2019670.36,15082521.37,13062851.01
1997-06-11,869.57,4.3,0.5,869.57,0.0,True,1,17432,-869.57,-2020539.93,15158344.24,13137804.31
1997-06-12,883.46,13.89,1.6,883.46,0.0,True,1,17433,-883.46,-2021423.39,15401358.18,13379934.79
1997-06-13,893.27,9.81,1.11,893.27,0.0,True,1,17434,-893.27,-2022316.66,15573269.18,13550952.52
1997-06-16,893.9,0.63,0.07,893.9,0.0,True,1,17435,-893.9,-2023210.56,15585146.5,13561935.94
1997-06-17,894.42,0.52,0.06,894.42,0.0,True,1,17436,-894.42,-2024104.98,15595107.12,13571002.14
1997-06-18,889.06,-5.36,-0.6,894.42,-0.6,True,1,17437,-889.06,-2024994.04,15502539.22,13477545.18
1997-06-19,897.99,8.93,1.0,897.99,0.0,True,1,17438,-897.99,-2025892.03,15659149.62,13633257.59
1997-06-20,898.7,0.71,0.08,898.7,0.0,True,1,17439,-898.7,-2026790.73,15672429.3,13645638.57
1997-06-23,878.62,-20.08,-2.23,898.7,-2.23,True,1,17440,-878.62,-2027669.35,15323132.8,13295463.45
1997-06-24,896.34,17.72,2.02,898.7,-0.26,True,1,17441,-896.34,-2028565.69,15633065.94,13604500.25
1997-06-25,888.99,-7.35,-0.82,898.7,-1.08,True,1,17442,-888.99,-2029454.68,15505763.58,13476308.9
1997-06-26,883.68,-5.31,-0.6,898.7,-1.67,True,1,17443,-883.68,-2030338.36,15414030.24,13383691.88
1997-06-27,887.3,3.62,0.41,898.7,-1.27,True,1,17444,-887.3,-2031225.66,15478061.2,13446835.54
1997-06-30,885.14,-2.16,-0.24,898.7,-1.51,True,1,17445,-885.14,-2032110.8,15441267.3,13409156.5
1997-07-01,891.03,5.89,0.66,898.7,-0.85,True,1,17446,-891.03,-2033001.83,15544909.38,13511907.55
1997-07-02,904.03,13.0,1.46,904.03,0.0,True,1,17447,-904.03,-2033905.86,15772611.41,13738705.55
1997-07-03,916.92,12.89,1.43,916.92,0.0,True,1,17448,-916.92,-2034822.78,15998420.16,13963597.38
1997-07-07,912.2,-4.72,-0.52,916.92,-0.52,True,1,17449,-912.2,-2035734.98,15916977.8,13881242.82
1997-07-08,918.75,6.55,0.72,918.75,0.0,True,1,17450,-918.75,-2036653.73,16032187.5,13995533.77
1997-07-09,907.54,-11.21,-1.22,918.75,-1.22,True,1,17451,-907.54,-2037561.27,15837480.54,13799919.27
1997-07-10,913.78,6.24,0.69,918.75,-0.54,True,1,17452,-913.78,-2038475.05,15947288.56,13908813.51
1997-07-11,916.68,2.9,0.32,918.75,-0.22,True,1,17453,-916.68,-2039391.73,15998816.04,13959424.31
1997-07-14,918.38,1.7,0.18,918.75,-0.04,True,1,17454,-918.38,-2040310.11,16029404.52,13989094.41
1997-07-15,925.76,7.38,0.8,925.76,0.0,True,1,17455,-925.76,-2041235.87,16159140.8,14117904.93
1997-07-16,936.59,10.83,1.17,936.59,0.0,True,1,17456,-936.59,-2042172.46,16349115.04,14306942.58
1997-07-17,931.61,-4.98,-0.53,936.59,-0.53,True,1,17457,-931.61,-2043104.07,16263115.77,14220011.7
1997-07-18,915.3,-16.31,-1.75,936.59,-2.27,True,1,17458,-915.3,-2044019.37,15979307.4,13935288.03
1997-07-21,912.94,-2.36,-0.26,936.59,-2.52,True,1,17459,-912.94,-2044932.31,15939019.46,13894087.15
1997-07-22,933.98,21.04,2.31,936.59,-0.28,True,1,17460,-933.98,-2045866.29,16307290.8,14261424.51
1997-07-23,936.56,2.58,0.28,936.59,-0.0,True,1,17461,-936.56,-2046802.85,16353274.16,14306471.31
1997-07-24,940.3,3.74,0.4,940.3,0.0,True,1,17462,-940.3,-2047743.15,16419518.6,14371775.45
1997-07-25,938.79,-1.51,-0.16,940.3,-0.16,True,1,17463,-938.79,-2048681.94,16394089.77,14345407.83
1997-07-28,936.45,-2.34,-0.25,940.3,-0.41,True,1,17464,-936.45,-2049618.39,16354162.8,14304544.41
1997-07-29,942.29,5.84,0.62,942.29,0.0,True,1,17465,-942.29,-2050560.68,16457094.85,14406534.17
1997-07-30,952.29,10.0,1.06,952.29,0.0,True,1,17466,-952.29,-2051512.97,16632697.14,14581184.17
1997-07-31,954.31,2.02,0.21,954.31,0.0,True,1,17467,-954.31,-2052467.28,16668932.77,14616465.49
1997-08-01,947.14,-7.17,-0.75,954.31,-0.75,True,1,17468,-947.14,-2053414.42,16544641.52,14491227.1
1997-08-04,950.3,3.16,0.33,954.31,-0.42,True,1,17469,-950.3,-2054364.72,16600790.7,14546425.98
1997-08-05,952.37,2.07,0.22,954.31,-0.2,True,1,17470,-952.37,-2055317.09,16637903.9,14582586.81
1997-08-06,960.32,7.95,0.84,960.32,0.0,True,1,17471,-960.32,-2056277.41,16777750.72,14721473.31
1997-08-07,951.19,-9.13,-0.95,960.32,-0.95,True,1,17472,-951.19,-2057228.6,16619191.68,14561963.08
1997-08-08,933.54,-17.65,-1.86,960.32,-2.79,True,1,17473,-933.54,-2058162.14,16311744.42,14253582.28
1997-08-11,937.0,3.46,0.37,960.32,-2.43,True,1,17474,-937.0,-2059099.14,16373138.0,14314038.86
1997-08-12,926.53,-10.47,-1.12,960.32,-3.52,True,1,17475,-926.53,-2060025.67,16191111.75,14131086.08
1997-08-13,922.02,-4.51,-0.49,960.32,-3.99,True,1,17476,-922.02,-2060947.69,16113221.52,14052273.83
1997-08-14,924.77,2.75,0.3,960.32,-3.7,True,1,17477,-924.77,-2061872.46,16162205.29,14100332.83
1997-08-15,900.81,-23.96,-2.59,960.32,-6.2,True,1,17478,-900.81,-2062773.27,15744357.18,13681583.91
1997-08-18,912.49,11.68,1.3,960.32,-4.98,True,1,17479,-912.49,-2063685.76,15949412.71,13885726.95
1997-08-19,926.01,13.52,1.48,960.32,-3.57,True,1,17480,-926.01,-2064611.77,16186654.8,14122043.03
1997-08-20,939.35,13.34,1.44,960.32,-2.18,True,1,17481,-939.35,-2065551.12,16420777.35,14355226.23
1997-08-21,925.05,-14.3,-1.52,960.32,-3.67,True,1,17482,-925.05,-2066476.17,16171724.1,14105247.93
1997-08-22,923.54,-1.51,-0.16,960.32,-3.83,True,1,17483,-923.54,-2067399.71,16146249.82,14078850.11
1997-08-25,920.16,-3.38,-0.37,960.32,-4.18,True,1,17484,-920.16,-2068319.87,16088077.44,14019757.57
1997-08-26,913.02,-7.14,-0.78,960.32,-4.92,True,1,17485,-913.02,-2069232.89,15964154.7,13894921.81
1997-08-27,913.7,0.68,0.07,960.32,-4.86,True,1,17486,-913.7,-2070146.59,15976958.2,13906811.61
1997-08-28,903.67,-10.03,-1.1,960.32,-5.9,True,1,17487,-903.67,-2071050.26,15802477.29,13731427.03
1997-08-29,899.47,-4.2,-0.46,960.32,-6.34,True,1,17488,-899.47,-2071949.73,15729931.36,13657981.63
1997-09-02,927.58,28.11,3.12,960.32,-3.41,True,1,17489,-927.58,-2072877.31,16222446.62,14149569.31
1997-09-03,927.86,0.28,0.03,960.32,-3.38,True,1,17490,-927.86,-2073805.17,16228271.4,14154466.23
1997-09-04,930.87,3.01,0.32,960.32,-3.07,True,1,17491,-930.87,-2074736.04,16281847.17,14207111.13
1997-09-05,929.05,-1.82,-0.2,960.32,-3.26,True,1,17492,-929.05,-2075665.09,16250942.6,14175277.51
1997-09-08,931.2,2.15,0.23,960.32,-3.03,True,1,17493,-931.2,-2076596.29,16289481.6,14212885.31
1997-09-09,933.62,2.42,0.26,960.32,-2.78,True,1,17494,-933.62,-2077529.91,16332748.28,14255218.37
1997-09-10,919.03,-14.59,-1.56,960.32,-4.3,True,1,17495,-919.03,-2078448.94,16078429.85,13999980.91
1997-09-11,912.59,-6.44,-0.7,960.32,-4.97,True,1,17496,-912.59,-2079361.53,15966674.64,13887313.11
1997-09-12,923.91,11.32,1.24,960.32,-3.79,True,1,17497,-923.91,-2080285.44,16165653.27,14085367.83
1997-09-15,919.77,-4.14,-0.45,960.32,-4.22,True,1,17498,-919.77,-2081205.21,16094135.46,14012930.25
1997-09-16,945.64,25.87,2.81,960.32,-1.53,True,1,17499,-945.64,-2082150.85,16547754.36,14465603.51
1997-09-17,943.0,-2.64,-0.28,960.32,-1.8,True,1,17500,-943.0,-2083093.85,16502500.0,14419406.15
1997-09-18,947.29,4.29,0.46,960.32,-1.36,True,1,17501,-947.29,-2084041.14,16578522.29,14494481.15
1997-09-19,950.51,3.22,0.34,960.32,-1.02,True,1,17502,-950.51,-2084991.65,16635826.02,14550834.37
1997-09-22,955.43,4.92,0.52,960.32,-0.51,True,1,17503,-955.43,-2085947.08,16722891.29,14636944.21
1997-09-23,951.93,-3.5,-0.37,960.32,-0.87,True,1,17504,-951.93,-2086899.01,16662582.72,14575683.71
1997-09-24,944.48,-7.45,-0.78,960.32,-1.65,True,1,17505,-944.48,-2087843.49,16533122.4,14445278.91
1997-09-25,937.91,-6.57,-0.7,960.32,-2.33,True,1,17506,-937.91,-2088781.4,16419052.46,14330271.06
1997-09-26,945.22,7.31,0.78,960.32,-1.57,True,1,17507,-945.22,-2089726.62,16547966.54,14458239.92
1997-09-29,953.34,8.12,0.86,960.32,-0.73,True,1,17508,-953.34,-2090679.96,16691076.72,14600396.76
1997-09-30,947.28,-6.06,-0.64,960.32,-1.36,True,1,17509,-947.28,-2091627.24,16585925.52,14494298.28
1997-10-01,955.41,8.13,0.86,960.32,-0.51,True,1,17510,-955.41,-2092582.65,16729229.1,14636646.45
1997-10-02,960.46,5.05,0.53,960.46,0.0,True,1,17511,-960.46,-2093543.11,16818615.06,14725071.95
1997-10-03,965.03,4.57,0.48,965.03,0.0,True,1,17512,-965.03,-2094508.14,16899605.36,14805097.22
1997-10-06,972.69,7.66,0.79,972.69,0.0,True,1,17513,-972.69,-2095480.83,17034719.97,14939239.14
1997-10-07,983.12,10.43,1.07,983.12,0.0,True,1,17514,-983.12,-2096463.95,17218363.68,15121899.73
1997-10-08,973.84,-9.28,-0.94,983.12,-0.94,True,1,17515,-973.84,-2097437.79,17056807.6,14959369.81
1997-10-09,970.62,-3.22,-0.33,983.12,-1.27,True,1,17516,-970.62,-2098408.41,17001379.92,14902971.51
1997-10-10,966.98,-3.64,-0.38,983.12,-1.64,True,1,17517,-966.98,-2099375.39,16938588.66,14839213.27
1997-10-13,968.1,1.12,0.12,983.12,-1.53,True,1,17518,-968.1,-2100343.49,16959175.8,14858832.31
1997-10-14,970.28,2.18,0.22,983.12,-1.31,True,1,17519,-970.28,-2101313.77,16998335.32,14897021.55
1997-10-15,965.72,-4.56,-0.47,983.12,-1.77,True,1,17520,-965.72,-2102279.49,16919414.4,14817134.91
1997-10-16,955.25,-10.47,-1.08,983.12,-2.84,True,1,17521,-955.25,-2103234.74,16736935.25,14633700.51
1997-10-17,944.16,-11.09,-1.16,983.12,-3.96,True,1,17522,-944.16,-2104178.9,16543571.52,14439392.62
1997-10-20,955.61,11.45,1.21,983.12,-2.8,True,1,17523,-955.61,-2105134.51,16745154.03,14640019.52
1997-10-21,972.28,16.67,1.74,983.12,-1.1,True,1,17524,-972.28,-2106106.79,17038234.72,14932127.93
1997-10-22,968.49,-3.79,-0.39,983.12,-1.49,True,1,17525,-968.49,-2107075.28,16972787.25,14865711.97
1997-10-23,950.69,-17.8,-1.84,983.12,-3.3,True,1,17526,-950.69,-2108025.97,16661792.94,14553766.97
1997-10-24,941.64,-9.05,-0.95,983.12,-4.22,True,1,17527,-941.64,-2108967.61,16504124.28,14395156.67
1997-10-27,876.99,-64.65,-6.87,983.12,-10.8,True,1,17528,-876.99,-2109844.6,15371880.72,13262036.12
1997-10-28,921.85,44.86,5.12,983.12,-6.23,True,1,17529,-921.85,-2110766.45,16159108.65,14048342.2
1997-10-29,919.16,-2.69,-0.29,983.12,-6.51,True,1,17530,-919.16,-2111685.61,16112874.8,14001189.19
1997-10-30,903.68,-15.48,-1.68,983.12,-8.08,True,1,17531,-903.68,-2112589.29,15842414.08,13729824.79
1997-10-31,914.62,10.94,1.21,983.12,-6.97,True,1,17532,-914.62,-2113503.91,16035117.84,13921613.93
1997-11-03,938.99,24.37,2.66,983.12,-4.49,True,1,17533,-938.99,-2114442.9,16463311.67,14348868.77
1997-11-04,940.76,1.77,0.19,983.12,-4.31,True,1,17534,-940.76,-2115383.66,16495285.84,14379902.18
1997-11-05,942.76,2.0,0.21,983.12,-4.11,True,1,17535,-942.76,-2116326.42,16531296.6,14414970.18
1997-11-06,938.03,-4.73,-0.5,983.12,-4.59,True,1,17536,-938.03,-2117264.45,16449294.08,14332029.63
1997-11-07,927.51,-10.52,-1.12,983.12,-5.66,True,1,17537,-927.51,-2118191.96,16265742.87,14147550.91
1997-11-10,921.13,-6.38,-0.69,983.12,-6.3,True,1,17538,-921.13,-2119113.09,16154777.94,14035664.85
1997-11-11,923.78,2.65,0.29,983.12,-6.04,True,1,17539,-923.78,-2120036.87,16202177.42,14082140.55
1997-11-12,905.96,-17.82,-1.93,983.12,-7.85,True,1,17540,-905.96,-2120942.83,15890538.4,13769595.57
1997-11-13,916.66,10.7,1.18,983.12,-6.76,True,1,17541,-916.66,-2121859.49,16079133.06,13957273.57
1997-11-14,928.35,11.69,1.27,983.12,-5.57,True,1,17542,-928.35,-2122787.84,16285115.7,14162327.86
1997-11-17,946.2,17.85,1.92,983.12,-3.76,True,1,17543,-946.2,-2123734.04,16599186.6,14475452.56
1997-11-18,938.23,-7.97,-0.84,983.12,-4.57,True,1,17544,-938.23,-2124672.27,16460307.12,14335634.85
1997-11-19,944.59,6.36,0.68,983.12,-3.92,True,1,17545,-944.59,-2125616.86,16572831.55,14447214.69
1997-11-20,958.98,14.39,1.52,983.12,-2.46,True,1,17546,-958.98,-2126575.84,16826263.08,14699687.24
1997-11-21,963.09,4.11,0.43,983.12,-2.04,True,1,17547,-963.09,-2127538.93,16899340.23,14771801.3
1997-11-24,946.67,-16.42,-1.7,983.12,-3.71,True,1,17548,-946.67,-2128485.6,16612165.16,14483679.56
1997-11-25,950.82,4.15,0.44,983.12,-3.28,True,1,17549,-950.82,-2129436.42,16685940.18,14556503.76
1997-11-26,951.64,0.82,0.09,983.12,-3.2,True,1,17550,-951.64,-2130388.06,16701282.0,14570893.94
1997-11-28,955.4,3.76,0.4,983.12,-2.82,True,1,17551,-955.4,-2131343.46,16768225.4,14636881.94
1997-12-01,974.77,19.37,2.03,983.12,-0.85,True,1,17552,-974.77,-2132318.23,17109163.04,14976844.81
1997-12-02,971.68,-3.09,-0.32,983.12,-1.16,True,1,17553,-971.68,-2133289.91,17055899.04,14922609.13
1997-12-03,976.77,5.09,0.52,983.12,-0.65,True,1,17554,-976.77,-2134266.68,17146220.58,15011953.9
1997-12-04,973.1,-3.67,-0.38,983.12,-1.02,True,1,17555,-973.1,-2135239.78,17082770.5,14947530.72
1997-12-05,983.79,10.69,1.1,983.79,0.0,True,1,17556,-983.79,-2136223.57,17271417.24,15135193.67
1997-12-08,982.37,-1.42,-0.14,983.79,-0.14,True,1,17557,-982.37,-2137205.94,17247470.09,15110264.15
1997-12-09,975.78,-6.59,-0.67,983.79,-0.81,True,1,17558,-975.78,-2138181.72,17132745.24,14994563.52
1997-12-10,969.79,-5.99,-0.61,983.79,-1.42,True,1,17559,-969.79,-2139151.51,17028542.61,14889391.1
1997-12-11,954.94,-14.85,-1.53,983.79,-2.93,True,1,17560,-954.94,-2140106.45,16768746.4,14628639.95
1997-12-12,953.39,-1.55,-0.16,983.79,-3.09,True,1,17561,-953.39,-2141059.84,16742481.79,14601421.95
1997-12-15,963.39,10.0,1.05,983.79,-2.07,True,1,17562,-963.39,-2142023.23,16919055.18,14777031.95
1997-12-16,968.04,4.65,0.48,983.79,-1.6,True,1,17563,-968.04,-2142991.27,17001686.52,14858695.25
1997-12-17,965.54,-2.5,-0.26,983.79,-1.86,True,1,17564,-965.54,-2143956.81,16958744.56,14814787.75
1997-12-18,955.3,-10.24,-1.06,983.79,-2.9,True,1,17565,-955.3,-2144912.11,16779844.5,14634932.39
1997-12-19,946.78,-8.52,-0.89,983.79,-3.76,True,1,17566,-946.78,-2145858.89,16631137.48,14485278.59
1997-12-22,953.7,6.92,0.73,983.79,-3.06,True,1,17567,-953.7,-2146812.59,16753647.9,14606835.31
1997-12-23,939.13,-14.57,-1.53,983.79,-4.54,True,1,17568,-939.13,-2147751.72,16498635.84,14350884.12
1997-12-24,932.7,-6.43,-0.68,983.79,-5.19,True,1,17569,-932.7,-2148684.42,16386606.3,14237921.88
1997-12-26,936.46,3.76,0.4,983.79,-4.81,True,1,17570,-936.46,-2149620.88,16453602.2,14303981.32
1997-12-29,953.35,16.89,1.8,983.79,-3.09,True,1,17571,-953.35,-2150574.23,16751312.85,14600738.62
1997-12-30,970.84,17.49,1.84,983.79,-1.32,True,1,17572,-970.84,-2151545.07,17059600.48,14908055.41
1997-12-31,970.43,-0.41,-0.04,983.79,-1.36,True,1,17573,-970.43,-2152515.5,17053366.39,14900850.89
1998-01-02,975.04,4.61,0.48,983.79,-0.89,True,1,17574,-975.04,-2153490.54,17135352.96,14981862.42
1998-01-05,977.07,2.03,0.21,983.79,-0.68,True,1,17575,-977.07,-2154467.61,17172005.25,15017537.64
1998-01-06,966.58,-10.49,-1.07,983.79,-1.75,True,1,17576,-966.58,-2155434.19,16988610.08,14833175.89
1998-01-07,964.0,-2.58,-0.27,983.79,-2.01,True,1,17577,-964.0,-2156398.19,16944228.0,14787829.81
1998-01-08,956.05,-7.95,-0.82,983.79,-2.82,True,1,17578,-956.05,-2157354.24,16805446.9,14648092.66
1998-01-09,927.69,-28.36,-2.97,983.79,-5.7,True,1,17579,-927.69,-2158281.93,16307862.51,14149580.58
1998-01-12,939.21,11.52,1.24,983.79,-4.53,True,1,17580,-939.21,-2159221.14,16511311.8,14352090.66
1998-01-13,952.12,12.91,1.38,983.79,-3.22,True,1,17581,-952.12,-2160173.26,16739221.72,14579048.46
1998-01-14,957.94,5.82,0.61,983.79,-2.63,True,1,17582,-957.94,-2161131.2,16842501.08,14681369.88
1998-01-15,950.73,-7.21,-0.75,983.79,-3.36,True,1,17583,-950.73,-2162081.93,16716685.59,14554603.66
1998-01-16,961.51,10.78,1.13,983.79,-2.26,True,1,17584,-961.51,-2163043.44,16907191.84,14744148.4
1998-01-20,978.6,17.09,1.78,983.79,-0.53,True,1,17585,-978.6,-2164022.04,17208681.0,15044658.96
1998-01-21,970.81,-7.79,-0.8,983.79,-1.32,True,1,17586,-970.81,-2164992.85,17072664.66,14907671.81
1998-01-22,963.04,-7.77,-0.8,983.79,-2.11,True,1,17587,-963.04,-2165955.89,16936984.48,14771028.59
1998-01-23,957.59,-5.45,-0.57,983.79,-2.66,True,1,17588,-957.59,-2166913.48,16842092.92,14675179.44
1998-01-26,956.95,-0.64,-0.07,983.79,-2.73,True,1,17589,-956.95,-2167870.43,16831793.55,14663923.12
1998-01-27,969.02,12.07,1.26,983.79,-1.5,True,1,17590,-969.02,-2168839.45,17045061.8,14876222.35
1998-01-28,977.46,8.44,0.87,983.79,-0.64,True,1,17591,-977.46,-2169816.91,17194498.86,15024681.95
1998-01-29,985.49,8.03,0.82,985.49,0.0,True,1,17592,-985.49,-2170802.4,17336740.08,15165937.68
1998-01-30,980.28,-5.21,-0.53,985.49,-0.53,True,1,17593,-980.28,-2171782.68,17246066.04,15074283.36
1998-02-02,1001.27,20.99,2.14,1001.27,0.0,True,1,17594,-1001.27,-2172783.95,17616344.38,15443560.43
1998-02-03,1006.0,4.73,0.47,1006.0,0.0,True,1,17595,-1006.0,-2173789.95,17700570.0,15526780.05
1998-02-04,1006.9,0.9,0.09,1006.9,0.0,True,1,17596,-1006.9,-2174796.85,17717412.4,15542615.55
1998-02-05,1003.54,-3.36,-0.33,1006.9,-0.33,True,1,17597,-1003.54,-2175800.39,17659293.38,15483492.99
1998-02-06,1012.46,8.92,0.89,1012.46,0.0,True,1,17598,-1012.46,-2176812.85,17817271.08,15640458.23
1998-02-09,1010.74,-1.72,-0.17,1012.46,-0.17,True,1,17599,-1010.74,-2177823.59,17788013.26,15610189.67
1998-02-10,1019.01,8.27,0.82,1019.01,0.0,True,1,17600,-1019.01,-2178842.6,17934576.0,15755733.4
1998-02-11,1020.01,1.0,0.1,1020.01,0.0,True,1,17601,-1020.01,-2179862.61,17953196.01,15773333.4
1998-02-12,1024.14,4.13,0.4,1024.14,0.0,True,1,17602,-1024.14,-2180886.75,18026912.28,15846025.53
1998-02-13,1020.09,-4.05,-0.4,1024.14,-0.4,True,1,17603,-1020.09,-2181906.84,17956644.27,15774737.43
1998-02-17,1022.76,2.67,0.26,1024.14,-0.14,True,1,17604,-1022.76,-2182929.6,18004667.04,15821737.44
1998-02-18,1032.08,9.32,0.91,1032.08,0.0,True,1,17605,-1032.08,-2183961.68,18169768.4,15985806.72
1998-02-19,1028.28,-3.8,-0.37,1032.08,-0.37,True,1,17606,-1028.28,-2184989.96,18103897.68,15918907.72
1998-02-20,1034.21,5.93,0.58,1034.21,0.0,True,1,17607,-1034.21,-2186024.17,18209335.47,16023311.3
1998-02-23,1038.14,3.93,0.38,1038.14,0.0,True,1,17608,-1038.14,-2187062.31,18279569.12,16092506.81
1998-02-24,1030.56,-7.58,-0.73,1038.14,-0.73,True,1,17609,-1030.56,-2188092.87,18147131.04,15959038.17
1998-02-25,1042.9,12.34,1.2,1042.9,0.0,True,1,17610,-1042.9,-2189135.77,18365469.0,16176333.23
1998-02-26,1048.67,5.77,0.55,1048.67,0.0,True,1,17611,-1048.67,-2190184.44,18468127.37,16277942.93
1998-02-27,1049.34,0.67,0.06,1049.34,0.0,True,1,17612,-1049.34,-2191233.78,18480976.08,16289742.3
1998-03-02,1047.7,-1.64,-0.16,1049.34,-0.16,True,1,17613,-1047.7,-2192281.48,18453140.1,16260858.62
1998-03-03,1052.02,4.32,0.41,1052.02,0.0,True,1,17614,-1052.02,-2193333.5,18530280.28,16336946.78
1998-03-04,1047.33,-4.69,-0.45,1052.02,-0.45,True,1,17615,-1047.33,-2194380.83,18448717.95,16254337.12
1998-03-05,1035.05,-12.28,-1.17,1052.02,-1.61,True,1,17616,-1035.05,-2195415.88,18233440.8,16038024.92
1998-03-06,1055.69,20.64,1.99,1055.69,0.0,True,1,17617,-1055.69,-2196471.57,18598090.73,16401619.16
1998-03-09,1052.31,-3.38,-0.32,1055.69,-0.32,True,1,17618,-1052.31,-2197523.88,18539597.58,16342073.7
1998-03-10,1064.25,11.94,1.14,1064.25,0.0,True,1,17619,-1064.25,-2198588.13,18751020.75,16552432.62
1998-03-11,1068.47,4.22,0.4,1068.47,0.0,True,1,17620,-1068.47,-2199656.6,18826441.4,16626784.8
1998-03-12,1069.92,1.45,0.14,1069.92,0.0,True,1,17621,-1069.92,-2200726.52,18853060.32,16652333.8
1998-03-13,1068.61,-1.31,-0.12,1069.92,-0.12,True,1,17622,-1068.61,-2201795.13,18831045.42,16629250.29
1998-03-16,1079.27,10.66,1.0,1079.27,0.0,True,1,17623,-1079.27,-2202874.4,19019975.21,16817100.81
1998-03-17,1080.45,1.18,0.11,1080.45,0.0,True,1,17624,-1080.45,-2203954.85,19041850.8,16837895.95
1998-03-18,1085.52,5.07,0.47,1085.52,0.0,True,1,17625,-1085.52,-2205040.37,19132290.0,16927249.63
1998-03-19,1089.74,4.22,0.39,1089.74,0.0,True,1,17626,-1089.74,-2206130.11,19207757.24,17001627.13
1998-03-20,1099.16,9.42,0.86,1099.16,0.0,True,1,17627,-1099.16,-2207229.27,19374893.32,17167664.05
1998-03-23,1095.55,-3.61,-0.33,1099.16,-0.33,True,1,17628,-1095.55,-2208324.82,19312355.4,17104030.58
1998-03-24,1105.65,10.1,0.92,1105.65,0.0,True,1,17629,-1105.65,-2209430.47,19491503.85,17282073.38
1998-03-25,1101.93,-3.72,-0.34,1105.65,-0.34,True,1,17630,-1101.93,-2210532.4,19427025.9,17216493.5
1998-03-26,1100.8,-1.13,-0.1,1105.65,-0.44,True,1,17631,-1100.8,-2211633.2,19408204.8,17196571.6
1998-03-27,1095.44,-5.36,-0.49,1105.65,-0.92,True,1,17632,-1095.44,-2212728.64,19314798.08,17102069.44
1998-03-30,1093.6,-1.84,-0.17,1105.65,-1.09,True,1,17633,-1093.6,-2213822.24,19283448.8,17069626.56
1998-03-31,1101.75,8.15,0.74,1105.65,-0.35,True,1,17634,-1101.75,-2214923.99,19428259.5,17213335.51
1998-04-01,1108.15,6.4,0.58,1108.15,0.0,True,1,17635,-1108.15,-2216032.14,19542225.25,17326193.11
1998-04-02,1120.01,11.86,1.07,1120.01,0.0,True,1,17636,-1120.01,-2217152.15,19752496.36,17535344.21
1998-04-03,1122.7,2.69,0.24,1122.7,0.0,True,1,17637,-1122.7,-2218274.85,19801059.9,17582785.05
1998-04-06,1121.38,-1.32,-0.12,1122.7,-0.12,True,1,17638,-1121.38,-2219396.23,19778900.44,17559504.21
1998-04-07,1109.55,-11.83,-1.06,1122.7,-1.17,True,1,17639,-1109.55,-2220505.78,19571352.45,17350846.67
1998-04-08,1101.65,-7.9,-0.71,1122.7,-1.88,True,1,17640,-1101.65,-2221607.43,19433106.0,17211498.57
1998-04-09,1110.67,9.02,0.82,1122.7,-1.07,True,1,17641,-1110.67,-2222718.1,19593329.47,17370611.37
1998-04-13,1109.69,-0.98,-0.09,1122.7,-1.16,True,1,17642,-1109.69,-2223827.79,19577150.98,17353323.19
1998-04-14,1115.75,6.06,0.55,1122.7,-0.62,True,1,17643,-1115.75,-2224943.54,19685177.25,17460233.71
1998-04-15,1119.32,3.57,0.32,1122.7,-0.3,True,1,17644,-1119.32,-2226062.86,19749282.08,17523219.22
1998-04-16,1108.17,-11.15,-1.0,1122.7,-1.29,True,1,17645,-1108.17,-2227171.03,19553659.65,17326488.62
1998-04-17,1122.72,14.55,1.31,1122.72,0.0,True,1,17646,-1122.72,-2228293.75,19811517.12,17583223.37
1998-04-20,1123.65,0.93,0.08,1123.65,0.0,True,1,17647,-1123.65,-2229417.4,19829051.55,17599634.15
1998-04-21,1126.67,3.02,0.27,1126.67,0.0,True,1,17648,-1126.67,-2230544.07,19883472.16,17652928.09
1998-04-22,1130.54,3.87,0.34,1130.54,0.0,True,1,17649,-1130.54,-2231674.61,19952900.46,17721225.85
1998-04-23,1119.58,-10.96,-0.97,1130.54,-0.97,True,1,17650,-1119.58,-2232794.19,19760587.0,17527792.81
1998-04-24,1107.9,-11.68,-1.04,1130.54,-2.0,True,1,17651,-1107.9,-2233902.09,19555542.9,17321640.81
1998-04-27,1086.54,-21.36,-1.93,1130.54,-3.89,True,1,17652,-1086.54,-2234988.63,19179604.08,16944615.45
1998-04-28,1085.11,-1.43,-0.13,1130.54,-4.02,True,1,17653,-1085.11,-2236073.74,19155446.83,16919373.09
1998-04-29,1094.62,9.51,0.88,1130.54,-3.18,True,1,17654,-1094.62,-2237168.36,19324421.48,17087253.12
1998-04-30,1111.75,17.13,1.56,1130.54,-1.66,True,1,17655,-1111.75,-2238280.11,19627946.25,17389666.14
1998-05-01,1121.0,9.25,0.83,1130.54,-0.84,True,1,17656,-1121.0,-2239401.11,19792376.0,17552974.89
1998-05-04,1122.07,1.07,0.1,1130.54,-0.75,True,1,17657,-1122.07,-2240523.18,19812389.99,17571866.81
1998-05-05,1115.5,-6.57,-0.59,1130.54,-1.33,True,1,17658,-1115.5,-2241638.68,19697499.0,17455860.32
1998-05-06,1104.92,-10.58,-0.95,1130.54,-2.27,True,1,17659,-1104.92,-2242743.6,19511782.28,17269038.68
1998-05-07,1095.14,-9.78,-0.88,1130.54,-3.13,True,1,17660,-1095.14,-2243838.74,19340172.4,17096333.66
1998-05-08,1108.14,13.0,1.19,1130.54,-1.98,True,1,17661,-1108.14,-2244946.88,19570860.54,17325913.66
1998-05-11,1106.64,-1.5,-0.14,1130.54,-2.11,True,1,17662,-1106.64,-2246053.52,19545475.68,17299422.16
1998-05-12,1115.79,9.15,0.83,1130.54,-1.3,True,1,17663,-1115.79,-2247169.31,19708198.77,17461029.46
1998-05-13,1118.86,3.07,0.28,1130.54,-1.03,True,1,17664,-1118.86,-2248288.17,19763543.04,17515254.87
1998-05-14,1117.37,-1.49,-0.13,1130.54,-1.16,True,1,17665,-1117.37,-2249405.54,19738341.05,17488935.51
1998-05-15,1108.73,-8.64,-0.77,1130.54,-1.93,True,1,17666,-1108.73,-2250514.27,19586824.18,17336309.91
1998-05-18,1105.82,-2.91,-0.26,1130.54,-2.19,True,1,17667,-1105.82,-2251620.09,19536521.94,17284901.85
1998-05-19,1109.52,3.7,0.34,1130.54,-1.86,True,1,17668,-1109.52,-2252729.61,19602999.36,17350269.75
1998-05-20,1119.06,9.54,0.86,1130.54,-1.01,True,1,17669,-1119.06,-2253848.67,19772671.14,17518822.47
1998-05-21,1114.64,-4.42,-0.4,1130.54,-1.41,True,1,17670,-1114.64,-2254963.31,19695688.8,17440725.49
1998-05-22,1110.47,-4.17,-0.37,1130.54,-1.78,True,1,17671,-1110.47,-2256073.78,19623115.37,17367041.59
1998-05-26,1094.02,-16.45,-1.48,1130.54,-3.23,True,1,17672,-1094.02,-2257167.8,19333521.44,17076353.64
1998-05-27,1092.23,-1.79,-0.16,1130.54,-3.39,True,1,17673,-1092.23,-2258260.03,19302980.79,17044720.76
1998-05-28,1097.6,5.37,0.49,1130.54,-2.91,True,1,17674,-1097.6,-2259357.63,19398982.4,17139624.77
1998-05-29,1090.82,-6.78,-0.62,1130.54,-3.51,True,1,17675,-1090.82,-2260448.45,19280243.5,17019795.05
1998-06-01,1090.98,0.16,0.02,1130.54,-3.5,True,1,17676,-1090.98,-2261539.43,19284162.48,17022623.05
1998-06-02,1093.22,2.24,0.2,1130.54,-3.3,True,1,17677,-1093.22,-2262632.65,19324849.94,17062217.29
1998-06-03,1082.73,-10.49,-0.96,1130.54,-4.23,True,1,17678,-1082.73,-2263715.38,19140500.94,16876785.56
1998-06-04,1094.83,12.1,1.12,1130.54,-3.16,True,1,17679,-1094.83,-2264810.21,19355499.57,17090689.36
1998-06-05,1113.86,19.03,1.74,1130.54,-1.48,True,1,17680,-1113.86,-2265924.07,19693044.8,17427120.73
1998-06-08,1115.72,1.86,0.17,1130.54,-1.31,True,1,17681,-1115.72,-2267039.79,19727045.32,17460005.53
1998-06-09,1118.41,2.69,0.24,1130.54,-1.07,True,1,17682,-1118.41,-2268158.2,19775725.62,17507567.42
1998-06-10,1112.28,-6.13,-0.55,1130.54,-1.62,True,1,17683,-1112.28,-2269270.48,19668447.24,17399176.76
1998-06-11,1094.58,-17.7,-1.59,1130.54,-3.18,True,1,17684,-1094.58,-2270365.06,19356552.72,17086187.66
1998-06-12,1098.84,4.26,0.39,1130.54,-2.8,True,1,17685,-1098.84,-2271463.9,19432985.4,17161521.5
1998-06-15,1077.01,-21.83,-1.99,1130.54,-4.74,True,1,17686,-1077.01,-2272540.91,19047998.86,16775457.95
1998-06-16,1087.59,10.58,0.98,1130.54,-3.8,True,1,17687,-1087.59,-2273628.5,19236204.33,16962575.83
1998-06-17,1107.11,19.52,1.8,1130.54,-2.07,True,1,17688,-1107.11,-2274735.61,19582561.68,17307826.07
1998-06-18,1106.37,-0.74,-0.07,1130.54,-2.14,True,1,17689,-1106.37,-2275841.98,19570578.93,17294736.95
1998-06-19,1100.65,-5.72,-0.52,1130.54,-2.64,True,1,17690,-1100.65,-2276942.63,19470498.5,17193555.87
1998-06-22,1103.21,2.56,0.23,1130.54,-2.42,True,1,17691,-1103.21,-2278045.84,19516888.11,17238842.27
1998-06-23,1119.49,16.28,1.48,1130.54,-0.98,True,1,17692,-1119.49,-2279165.33,19806017.08,17526851.75
1998-06-24,1132.88,13.39,1.2,1132.88,0.0,True,1,17693,-1132.88,-2280298.21,20044045.84,17763747.63
1998-06-25,1129.28,-3.6,-0.32,1132.88,-0.32,True,1,17694,-1129.28,-2281427.49,19981480.32,17700052.83
1998-06-26,1133.2,3.92,0.35,1133.2,0.0,True,1,17695,-1133.2,-2282560.69,20051974.0,17769413.31
1998-06-29,1138.49,5.29,0.47,1138.49,0.0,True,1,17696,-1138.49,-2283699.18,20146719.04,17863019.86
1998-06-30,1133.84,-4.65,-0.41,1138.49,-0.41,True,1,17697,-1133.84,-2284833.02,20065566.48,17780733.46
1998-07-01,1148.56,14.72,1.3,1148.56,0.0,True,1,17698,-1148.56,-2285981.58,20327214.88,18041233.3
1998-07-02,1146.42,-2.14,-0.19,1148.56,-0.19,True,1,17699,-1146.42,-2287128.0,20290487.58,18003359.58
1998-07-06,1157.33,10.91,0.95,1157.33,0.0,True,1,17700,-1157.33,-2288285.33,20484741.0,18196455.67
1998-07-07,1154.66,-2.67,-0.23,1157.33,-0.23,True,1,17701,-1154.66,-2289439.99,20438636.66,18149196.67
1998-07-08,1166.38,11.72,1.01,1166.38,0.0,True,1,17702,-1166.38,-2290606.37,20647258.76,18356652.39
1998-07-09,1158.56,-7.82,-0.67,1166.38,-0.67,True,1,17703,-1158.56,-2291764.93,20509987.68,18218222.75
1998-07-10,1164.33,5.77,0.5,1166.38,-0.18,True,1,17704,-1164.33,-2292929.26,20613298.32,18320369.06
1998-07-13,1165.19,0.86,0.07,1166.38,-0.1,True,1,17705,-1165.19,-2294094.45,20629688.95,18335594.5
1998-07-14,1177.58,12.39,1.06,1177.58,0.0,True,1,17706,-1177.58,-2295272.03,20850231.48,18554959.45
1998-07-15,1174.81,-2.77,-0.24,1177.58,-0.24,True,1,17707,-1174.81,-2296446.84,20802360.67,18505913.83
1998-07-16,1183.99,9.18,0.78,1183.99,0.0,True,1,17708,-1183.99,-2297630.83,20966094.92,18668464.09
1998-07-17,1186.75,2.76,0.23,1186.75,0.0,True,1,17709,-1186.75,-2298817.58,21016155.75,18717338.17
1998-07-20,1184.1,-2.65,-0.22,1186.75,-0.22,True,1,17710,-1184.1,-2300001.68,20970411.0,18670409.32
1998-07-21,1165.07,-19.03,-1.61,1186.75,-1.83,True,1,17711,-1165.07,-2301166.75,20634554.77,18333388.02
1998-07-22,1164.08,-0.99,-0.08,1186.75,-1.91,True,1,17712,-1164.08,-2302330.83,20618184.96,18315854.13
1998-07-23,1139.75,-24.33,-2.09,1186.75,-3.96,True,1,17713,-1139.75,-2303470.58,20188391.75,17884921.17
1998-07-24,1140.8,1.05,0.09,1186.75,-3.87,True,1,17714,-1140.8,-2304611.38,20208131.2,17903519.82
1998-07-27,1147.27,6.47,0.57,1186.75,-3.33,True,1,17715,-1147.27,-2305758.65,20323888.05,18018129.4
1998-07-28,1130.24,-17.03,-1.48,1186.75,-4.76,True,1,17716,-1130.24,-2306888.89,20023331.84,17716442.95
1998-07-29,1125.21,-5.03,-0.44,1186.75,-5.19,True,1,17717,-1125.21,-2308014.1,19935345.57,17627331.47
1998-07-30,1142.95,17.74,1.58,1186.75,-3.69,True,1,17718,-1142.95,-2309157.05,20250788.1,17941631.05
1998-07-31,1120.67,-22.28,-1.95,1186.75,-5.57,True,1,17719,-1120.67,-2310277.72,19857151.73,17546874.01
1998-08-03,1112.44,-8.23,-0.73,1186.75,-6.26,True,1,17720,-1112.44,-2311390.16,19712436.8,17401046.64
1998-08-04,1072.12,-40.32,-3.62,1186.75,-9.66,True,1,17721,-1072.12,-2312462.28,18999038.52,16686576.24
1998-08-05,1081.43,9.31,0.87,1186.75,-8.88,True,1,17722,-1081.43,-2313543.71,19165102.46,16851558.75
1998-08-06,1089.63,8.2,0.76,1186.75,-8.18,True,1,17723,-1089.63,-2314633.34,19311512.49,16996879.15
1998-08-07,1089.45,-0.18,-0.02,1186.75,-8.2,True,1,17724,-1089.45,-2315722.79,19309411.8,16993689.01
1998-08-10,1083.14,-6.31,-0.58,1186.75,-8.73,True,1,17725,-1083.14,-2316805.93,19198656.5,16881850.57
1998-08-11,1068.98,-14.16,-1.31,1186.75,-9.92,True,1,17726,-1068.98,-2317874.91,18948739.48,16630864.57
1998-08-12,1084.22,15.24,1.43,1186.75,-8.64,True,1,17727,-1084.22,-2318959.13,19219967.94,16901008.81
1998-08-13,1074.91,-9.31,-0.86,1186.75,-9.42,True,1,17728,-1074.91,-2320034.04,19056004.48,16735970.44
1998-08-14,1062.75,-12.16,-1.13,1186.75,-10.45,True,1,17729,-1062.75,-2321096.79,18841494.75,16520397.96
1998-08-17,1083.67,20.92,1.97,1186.75,-8.69,True,1,17730,-1083.67,-2322180.46,19213469.1,16891288.64
1998-08-18,1101.2,17.53,1.62,1186.75,-7.21,True,1,17731,-1101.2,-2323281.66,19525377.2,17202095.54
1998-08-19,1098.06,-3.14,-0.28,1186.75,-7.47,True,1,17732,-1098.06,-2324379.72,19470799.92,17146420.2
1998-08-20,1091.6,-6.46,-0.59,1186.75,-8.02,True,1,17733,-1091.6,-2325471.32,19357342.8,17031871.48
1998-08-21,1081.24,-10.36,-0.95,1186.75,-8.89,True,1,17734,-1081.24,-2326552.56,19174710.16,16848157.6
1998-08-24,1088.14,6.9,0.64,1186.75,-8.31,True,1,17735,-1088.14,-2327640.7,19298162.9,16970522.2
1998-08-25,1092.85,4.71,0.43,1186.75,-7.91,True,1,17736,-1092.85,-2328733.55,19382787.6,17054054.05
1998-08-26,1084.19,-8.66,-0.79,1186.75,-8.64,True,1,17737,-1084.19,-2329817.74,19230278.03,16900460.29
1998-08-27,1042.59,-41.6,-3.84,1186.75,-12.15,True,1,17738,-1042.59,-2330860.33,18493461.42,16162601.09
1998-08-28,1027.14,-15.45,-1.48,1186.75,-13.45,True,1,17739,-1027.14,-2331887.47,18220436.46,15888548.99
1998-08-31,957.28,-69.86,-6.8,1186.75,-19.34,True,1,17740,-957.28,-2332844.75,16982147.2,14649302.45
1998-09-01,994.26,36.98,3.86,1186.75,-16.22,True,1,17741,-994.26,-2333839.01,17639166.66,15305327.65
1998-09-02,990.48,-3.78,-0.38,1186.75,-16.54,True,1,17742,-990.48,-2334829.49,17573096.16,15238266.67
1998-09-03,982.26,-8.22,-0.83,1186.75,-17.23,True,1,17743,-982.26,-2335811.75,17428239.18,15092427.43
1998-09-04,973.89,-8.37,-0.85,1186.75,-17.94,True,1,17744,-973.89,-2336785.64,17280704.16,14943918.52
1998-09-08,1023.46,49.57,5.09,1186.75,-13.76,True,1,17745,-1023.46,-2337809.1,18161297.7,15823488.6
1998-09-09,1006.2,-17.26,-1.69,1186.75,-15.21,True,1,17746,-1006.2,-2338815.3,17856025.2,15517209.9
1998-09-10,980.19,-26.01,-2.58,1186.75,-17.41,True,1,17747,-980.19,-2339795.49,17395431.93,15055636.44
1998-09-11,1009.06,28.87,2.94,1186.75,-14.97,True,1,17748,-1009.06,-2340804.55,17908796.88,15567992.33
1998-09-14,1029.72,20.66,2.05,1186.75,-13.23,True,1,17749,-1029.72,-2341834.27,18276500.28,15934666.01
1998-09-15,1037.68,7.96,0.77,1186.75,-12.56,True,1,17750,-1037.68,-2342871.95,18418820.0,16075948.05
1998-09-16,1045.48,7.8,0.75,1186.75,-11.9,True,1,17751,-1045.48,-2343917.43,18558315.48,16214398.05
1998-09-17,1018.87,-26.61,-2.54,1186.75,-14.15,True,1,17752,-1018.87,-2344936.3,18086980.24,15742043.94
1998-09-18,1020.09,1.22,0.12,1186.75,-14.04,True,1,17753,-1020.09,-2345956.39,18109657.77,15763701.38
1998-09-21,1023.89,3.8,0.37,1186.75,-13.72,True,1,17754,-1023.89,-2346980.28,18178143.06,15831162.78
1998-09-22,1029.63,5.74,0.56,1186.75,-13.24,True,1,17755,-1029.63,-2348009.91,18281080.65,15933070.74
1998-09-23,1066.09,36.46,3.54,1186.75,-10.17,True,1,17756,-1066.09,-2349076.0,18929494.04,16580418.04
1998-09-24,1042.72,-23.37,-2.19,1186.75,-12.14,True,1,17757,-1042.72,-2350118.72,18515579.04,16165460.32
1998-09-25,1044.75,2.03,0.2,1186.75,-11.96,True,1,17758,-1044.75,-2351163.47,18552670.5,16201507.03
1998-09-28,1048.69,3.94,0.38,1186.75,-11.63,True,1,17759,-1048.69,-2352212.16,18623685.71,16271473.55
1998-09-29,1049.02,0.33,0.03,1186.75,-11.61,True,1,17760,-1049.02,-2353261.18,18630595.2,16277334.02
1998-09-30,1017.01,-32.01,-3.05,1186.75,-14.3,True,1,17761,-1017.01,-2354278.19,18063114.61,15708836.42
1998-10-01,986.39,-30.62,-3.01,1186.75,-16.88,True,1,17762,-986.39,-2355264.58,17520259.18,15164994.6
1998-10-02,1002.6,16.21,1.64,1186.75,-15.52,True,1,17763,-1002.6,-2356267.18,17809183.8,15452916.62
1998-10-05,988.56,-14.04,-1.4,1186.75,-16.7,True,1,17764,-988.56,-2357255.74,17560779.84,15203524.1
1998-10-06,984.59,-3.97,-0.4,1186.75,-17.04,True,1,17765,-984.59,-2358240.33,17491241.35,15133001.02
1998-10-07,970.68,-13.91,-1.41,1186.75,-18.21,True,1,17766,-970.68,-2359211.01,17245100.88,14885889.87
1998-10-08,959.44,-11.24,-1.16,1186.75,-19.15,True,1,17767,-959.44,-2360170.45,17046370.48,14686200.03
1998-10-09,984.39,24.95,2.6,1186.75,-17.05,True,1,17768,-984.39,-2361154.84,17490641.52,15129486.68
1998-10-12,997.71,13.32,1.35,1186.75,-15.93,True,1,17769,-997.71,-2362152.55,17728308.99,15366156.44
1998-10-13,994.8,-2.91,-0.29,1186.75,-16.17,True,1,17770,-994.8,-2363147.35,17677596.0,15314448.65
1998-10-14,1005.53,10.73,1.08,1186.75,-15.27,True,1,17771,-1005.53,-2364152.88,17869273.63,15505120.75
1998-10-15,1047.49,41.96,4.17,1186.75,-11.74,True,1,17772,-1047.49,-2365200.37,18615992.28,16250791.91
1998-10-16,1056.42,8.93,0.85,1186.75,-10.98,True,1,17773,-1056.42,-2366256.79,18775752.66,16409495.87
1998-10-19,1062.39,5.97,0.56,1186.75,-10.48,True,1,17774,-1062.39,-2367319.18,18882919.86,16515600.68
1998-10-20,1063.93,1.54,0.14,1186.75,-10.35,True,1,17775,-1063.93,-2368383.11,18911355.75,16542972.64
1998-10-21,1069.92,5.99,0.56,1186.75,-9.85,True,1,17776,-1069.92,-2369453.03,19018897.92,16649444.89
1998-10-22,1078.48,8.56,0.8,1186.75,-9.12,True,1,17777,-1078.48,-2370531.51,19172138.96,16801607.45
1998-10-23,1070.67,-7.81,-0.72,1186.75,-9.78,True,1,17778,-1070.67,-2371602.18,19034371.26,16662769.08
1998-10-26,1072.32,1.65,0.15,1186.75,-9.64,True,1,17779,-1072.32,-2372674.5,19064777.28,16692102.78
1998-10-27,1065.34,-6.98,-0.65,1186.75,-10.23,True,1,17780,-1065.34,-2373739.84,18941745.2,16568005.36
1998-10-28,1068.09,2.75,0.26,1186.75,-10.0,True,1,17781,-1068.09,-2374807.93,18991708.29,16616900.36
1998-10-29,1085.93,17.84,1.67,1186.75,-8.49,True,1,17782,-1085.93,-2375893.86,19310007.26,16934113.4
1998-10-30,1098.67,12.74,1.17,1186.75,-7.42,True,1,17783,-1098.67,-2376992.53,19537648.61,17160656.08
1998-11-02,1111.6,12.93,1.18,1186.75,-6.33,True,1,17784,-1111.6,-2378104.13,19768694.4,17390590.27
1998-11-03,1110.84,-0.76,-0.07,1186.75,-6.4,True,1,17785,-1110.84,-2379214.97,19756289.4,17377074.43
1998-11-04,1118.67,7.83,0.7,1186.75,-5.74,True,1,17786,-1118.67,-2380333.64,19896664.62,17516330.98
1998-11-05,1133.85,15.18,1.36,1186.75,-4.46,True,1,17787,-1133.85,-2381467.49,20167789.95,17786322.46
1998-11-06,1141.01,7.16,0.63,1186.75,-3.85,True,1,17788,-1141.01,-2382608.5,20296285.88,17913677.38
1998-11-09,1130.2,-10.81,-0.95,1186.75,-4.76,True,1,17789,-1130.2,-2383738.7,20105127.8,17721389.1
1998-11-10,1128.26,-1.94,-0.17,1186.75,-4.93,True,1,17790,-1128.26,-2384866.96,20071745.4,17686878.44
1998-11-11,1120.97,-7.29,-0.65,1186.75,-5.54,True,1,17791,-1120.97,-2385987.93,19943177.27,17557189.34
1998-11-12,1117.69,-3.28,-0.29,1186.75,-5.82,True,1,17792,-1117.69,-2387105.62,19885940.48,17498834.86
1998-11-13,1125.72,8.03,0.72,1186.75,-5.14,True,1,17793,-1125.72,-2388231.34,20029935.96,17641704.62
1998-11-16,1135.87,10.15,0.9,1186.75,-4.29,True,1,17794,-1135.87,-2389367.21,20211670.78,17822303.57
1998-11-17,1139.32,3.45,0.3,1186.75,-4.0,True,1,17795,-1139.32,-2390506.53,20274199.4,17883692.87
1998-11-18,1144.48,5.16,0.45,1186.75,-3.56,True,1,17796,-1144.48,-2391651.01,20367166.08,17975515.07
1998-11-19,1152.61,8.13,0.71,1186.75,-2.88,True,1,17797,-1152.61,-2392803.62,20513000.17,18120196.55
1998-11-20,1163.55,10.94,0.95,1186.75,-1.96,True,1,17798,-1163.55,-2393967.17,20708862.9,18314895.73
1998-11-23,1188.21,24.66,2.12,1188.21,0.0,True,1,17799,-1188.21,-2395155.38,21148949.79,18753794.41
1998-11-24,1182.99,-5.22,-0.44,1188.21,-0.44,True,1,17800,-1182.99,-2396338.37,21057222.0,18660883.63
1998-11-25,1186.87,3.88,0.33,1188.21,-0.11,True,1,17801,-1186.87,-2397525.24,21127472.87,18729947.63
1998-11-27,1192.33,5.46,0.46,1192.33,0.0,True,1,17802,-1192.33,-2398717.57,21225858.66,18827141.09
1998-11-30,1163.63,-28.7,-2.41,1192.33,-2.41,True,1,17803,-1163.63,-2399881.2,20716104.89,18316223.69
1998-12-01,1175.28,11.65,1.0,1192.33,-1.43,True,1,17804,-1175.28,-2401056.48,20924685.12,18523628.64
1998-12-02,1171.25,-4.03,-0.34,1192.33,-1.77,True,1,17805,-1171.25,-2402227.73,20854106.25,18451878.52
1998-12-03,1150.14,-21.11,-1.8,1192.33,-3.54,True,1,17806,-1150.14,-2403377.87,20479392.84,18076014.97
1998-12-04,1176.74,26.6,2.31,1192.33,-1.31,True,1,17807,-1176.74,-2404554.61,20954209.18,18549654.57
1998-12-07,1187.7,10.96,0.93,1192.33,-0.39,True,1,17808,-1187.7,-2405742.31,21150561.6,18744819.29
1998-12-08,1181.38,-6.32,-0.53,1192.33,-0.92,True,1,17809,-1181.38,-2406923.69,21039196.42,18632272.73
1998-12-09,1183.49,2.11,0.18,1192.33,-0.74,True,1,17810,-1183.49,-2408107.18,21077956.9,18669849.72
1998-12-10,1165.02,-18.47,-1.56,1192.33,-2.29,True,1,17811,-1165.02,-2409272.2,20750171.22,18340899.02
1998-12-11,1166.46,1.44,0.12,1192.33,-2.17,True,1,17812,-1166.46,-2410438.66,20776985.52,18366546.86
1998-12-14,1141.2,-25.26,-2.17,1192.33,-4.29,True,1,17813,-1141.2,-2411579.86,20328195.6,17916615.74
1998-12-15,1162.83,21.63,1.9,1192.33,-2.47,True,1,17814,-1162.83,-2412742.69,20714653.62,18301910.93
1998-12-16,1161.94,-0.89,-0.08,1192.33,-2.55,True,1,17815,-1161.94,-2413904.63,20699961.1,18286056.47
1998-12-17,1179.98,18.04,1.55,1192.33,-1.04,True,1,17816,-1179.98,-2415084.61,21022523.68,18607439.07
1998-12-18,1188.03,8.05,0.68,1192.33,-0.36,True,1,17817,-1188.03,-2416272.64,21167130.51,18750857.87
1998-12-21,1202.84,14.81,1.25,1202.84,0.0,True,1,17818,-1202.84,-2417475.48,21432203.12,19014727.64
1998-12-22,1203.57,0.73,0.06,1203.57,0.0,True,1,17819,-1203.57,-2418679.05,21446413.83,19027734.78
1998-12-23,1228.54,24.97,2.08,1228.54,0.0,True,1,17820,-1228.54,-2419907.59,21892582.8,19472675.21
1998-12-24,1226.27,-2.27,-0.18,1228.54,-0.18,True,1,17821,-1226.27,-2421133.86,21853357.67,19432223.81
1998-12-28,1225.49,-0.78,-0.06,1228.54,-0.25,True,1,17822,-1225.49,-2422359.35,21840682.78,19418323.43
1998-12-29,1241.81,16.32,1.33,1241.81,0.0,True,1,17823,-1241.81,-2423601.16,22132779.63,19709178.47
1998-12-30,1231.93,-9.88,-0.8,1241.81,-0.8,True,1,17824,-1231.93,-2424833.09,21957920.32,19533087.23
1998-12-31,1229.23,-2.7,-0.22,1241.81,-1.01,True,1,17825,-1229.23,-2426062.32,21911024.75,19484962.43
1999-01-04,1228.1,-1.13,-0.09,1241.81,-1.1,True,1,17826,-1228.1,-2427290.42,21892110.6,19464820.18
1999-01-05,1244.78,16.68,1.36,1244.78,0.0,True,1,17827,-1244.78,-2428535.2,22190693.06,19762157.86
1999-01-06,1272.34,27.56,2.21,1272.34,0.0,True,1,17828,-1272.34,-2429807.54,22683277.52,20253469.98
1999-01-07,1269.73,-2.61,-0.2,1272.34,-0.2,True,1,17829,-1269.73,-2431077.27,22638016.17,20206938.9
1999-01-08,1275.09,5.36,0.42,1275.09,0.0,True,1,17830,-1275.09,-2432352.36,22734854.7,20302502.34
1999-01-11,1263.88,-11.21,-0.88,1275.09,-0.88,True,1,17831,-1263.88,-2433616.24,22536244.28,20102628.04
1999-01-12,1239.51,-24.37,-1.93,1275.09,-2.79,True,1,17832,-1239.51,-2434855.75,22102942.32,19668086.57
1999-01-13,1234.4,-5.11,-0.41,1275.09,-3.19,True,1,17833,-1234.4,-2436090.15,22013055.2,19576965.05
1999-01-14,1212.19,-22.21,-1.8,1275.09,-4.93,True,1,17834,-1212.19,-2437302.34,21618196.46,19180894.12
1999-01-15,1243.26,31.07,2.56,1275.09,-2.5,True,1,17835,-1243.26,-2438545.6,22173542.1,19734996.5
1999-01-19,1252.0,8.74,0.7,1275.09,-1.81,True,1,17836,-1252.0,-2439797.6,22330672.0,19890874.4
1999-01-20,1256.62,4.62,0.37,1275.09,-1.45,True,1,17837,-1256.62,-2441054.22,22414330.94,19973276.72
1999-01-21,1235.16,-21.46,-1.71,1275.09,-3.13,True,1,17838,-1235.16,-2442289.38,22032784.08,19590494.7
1999-01-22,1225.19,-9.97,-0.81,1275.09,-3.91,True,1,17839,-1225.19,-2443514.57,21856164.41,19412649.84
1999-01-25,1233.98,8.79,0.72,1275.09,-3.22,True,1,17840,-1233.98,-2444748.55,22014203.2,19569454.65
1999-01-26,1252.31,18.33,1.48,1275.09,-1.79,True,1,17841,-1252.31,-2446000.86,22342462.71,19896461.85
1999-01-27,1243.17,-9.14,-0.73,1275.09,-2.5,True,1,17842,-1243.17,-2447244.03,22180639.14,19733395.11
1999-01-28,1265.37,22.2,1.79,1275.09,-0.76,True,1,17843,-1265.37,-2448509.4,22577996.91,20129487.51
1999-01-29,1279.64,14.27,1.13,1279.64,0.0,True,1,17844,-1279.64,-2449789.04,22833896.16,20384107.12
1999-02-01,1273.0,-6.64,-0.52,1279.64,-0.52,True,1,17845,-1273.0,-2451062.04,22716685.0,20265622.96
1999-02-02,1261.99,-11.01,-0.86,1279.64,-1.38,True,1,17846,-1261.99,-2452324.03,22521473.54,20069149.51
1999-02-03,1272.07,10.08,0.8,1279.64,-0.59,True,1,17847,-1272.07,-2453596.1,22702633.29,20249037.19
1999-02-04,1248.49,-23.58,-1.85,1279.64,-2.43,True,1,17848,-1248.49,-2454844.59,22283049.52,19828204.93
1999-02-05,1239.4,-9.09,-0.73,1279.64,-3.14,True,1,17849,-1239.4,-2456083.99,22122050.6,19665966.61
1999-02-08,1243.77,4.37,0.35,1279.64,-2.8,True,1,17850,-1243.77,-2457327.76,22201294.5,19743966.74
1999-02-09,1216.14,-27.63,-2.22,1279.64,-4.96,True,1,17851,-1216.14,-2458543.9,21709315.14,19250771.24
1999-02-10,1223.55,7.41,0.61,1279.64,-4.38,True,1,17852,-1223.55,-2459767.45,21842814.6,19383047.15
1999-02-11,1254.04,30.49,2.49,1279.64,-2.0,True,1,17853,-1254.04,-2461021.49,22388376.12,19927354.63
1999-02-12,1230.13,-23.91,-1.91,1279.64,-3.87,True,1,17854,-1230.13,-2462251.62,21962741.02,19500489.4
1999-02-16,1241.87,11.74,0.95,1279.64,-2.95,True,1,17855,-1241.87,-2463493.49,22173588.85,19710095.36
1999-02-17,1224.03,-17.84,-1.44,1279.64,-4.35,True,1,17856,-1224.03,-2464717.52,21856279.68,19391562.16
1999-02-18,1237.28,13.25,1.08,1279.64,-3.31,True,1,17857,-1237.28,-2465954.8,22094108.96,19628154.16
1999-02-19,1239.22,1.94,0.16,1279.64,-3.16,True,1,17858,-1239.22,-2467194.02,22129990.76,19662796.74
1999-02-22,1272.14,32.92,2.66,1279.64,-0.59,True,1,17859,-1272.14,-2468466.16,22719148.26,20250682.1
1999-02-23,1271.18,-0.96,-0.08,1279.64,-0.66,True,1,17860,-1271.18,-2469737.34,22703274.8,20233537.46
1999-02-24,1253.41,-17.77,-1.4,1279.64,-2.05,True,1,17861,-1253.41,-2470990.75,22387156.01,19916165.26
1999-02-25,1245.02,-8.39,-0.67,1279.64,-2.7,True,1,17862,-1245.02,-2472235.77,22238547.24,19766311.47
1999-02-26,1238.33,-6.69,-0.54,1279.64,-3.23,True,1,17863,-1238.33,-2473474.1,22120288.79,19646814.69
1999-03-01,1236.16,-2.17,-0.18,1279.64,-3.4,True,1,17864,-1236.16,-2474710.26,22082762.24,19608051.98
1999-03-02,1225.5,-10.66,-0.86,1279.64,-4.23,True,1,17865,-1225.5,-2475935.76,21893557.5,19417621.74
1999-03-03,1227.7,2.2,0.18,1279.64,-4.06,True,1,17866,-1227.7,-2477163.46,21934088.2,19456924.74
1999-03-04,1246.64,18.94,1.54,1279.64,-2.58,True,1,17867,-1246.64,-2478410.1,22273716.88,19795306.78
1999-03-05,1275.47,28.83,2.31,1279.64,-0.33,True,1,17868,-1275.47,-2479685.57,22790097.96,20310412.39
1999-03-08,1282.73,7.26,0.57,1282.73,0.0,True,1,17869,-1282.73,-2480968.3,22921102.37,20440134.07
1999-03-09,1279.84,-2.89,-0.22,1282.73,-0.22,True,1,17870,-1279.84,-2482248.14,22870740.8,20388492.66
1999-03-10,1286.84,7.0,0.55,1286.84,0.0,True,1,17871,-1286.84,-2483534.98,22997117.64,20513582.66
1999-03-11,1297.68,10.84,0.84,1297.68,0.0,True,1,17872,-1297.68,-2484832.66,23192136.96,20707304.3
1999-03-12,1294.59,-3.09,-0.24,1297.68,-0.24,True,1,17873,-1294.59,-2486127.25,23138207.07,20652079.82
1999-03-15,1307.26,12.67,0.98,1307.26,0.0,True,1,17874,-1307.26,-2487434.51,23365965.24,20878530.73
1999-03-16,1306.38,-0.88,-0.07,1307.26,-0.07,True,1,17875,-1306.38,-2488740.89,23351542.5,20862801.61
1999-03-17,1297.82,-8.56,-0.66,1307.26,-0.72,True,1,17876,-1297.82,-2490038.71,23199830.32,20709791.61
1999-03-18,1316.55,18.73,1.44,1316.55,0.0,True,1,17877,-1316.55,-2491355.26,23535964.35,21044609.09
1999-03-19,1299.29,-17.26,-1.31,1316.55,-1.31,True,1,17878,-1299.29,-2492654.55,23228706.62,20736052.07
1999-03-22,1297.01,-2.28,-0.18,1316.55,-1.48,True,1,17879,-1297.01,-2493951.56,23189241.79,20695290.23
1999-03-23,1262.14,-34.87,-2.69,1316.55,-4.13,True,1,17880,-1262.14,-2495213.7,22567063.2,20071849.5
1999-03-24,1268.59,6.45,0.51,1316.55,-3.64,True,1,17881,-1268.59,-2496482.29,22683657.79,20187175.5
1999-03-25,1289.99,21.4,1.69,1316.55,-2.02,True,1,17882,-1289.99,-2497772.28,23067601.18,20569828.9
1999-03-26,1282.8,-7.19,-0.56,1316.55,-2.56,True,1,17883,-1282.8,-2499055.08,22940312.4,20441257.32
1999-03-29,1310.17,27.37,2.13,1316.55,-0.48,True,1,17884,-1310.17,-2500365.25,23431080.28,20930715.03
1999-03-30,1300.75,-9.42,-0.72,1316.55,-1.2,True,1,17885,-1300.75,-2501666.0,23263913.75,20762247.75
1999-03-31,1286.37,-14.38,-1.11,1316.55,-2.29,True,1,17886,-1286.37,-2502952.37,23008013.82,20505061.45
1999-04-01,1293.72,7.35,0.57,1316.55,-1.73,True,1,17887,-1293.72,-2504246.09,23140769.64,20636523.55
1999-04-05,1321.12,27.4,2.12,1321.12,0.0,True,1,17888,-1321.12,-2505567.21,23632194.56,21126627.35
1999-04-06,1317.89,-3.23,-0.24,1321.12,-0.24,True,1,17889,-1317.89,-2506885.1,23575734.21,21068849.11
1999-04-07,1326.89,9.0,0.68,1326.89,0.0,True,1,17890,-1326.89,-2508211.99,23738062.1,21229850.11
1999-04-08,1343.98,17.09,1.29,1343.98,0.0,True,1,17891,-1343.98,-2509555.97,24045146.18,21535590.21
1999-04-09,1348.35,4.37,0.32,1348.35,0.0,True,1,17892,-1348.35,-2510904.32,24124678.2,21613773.88
1999-04-12,1358.63,10.28,0.76,1358.63,0.0,True,1,17893,-1358.63,-2512262.95,24309966.59,21797703.64
1999-04-13,1349.82,-8.81,-0.65,1358.63,-0.65,True,1,17894,-1349.82,-2513612.77,24153679.08,21640066.31
1999-04-14,1328.44,-21.38,-1.58,1358.63,-2.22,True,1,17895,-1328.44,-2514941.21,23772433.8,21257492.59
1999-04-15,1322.85,-5.59,-0.42,1358.63,-2.63,True,1,17896,-1322.85,-2516264.06,23673723.6,21157459.54
1999-04-16,1319.0,-3.85,-0.29,1358.63,-2.92,True,1,17897,-1319.0,-2517583.06,23606143.0,21088559.94
1999-04-19,1289.48,-29.52,-2.24,1358.63,-5.09,True,1,17898,-1289.48,-2518872.54,23079113.04,20560240.5
1999-04-20,1306.17,16.69,1.29,1358.63,-3.86,True,1,17899,-1306.17,-2520178.71,23379136.83,20858958.12
1999-04-21,1336.12,29.95,2.29,1358.63,-1.66,True,1,17900,-1336.12,-2521514.83,23916548.0,21395033.17
1999-04-22,1358.82,22.7,1.7,1358.82,0.0,True,1,17901,-1358.82,-2522873.65,24324236.82,21801363.17
1999-04-23,1356.85,-1.97,-0.14,1358.82,-0.14,True,1,17902,-1356.85,-2524230.5,24290328.7,21766098.2
1999-04-26,1360.04,3.19,0.24,1360.04,0.0,True,1,17903,-1360.04,-2525590.54,24348796.12,21823205.58
1999-04-27,1362.8,2.76,0.2,1362.8,0.0,True,1,17904,-1362.8,-2526953.34,24399571.2,21872617.86
1999-04-28,1350.91,-11.89,-0.87,1362.8,-0.87,True,1,17905,-1350.91,-2528304.25,24188043.55,21659739.3
1999-04-29,1342.83,-8.08,-0.6,1362.8,-1.46,True,1,17906,-1342.83,-2529647.08,24044713.98,21515066.9
1999-04-30,1335.18,-7.65,-0.57,1362.8,-2.03,True,1,17907,-1335.18,-2530982.26,23909068.26,21378086.0
1999-05-03,1354.63,19.45,1.46,1362.8,-0.6,True,1,17908,-1354.63,-2532336.89,24258714.04,21726377.15
1999-05-04,1332.0,-22.63,-1.67,1362.8,-2.26,True,1,17909,-1332.0,-2533668.89,23854788.0,21321119.11
1999-05-05,1347.31,15.31,1.15,1362.8,-1.14,True,1,17910,-1347.31,-2535016.2,24130322.1,21595305.9
1999-05-06,1332.05,-15.26,-1.13,1362.8,-2.26,True,1,17911,-1332.05,-2536348.25,23858347.55,21321999.3
1999-05-07,1345.0,12.95,0.97,1362.8,-1.31,True,1,17912,-1345.0,-2537693.25,24091640.0,21553946.75
1999-05-10,1340.3,-4.7,-0.35,1362.8,-1.65,True,1,17913,-1340.3,-2539033.55,24008793.9,21469760.35
1999-05-11,1355.61,15.31,1.14,1362.8,-0.53,True,1,17914,-1355.61,-2540389.16,24284397.54,21744008.38
1999-05-12,1364.0,8.39,0.62,1364.0,0.0,True,1,17915,-1364.0,-2541753.16,24436060.0,21894306.84
1999-05-13,1367.56,3.56,0.26,1367.56,0.0,True,1,17916,-1367.56,-2543120.72,24501204.96,21958084.24
1999-05-14,1337.8,-29.76,-2.18,1367.56,-2.18,True,1,17917,-1337.8,-2544458.52,23969362.6,21424904.08
1999-05-17,1339.49,1.69,0.13,1367.56,-2.05,True,1,17918,-1339.49,-2545798.01,24000981.82,21455183.81
1999-05-18,1333.32,-6.17,-0.46,1367.56,-2.5,True,1,17919,-1333.32,-2547131.33,23891761.08,21344629.75
1999-05-19,1344.23,10.91,0.82,1367.56,-1.71,True,1,17920,-1344.23,-2548475.56,24088601.6,21540126.04
1999-05-20,1338.83,-5.4,-0.4,1367.56,-2.1,True,1,17921,-1338.83,-2549814.39,23993172.43,21443358.04
1999-05-21,1330.29,-8.54,-0.64,1367.56,-2.72,True,1,17922,-1330.29,-2551144.68,23841457.38,21290312.7
1999-05-24,1306.65,-23.64,-1.78,1367.56,-4.45,True,1,17923,-1306.65,-2552451.33,23419087.95,20866636.62
1999-05-25,1284.4,-22.25,-1.7,1367.56,-6.08,True,1,17924,-1284.4,-2553735.73,23021585.6,20467849.87
1999-05-26,1304.76,20.36,1.58,1367.56,-4.59,True,1,17925,-1304.76,-2555040.49,23387823.0,20832782.51
1999-05-27,1281.41,-23.35,-1.79,1367.56,-6.3,True,1,17926,-1281.41,-2556321.9,22970555.66,20414233.76
1999-05-28,1301.84,20.43,1.59,1367.56,-4.81,True,1,17927,-1301.84,-2557623.74,23338085.68,20780461.94
1999-06-01,1294.26,-7.58,-0.58,1367.56,-5.36,True,1,17928,-1294.26,-2558918.0,23203493.28,20644575.28
1999-06-02,1294.81,0.55,0.04,1367.56,-5.32,True,1,17929,-1294.81,-2560212.81,23214648.49,20654435.68
1999-06-03,1299.54,4.73,0.36,1367.56,-4.97,True,1,17930,-1299.54,-2561512.35,23300752.2,20739239.85
1999-06-04,1327.75,28.21,2.17,1367.56,-2.91,True,1,17931,-1327.75,-2562840.1,23807885.25,21245045.15
1999-06-07,1334.52,6.77,0.51,1367.56,-2.42,True,1,17932,-1334.52,-2564174.62,23930612.64,21366438.02
1999-06-08,1317.33,-17.19,-1.29,1367.56,-3.67,True,1,17933,-1317.33,-2565491.95,23623678.89,21058186.94
1999-06-09,1318.64,1.31,0.1,1367.56,-3.58,True,1,17934,-1318.64,-2566810.59,23648489.76,21081679.17
1999-06-10,1302.82,-15.82,-1.2,1367.56,-4.73,True,1,17935,-1302.82,-2568113.41,23366076.7,20797963.29
1999-06-11,1293.64,-9.18,-0.7,1367.56,-5.4,True,1,17936,-1293.64,-2569407.05,23202727.04,20633319.99
1999-06-14,1294.0,0.36,0.03,1367.56,-5.38,True,1,17937,-1294.0,-2570701.05,23210478.0,20639776.95
1999-06-15,1301.16,7.16,0.55,1367.56,-4.86,True,1,17938,-1301.16,-2572002.21,23340208.08,20768205.87
1999-06-16,1330.41,29.25,2.25,1367.56,-2.72,True,1,17939,-1330.41,-2573332.62,23866224.99,21292892.37
1999-06-17,1339.9,9.49,0.71,1367.56,-2.02,True,1,17940,-1339.9,-2574672.52,24037806.0,21463133.48
1999-06-18,1342.84,2.94,0.22,1367.56,-1.81,True,1,17941,-1342.84,-2576015.36,24091892.44,21515877.08
1999-06-21,1349.0,6.16,0.46,1367.56,-1.36,True,1,17942,-1349.0,-2577364.36,24203758.0,21626393.64
1999-06-22,1335.88,-13.12,-0.97,1367.56,-2.32,True,1,17943,-1335.88,-2578700.24,23969694.84,21390994.6
1999-06-23,1333.06,-2.82,-0.21,1367.56,-2.52,True,1,17944,-1333.06,-2580033.3,23920428.64,21340395.34
1999-06-24,1315.78,-17.28,-1.3,1367.56,-3.79,True,1,17945,-1315.78,-2581349.08,23611672.1,21030323.02
1999-06-25,1315.31,-0.47,-0.04,1367.56,-3.82,True,1,17946,-1315.31,-2582664.39,23604553.26,21021888.87
1999-06-28,1331.35,16.04,1.22,1367.56,-2.65,True,1,17947,-1331.35,-2583995.74,23893738.45,21309742.71
1999-06-29,1351.45,20.1,1.51,1367.56,-1.18,True,1,17948,-1351.45,-2585347.19,24255824.6,21670477.41
1999-06-30,1372.71,21.26,1.57,1372.71,0.0,True,1,17949,-1372.71,-2586719.9,24638771.79,22052051.89
1999-07-01,1380.96,8.25,0.6,1380.96,0.0,True,1,17950,-1380.96,-2588100.86,24788232.0,22200131.14
1999-07-02,1391.22,10.26,0.74,1391.22,0.0,True,1,17951,-1391.22,-2589492.08,24973790.22,22384298.14
1999-07-06,1388.12,-3.1,-0.22,1391.22,-0.22,True,1,17952,-1388.12,-2590880.2,24919530.24,22328650.04
1999-07-07,1395.86,7.74,0.56,1395.86,0.0,True,1,17953,-1395.86,-2592276.06,25059874.58,22467598.52
1999-07-08,1394.42,-1.44,-0.1,1395.86,-0.1,True,1,17954,-1394.42,-2593670.48,25035416.68,22441746.2
1999-07-09,1403.28,8.86,0.64,1403.28,0.0,True,1,17955,-1403.28,-2595073.76,25195892.4,22600818.64
1999-07-12,1399.1,-4.18,-0.3,1403.28,-0.3,True,1,17956,-1399.1,-2596472.86,25122239.6,22525766.74
1999-07-13,1393.56,-5.54,-0.4,1403.28,-0.69,True,1,17957,-1393.56,-2597866.42,25024156.92,22426290.5
1999-07-14,1398.17,4.61,0.33,1403.28,-0.36,True,1,17958,-1398.17,-2599264.59,25108336.86,22509072.27
1999-07-15,1409.62,11.45,0.82,1409.62,0.0,True,1,17959,-1409.62,-2600674.21,25315365.58,22714691.37
1999-07-16,1418.78,9.16,0.65,1418.78,0.0,True,1,17960,-1418.78,-2602092.99,25481288.8,22879195.81
1999-07-19,1407.65,-11.13,-0.78,1418.78,-0.78,True,1,17961,-1407.65,-2603500.64,25282801.65,22679301.01
1999-07-20,1377.1,-30.55,-2.17,1418.78,-2.94,True,1,17962,-1377.1,-2604877.74,24735470.2,22130592.46
1999-07-21,1379.29,2.19,0.16,1418.78,-2.78,True,1,17963,-1379.29,-2606257.03,24776186.27,22169929.24
1999-07-22,1360.97,-18.32,-1.33,1418.78,-4.08,True,1,17964,-1360.97,-2607618.0,24448465.08,21840847.08
1999-07-23,1356.94,-4.03,-0.3,1418.78,-4.36,True,1,17965,-1356.94,-2608974.94,24377427.1,21768452.16
1999-07-26,1347.76,-9.18,-0.68,1418.78,-5.01,True,1,17966,-1347.76,-2610322.7,24213856.16,21603533.46
1999-07-27,1362.84,15.08,1.12,1418.78,-3.94,True,1,17967,-1362.84,-2611685.54,24486146.28,21874460.74
1999-07-28,1365.4,2.56,0.19,1418.78,-3.76,True,1,17968,-1365.4,-2613050.94,24533507.2,21920456.26
1999-07-29,1341.03,-24.37,-1.78,1418.78,-5.48,True,1,17969,-1341.03,-2614391.97,24096968.07,21482576.1
1999-07-30,1328.72,-12.31,-0.92,1418.78,-6.35,True,1,17970,-1328.72,-2615720.69,23877098.4,21261377.71
1999-08-02,1328.05,-0.67,-0.05,1418.78,-6.4,True,1,17971,-1328.05,-2617048.74,23866386.55,21249337.81
1999-08-03,1322.18,-5.87,-0.44,1418.78,-6.81,True,1,17972,-1322.18,-2618370.92,23762218.96,21143848.04
1999-08-04,1305.33,-16.85,-1.27,1418.78,-8.0,True,1,17973,-1305.33,-2619676.25,23460696.09,20841019.84
1999-08-05,1313.71,8.38,0.64,1418.78,-7.41,True,1,17974,-1313.71,-2620989.96,23612623.54,20991633.58
1999-08-06,1300.29,-13.42,-1.02,1418.78,-8.35,True,1,17975,-1300.29,-2622290.25,23372712.75,20750422.5
1999-08-09,1297.8,-2.49,-0.19,1418.78,-8.53,True,1,17976,-1297.8,-2623588.05,23329252.8,20705664.75
1999-08-10,1281.43,-16.37,-1.26,1418.78,-9.68,True,1,17977,-1281.43,-2624869.48,23036267.11,20411397.63
1999-08-11,1301.93,20.5,1.6,1418.78,-8.24,True,1,17978,-1301.93,-2626171.41,23406097.54,20779926.13
1999-08-12,1298.16,-3.77,-0.29,1418.78,-8.5,True,1,17979,-1298.16,-2627469.57,23339618.64,20712149.07
1999-08-13,1327.68,29.52,2.27,1418.78,-6.42,True,1,17980,-1327.68,-2628797.25,23871686.4,21242889.15
1999-08-16,1330.77,3.09,0.23,1418.78,-6.2,True,1,17981,-1330.77,-2630128.02,23928575.37,21298447.35
1999-08-17,1344.16,13.39,1.01,1418.78,-5.26,True,1,17982,-1344.16,-2631472.18,24170685.12,21539212.94
1999-08-18,1332.84,-11.32,-0.84,1418.78,-6.06,True,1,17983,-1332.84,-2632805.02,23968461.72,21335656.7
1999-08-19,1323.59,-9.25,-0.69,1418.78,-6.71,True,1,17984,-1323.59,-2634128.61,23803442.56,21169313.95
1999-08-20,1336.61,13.02,0.98,1418.78,-5.79,True,1,17985,-1336.61,-2635465.22,24038930.85,21403465.63
1999-08-23,1360.22,23.61,1.77,1418.78,-4.13,True,1,17986,-1360.22,-2636825.44,24464916.92,21828091.48
1999-08-24,1363.5,3.28,0.24,1418.78,-3.9,True,1,17987,-1363.5,-2638188.94,24525274.5,21887085.56
1999-08-25,1381.79,18.29,1.34,1418.78,-2.61,True,1,17988,-1381.79,-2639570.73,24855638.52,22216067.79
1999-08-26,1362.01,-19.78,-1.43,1418.78,-4.0,True,1,17989,-1362.01,-2640932.74,24501197.89,21860265.15
1999-08-27,1348.27,-13.74,-1.01,1418.78,-4.97,True,1,17990,-1348.27,-2642281.01,24255377.3,21613096.29
1999-08-30,1324.02,-24.25,-1.8,1418.78,-6.68,True,1,17991,-1324.02,-2643605.03,23820443.82,21176838.79
1999-08-31,1320.41,-3.61,-0.27,1418.78,-6.93,True,1,17992,-1320.41,-2644925.44,23756816.72,21111891.28
1999-09-01,1331.07,10.66,0.81,1418.78,-6.18,True,1,17993,-1331.07,-2646256.51,23949942.51,21303686.0
1999-09-02,1319.11,-11.96,-0.9,1418.78,-7.02,True,1,17994,-1319.11,-2647575.62,23736065.34,21088489.72
1999-09-03,1357.24,38.13,2.89,1418.78,-4.34,True,1,17995,-1357.24,-2648932.86,24423533.8,21774600.94
1999-09-07,1350.45,-6.79,-0.5,1418.78,-4.82,True,1,17996,-1350.45,-2650283.31,24302698.2,21652414.89
1999-09-08,1344.15,-6.3,-0.47,1418.78,-5.26,True,1,17997,-1344.15,-2651627.46,24190667.55,21539040.09
1999-09-09,1347.66,3.51,0.26,1418.78,-5.01,True,1,17998,-1347.66,-2652975.12,24255184.68,21602209.56
1999-09-10,1351.66,4.0,0.3,1418.78,-4.73,True,1,17999,-1351.66,-2654326.78,24328528.34,21674201.56
1999-09-13,1344.13,-7.53,-0.56,1418.78,-5.26,True,1,18000,-1344.13,-2655670.91,24194340.0,21538669.09
1999-09-14,1336.29,-7.84,-0.58,1418.78,-5.81,True,1,18001,-1336.29,-2657007.2,24054556.29,21397549.09
1999-09-15,1317.97,-18.32,-1.37,1418.78,-7.1,True,1,18002,-1317.97,-2658325.17,23726095.94,21067770.77
1999-09-16,1318.48,0.51,0.04,1418.78,-7.07,True,1,18003,-1318.48,-2659643.65,23736595.44,21076951.79
1999-09-17,1335.42,16.94,1.28,1418.78,-5.88,True,1,18004,-1335.42,-2660979.07,24042901.68,21381922.61
1999-09-20,1335.53,0.11,0.01,1418.78,-5.87,True,1,18005,-1335.53,-2662314.6,24046217.65,21383903.05
1999-09-21,1307.58,-27.95,-2.09,1418.78,-7.84,True,1,18006,-1307.58,-2663622.18,23544285.48,20880663.3
1999-09-22,1310.51,2.93,0.22,1418.78,-7.63,True,1,18007,-1310.51,-2664932.69,23598353.57,20933420.88
1999-09-23,1280.41,-30.1,-2.3,1418.78,-9.75,True,1,18008,-1280.41,-2666213.1,23057623.28,20391410.18
1999-09-24,1277.36,-3.05,-0.24,1418.78,-9.97,True,1,18009,-1277.36,-2667490.46,23003976.24,20336485.78
1999-09-27,1283.31,5.95,0.47,1418.78,-9.55,True,1,18010,-1283.31,-2668773.77,23112413.1,20443639.33
1999-09-28,1282.2,-1.11,-0.09,1418.78,-9.63,True,1,18011,-1282.2,-2670055.97,23093704.2,20423648.23
1999-09-29,1268.37,-13.83,-1.08,1418.78,-10.6,True,1,18012,-1268.37,-2671324.34,22845880.44,20174556.1
1999-09-30,1282.71,14.34,1.13,1418.78,-9.59,True,1,18013,-1282.71,-2672607.05,23105455.23,20432848.18
1999-10-01,1282.81,0.1,0.01,1418.78,-9.58,True,1,18014,-1282.81,-2673889.86,23108539.34,20434649.48
1999-10-04,1304.6,21.79,1.7,1418.78,-8.05,True,1,18015,-1304.6,-2675194.46,23502369.0,20827174.54
1999-10-05,1301.35,-3.25,-0.25,1418.78,-8.28,True,1,18016,-1301.35,-2676495.81,23445121.6,20768625.79
1999-10-06,1325.4,24.05,1.85,1418.78,-6.58,True,1,18017,-1325.4,-2677821.21,23879731.8,21201910.59
1999-10-07,1317.64,-7.76,-0.58,1418.78,-7.13,True,1,18018,-1317.64,-2679138.85,23741237.52,21062098.67
1999-10-08,1336.02,18.38,1.4,1418.78,-5.83,True,1,18019,-1336.02,-2680474.87,24073744.38,21393269.51
1999-10-11,1335.21,-0.81,-0.06,1418.78,-5.89,True,1,18020,-1335.21,-2681810.08,24060484.2,21378674.12
1999-10-12,1313.04,-22.17,-1.66,1418.78,-7.45,True,1,18021,-1313.04,-2683123.12,23662293.84,20979170.72
1999-10-13,1285.55,-27.49,-2.09,1418.78,-9.39,True,1,18022,-1285.55,-2684408.67,23168182.1,20483773.43
1999-10-14,1283.42,-2.13,-0.17,1418.78,-9.54,True,1,18023,-1283.42,-2685692.09,23131078.66,20445386.57
1999-10-15,1247.41,-36.01,-2.81,1418.78,-12.08,True,1,18024,-1247.41,-2686939.5,22483317.84,19796378.34
1999-10-18,1254.13,6.72,0.54,1418.78,-11.6,True,1,18025,-1254.13,-2688193.63,22605693.25,19917499.62
1999-10-19,1261.32,7.19,0.57,1418.78,-11.1,True,1,18026,-1261.32,-2689454.95,22736554.32,20047099.37
1999-10-20,1289.43,28.11,2.23,1418.78,-9.12,True,1,18027,-1289.43,-2690744.38,23244554.61,20553810.23
1999-10-21,1283.61,-5.82,-0.45,1418.78,-9.53,True,1,18028,-1283.61,-2692027.99,23140921.08,20448893.09
1999-10-22,1301.65,18.04,1.4,1418.78,-8.26,True,1,18029,-1301.65,-2693329.64,23467447.85,20774118.21
1999-10-25,1293.63,-8.02,-0.62,1418.78,-8.82,True,1,18030,-1293.63,-2694623.27,23324148.9,20629525.63
1999-10-26,1281.91,-11.72,-0.91,1418.78,-9.65,True,1,18031,-1281.91,-2695905.18,23114119.21,20418214.03
1999-10-27,1296.71,14.8,1.16,1418.78,-8.6,True,1,18032,-1296.71,-2697201.89,23382274.72,20685072.83
1999-10-28,1342.44,45.73,3.53,1418.78,-5.38,True,1,18033,-1342.44,-2698544.33,24208220.52,21509676.19
1999-10-29,1362.93,20.49,1.53,1418.78,-3.94,True,1,18034,-1362.93,-2699907.26,24579079.62,21879172.36
1999-11-01,1354.12,-8.81,-0.65,1418.78,-4.56,True,1,18035,-1354.12,-2701261.38,24421554.2,21720292.82
1999-11-02,1347.74,-6.38,-0.47,1418.78,-5.01,True,1,18036,-1347.74,-2702609.12,24307838.64,21605229.52
1999-11-03,1354.93,7.19,0.53,1418.78,-4.5,True,1,18037,-1354.93,-2703964.05,24438872.41,21734908.36
1999-11-04,1362.64,7.71,0.57,1418.78,-3.96,True,1,18038,-1362.64,-2705326.69,24579300.32,21873973.63
1999-11-05,1370.23,7.59,0.56,1418.78,-3.42,True,1,18039,-1370.23,-2706696.92,24717578.97,22010882.05
1999-11-08,1377.01,6.78,0.5,1418.78,-2.94,True,1,18040,-1377.01,-2708073.93,24841260.4,22133186.47
1999-11-09,1365.28,-11.73,-0.85,1418.78,-3.77,True,1,18041,-1365.28,-2709439.21,24631016.48,21921577.27
1999-11-10,1373.46,8.18,0.6,1418.78,-3.19,True,1,18042,-1373.46,-2710812.67,24779965.32,22069152.65
1999-11-11,1381.46,8.0,0.58,1418.78,-2.63,True,1,18043,-1381.46,-2712194.13,24925682.78,22213488.65
1999-11-12,1396.06,14.6,1.06,1418.78,-1.6,True,1,18044,-1396.06,-2713590.19,25190506.64,22476916.45
1999-11-15,1394.39,-1.67,-0.12,1418.78,-1.72,True,1,18045,-1394.39,-2714984.58,25161767.55,22446782.97
1999-11-16,1420.07,25.68,1.84,1420.07,0.0,True,1,18046,-1420.07,-2716404.65,25626583.22,22910178.57
1999-11-17,1410.71,-9.36,-0.66,1420.07,-0.66,True,1,18047,-1410.71,-2717815.36,25459083.37,22741268.01
1999-11-18,1424.94,14.23,1.01,1424.94,0.0,True,1,18048,-1424.94,-2719240.3,25717317.12,22998076.82
1999-11-19,1422.0,-2.94,-0.21,1424.94,-0.21,True,1,18049,-1422.0,-2720662.3,25665678.0,22945015.7
1999-11-22,1420.94,-1.06,-0.08,1424.94,-0.28,True,1,18050,-1420.94,-2722083.24,25647967.0,22925883.76
1999-11-23,1404.64,-16.3,-1.15,1424.94,-1.42,True,1,18051,-1404.64,-2723487.88,25355156.64,22631668.76
1999-11-24,1417.08,12.44,0.89,1424.94,-0.55,True,1,18052,-1417.08,-2724904.96,25581128.16,22856223.2
1999-11-26,1416.62,-0.46,-0.03,1424.94,-0.58,True,1,18053,-1416.62,-2726321.58,25574240.86,22847919.28
1999-11-29,1407.83,-8.79,-0.62,1424.94,-1.2,True,1,18054,-1407.83,-2727729.41,25416962.82,22689233.41
1999-11-30,1388.91,-18.92,-1.34,1424.94,-2.53,True,1,18055,-1388.91,-2729118.32,25076770.05,22347651.73
1999-12-01,1397.72,8.81,0.63,1424.94,-1.91,True,1,18056,-1397.72,-2730516.04,25237232.32,22506716.28
1999-12-02,1409.04,11.32,0.81,1424.94,-1.12,True,1,18057,-1409.04,-2731925.08,25443035.28,22711110.2
1999-12-03,1433.3,24.26,1.72,1433.3,0.0,True,1,18058,-1433.3,-2733358.38,25882531.4,23149173.02
1999-12-06,1423.33,-9.97,-0.7,1433.3,-0.7,True,1,18059,-1423.33,-2734781.71,25703916.47,22969134.76
1999-12-07,1409.17,-14.16,-1.0,1433.3,-1.68,True,1,18060,-1409.17,-2736190.88,25449610.2,22713419.32
1999-12-08,1403.88,-5.29,-0.38,1433.3,-2.05,True,1,18061,-1403.88,-2737594.76,25355476.68,22617881.92
1999-12-09,1408.11,4.23,0.3,1433.3,-1.76,True,1,18062,-1408.11,-2739002.87,25433282.82,22694279.95
1999-12-10,1417.04,8.93,0.63,1433.3,-1.13,True,1,18063,-1417.04,-2740419.91,25595993.52,22855573.61
1999-12-13,1415.22,-1.82,-0.13,1433.3,-1.26,True,1,18064,-1415.22,-2741835.13,25564534.08,22822698.95
1999-12-14,1403.17,-12.05,-0.85,1433.3,-2.1,True,1,18065,-1403.17,-2743238.3,25348266.05,22605027.75
1999-12-15,1413.33,10.16,0.72,1433.3,-1.39,True,1,18066,-1413.33,-2744651.63,25533219.78,22788568.15
1999-12-16,1418.78,5.45,0.39,1433.3,-1.01,True,1,18067,-1418.78,-2746070.41,25633098.26,22887027.85
1999-12-17,1421.03,2.25,0.16,1433.3,-0.86,True,1,18068,-1421.03,-2747491.44,25675170.04,22927678.6
1999-12-20,1418.09,-2.94,-0.21,1433.3,-1.06,True,1,18069,-1418.09,-2748909.53,25623468.21,22874558.68
1999-12-21,1433.43,15.34,1.08,1433.43,0.0,True,1,18070,-1433.43,-2750342.96,25902080.1,23151737.14
1999-12-22,1436.13,2.7,0.19,1436.13,0.0,True,1,18071,-1436.13,-2751779.09,25952305.23,23200526.14
1999-12-23,1458.34,22.21,1.55,1458.34,0.0,True,1,18072,-1458.34,-2753237.43,26355120.48,23601883.05
1999-12-27,1457.1,-1.24,-0.08,1458.34,-0.08,True,1,18073,-1457.1,-2754694.53,26334168.3,23579473.77
1999-12-28,1457.66,0.56,0.04,1458.34,-0.05,True,1,18074,-1457.66,-2756152.19,26345746.84,23589594.65
1999-12-29,1463.46,5.8,0.4,1463.46,0.0,True,1,18075,-1463.46,-2757615.65,26452039.5,23694423.85
1999-12-30,1464.47,1.01,0.07,1464.47,0.0,True,1,18076,-1464.47,-2759080.12,26471759.72,23712679.6
1999-12-31,1469.25,4.78,0.33,1469.25,0.0,True,1,18077,-1469.25,-2760549.37,26559632.25,23799082.88
2000-01-03,1455.22,-14.03,-0.96,1469.25,-0.96,True,1,18078,-1455.22,-2762004.59,26307467.16,23545462.57
2000-01-04,1399.42,-55.8,-3.83,1469.25,-4.75,True,1,18079,-1399.42,-2763404.01,25300114.18,22536710.17
2000-01-05,1402.11,2.69,0.19,1469.25,-4.57,True,1,18080,-1402.11,-2764806.12,25350148.8,22585342.68
2000-01-06,1403.45,1.34,0.1,1469.25,-4.48,True,1,18081,-1403.45,-2766209.57,25375779.45,22609569.88
2000-01-07,1441.47,38.02,2.71,1469.25,-1.89,True,1,18082,-1441.47,-2767651.04,26064660.54,23297009.5
2000-01-10,1457.6,16.13,1.12,1469.25,-0.79,True,1,18083,-1457.6,-2769108.64,26357780.8,23588672.16
2000-01-11,1438.56,-19.04,-1.31,1469.25,-2.09,True,1,18084,-1438.56,-2770547.2,26014919.04,23244371.84
2000-01-12,1432.25,-6.31,-0.44,1469.25,-2.52,True,1,18085,-1432.25,-2771979.45,25902241.25,23130261.8
2000-01-13,1449.68,17.43,1.22,1469.25,-1.33,True,1,18086,-1449.68,-2773429.13,26218912.48,23445483.35
2000-01-14,1465.15,15.47,1.07,1469.25,-0.28,True,1,18087,-1465.15,-2774894.28,26500168.05,23725273.77
2000-01-18,1455.14,-10.01,-0.68,1469.25,-0.96,True,1,18088,-1455.14,-2776349.42,26320572.32,23544222.9
2000-01-19,1455.9,0.76,0.05,1469.25,-0.91,True,1,18089,-1455.9,-2777805.32,26335775.1,23557969.78
2000-01-20,1445.57,-10.33,-0.71,1469.25,-1.61,True,1,18090,-1445.57,-2779250.89,26150361.3,23371110.41
2000-01-21,1441.36,-4.21,-0.29,1469.25,-1.9,True,1,18091,-1441.36,-2780692.25,26075643.76,23294951.51
2000-01-24,1401.53,-39.83,-2.76,1469.25,-4.61,True,1,18092,-1401.53,-2782093.78,25356480.76,22574386.98
2000-01-25,1410.03,8.5,0.61,1469.25,-4.03,True,1,18093,-1410.03,-2783503.81,25511672.79,22728168.98
2000-01-26,1404.09,-5.94,-0.42,1469.25,-4.43,True,1,18094,-1404.09,-2784907.9,25405604.46,22620696.56
2000-01-27,1398.56,-5.53,-0.39,1469.25,-4.81,True,1,18095,-1398.56,-2786306.46,25306943.2,22520636.74
2000-01-28,1360.16,-38.4,-2.75,1469.25,-7.42,True,1,18096,-1360.16,-2787666.62,24613455.36,21825788.74
2000-01-31,1394.46,34.3,2.52,1469.25,-5.09,True,1,18097,-1394.46,-2789061.08,25235542.62,22446481.54
2000-02-01,1409.28,14.82,1.06,1469.25,-4.08,True,1,18098,-1409.28,-2790470.36,25505149.44,22714679.08
2000-02-02,1409.12,-0.16,-0.01,1469.25,-4.09,True,1,18099,-1409.12,-2791879.48,25503662.88,22711783.4
2000-02-03,1424.97,15.85,1.12,1469.25,-3.01,True,1,18100,-1424.97,-2793304.45,25791957.0,22998652.55
2000-02-04,1424.37,-0.6,-0.04,1469.25,-3.06,True,1,18101,-1424.37,-2794728.82,25782521.37,22987792.55
2000-02-07,1424.24,-0.13,-0.01,1469.25,-3.06,True,1,18102,-1424.24,-2796153.06,25781592.48,22985439.42
2000-02-08,1441.72,17.48,1.23,1469.25,-1.87,True,1,18103,-1441.72,-2797594.78,26099457.16,23301862.38
2000-02-09,1411.71,-30.01,-2.08,1469.25,-3.92,True,1,18104,-1411.71,-2799006.49,25557597.84,22758591.35
2000-02-10,1416.83,5.12,0.36,1469.25,-3.57,True,1,18105,-1416.83,-2800423.32,25651707.15,22851283.83
2000-02-11,1387.12,-29.71,-2.1,1469.25,-5.59,True,1,18106,-1387.12,-2801810.44,25115194.72,22313384.28
2000-02-14,1389.94,2.82,0.2,1469.25,-5.4,True,1,18107,-1389.94,-2803200.38,25167643.58,22364443.2
2000-02-15,1402.05,12.11,0.87,1469.25,-4.57,True,1,18108,-1402.05,-2804602.43,25388321.4,22583718.97
2000-02-16,1387.67,-14.38,-1.03,1469.25,-5.55,True,1,18109,-1387.67,-2805990.1,25129316.03,22323325.93
2000-02-17,1388.26,0.59,0.04,1469.25,-5.51,True,1,18110,-1388.26,-2807378.36,25141388.6,22334010.24
2000-02-18,1346.09,-42.17,-3.04,1469.25,-8.38,True,1,18111,-1346.09,-2808724.45,24379035.99,21570311.54
2000-02-22,1352.17,6.08,0.45,1469.25,-7.97,True,1,18112,-1352.17,-2810076.62,24490503.04,21680426.42
2000-02-23,1360.69,8.52,0.63,1469.25,-7.39,True,1,18113,-1360.69,-2811437.31,24646177.97,21834740.66
2000-02-24,1353.43,-7.26,-0.53,1469.25,-7.88,True,1,18114,-1353.43,-2812790.74,24516031.02,21703240.28
2000-02-25,1333.36,-20.07,-1.48,1469.25,-9.25,True,1,18115,-1333.36,-2814124.1,24153816.4,21339692.3
2000-02-28,1348.05,14.69,1.1,1469.25,-8.25,True,1,18116,-1348.05,-2815472.15,24421273.8,21605801.65
2000-02-29,1366.42,18.37,1.36,1469.25,-7.0,True,1,18117,-1366.42,-2816838.57,24755431.14,21938592.57
2000-03-01,1379.19,12.77,0.94,1469.25,-6.13,True,1,18118,-1379.19,-2818217.76,24988164.42,22169946.66
2000-03-02,1381.76,2.57,0.19,1469.25,-5.96,True,1,18119,-1381.76,-2819599.52,25036109.44,22216509.92
2000-03-03,1409.17,27.41,1.98,1469.25,-4.09,True,1,18120,-1409.17,-2821008.69,25534160.4,22713151.71
2000-03-06,1391.28,-17.89,-1.27,1469.25,-5.31,True,1,18121,-1391.28,-2822399.97,25211384.88,22388984.91
2000-03-07,1355.62,-35.66,-2.56,1469.25,-7.73,True,1,18122,-1355.62,-2823755.59,24566545.64,21742790.05
2000-03-08,1366.7,11.08,0.82,1469.25,-6.98,True,1,18123,-1366.7,-2825122.29,24768704.1,21943581.81
2000-03-09,1401.69,34.99,2.56,1469.25,-4.6,True,1,18124,-1401.69,-2826523.98,25404229.56,22577705.58
2000-03-10,1395.07,-6.62,-0.47,1469.25,-5.05,True,1,18125,-1395.07,-2827919.05,25285643.75,22457724.7
2000-03-13,1383.62,-11.45,-0.82,1469.25,-5.83,True,1,18126,-1383.62,-2829302.67,25079496.12,22250193.45
2000-03-14,1359.15,-24.47,-1.77,1469.25,-7.49,True,1,18127,-1359.15,-2830661.82,24637312.05,21806650.23
2000-03-15,1392.14,32.99,2.43,1469.25,-5.25,True,1,18128,-1392.14,-2832053.96,25236713.92,22404659.96
2000-03-16,1458.47,66.33,4.76,1469.25,-0.73,True,1,18129,-1458.47,-2833512.43,26440602.63,23607090.2
2000-03-17,1464.47,6.0,0.41,1469.25,-0.32,True,1,18130,-1464.47,-2834976.9,26550841.1,23715864.2
2000-03-20,1456.63,-7.84,-0.54,1469.25,-0.86,True,1,18131,-1456.63,-2836433.53,26410158.53,23573725.0
2000-03-21,1493.87,37.24,2.56,1493.87,0.0,True,1,18132,-1493.87,-2837927.4,27086850.84,24248923.44
2000-03-22,1500.64,6.77,0.45,1500.64,0.0,True,1,18133,-1500.64,-2839428.04,27211105.12,24371677.08
2000-03-23,1527.35,26.71,1.78,1527.35,0.0,True,1,18134,-1527.35,-2840955.39,27696964.9,24856009.51
2000-03-24,1527.46,0.11,0.01,1527.46,0.0,True,1,18135,-1527.46,-2842482.85,27700487.1,24858004.25
2000-03-27,1523.86,-3.6,-0.24,1527.46,-0.24,True,1,18136,-1523.86,-2844006.71,27636724.96,24792718.25
2000-03-28,1507.73,-16.13,-1.06,1527.46,-1.29,True,1,18137,-1507.73,-2845514.44,27345699.01,24500184.57
2000-03-29,1508.52,0.79,0.05,1527.46,-1.24,True,1,18138,-1508.52,-2847022.96,27361535.76,24514512.8
2000-03-30,1487.92,-20.6,-1.37,1527.46,-2.59,True,1,18139,-1487.92,-2848510.88,26989380.88,24140870.0
2000-03-31,1498.58,10.66,0.72,1527.46,-1.89,True,1,18140,-1498.58,-2850009.46,27184241.2,24334231.74
2000-04-03,1505.97,7.39,0.49,1527.46,-1.41,True,1,18141,-1505.97,-2851515.43,27319801.77,24468286.34
2000-04-04,1494.73,-11.24,-0.75,1527.46,-2.14,True,1,18142,-1494.73,-2853010.16,27117391.66,24264381.5
2000-04-05,1487.37,-7.36,-0.49,1527.46,-2.62,True,1,18143,-1487.37,-2854497.53,26985353.91,24130856.38
2000-04-06,1501.34,13.97,0.94,1527.46,-1.71,True,1,18144,-1501.34,-2855998.87,27240312.96,24384314.09
2000-04-07,1516.35,15.01,1.0,1527.46,-0.73,True,1,18145,-1516.35,-2857515.22,27514170.75,24656655.53
2000-04-10,1504.46,-11.89,-0.78,1527.46,-1.51,True,1,18146,-1504.46,-2859019.68,27299931.16,24440911.48
2000-04-11,1500.59,-3.87,-0.26,1527.46,-1.76,True,1,18147,-1500.59,-2860520.27,27231206.73,24370686.46
2000-04-12,1467.17,-33.42,-2.23,1527.46,-3.95,True,1,18148,-1467.17,-2861987.44,26626201.16,23764213.72
2000-04-13,1440.51,-26.66,-1.82,1527.46,-5.69,True,1,18149,-1440.51,-2863427.95,26143815.99,23280388.04
2000-04-14,1356.56,-83.95,-5.83,1527.46,-11.19,True,1,18150,-1356.56,-2864784.51,24621564.0,21756779.49
2000-04-17,1401.44,44.88,3.31,1527.46,-8.25,True,1,18151,-1401.44,-2866185.95,25437537.44,22571351.49
2000-04-18,1441.61,40.17,2.87,1527.46,-5.62,True,1,18152,-1441.61,-2867627.56,26168104.72,23300477.16
2000-04-19,1427.47,-14.14,-0.98,1527.46,-6.55,True,1,18153,-1427.47,-2869055.03,25912862.91,23043807.88
2000-04-20,1434.54,7.07,0.5,1527.46,-6.08,True,1,18154,-1434.54,-2870489.57,26042639.16,23172149.59
2000-04-24,1429.86,-4.68,-0.33,1527.46,-6.39,True,1,18155,-1429.86,-2871919.43,25959108.3,23087188.87
2000-04-25,1477.44,47.58,3.33,1527.46,-3.28,True,1,18156,-1477.44,-2873396.87,26824400.64,23951003.77
2000-04-26,1460.99,-16.45,-1.11,1527.46,-4.35,True,1,18157,-1460.99,-2874857.86,26527195.43,23652337.57
2000-04-27,1464.92,3.93,0.27,1527.46,-4.09,True,1,18158,-1464.92,-2876322.78,26600017.36,23723694.58
2000-04-28,1452.43,-12.49,-0.85,1527.46,-4.91,True,1,18159,-1452.43,-2877775.21,26374676.37,23496901.16
2000-05-01,1468.25,15.82,1.09,1527.46,-3.88,True,1,18160,-1468.25,-2879243.46,26663420.0,23784176.54
2000-05-02,1446.29,-21.96,-1.5,1527.46,-5.31,True,1,18161,-1446.29,-2880689.75,26266072.69,23385382.94
2000-05-03,1415.1,-31.19,-2.16,1527.46,-7.36,True,1,18162,-1415.1,-2882104.85,25701046.2,22818941.35
2000-05-04,1409.57,-5.53,-0.39,1527.46,-7.72,True,1,18163,-1409.57,-2883514.42,25602019.91,22718505.49
2000-05-05,1432.63,23.06,1.64,1527.46,-6.21,True,1,18164,-1432.63,-2884947.05,26022291.32,23137344.27
2000-05-08,1424.17,-8.46,-0.59,1527.46,-6.76,True,1,18165,-1424.17,-2886371.22,25870048.05,22983676.83
2000-05-09,1412.14,-12.03,-0.84,1527.46,-7.55,True,1,18166,-1412.14,-2887783.36,25652935.24,22765151.88
2000-05-10,1383.05,-29.09,-2.06,1527.46,-9.45,True,1,18167,-1383.05,-2889166.41,25125869.35,22236702.94
2000-05-11,1407.81,24.76,1.79,1527.46,-7.83,True,1,18168,-1407.81,-2890574.22,25577092.08,22686517.86
2000-05-12,1420.96,13.15,0.93,1527.46,-6.97,True,1,18169,-1420.96,-2891995.18,25817422.24,22925427.06
2000-05-15,1452.36,31.4,2.21,1527.46,-4.92,True,1,18170,-1452.36,-2893447.54,26389381.2,23495933.66
2000-05-16,1466.04,13.68,0.94,1527.46,-4.02,True,1,18171,-1466.04,-2894913.58,26639412.84,23744499.26
2000-05-17,1447.8,-18.24,-1.24,1527.46,-5.22,True,1,18172,-1447.8,-2896361.38,26309421.6,23413060.22
2000-05-18,1437.21,-10.59,-0.73,1527.46,-5.91,True,1,18173,-1437.21,-2897798.59,26118417.33,23220618.74
2000-05-19,1406.95,-30.26,-2.1,1527.46,-7.89,True,1,18174,-1406.95,-2899205.54,25569909.3,22670703.76
2000-05-22,1400.72,-6.23,-0.44,1527.46,-8.3,True,1,18175,-1400.72,-2900606.26,25458086.0,22557479.74
2000-05-23,1373.86,-26.86,-1.92,1527.46,-10.06,True,1,18176,-1373.86,-2901980.12,24971279.36,22069299.24
2000-05-24,1399.05,25.19,1.83,1527.46,-8.41,True,1,18177,-1399.05,-2903379.17,25430531.85,22527152.68
2000-05-25,1381.52,-17.53,-1.25,1527.46,-9.55,True,1,18178,-1381.52,-2904760.69,25113270.56,22208509.87
2000-05-26,1378.02,-3.5,-0.25,1527.46,-9.78,True,1,18179,-1378.02,-2906138.71,25051025.58,22144886.87
2000-05-30,1422.45,44.43,3.22,1527.46,-6.88,True,1,18180,-1422.45,-2907561.16,25860141.0,22952579.84
2000-05-31,1420.6,-1.85,-0.13,1527.46,-7.0,True,1,18181,-1420.6,-2908981.76,25827928.6,22918946.84
2000-06-01,1448.81,28.21,1.99,1527.46,-5.15,True,1,18182,-1448.81,-2910430.57,26342263.42,23431832.85
2000-06-02,1477.26,28.45,1.96,1527.46,-3.29,True,1,18183,-1477.26,-2911907.83,26861018.58,23949110.75
2000-06-05,1467.63,-9.63,-0.65,1527.46,-3.92,True,1,18184,-1467.63,-2913375.46,26687383.92,23774008.46
2000-06-06,1457.84,-9.79,-0.67,1527.46,-4.56,True,1,18185,-1457.84,-2914833.3,26510820.4,23595987.1
2000-06-07,1471.36,13.52,0.93,1527.46,-3.67,True,1,18186,-1471.36,-2916304.66,26758152.96,23841848.3
2000-06-08,1461.67,-9.69,-0.66,1527.46,-4.31,True,1,18187,-1461.67,-2917766.33,26583392.29,23665625.96
2000-06-09,1456.95,-4.72,-0.32,1527.46,-4.62,True,1,18188,-1456.95,-2919223.28,26499006.6,23579783.32
2000-06-12,1446.0,-10.95,-0.75,1527.46,-5.33,True,1,18189,-1446.0,-2920669.28,26301294.0,23380624.72
2000-06-13,1469.44,23.44,1.62,1527.46,-3.8,True,1,18190,-1469.44,-2922138.72,26729113.6,23806974.88
2000-06-14,1470.54,1.1,0.08,1527.46,-3.73,True,1,18191,-1470.54,-2923609.26,26750593.14,23826983.88
2000-06-15,1478.73,8.19,0.56,1527.46,-3.19,True,1,18192,-1478.73,-2925087.99,26901056.16,23975968.17
2000-06-16,1464.46,-14.27,-0.96,1527.46,-4.12,True,1,18193,-1464.46,-2926552.45,26642920.78,23716368.33
2000-06-19,1486.0,21.54,1.47,1527.46,-2.71,True,1,18194,-1486.0,-2928038.45,27036284.0,24108245.55
2000-06-20,1475.95,-10.05,-0.68,1527.46,-3.37,True,1,18195,-1475.95,-2929514.4,26854910.25,23925395.85
2000-06-21,1479.13,3.18,0.22,1527.46,-3.16,True,1,18196,-1479.13,-2930993.53,26914249.48,23983255.95
2000-06-22,1452.18,-26.95,-1.82,1527.46,-4.93,True,1,18197,-1452.18,-2932445.71,26425319.46,23492873.75
2000-06-23,1441.48,-10.7,-0.74,1527.46,-5.63,True,1,18198,-1441.48,-2933887.19,26232053.04,23298165.85
2000-06-26,1455.31,13.83,0.96,1527.46,-4.72,True,1,18199,-1455.31,-2935342.5,26485186.69,23549844.19
2000-06-27,1450.55,-4.76,-0.33,1527.46,-5.04,True,1,18200,-1450.55,-2936793.05,26400010.0,23463216.95
2000-06-28,1454.82,4.27,0.29,1527.46,-4.76,True,1,18201,-1454.82,-2938247.87,26479178.82,23540930.95
2000-06-29,1442.39,-12.43,-0.85,1527.46,-5.57,True,1,18202,-1442.39,-2939690.26,26254382.78,23314692.52
2000-06-30,1454.6,12.21,0.85,1527.46,-4.77,True,1,18203,-1454.6,-2941144.86,26478083.8,23536938.94
2000-07-03,1469.54,14.94,1.03,1527.46,-3.79,True,1,18204,-1469.54,-2942614.4,26751506.16,23808891.76
2000-07-05,1446.23,-23.31,-1.59,1527.46,-5.32,True,1,18205,-1446.23,-2944060.63,26328617.15,23384556.52
2000-07-06,1456.67,10.44,0.72,1527.46,-4.63,True,1,18206,-1456.67,-2945517.3,26520134.02,23574616.72
2000-07-07,1478.9,22.23,1.53,1527.46,-3.18,True,1,18207,-1478.9,-2946996.2,26926332.3,23979336.1
2000-07-10,1475.62,-3.28,-0.22,1527.46,-3.39,True,1,18208,-1475.62,-2948471.82,26868088.96,23919617.14
2000-07-11,1480.88,5.26,0.36,1527.46,-3.05,True,1,18209,-1480.88,-2949952.7,26965343.92,24015391.22
2000-07-12,1492.92,12.04,0.81,1527.46,-2.26,True,1,18210,-1492.92,-2951445.62,27186073.2,24234627.58
2000-07-13,1495.84,2.92,0.2,1527.46,-2.07,True,1,18211,-1495.84,-2952941.46,27240742.24,24287800.78
2000-07-14,1509.98,14.14,0.94,1527.46,-1.14,True,1,18212,-1509.98,-2954451.44,27499755.76,24545304.32
2000-07-17,1510.49,0.51,0.03,1527.46,-1.11,True,1,18213,-1510.49,-2955961.93,27510554.37,24554592.44
2000-07-18,1493.74,-16.75,-1.11,1527.46,-2.21,True,1,18214,-1493.74,-2957455.67,27206980.36,24249524.69
2000-07-19,1481.96,-11.78,-0.79,1527.46,-2.98,True,1,18215,-1481.96,-2958937.63,26993901.4,24034963.77
2000-07-20,1495.57,13.61,0.92,1527.46,-2.09,True,1,18216,-1495.57,-2960433.2,27243303.12,24282869.92
2000-07-21,1480.19,-15.38,-1.03,1527.46,-3.1,True,1,18217,-1480.19,-2961913.39,26964621.23,24002707.84
2000-07-24,1464.29,-15.9,-1.07,1527.46,-4.14,True,1,18218,-1464.29,-2963377.68,26676435.22,23713057.54
2000-07-25,1474.47,10.18,0.7,1527.46,-3.47,True,1,18219,-1474.47,-2964852.15,26863368.93,23898516.78
2000-07-26,1452.42,-22.05,-1.5,1527.46,-4.91,True,1,18220,-1452.42,-2966304.57,26463092.4,23496787.83
2000-07-27,1449.62,-2.8,-0.19,1527.46,-5.1,True,1,18221,-1449.62,-2967754.19,26413526.02,23445771.83
2000-07-28,1419.89,-29.73,-2.05,1527.46,-7.04,True,1,18222,-1419.89,-2969174.08,25873235.58,22904061.5
2000-07-31,1430.83,10.94,0.77,1527.46,-6.33,True,1,18223,-1430.83,-2970604.91,26074015.09,23103410.18
2000-08-01,1438.1,7.27,0.51,1527.46,-5.85,True,1,18224,-1438.1,-2972043.01,26207934.4,23235891.39
2000-08-02,1438.7,0.6,0.04,1527.46,-5.81,True,1,18225,-1438.7,-2973481.71,26220307.5,23246825.79
2000-08-03,1452.56,13.86,0.96,1527.46,-4.9,True,1,18226,-1452.56,-2974934.27,26474358.56,23499424.29
2000-08-04,1462.93,10.37,0.71,1527.46,-4.22,True,1,18227,-1462.93,-2976397.2,26664825.11,23688427.91
2000-08-07,1479.32,16.39,1.12,1527.46,-3.15,True,1,18228,-1479.32,-2977876.52,26965044.96,23987168.44
2000-08-08,1482.8,3.48,0.24,1527.46,-2.92,True,1,18229,-1482.8,-2979359.32,27029961.2,24050601.88
2000-08-09,1472.87,-9.93,-0.67,1527.46,-3.57,True,1,18230,-1472.87,-2980832.19,26850420.1,23869587.91
2000-08-10,1460.25,-12.62,-0.86,1527.46,-4.4,True,1,18231,-1460.25,-2982292.44,26621817.75,23639525.31
2000-08-11,1471.84,11.59,0.79,1527.46,-3.64,True,1,18232,-1471.84,-2983764.28,26834586.88,23850822.6
2000-08-14,1491.56,19.72,1.34,1527.46,-2.35,True,1,18233,-1491.56,-2985255.84,27195613.48,24210357.64
2000-08-15,1484.43,-7.13,-0.48,1527.46,-2.82,True,1,18234,-1484.43,-2986740.27,27067096.62,24080356.35
2000-08-16,1479.85,-4.58,-0.31,1527.46,-3.12,True,1,18235,-1479.85,-2988220.12,26985064.75,23996844.63
2000-08-17,1496.07,16.22,1.1,1527.46,-2.06,True,1,18236,-1496.07,-2989716.19,27282332.52,24292616.33
2000-08-18,1491.72,-4.35,-0.29,1527.46,-2.34,True,1,18237,-1491.72,-2991207.91,27204497.64,24213289.73
2000-08-21,1499.48,7.76,0.52,1527.46,-1.83,True,1,18238,-1499.48,-2992707.39,27347516.24,24354808.85
2000-08-22,1498.13,-1.35,-0.09,1527.46,-1.92,True,1,18239,-1498.13,-2994205.52,27324393.07,24330187.55
2000-08-23,1505.97,7.84,0.52,1527.46,-1.41,True,1,18240,-1505.97,-2995711.49,27468892.8,24473181.31
2000-08-24,1508.31,2.34,0.16,1527.46,-1.25,True,1,18241,-1508.31,-2997219.8,27513082.71,24515862.91
2000-08-25,1506.45,-1.86,-0.12,1527.46,-1.38,True,1,18242,-1506.45,-2998726.25,27480660.9,24481934.65
2000-08-28,1514.09,7.64,0.51,1527.46,-0.88,True,1,18243,-1514.09,-3000240.34,27621543.87,24621303.53
2000-08-29,1509.84,-4.25,-0.28,1527.46,-1.15,True,1,18244,-1509.84,-3001750.18,27545520.96,24543770.78
2000-08-30,1502.59,-7.25,-0.48,1527.46,-1.63,True,1,18245,-1502.59,-3003252.77,27414754.55,24411501.78
2000-08-31,1517.68,15.09,1.0,1527.46,-0.64,True,1,18246,-1517.68,-3004770.45,27691589.28,24686818.83
2000-09-01,1520.77,3.09,0.2,1527.46,-0.44,True,1,18247,-1520.77,-3006291.22,27749490.19,24743198.97
2000-09-05,1507.08,-13.69,-0.9,1527.46,-1.33,True,1,18248,-1507.08,-3007798.3,27501195.84,24493397.54
2000-09-06,1492.25,-14.83,-0.98,1527.46,-2.31,True,1,18249,-1492.25,-3009290.55,27232070.25,24222779.7
2000-09-07,1502.51,10.26,0.69,1527.46,-1.63,True,1,18250,-1502.51,-3010793.06,27420807.5,24410014.44
2000-09-08,1494.5,-8.01,-0.53,1527.46,-2.16,True,1,18251,-1494.5,-3012287.56,27276119.5,24263831.94
2000-09-11,1489.26,-5.24,-0.35,1527.46,-2.5,True,1,18252,-1489.26,-3013776.82,27181973.52,24168196.7
2000-09-12,1481.99,-7.27,-0.49,1527.46,-2.98,True,1,18253,-1481.99,-3015258.81,27050763.47,24035504.66
2000-09-13,1484.91,2.92,0.2,1527.46,-2.79,True,1,18254,-1484.91,-3016743.72,27105547.14,24088803.42
2000-09-14,1480.87,-4.04,-0.27,1527.46,-3.05,True,1,18255,-1480.87,-3018224.59,27033281.85,24015057.26
2000-09-15,1465.81,-15.06,-1.02,1527.46,-4.04,True,1,18256,-1465.81,-3019690.4,26759827.36,23740136.96
2000-09-18,1444.51,-21.3,-1.45,1527.46,-5.43,True,1,18257,-1444.51,-3021134.91,26372419.07,23351284.16
2000-09-19,1459.9,15.39,1.06,1527.46,-4.42,True,1,18258,-1459.9,-3022594.81,26654854.2,23632259.39
2000-09-20,1451.34,-8.56,-0.59,1527.46,-4.98,True,1,18259,-1451.34,-3024046.15,26500017.06,23475970.91
2000-09-21,1449.05,-2.29,-0.16,1527.46,-5.13,True,1,18260,-1449.05,-3025495.2,26459653.0,23434157.8
2000-09-22,1448.72,-0.33,-0.02,1527.46,-5.16,True,1,18261,-1448.72,-3026943.92,26455075.92,23428132.0
2000-09-25,1439.03,-9.69,-0.67,1527.46,-5.79,True,1,18262,-1439.03,-3028382.95,26279565.86,23251182.91
2000-09-26,1427.21,-11.82,-0.82,1527.46,-6.56,True,1,18263,-1427.21,-3029810.16,26065136.23,23035326.07
2000-09-27,1426.57,-0.64,-0.04,1527.46,-6.6,True,1,18264,-1426.57,-3031236.73,26054874.48,23023637.75
2000-09-28,1458.29,31.72,2.22,1527.46,-4.53,True,1,18265,-1458.29,-3032695.02,26635666.85,23602971.83
2000-09-29,1436.51,-21.78,-1.49,1527.46,-5.95,True,1,18266,-1436.51,-3034131.53,26239291.66,23205160.13
2000-10-02,1436.23,-0.28,-0.02,1527.46,-5.97,True,1,18267,-1436.23,-3035567.76,26235613.41,23200045.65
2000-10-03,1426.46,-9.77,-0.68,1527.46,-6.61,True,1,18268,-1426.46,-3036994.22,26058571.28,23021577.06
2000-10-04,1434.32,7.86,0.55,1527.46,-6.1,True,1,18269,-1434.32,-3038428.54,26203592.08,23165163.54
2000-10-05,1436.28,1.96,0.14,1527.46,-5.97,True,1,18270,-1436.28,-3039864.82,26240835.6,23200970.78
2000-10-06,1408.99,-27.29,-1.9,1527.46,-7.76,True,1,18271,-1408.99,-3041273.81,25743656.29,22702382.48
2000-10-09,1402.03,-6.96,-0.49,1527.46,-8.21,True,1,18272,-1402.03,-3042675.84,25617892.16,22575216.32
2000-10-10,1387.02,-15.01,-1.07,1527.46,-9.19,True,1,18273,-1387.02,-3044062.86,25345016.46,22300953.6
2000-10-11,1364.59,-22.43,-1.62,1527.46,-10.66,True,1,18274,-1364.59,-3045427.45,24936517.66,21891090.21
2000-10-12,1329.78,-34.81,-2.55,1527.46,-12.94,True,1,18275,-1329.78,-3046757.23,24301729.5,21254972.27
2000-10-13,1374.17,44.39,3.34,1527.46,-10.04,True,1,18276,-1374.17,-3048131.4,25114330.92,22066199.52
2000-10-16,1374.62,0.45,0.03,1527.46,-10.01,True,1,18277,-1374.62,-3049506.02,25123929.74,22074423.72
2000-10-17,1349.97,-24.65,-1.79,1527.46,-11.62,True,1,18278,-1349.97,-3050855.99,24674751.66,21623895.67
2000-10-18,1342.13,-7.84,-0.58,1527.46,-12.13,True,1,18279,-1342.13,-3052198.12,24532794.27,21480596.15
2000-10-19,1388.76,46.63,3.47,1527.46,-9.08,True,1,18280,-1388.76,-3053586.88,25386532.8,22332945.92
2000-10-20,1396.93,8.17,0.59,1527.46,-8.55,True,1,18281,-1396.93,-3054983.81,25537277.33,22482293.52
2000-10-23,1395.78,-1.15,-0.08,1527.46,-8.62,True,1,18282,-1395.78,-3056379.59,25517649.96,22461270.37
2000-10-24,1398.13,2.35,0.17,1527.46,-8.47,True,1,18283,-1398.13,-3057777.72,25562010.79,22504233.07
2000-10-25,1364.9,-33.23,-2.38,1527.46,-10.64,True,1,18284,-1364.9,-3059142.62,24955831.6,21896688.98
2000-10-26,1364.44,-0.46,-0.03,1527.46,-10.67,True,1,18285,-1364.44,-3060507.06,24948785.4,21888278.34
2000-10-27,1379.58,15.14,1.11,1527.46,-9.68,True,1,18286,-1379.58,-3061886.64,25226999.88,22165113.24
2000-10-30,1398.66,19.08,1.38,1527.46,-8.43,True,1,18287,-1398.66,-3063285.3,25577295.42,22514010.12
2000-10-31,1429.4,30.74,2.2,1527.46,-6.42,True,1,18288,-1429.4,-3064714.7,26140867.2,23076152.5
2000-11-01,1421.22,-8.18,-0.57,1527.46,-6.96,True,1,18289,-1421.22,-3066135.92,25992692.58,22926556.66
2000-11-02,1428.32,7.1,0.5,1527.46,-6.49,True,1,18290,-1428.32,-3067564.24,26123972.8,23056408.56
2000-11-03,1426.69,-1.63,-0.11,1527.46,-6.6,True,1,18291,-1426.69,-3068990.93,26095586.79,23026595.86
2000-11-06,1432.19,5.5,0.39,1527.46,-6.24,True,1,18292,-1432.19,-3070423.12,26197619.48,23127196.36
2000-11-07,1431.87,-0.32,-0.02,1527.46,-6.26,True,1,18293,-1431.87,-3071854.99,26193197.91,23121342.92
2000-11-08,1409.28,-22.59,-1.58,1527.46,-7.74,True,1,18294,-1409.28,-3073264.27,25781368.32,22708104.05
2000-11-09,1400.14,-9.14,-0.65,1527.46,-8.34,True,1,18295,-1400.14,-3074664.41,25615561.3,22540896.89
2000-11-10,1365.98,-34.16,-2.44,1527.46,-10.57,True,1,18296,-1365.98,-3076030.39,24991970.08,21915939.69
2000-11-13,1351.26,-14.72,-1.08,1527.46,-11.54,True,1,18297,-1351.26,-3077381.65,24724004.22,21646622.57
2000-11-14,1382.95,31.69,2.35,1527.46,-9.46,True,1,18298,-1382.95,-3078764.6,25305219.1,22226454.5
2000-11-15,1389.81,6.86,0.5,1527.46,-9.01,True,1,18299,-1389.81,-3080154.41,25432133.19,22351978.78
2000-11-16,1372.32,-17.49,-1.26,1527.46,-10.16,True,1,18300,-1372.32,-3081526.73,25113456.0,22031929.27
2000-11-17,1367.72,-4.6,-0.34,1527.46,-10.46,True,1,18301,-1367.72,-3082894.45,25030643.72,21947749.27
2000-11-20,1342.62,-25.1,-1.84,1527.46,-12.1,True,1,18302,-1342.62,-3084237.07,24572631.24,21488394.17
2000-11-21,1347.35,4.73,0.35,1527.46,-11.79,True,1,18303,-1347.35,-3085584.42,24660547.05,21574962.63
2000-11-22,1322.36,-24.99,-1.86,1527.46,-13.43,True,1,18304,-1322.36,-3086906.78,24204477.44,21117570.66
2000-11-24,1341.77,19.41,1.47,1527.46,-12.16,True,1,18305,-1341.77,-3088248.55,24561099.85,21472851.3
2000-11-27,1348.97,7.2,0.54,1527.46,-11.68,True,1,18306,-1348.97,-3089597.52,24694244.82,21604647.3
2000-11-28,1336.09,-12.88,-0.96,1527.46,-12.53,True,1,18307,-1336.09,-3090933.61,24459799.63,21368866.02
2000-11-29,1341.93,5.84,0.44,1527.46,-12.15,True,1,18308,-1341.93,-3092275.54,24568054.44,21475778.9
2000-11-30,1314.95,-26.98,-2.01,1527.46,-13.91,True,1,18309,-1314.95,-3093590.49,24075419.55,20981829.06
2000-12-01,1315.23,0.28,0.02,1527.46,-13.89,True,1,18310,-1315.23,-3094905.72,24081861.3,20986955.58
2000-12-04,1324.97,9.74,0.74,1527.46,-13.26,True,1,18311,-1324.97,-3096230.69,24261525.67,21165294.98
2000-12-05,1376.54,51.57,3.89,1527.46,-9.88,True,1,18312,-1376.54,-3097607.23,25207200.48,22109593.25
2000-12-06,1351.46,-25.08,-1.82,1527.46,-11.52,True,1,18313,-1351.46,-3098958.69,24749286.98,21650328.29
2000-12-07,1343.55,-7.91,-0.58,1527.46,-12.04,True,1,18314,-1343.55,-3100302.24,24605774.7,21505472.46
2000-12-08,1369.89,26.34,1.96,1527.46,-10.32,True,1,18315,-1369.89,-3101672.13,25089535.35,21987863.22
2000-12-11,1380.2,10.31,0.75,1527.46,-9.64,True,1,18316,-1380.2,-3103052.33,25279743.2,22176690.87
2000-12-12,1371.18,-9.02,-0.65,1527.46,-10.23,True,1,18317,-1371.18,-3104423.51,25115904.06,22011480.55
2000-12-13,1359.99,-11.19,-0.82,1527.46,-10.96,True,1,18318,-1359.99,-3105783.5,24912296.82,21806513.32
2000-12-14,1340.93,-19.06,-1.4,1527.46,-12.21,True,1,18319,-1340.93,-3107124.43,24564496.67,21457372.24
2000-12-15,1312.15,-28.78,-2.15,1527.46,-14.1,True,1,18320,-1312.15,-3108436.58,24038588.0,20930151.42
2000-12-18,1322.74,10.59,0.81,1527.46,-13.4,True,1,18321,-1322.74,-3109759.32,24233919.54,21124160.22
2000-12-19,1305.6,-17.14,-1.3,1527.46,-14.52,True,1,18322,-1305.6,-3111064.92,23921203.2,20810138.28
2000-12-20,1264.74,-40.86,-3.13,1527.46,-17.2,True,1,18323,-1264.74,-3112329.66,23173831.02,20061501.36
2000-12-21,1274.86,10.12,0.8,1527.46,-16.54,True,1,18324,-1274.86,-3113604.52,23360534.64,20246930.12
2000-12-22,1305.95,31.09,2.44,1527.46,-14.5,True,1,18325,-1305.95,-3114910.47,23931533.75,20816623.28
2000-12-26,1315.19,9.24,0.71,1527.46,-13.9,True,1,18326,-1315.19,-3116225.66,24102171.94,20985946.28
2000-12-27,1328.92,13.73,1.04,1527.46,-13.0,True,1,18327,-1328.92,-3117554.58,24355116.84,21237562.26
2000-12-28,1334.22,5.3,0.4,1527.46,-12.65,True,1,18328,-1334.22,-3118888.8,24453584.16,21334695.36
2000-12-29,1320.28,-13.94,-1.04,1527.46,-13.56,True,1,18329,-1320.28,-3120209.08,24199412.12,21079203.04
2001-01-02,1283.27,-37.01,-2.8,1527.46,-15.99,True,1,18330,-1283.27,-3121492.35,23522339.1,20400846.75
2001-01-03,1347.56,64.29,5.01,1527.46,-11.78,True,1,18331,-1347.56,-3122839.91,24702122.36,21579282.45
2001-01-04,1333.34,-14.22,-1.06,1527.46,-12.71,True,1,18332,-1333.34,-3124173.25,24442788.88,21318615.63
2001-01-05,1298.35,-34.99,-2.62,1527.46,-15.0,True,1,18333,-1298.35,-3125471.6,23802650.55,20677178.95
2001-01-08,1295.86,-2.49,-0.19,1527.46,-15.16,True,1,18334,-1295.86,-3126767.46,23758297.24,20631529.78
2001-01-09,1300.8,4.94,0.38,1527.46,-14.84,True,1,18335,-1300.8,-3128068.26,23850168.0,20722099.74
2001-01-10,1313.27,12.47,0.96,1527.46,-14.02,True,1,18336,-1313.27,-3129381.53,24080118.72,20950737.19
2001-01-11,1326.82,13.55,1.03,1527.46,-13.14,True,1,18337,-1326.82,-3130708.35,24329898.34,21199189.99
2001-01-12,1318.55,-8.27,-0.62,1527.46,-13.68,True,1,18338,-1318.55,-3132026.9,24179569.9,21047543.0
2001-01-16,1326.65,8.1,0.61,1527.46,-13.15,True,1,18339,-1326.65,-3133353.55,24329434.35,21196080.8
2001-01-17,1329.47,2.82,0.21,1527.46,-12.96,True,1,18340,-1329.47,-3134683.02,24382479.8,21247796.78
2001-01-18,1347.97,18.5,1.39,1527.46,-11.75,True,1,18341,-1347.97,-3136030.99,24723117.77,21587086.78
2001-01-19,1342.54,-5.43,-0.4,1527.46,-12.11,True,1,18342,-1342.54,-3137373.53,24624868.68,21487495.15
2001-01-22,1342.9,0.36,0.03,1527.46,-12.08,True,1,18343,-1342.9,-3138716.43,24632814.7,21494098.27
2001-01-23,1360.4,17.5,1.3,1527.46,-10.94,True,1,18344,-1360.4,-3140076.83,24955177.6,21815100.77
2001-01-24,1364.3,3.9,0.29,1527.46,-10.68,True,1,18345,-1364.3,-3141441.13,25028083.5,21886642.37
2001-01-25,1357.51,-6.79,-0.5,1527.46,-11.13,True,1,18346,-1357.51,-3142798.64,24904878.46,21762079.82
2001-01-26,1354.95,-2.56,-0.19,1527.46,-11.29,True,1,18347,-1354.95,-3144153.59,24859267.65,21715114.06
2001-01-29,1364.17,9.22,0.68,1527.46,-10.69,True,1,18348,-1364.17,-3145517.76,25029791.16,21884273.4
2001-01-30,1373.73,9.56,0.7,1527.46,-10.06,True,1,18349,-1373.73,-3146891.49,25206571.77,22059680.28
2001-01-31,1366.01,-7.72,-0.56,1527.46,-10.57,True,1,18350,-1366.01,-3148257.5,25066283.5,21918026.0
2001-02-01,1373.47,7.46,0.55,1527.46,-10.08,True,1,18351,-1373.47,-3149630.97,25204547.97,22054917.0
2001-02-02,1349.47,-24.0,-1.75,1527.46,-11.65,True,1,18352,-1349.47,-3150980.44,24765473.44,21614493.0
2001-02-05,1354.31,4.84,0.36,1527.46,-11.34,True,1,18353,-1354.31,-3152334.75,24855651.43,21703316.68
2001-02-06,1352.26,-2.05,-0.15,1527.46,-11.47,True,1,18354,-1352.26,-3153687.01,24819380.04,21665693.03
2001-02-07,1340.89,-11.37,-0.84,1527.46,-12.21,True,1,18355,-1340.89,-3155027.9,24612035.95,21457008.05
2001-02-08,1332.53,-8.36,-0.62,1527.46,-12.76,True,1,18356,-1332.53,-3156360.43,24459920.68,21303560.25
2001-02-09,1314.76,-17.77,-1.33,1527.46,-13.92,True,1,18357,-1314.76,-3157675.19,24135049.32,20977374.13
2001-02-12,1330.31,15.55,1.18,1527.46,-12.91,True,1,18358,-1330.31,-3159005.5,24421830.98,21262825.48
2001-02-13,1318.8,-11.51,-0.86,1527.46,-13.66,True,1,18359,-1318.8,-3160324.3,24211849.2,21051524.9
2001-02-14,1315.92,-2.88,-0.22,1527.46,-13.85,True,1,18360,-1315.92,-3161640.22,24160291.2,20998650.98
2001-02-15,1326.61,10.69,0.81,1527.46,-13.15,True,1,18361,-1326.61,-3162966.83,24357886.21,21194919.38
2001-02-16,1301.53,-25.08,-1.89,1527.46,-14.79,True,1,18362,-1301.53,-3164268.36,23898693.86,20734425.5
2001-02-20,1278.94,-22.59,-1.74,1527.46,-16.27,True,1,18363,-1278.94,-3165547.3,23485175.22,20319627.92
2001-02-21,1255.27,-23.67,-1.85,1527.46,-17.82,True,1,18364,-1255.27,-3166802.57,23051778.28,19884975.71
2001-02-22,1252.82,-2.45,-0.2,1527.46,-17.98,True,1,18365,-1252.82,-3168055.39,23008039.3,19839983.91
2001-02-23,1245.86,-6.96,-0.56,1527.46,-18.44,True,1,18366,-1245.86,-3169301.25,22881464.76,19712163.51
2001-02-26,1267.65,21.79,1.75,1527.46,-17.01,True,1,18367,-1267.65,-3170568.9,23282927.55,20112358.65
2001-02-27,1257.94,-9.71,-0.77,1527.46,-17.64,True,1,18368,-1257.94,-3171826.84,23105841.92,19934015.08
2001-02-28,1239.94,-18.0,-1.43,1527.46,-18.82,True,1,18369,-1239.94,-3173066.78,22776457.86,19603391.08
2001-03-01,1241.23,1.29,0.1,1527.46,-18.74,True,1,18370,-1241.23,-3174308.01,22801395.1,19627087.09
2001-03-02,1234.18,-7.05,-0.57,1527.46,-19.2,True,1,18371,-1234.18,-3175542.19,22673120.78,19497578.59
2001-03-05,1241.41,7.23,0.59,1527.46,-18.73,True,1,18372,-1241.41,-3176783.6,22807184.52,19630400.92
2001-03-06,1253.8,12.39,1.0,1527.46,-17.92,True,1,18373,-1253.8,-3178037.4,23036067.4,19858030.0
2001-03-07,1261.89,8.09,0.64,1527.46,-17.39,True,1,18374,-1261.89,-3179299.29,23185966.86,20006667.57
2001-03-08,1264.74,2.85,0.23,1527.46,-17.2,True,1,18375,-1264.74,-3180564.03,23239597.5,20059033.47
2001-03-09,1233.42,-31.32,-2.48,1527.46,-19.25,True,1,18376,-1233.42,-3181797.45,22665325.92,19483528.47
2001-03-12,1180.16,-53.26,-4.32,1527.46,-22.74,True,1,18377,-1180.16,-3182977.61,21687800.32,18504822.71
2001-03-13,1197.66,17.5,1.48,1527.46,-21.59,True,1,18378,-1197.66,-3184175.27,22010595.48,18826420.21
2001-03-14,1166.71,-30.95,-2.58,1527.46,-23.62,True,1,18379,-1166.71,-3185341.98,21442963.09,18257621.11
2001-03-15,1173.56,6.85,0.59,1527.46,-23.17,True,1,18380,-1173.56,-3186515.54,21570032.8,18383517.26
2001-03-16,1150.53,-23.03,-1.96,1527.46,-24.68,True,1,18381,-1150.53,-3187666.07,21147891.93,17960225.86
2001-03-19,1170.81,20.28,1.76,1527.46,-23.35,True,1,18382,-1170.81,-3188836.88,21521829.42,18332992.54
2001-03-20,1142.62,-28.19,-2.41,1527.46,-25.2,True,1,18383,-1142.62,-3189979.5,21004783.46,17814803.96
2001-03-21,1122.14,-20.48,-1.79,1527.46,-26.54,True,1,18384,-1122.14,-3191101.64,20629421.76,17438320.12
2001-03-22,1117.58,-4.56,-0.41,1527.46,-26.83,True,1,18385,-1117.58,-3192219.22,20546708.3,17354489.08
2001-03-23,1139.83,22.25,1.99,1527.46,-25.38,True,1,18386,-1139.83,-3193359.05,20956914.38,17763555.33
2001-03-26,1152.69,12.86,1.13,1527.46,-24.54,True,1,18387,-1152.69,-3194511.74,21194511.03,17999999.29
2001-03-27,1182.17,29.48,2.56,1527.46,-22.6,True,1,18388,-1182.17,-3195693.91,21737741.96,18542048.05
2001-03-28,1153.29,-28.88,-2.44,1527.46,-24.5,True,1,18389,-1153.29,-3196847.2,21207849.81,18011002.61
2001-03-29,1147.95,-5.34,-0.46,1527.46,-24.85,True,1,18390,-1147.95,-3197995.15,21110800.5,17912805.35
2001-03-30,1160.33,12.38,1.08,1527.46,-24.04,True,1,18391,-1160.33,-3199155.48,21339629.03,18140473.55
2001-04-02,1145.87,-14.46,-1.25,1527.46,-24.98,True,1,18392,-1145.87,-3200301.35,21074841.04,17874539.69
2001-04-03,1106.46,-39.41,-3.44,1527.46,-27.56,True,1,18393,-1106.46,-3201407.81,20351118.78,17149710.97
2001-04-04,1103.25,-3.21,-0.29,1527.46,-27.77,True,1,18394,-1103.25,-3202511.06,20293180.5,17090669.44
2001-04-05,1151.44,48.19,4.37,1527.46,-24.62,True,1,18395,-1151.44,-3203662.5,21180738.8,17977076.3
2001-04-06,1128.43,-23.01,-2.0,1527.46,-26.12,True,1,18396,-1128.43,-3204790.93,20758598.28,17553807.35
2001-04-09,1137.59,9.16,0.81,1527.46,-25.52,True,1,18397,-1137.59,-3205928.52,20928243.23,17722314.71
2001-04-10,1168.38,30.79,2.71,1527.46,-23.51,True,1,18398,-1168.38,-3207096.9,21495855.24,18288758.34
2001-04-11,1165.89,-2.49,-0.21,1527.46,-23.67,True,1,18399,-1165.89,-3208262.79,21451210.11,18242947.32
2001-04-12,1183.5,17.61,1.51,1527.46,-22.52,True,1,18400,-1183.5,-3209446.29,21776400.0,18566953.71
2001-04-16,1179.68,-3.82,-0.32,1527.46,-22.77,True,1,18401,-1179.68,-3210625.97,21707291.68,18496665.71
2001-04-17,1191.81,12.13,1.03,1527.46,-21.97,True,1,18402,-1191.81,-3211817.78,21931687.62,18719869.84
2001-04-18,1238.16,46.35,3.89,1527.46,-18.94,True,1,18403,-1238.16,-3213055.94,22785858.48,19572802.54
2001-04-19,1253.69,15.53,1.25,1527.46,-17.92,True,1,18404,-1253.69,-3214309.63,23072910.76,19858601.13
2001-04-20,1242.98,-10.71,-0.85,1527.46,-18.62,True,1,18405,-1242.98,-3215552.61,22877046.9,19661494.29
2001-04-23,1224.36,-18.62,-1.5,1527.46,-19.84,True,1,18406,-1224.36,-3216776.97,22535570.16,19318793.19
2001-04-24,1209.47,-14.89,-1.22,1527.46,-20.82,True,1,18407,-1209.47,-3217986.44,22262714.29,19044727.85
2001-04-25,1228.75,19.28,1.59,1527.46,-19.56,True,1,18408,-1228.75,-3219215.19,22618830.0,19399614.81
2001-04-26,1234.52,5.77,0.47,1527.46,-19.18,True,1,18409,-1234.52,-3220449.71,22726278.68,19505828.97
2001-04-27,1253.05,18.53,1.5,1527.46,-17.96,True,1,18410,-1253.05,-3221702.76,23068650.5,19846947.74
2001-04-30,1249.46,-3.59,-0.29,1527.46,-18.2,True,1,18411,-1249.46,-3222952.22,23003808.06,19780855.84
2001-05-01,1266.44,16.98,1.36,1527.46,-17.09,True,1,18412,-1266.44,-3224218.66,23317693.28,20093474.62
2001-05-02,1267.43,0.99,0.08,1527.46,-17.02,True,1,18413,-1267.43,-3225486.09,23337188.59,20111702.5
2001-05-03,1248.58,-18.85,-1.49,1527.46,-18.26,True,1,18414,-1248.58,-3226734.67,22991352.12,19764617.45
2001-05-04,1266.61,18.03,1.44,1527.46,-17.08,True,1,18415,-1266.61,-3228001.28,23324623.15,20096621.87
2001-05-07,1263.51,-3.1,-0.24,1527.46,-17.28,True,1,18416,-1263.51,-3229264.79,23268800.16,20039535.37
2001-05-08,1261.2,-2.31,-0.18,1527.46,-17.43,True,1,18417,-1261.2,-3230525.99,23227520.4,19996994.41
2001-05-09,1255.54,-5.66,-0.45,1527.46,-17.8,True,1,18418,-1255.54,-3231781.53,23124535.72,19892754.19
2001-05-10,1255.18,-0.36,-0.03,1527.46,-17.83,True,1,18419,-1255.18,-3233036.71,23119160.42,19886123.71
2001-05-11,1245.67,-9.51,-0.76,1527.46,-18.45,True,1,18420,-1245.67,-3234282.38,22945241.4,19710959.02
2001-05-14,1248.92,3.25,0.26,1527.46,-18.24,True,1,18421,-1248.92,-3235531.3,23006355.32,19770824.02
2001-05-15,1249.44,0.52,0.04,1527.46,-18.2,True,1,18422,-1249.44,-3236780.74,23017183.68,19780402.94
2001-05-16,1284.99,35.55,2.84,1527.46,-15.87,True,1,18423,-1284.99,-3238065.73,23673370.77,20435305.04
2001-05-17,1288.49,3.5,0.27,1527.46,-15.64,True,1,18424,-1288.49,-3239354.22,23739139.76,20499785.54
2001-05-18,1291.96,3.47,0.27,1527.46,-15.42,True,1,18425,-1291.96,-3240646.18,23804363.0,20563716.82
2001-05-21,1312.83,20.87,1.62,1527.46,-14.05,True,1,18426,-1312.83,-3241959.01,24190205.58,20948246.57
2001-05-22,1309.38,-3.45,-0.26,1527.46,-14.28,True,1,18427,-1309.38,-3243268.39,24127945.26,20884676.87
2001-05-23,1289.05,-20.33,-1.55,1527.46,-15.61,True,1,18428,-1289.05,-3244557.44,23754613.4,20510055.96
2001-05-24,1293.17,4.12,0.32,1527.46,-15.34,True,1,18429,-1293.17,-3245850.61,23831829.93,20585979.32
2001-05-25,1277.89,-15.28,-1.18,1527.46,-16.34,True,1,18430,-1277.89,-3247128.5,23551512.7,20304384.2
2001-05-29,1267.93,-9.96,-0.78,1527.46,-16.99,True,1,18431,-1267.93,-3248396.43,23369217.83,20120821.4
2001-05-30,1248.08,-19.85,-1.57,1527.46,-18.29,True,1,18432,-1248.08,-3249644.51,23004610.56,19754966.05
2001-05-31,1255.82,7.74,0.62,1527.46,-17.78,True,1,18433,-1255.82,-3250900.33,23148530.06,19897629.73
2001-06-01,1260.67,4.85,0.39,1527.46,-17.47,True,1,18434,-1260.67,-3252161.0,23239190.78,19987029.78
2001-06-04,1267.11,6.44,0.51,1527.46,-17.05,True,1,18435,-1267.11,-3253428.11,23359172.85,20105744.74
2001-06-05,1283.57,16.46,1.3,1527.46,-15.97,True,1,18436,-1283.57,-3254711.68,23663896.52,20409184.84
2001-06-06,1270.03,-13.54,-1.06,1527.46,-16.85,True,1,18437,-1270.03,-3255981.71,23415543.11,20159561.4
2001-06-07,1276.96,6.93,0.55,1527.46,-16.4,True,1,18438,-1276.96,-3257258.67,23544588.48,20287329.81
2001-06-08,1264.96,-12.0,-0.94,1527.46,-17.18,True,1,18439,-1264.96,-3258523.63,23324597.44,20066073.81
2001-06-11,1254.39,-10.57,-0.84,1527.46,-17.88,True,1,18440,-1254.39,-3259778.02,23130951.6,19871173.58
2001-06-12,1255.85,1.46,0.12,1527.46,-17.78,True,1,18441,-1255.85,-3261033.87,23159129.85,19898095.98
2001-06-13,1241.6,-14.25,-1.14,1527.46,-18.72,True,1,18442,-1241.6,-3262275.47,22897587.2,19635311.73
2001-06-14,1219.87,-21.73,-1.75,1527.46,-20.14,True,1,18443,-1219.87,-3263495.34,22498062.41,19234567.07
2001-06-15,1214.36,-5.51,-0.45,1527.46,-20.5,True,1,18444,-1214.36,-3264709.7,22397655.84,19132946.14
2001-06-18,1208.43,-5.93,-0.49,1527.46,-20.89,True,1,18445,-1208.43,-3265918.13,22289491.35,19023573.22
2001-06-19,1212.58,4.15,0.34,1527.46,-20.62,True,1,18446,-1212.58,-3267130.71,22367250.68,19100119.97
2001-06-20,1223.14,10.56,0.87,1527.46,-19.92,True,1,18447,-1223.14,-3268353.85,22563263.58,19294909.73
2001-06-21,1237.04,13.9,1.14,1527.46,-19.01,True,1,18448,-1237.04,-3269590.89,22820913.92,19551323.03
2001-06-22,1225.35,-11.69,-0.94,1527.46,-19.78,True,1,18449,-1225.35,-3270816.24,22606482.15,19335665.91
2001-06-25,1218.6,-6.75,-0.55,1527.46,-20.22,True,1,18450,-1218.6,-3272034.84,22483170.0,19211135.16
2001-06-26,1216.76,-1.84,-0.15,1527.46,-20.34,True,1,18451,-1216.76,-3273251.6,22450438.76,19177187.16
2001-06-27,1211.07,-5.69,-0.47,1527.46,-20.71,True,1,18452,-1211.07,-3274462.67,22346663.64,19072200.97
2001-06-28,1226.2,15.13,1.25,1527.46,-19.72,True,1,18453,-1226.2,-3275688.87,22627068.6,19351379.73
2001-06-29,1224.38,-1.82,-0.15,1527.46,-19.84,True,1,18454,-1224.38,-3276913.25,22594708.52,19317795.27
2001-07-02,1236.72,12.34,1.01,1527.46,-19.03,True,1,18455,-1236.72,-3278149.97,22823667.6,19545517.63
2001-07-03,1234.45,-2.27,-0.18,1527.46,-19.18,True,1,18456,-1234.45,-3279384.42,22783009.2,19503624.78
2001-07-05,1219.24,-15.21,-1.23,1527.46,-20.18,True,1,18457,-1219.24,-3280603.66,22503512.68,19222909.02
2001-07-06,1190.59,-28.65,-2.35,1527.46,-22.05,True,1,18458,-1190.59,-3281794.25,21975910.22,18694115.97
2001-07-09,1198.78,8.19,0.69,1527.46,-21.52,True,1,18459,-1198.78,-3282993.03,22128280.02,18845286.99
2001-07-10,1181.52,-17.26,-1.44,1527.46,-22.65,True,1,18460,-1181.52,-3284174.55,21810859.2,18526684.65
2001-07-11,1180.18,-1.34,-0.11,1527.46,-22.74,True,1,18461,-1180.18,-3285354.73,21787302.98,18501948.25
2001-07-12,1208.14,27.96,2.37,1527.46,-20.9,True,1,18462,-1208.14,-3286562.87,22304680.68,19018117.81
2001-07-13,1215.68,7.54,0.62,1527.46,-20.41,True,1,18463,-1215.68,-3287778.55,22445099.84,19157321.29
2001-07-16,1202.45,-13.23,-1.09,1527.46,-21.28,True,1,18464,-1202.45,-3288981.0,22202036.8,18913055.8
2001-07-17,1214.44,11.99,1.0,1527.46,-20.49,True,1,18465,-1214.44,-3290195.44,22424634.6,19134439.16
2001-07-18,1207.71,-6.73,-0.55,1527.46,-20.93,True,1,18466,-1207.71,-3291403.15,22301572.86,19010169.71
2001-07-19,1215.02,7.31,0.6,1527.46,-20.45,True,1,18467,-1215.02,-3292618.17,22437774.34,19145156.17
2001-07-20,1210.85,-4.17,-0.34,1527.46,-20.73,True,1,18468,-1210.85,-3293829.02,22361977.8,19068148.78
2001-07-23,1191.03,-19.82,-1.64,1527.46,-22.02,True,1,18469,-1191.03,-3295020.05,21997133.07,18702113.02
2001-07-24,1171.65,-19.38,-1.63,1527.46,-23.29,True,1,18470,-1171.65,-3296191.7,21640375.5,18344183.8
2001-07-25,1190.49,18.84,1.61,1527.46,-22.06,True,1,18471,-1190.49,-3297382.19,21989540.79,18692158.6
2001-07-26,1202.93,12.44,1.04,1527.46,-21.25,True,1,18472,-1202.93,-3298585.12,22220522.96,18921937.84
2001-07-27,1205.82,2.89,0.24,1527.46,-21.06,True,1,18473,-1205.82,-3299790.94,22275112.86,18975321.92
2001-07-30,1204.52,-1.3,-0.11,1527.46,-21.14,True,1,18474,-1204.52,-3300995.46,22252302.48,18951307.02
2001-07-31,1211.23,6.71,0.56,1527.46,-20.7,True,1,18475,-1211.23,-3302206.69,22377474.25,19075267.56
2001-08-01,1215.93,4.7,0.39,1527.46,-20.4,True,1,18476,-1215.93,-3303422.62,22465522.68,19162100.06
2001-08-02,1220.75,4.82,0.4,1527.46,-20.08,True,1,18477,-1220.75,-3304643.37,22555797.75,19251154.38
2001-08-03,1214.35,-6.4,-0.52,1527.46,-20.5,True,1,18478,-1214.35,-3305857.72,22438759.3,19132901.58
2001-08-06,1200.48,-13.87,-1.14,1527.46,-21.41,True,1,18479,-1200.48,-3307058.2,22183669.92,18876611.72
2001-08-07,1204.4,3.92,0.33,1527.46,-21.15,True,1,18480,-1204.4,-3308262.6,22257312.0,18949049.4
2001-08-08,1183.53,-20.87,-1.73,1527.46,-22.52,True,1,18481,-1183.53,-3309446.13,21872817.93,18563371.8
2001-08-09,1183.43,-0.1,-0.01,1527.46,-22.52,True,1,18482,-1183.43,-3310629.56,21872153.26,18561523.7
2001-08-10,1190.16,6.73,0.57,1527.46,-22.08,True,1,18483,-1190.16,-3311819.72,21997727.28,18685907.56
2001-08-13,1191.29,1.13,0.1,1527.46,-22.01,True,1,18484,-1191.29,-3313011.01,22019804.36,18706793.35
2001-08-14,1186.73,-4.56,-0.38,1527.46,-22.31,True,1,18485,-1186.73,-3314197.74,21936704.05,18622506.31
2001-08-15,1178.02,-8.71,-0.73,1527.46,-22.88,True,1,18486,-1178.02,-3315375.76,21776877.72,18461501.96
2001-08-16,1181.66,3.64,0.31,1527.46,-22.64,True,1,18487,-1181.66,-3316557.42,21845348.42,18528791.0
2001-08-17,1161.97,-19.69,-1.67,1527.46,-23.93,True,1,18488,-1161.97,-3317719.39,21482501.36,18164781.97
2001-08-20,1171.41,9.44,0.81,1527.46,-23.31,True,1,18489,-1171.41,-3318890.8,21658199.49,18339308.69
2001-08-21,1157.26,-14.15,-1.21,1527.46,-24.24,True,1,18490,-1157.26,-3320048.06,21397737.4,18077689.34
2001-08-22,1165.31,8.05,0.7,1527.46,-23.71,True,1,18491,-1165.31,-3321213.37,21547747.21,18226533.84
2001-08-23,1162.09,-3.22,-0.28,1527.46,-23.92,True,1,18492,-1162.09,-3322375.46,21489368.28,18166992.82
2001-08-24,1184.93,22.84,1.96,1527.46,-22.42,True,1,18493,-1184.93,-3323560.39,21912910.49,18589350.1
2001-08-27,1179.21,-5.72,-0.48,1527.46,-22.8,True,1,18494,-1179.21,-3324739.6,21808309.74,18483570.14
2001-08-28,1161.51,-17.7,-1.5,1527.46,-23.96,True,1,18495,-1161.51,-3325901.11,21482127.45,18156226.34
2001-08-29,1148.56,-12.95,-1.12,1527.46,-24.81,True,1,18496,-1148.56,-3327049.67,21243765.76,17916716.09
2001-08-30,1129.03,-19.53,-1.7,1527.46,-26.08,True,1,18497,-1129.03,-3328178.7,20883667.91,17555489.21
2001-08-31,1133.58,4.55,0.4,1527.46,-25.79,True,1,18498,-1133.58,-3329312.28,20968962.84,17639650.56
2001-09-04,1132.94,-0.64,-0.06,1527.46,-25.83,True,1,18499,-1132.94,-3330445.22,20958257.06,17627811.84
2001-09-05,1131.74,-1.2,-0.11,1527.46,-25.91,True,1,18500,-1131.74,-3331576.96,20937190.0,17605613.04
2001-09-06,1106.4,-25.34,-2.24,1527.46,-27.57,True,1,18501,-1106.4,-3332683.36,20469506.4,17136823.04
2001-09-07,1085.78,-20.62,-1.86,1527.46,-28.92,True,1,18502,-1085.78,-3333769.14,20089101.56,16755332.42
2001-09-10,1092.54,6.76,0.62,1527.46,-28.47,True,1,18503,-1092.54,-3334861.68,20215267.62,16880405.94
2001-09-17,1038.77,-53.77,-4.92,1527.46,-31.99,True,1,18504,-1038.77,-3335900.45,19221400.08,15885499.63
2001-09-18,1032.74,-6.03,-0.58,1527.46,-32.39,True,1,18505,-1032.74,-3336933.19,19110853.7,15773920.51
2001-09-19,1016.1,-16.64,-1.61,1527.46,-33.48,True,1,18506,-1016.1,-3337949.29,18803946.6,15465997.31
2001-09-20,984.54,-31.56,-3.11,1527.46,-35.54,True,1,18507,-984.54,-3338933.83,18220881.78,14881947.95
2001-09-21,965.8,-18.74,-1.9,1527.46,-36.77,True,1,18508,-965.8,-3339899.63,17875026.4,14535126.77
2001-09-24,1003.45,37.65,3.9,1527.46,-34.31,True,1,18509,-1003.45,-3340903.08,18572856.05,15231952.97
2001-09-25,1012.27,8.82,0.88,1527.46,-33.73,True,1,18510,-1012.27,-3341915.35,18737117.7,15395202.35
2001-09-26,1007.04,-5.23,-0.52,1527.46,-34.07,True,1,18511,-1007.04,-3342922.39,18641317.44,15298395.05
2001-09-27,1018.61,11.57,1.15,1527.46,-33.31,True,1,18512,-1018.61,-3343941.0,18856508.32,15512567.32
2001-09-28,1040.94,22.33,2.19,1527.46,-31.85,True,1,18513,-1040.94,-3344981.94,19270922.22,15925940.28
2001-10-01,1038.55,-2.39,-0.23,1527.46,-32.01,True,1,18514,-1038.55,-3346020.49,19227714.7,15881694.21
2001-10-02,1051.33,12.78,1.23,1527.46,-31.17,True,1,18515,-1051.33,-3347071.82,19465374.95,16118303.13
2001-10-03,1072.28,20.95,1.99,1527.46,-29.8,True,1,18516,-1072.28,-3348144.1,19854336.48,16506192.38
2001-10-04,1069.63,-2.65,-0.25,1527.46,-29.97,True,1,18517,-1069.63,-3349213.73,19806338.71,16457124.98
2001-10-05,1071.38,1.75,0.16,1527.46,-29.86,True,1,18518,-1071.38,-3350285.11,19839814.84,16489529.73
2001-10-08,1062.44,-8.94,-0.83,1527.46,-30.44,True,1,18519,-1062.44,-3351347.55,19675326.36,16323978.81
2001-10-09,1056.75,-5.69,-0.54,1527.46,-30.82,True,1,18520,-1056.75,-3352404.3,19571010.0,16218605.7
2001-10-10,1080.99,24.24,2.29,1527.46,-29.23,True,1,18521,-1080.99,-3353485.29,20021015.79,16667530.5
2001-10-11,1097.43,16.44,1.52,1527.46,-28.15,True,1,18522,-1097.43,-3354582.72,20326598.46,16972015.74
2001-10-12,1091.65,-5.78,-0.53,1527.46,-28.53,True,1,18523,-1091.65,-3355674.37,20220632.95,16864958.58
2001-10-15,1089.98,-1.67,-0.15,1527.46,-28.64,True,1,18524,-1089.98,-3356764.35,20190789.52,16834025.17
2001-10-16,1097.54,7.56,0.69,1527.46,-28.15,True,1,18525,-1097.54,-3357861.89,20331928.5,16974066.61
2001-10-17,1077.09,-20.45,-1.86,1527.46,-29.48,True,1,18526,-1077.09,-3358938.98,19954169.34,16595230.36
2001-10-18,1068.61,-8.48,-0.79,1527.46,-30.04,True,1,18527,-1068.61,-3360007.59,19798137.47,16438129.88
2001-10-19,1073.48,4.87,0.46,1527.46,-29.72,True,1,18528,-1073.48,-3361081.07,19889437.44,16528356.37
2001-10-22,1089.9,16.42,1.53,1527.46,-28.65,True,1,18529,-1089.9,-3362170.97,20194757.1,16832586.13
2001-10-23,1084.78,-5.12,-0.47,1527.46,-28.98,True,1,18530,-1084.78,-3363255.75,20100973.4,16737717.65
2001-10-24,1085.2,0.42,0.04,1527.46,-28.95,True,1,18531,-1085.2,-3364340.95,20109841.2,16745500.25
2001-10-25,1100.09,14.89,1.37,1527.46,-27.98,True,1,18532,-1100.09,-3365441.04,20386867.88,17021426.84
2001-10-26,1104.61,4.52,0.41,1527.46,-27.68,True,1,18533,-1104.61,-3366545.65,20471737.13,17105191.48
2001-10-29,1078.3,-26.31,-2.38,1527.46,-29.41,True,1,18534,-1078.3,-3367623.95,19985212.2,16617588.25
2001-10-30,1059.79,-18.51,-1.72,1527.46,-30.62,True,1,18535,-1059.79,-3368683.74,19643207.65,16274523.91
2001-10-31,1059.78,-0.01,-0.0,1527.46,-30.62,True,1,18536,-1059.78,-3369743.52,19644082.08,16274338.56
2001-11-01,1084.1,24.32,2.3,1527.46,-29.03,True,1,18537,-1084.1,-3370827.62,20095961.7,16725134.08
2001-11-02,1087.2,3.1,0.29,1527.46,-28.82,True,1,18538,-1087.2,-3371914.82,20154513.6,16782598.78
2001-11-05,1102.84,15.64,1.44,1527.46,-27.8,True,1,18539,-1102.84,-3373017.66,20445550.76,17072533.1
2001-11-06,1118.86,16.02,1.45,1527.46,-26.75,True,1,18540,-1118.86,-3374136.52,20743664.4,17369527.88
2001-11-07,1115.8,-3.06,-0.27,1527.46,-26.95,True,1,18541,-1115.8,-3375252.32,20688047.8,17312795.48
2001-11-08,1118.54,2.74,0.25,1527.46,-26.77,True,1,18542,-1118.54,-3376370.86,20739968.68,17363597.82
2001-11-09,1120.31,1.77,0.16,1527.46,-26.66,True,1,18543,-1120.31,-3377491.17,20773908.33,17396417.16
2001-11-12,1118.33,-1.98,-0.18,1527.46,-26.78,True,1,18544,-1118.33,-3378609.5,20738311.52,17359702.02
2001-11-13,1139.09,20.76,1.86,1527.46,-25.43,True,1,18545,-1139.09,-3379748.59,21124424.05,17744675.46
2001-11-14,1141.21,2.12,0.19,1527.46,-25.29,True,1,18546,-1141.21,-3380889.8,21164880.66,17783990.86
2001-11-15,1142.24,1.03,0.09,1527.46,-25.22,True,1,18547,-1142.24,-3382032.04,21185125.28,17803093.24
2001-11-16,1138.65,-3.59,-0.31,1527.46,-25.46,True,1,18548,-1138.65,-3383170.69,21119680.2,17736509.51
2001-11-19,1151.06,12.41,1.09,1527.46,-24.64,True,1,18549,-1151.06,-3384321.75,21351011.94,17966690.19
2001-11-20,1142.66,-8.4,-0.73,1527.46,-25.19,True,1,18550,-1142.66,-3385464.41,21196343.0,17810878.59
2001-11-21,1137.03,-5.63,-0.49,1527.46,-25.56,True,1,18551,-1137.03,-3386601.44,21093043.53,17706442.09
2001-11-23,1150.34,13.31,1.17,1527.46,-24.69,True,1,18552,-1150.34,-3387751.78,21341107.68,17953355.9
2001-11-26,1157.42,7.08,0.62,1527.46,-24.23,True,1,18553,-1157.42,-3388909.2,21473613.26,18084704.06
2001-11-27,1149.5,-7.92,-0.68,1527.46,-24.74,True,1,18554,-1149.5,-3390058.7,21327823.0,17937764.3
2001-11-28,1128.52,-20.98,-1.82,1527.46,-26.12,True,1,18555,-1128.52,-3391187.22,20939688.6,17548501.38
2001-11-29,1140.2,11.68,1.03,1527.46,-25.35,True,1,18556,-1140.2,-3392327.42,21157551.2,17765223.78
2001-11-30,1139.45,-0.75,-0.07,1527.46,-25.4,True,1,18557,-1139.45,-3393466.87,21144773.65,17751306.78
2001-12-03,1129.9,-9.55,-0.84,1527.46,-26.03,True,1,18558,-1129.9,-3394596.77,20968684.2,17574087.43
2001-12-04,1144.8,14.9,1.32,1527.46,-25.05,True,1,18559,-1144.8,-3395741.57,21246343.2,17850601.63
2001-12-05,1170.35,25.55,2.23,1527.46,-23.38,True,1,18560,-1170.35,-3396911.92,21721696.0,18324784.08
2001-12-06,1167.1,-3.25,-0.28,1527.46,-23.59,True,1,18561,-1167.1,-3398079.02,21662543.1,18264464.08
2001-12-07,1158.31,-8.79,-0.75,1527.46,-24.17,True,1,18562,-1158.31,-3399237.33,21500550.22,18101312.89
2001-12-10,1139.93,-18.38,-1.59,1527.46,-25.37,True,1,18563,-1139.93,-3400377.26,21160520.59,17760143.33
2001-12-11,1136.76,-3.17,-0.28,1527.46,-25.58,True,1,18564,-1136.76,-3401514.02,21102812.64,17701298.62
2001-12-12,1137.07,0.31,0.03,1527.46,-25.56,True,1,18565,-1137.07,-3402651.09,21109704.55,17707053.46
2001-12-13,1119.38,-17.69,-1.56,1527.46,-26.72,True,1,18566,-1119.38,-3403770.47,20782409.08,17378638.61
2001-12-14,1123.09,3.71,0.33,1527.46,-26.47,True,1,18567,-1123.09,-3404893.56,20852412.03,17447518.47
2001-12-17,1134.36,11.27,1.0,1527.46,-25.74,True,1,18568,-1134.36,-3406027.92,21062796.48,17656768.56
2001-12-18,1142.92,8.56,0.76,1527.46,-25.18,True,1,18569,-1142.92,-3407170.84,21222881.48,17815710.64
2001-12-19,1149.56,6.64,0.58,1527.46,-24.74,True,1,18570,-1149.56,-3408320.4,21347329.2,17939008.8
2001-12-20,1139.93,-9.63,-0.84,1527.46,-25.37,True,1,18571,-1139.93,-3409460.33,21169640.03,17760179.7
2001-12-21,1144.89,4.96,0.44,1527.46,-25.05,True,1,18572,-1144.89,-3410605.22,21262897.08,17852291.86
2001-12-24,1144.65,-0.24,-0.02,1527.46,-25.06,True,1,18573,-1144.65,-3411749.87,21259584.45,17847834.58
2001-12-26,1149.37,4.72,0.41,1527.46,-24.75,True,1,18574,-1149.37,-3412899.24,21348398.38,17935499.14
2001-12-27,1157.13,7.76,0.68,1527.46,-24.24,True,1,18575,-1157.13,-3414056.37,21493689.75,18079633.38
2001-12-28,1161.02,3.89,0.34,1527.46,-23.99,True,1,18576,-1161.02,-3415217.39,21567107.52,18151890.13
2001-12-31,1148.08,-12.94,-1.12,1527.46,-24.84,True,1,18577,-1148.08,-3416365.47,21327882.16,17911516.69
2002-01-02,1154.67,6.59,0.57,1527.46,-24.41,True,1,18578,-1154.67,-3417520.14,21451459.26,18033939.12
2002-01-03,1165.27,10.6,0.92,1527.46,-23.71,True,1,18579,-1165.27,-3418685.41,21649551.33,18230865.92
2002-01-04,1172.51,7.24,0.62,1527.46,-23.24,True,1,18580,-1172.51,-3419857.92,21785235.8,18365377.88
2002-01-07,1164.89,-7.62,-0.65,1527.46,-23.74,True,1,18581,-1164.89,-3421022.81,21644821.09,18223798.28
2002-01-08,1160.71,-4.18,-0.36,1527.46,-24.01,True,1,18582,-1160.71,-3422183.52,21568313.22,18146129.7
2002-01-09,1155.14,-5.57,-0.48,1527.46,-24.38,True,1,18583,-1155.14,-3423338.66,21465966.62,18042627.96
2002-01-10,1156.55,1.41,0.12,1527.46,-24.28,True,1,18584,-1156.55,-3424495.21,21493325.2,18068829.99
2002-01-11,1145.6,-10.95,-0.95,1527.46,-25.0,True,1,18585,-1145.6,-3425640.81,21290976.0,17865335.19
2002-01-14,1138.41,-7.19,-0.63,1527.46,-25.47,True,1,18586,-1138.41,-3426779.22,21158488.26,17731709.04
2002-01-15,1146.19,7.78,0.68,1527.46,-24.96,True,1,18587,-1146.19,-3427925.41,21304233.53,17876308.12
2002-01-16,1127.57,-18.62,-1.62,1527.46,-26.18,True,1,18588,-1127.57,-3429052.98,20959271.16,17530218.18
2002-01-17,1138.88,11.31,1.0,1527.46,-25.44,True,1,18589,-1138.88,-3430191.86,21170640.32,17740448.46
2002-01-18,1127.58,-11.3,-0.99,1527.46,-26.18,True,1,18590,-1127.58,-3431319.44,20961712.2,17530392.76
2002-01-22,1119.31,-8.27,-0.73,1527.46,-26.72,True,1,18591,-1119.31,-3432438.75,20809092.21,17376653.46
2002-01-23,1128.18,8.87,0.79,1527.46,-26.14,True,1,18592,-1128.18,-3433566.93,20975122.56,17541555.63
2002-01-24,1132.15,3.97,0.35,1527.46,-25.88,True,1,18593,-1132.15,-3434699.08,21050064.95,17615365.87
2002-01-25,1133.28,1.13,0.1,1527.46,-25.81,True,1,18594,-1133.28,-3435832.36,21072208.32,17636375.96
2002-01-28,1133.06,-0.22,-0.02,1527.46,-25.82,True,1,18595,-1133.06,-3436965.42,21069250.7,17632285.28
2002-01-29,1100.64,-32.42,-2.86,1527.46,-27.94,True,1,18596,-1100.64,-3438066.06,20467501.44,17029435.38
2002-01-30,1113.57,12.93,1.18,1527.46,-27.1,True,1,18597,-1113.57,-3439179.63,20709061.29,17269881.66
2002-01-31,1130.2,16.63,1.49,1527.46,-26.01,True,1,18598,-1130.2,-3440309.83,21019459.6,17579149.77
2002-02-01,1122.2,-8.0,-0.71,1527.46,-26.53,True,1,18599,-1122.2,-3441432.03,20871797.8,17430365.77
2002-02-04,1094.44,-27.76,-2.47,1527.46,-28.35,True,1,18600,-1094.44,-3442526.47,20356584.0,16914057.53
2002-02-05,1090.02,-4.42,-0.4,1527.46,-28.64,True,1,18601,-1090.02,-3443616.49,20275462.02,16831845.53
2002-02-06,1083.51,-6.51,-0.6,1527.46,-29.06,True,1,18602,-1083.51,-3444700.0,20155453.02,16710753.02
2002-02-07,1080.17,-3.34,-0.31,1527.46,-29.28,True,1,18603,-1080.17,-3445780.17,20094402.51,16648622.34
2002-02-08,1096.22,16.05,1.49,1527.46,-28.23,True,1,18604,-1096.22,-3446876.39,20394076.88,16947200.49
2002-02-11,1111.94,15.72,1.43,1527.46,-27.2,True,1,18605,-1111.94,-3447988.33,20687643.7,17239655.37
2002-02-12,1107.5,-4.44,-0.4,1527.46,-27.49,True,1,18606,-1107.5,-3449095.83,20606145.0,17157049.17
2002-02-13,1118.51,11.01,0.99,1527.46,-26.77,True,1,18607,-1118.51,-3450214.34,20812115.57,17361901.23
2002-02-14,1116.48,-2.03,-0.18,1527.46,-26.91,True,1,18608,-1116.48,-3451330.82,20775459.84,17324129.02
2002-02-15,1104.18,-12.3,-1.1,1527.46,-27.71,True,1,18609,-1104.18,-3452435.0,20547685.62,17095250.62
2002-02-19,1083.34,-20.84,-1.89,1527.46,-29.08,True,1,18610,-1083.34,-3453518.34,20160957.4,16707439.06
2002-02-20,1097.98,14.64,1.35,1527.46,-28.12,True,1,18611,-1097.98,-3454616.32,20434505.78,16979889.46
2002-02-21,1080.95,-17.03,-1.55,1527.46,-29.23,True,1,18612,-1080.95,-3455697.27,20118641.4,16662944.13
2002-02-22,1089.84,8.89,0.82,1527.46,-28.65,True,1,18613,-1089.84,-3456787.11,20285191.92,16828404.81
2002-02-25,1109.43,19.59,1.8,1527.46,-27.37,True,1,18614,-1109.43,-3457896.54,20650930.02,17193033.48
2002-02-26,1109.38,-0.05,-0.0,1527.46,-27.37,True,1,18615,-1109.38,-3459005.92,20651108.7,17192102.78
2002-02-27,1109.89,0.51,0.05,1527.46,-27.34,True,1,18616,-1109.89,-3460115.81,20661712.24,17201596.43
2002-02-28,1106.73,-3.16,-0.28,1527.46,-27.54,True,1,18617,-1106.73,-3461222.54,20603992.41,17142769.87
2002-03-01,1131.78,25.05,2.26,1527.46,-25.9,True,1,18618,-1131.78,-3462354.32,21071480.04,17609125.72
2002-03-04,1153.84,22.06,1.95,1527.46,-24.46,True,1,18619,-1153.84,-3463508.16,21483346.96,18019838.8
2002-03-05,1146.14,-7.7,-0.67,1527.46,-24.96,True,1,18620,-1146.14,-3464654.3,21341126.8,17876472.5
2002-03-06,1162.77,16.63,1.45,1527.46,-23.88,True,1,18621,-1162.77,-3465817.07,21651940.17,18186123.1
2002-03-07,1157.54,-5.23,-0.45,1527.46,-24.22,True,1,18622,-1157.54,-3466974.61,21555709.88,18088735.27
2002-03-08,1164.31,6.77,0.58,1527.46,-23.78,True,1,18623,-1164.31,-3468138.92,21682945.13,18214806.21
2002-03-11,1168.26,3.95,0.34,1527.46,-23.52,True,1,18624,-1168.26,-3469307.18,21757674.24,18288367.06
2002-03-12,1165.58,-2.68,-0.23,1527.46,-23.69,True,1,18625,-1165.58,-3470472.76,21708927.5,18238454.74
2002-03-13,1154.09,-11.49,-0.99,1527.46,-24.44,True,1,18626,-1154.09,-3471626.85,21496080.34,18024453.49
2002-03-14,1153.04,-1.05,-0.09,1527.46,-24.51,True,1,18627,-1153.04,-3472779.89,21477676.08,18004896.19
2002-03-15,1166.16,13.12,1.14,1527.46,-23.65,True,1,18628,-1166.16,-3473946.05,21723228.48,18249282.43
2002-03-18,1165.55,-0.61,-0.05,1527.46,-23.69,True,1,18629,-1165.55,-3475111.6,21713030.95,18237919.35
2002-03-19,1170.29,4.74,0.41,1527.46,-23.38,True,1,18630,-1170.29,-3476281.89,21802502.7,18326220.81
2002-03-20,1151.85,-18.44,-1.58,1527.46,-24.59,True,1,18631,-1151.85,-3477433.74,21460117.35,17982683.61
2002-03-21,1153.59,1.74,0.15,1527.46,-24.48,True,1,18632,-1153.59,-3478587.33,21493688.88,18015101.55
2002-03-22,1148.7,-4.89,-0.42,1527.46,-24.8,True,1,18633,-1148.7,-3479736.03,21403727.1,17923991.07
2002-03-25,1131.87,-16.83,-1.46,1527.46,-25.9,True,1,18634,-1131.87,-3480867.9,21091265.58,17610397.68
2002-03-26,1138.49,6.62,0.58,1527.46,-25.46,True,1,18635,-1138.49,-3482006.39,21215761.15,17733754.76
2002-03-27,1144.58,6.09,0.54,1527.46,-25.07,True,1,18636,-1144.58,-3483150.97,21330392.88,17847241.91
2002-03-28,1147.39,2.81,0.25,1527.46,-24.88,True,1,18637,-1147.39,-3484298.36,21383907.43,17899609.07
2002-04-01,1146.54,-0.85,-0.07,1527.46,-24.94,True,1,18638,-1146.54,-3485444.9,21369212.52,17883767.62
2002-04-02,1136.76,-9.78,-0.85,1527.46,-25.58,True,1,18639,-1136.76,-3486581.66,21188069.64,17701487.98
2002-04-03,1125.4,-11.36,-1.0,1527.46,-26.32,True,1,18640,-1125.4,-3487707.06,20977456.0,17489748.94
2002-04-04,1126.34,0.94,0.08,1527.46,-26.26,True,1,18641,-1126.34,-3488833.4,20996103.94,17507270.54
2002-04-05,1122.73,-3.61,-0.32,1527.46,-26.5,True,1,18642,-1122.73,-3489956.13,20929932.66,17439976.53
2002-04-08,1125.29,2.56,0.23,1527.46,-26.33,True,1,18643,-1125.29,-3491081.42,20978781.47,17487700.05
2002-04-09,1117.8,-7.49,-0.67,1527.46,-26.82,True,1,18644,-1117.8,-3492199.22,20840263.2,17348063.98
2002-04-10,1130.47,12.67,1.13,1527.46,-25.99,True,1,18645,-1130.47,-3493329.69,21077613.15,17584283.46
2002-04-11,1103.69,-26.78,-2.37,1527.46,-27.74,True,1,18646,-1103.69,-3494433.38,20579403.74,17084970.36
2002-04-12,1111.01,7.32,0.66,1527.46,-27.26,True,1,18647,-1111.01,-3495544.39,20717003.47,17221459.08
2002-04-15,1102.55,-8.46,-0.76,1527.46,-27.82,True,1,18648,-1102.55,-3496646.94,20560352.4,17063705.46
2002-04-16,1128.37,25.82,2.34,1527.46,-26.13,True,1,18649,-1128.37,-3497775.31,21042972.13,17545196.82
2002-04-17,1126.07,-2.3,-0.2,1527.46,-26.28,True,1,18650,-1126.07,-3498901.38,21001205.5,17502304.12
2002-04-18,1124.47,-1.6,-0.14,1527.46,-26.38,True,1,18651,-1124.47,-3500025.85,20972489.97,17472464.12
2002-04-19,1125.17,0.7,0.06,1527.46,-26.34,True,1,18652,-1125.17,-3501151.02,20986670.84,17485519.82
2002-04-22,1107.83,-17.34,-1.54,1527.46,-27.47,True,1,18653,-1107.83,-3502258.85,20664352.99,17162094.14
2002-04-23,1100.96,-6.87,-0.62,1527.46,-27.92,True,1,18654,-1100.96,-3503359.81,20537307.84,17033948.03
2002-04-24,1093.14,-7.82,-0.71,1527.46,-28.43,True,1,18655,-1093.14,-3504452.95,20392526.7,16888073.75
2002-04-25,1091.48,-1.66,-0.15,1527.46,-28.54,True,1,18656,-1091.48,-3505544.43,20362650.88,16857106.45
2002-04-26,1076.32,-15.16,-1.39,1527.46,-29.54,True,1,18657,-1076.32,-3506620.75,20080902.24,16574281.49
2002-04-29,1065.45,-10.87,-1.01,1527.46,-30.25,True,1,18658,-1065.45,-3507686.2,19879166.1,16371479.9
2002-04-30,1076.92,11.47,1.08,1527.46,-29.5,True,1,18659,-1076.92,-3508763.12,20094250.28,16585487.16
2002-05-01,1086.46,9.54,0.89,1527.46,-28.87,True,1,18660,-1086.46,-3509849.58,20273343.6,16763494.02
2002-05-02,1084.56,-1.9,-0.18,1527.46,-29.0,True,1,18661,-1084.56,-3510934.14,20238974.16,16728040.02
2002-05-03,1073.43,-11.13,-1.03,1527.46,-29.72,True,1,18662,-1073.43,-3512007.57,20032350.66,16520343.09
2002-05-06,1052.67,-20.76,-1.93,1527.46,-31.08,True,1,18663,-1052.67,-3513060.24,19645980.21,16132919.97
2002-05-07,1049.49,-3.18,-0.3,1527.46,-31.29,True,1,18664,-1049.49,-3514109.73,19587681.36,16073571.63
2002-05-08,1088.85,39.36,3.75,1527.46,-28.72,True,1,18665,-1088.85,-3515198.58,20323385.25,16808186.67
2002-05-09,1073.01,-15.84,-1.46,1527.46,-29.75,True,1,18666,-1073.01,-3516271.59,20028804.66,16512533.07
2002-05-10,1054.99,-18.02,-1.68,1527.46,-30.93,True,1,18667,-1054.99,-3517326.58,19693498.33,16176171.75
2002-05-13,1074.56,19.57,1.86,1527.46,-29.65,True,1,18668,-1074.56,-3518401.14,20059886.08,16541484.94
2002-05-14,1097.28,22.72,2.11,1527.46,-28.16,True,1,18669,-1097.28,-3519498.42,20485120.32,16965621.9
2002-05-15,1091.07,-6.21,-0.57,1527.46,-28.57,True,1,18670,-1091.07,-3520589.49,20370276.9,16849687.41
2002-05-16,1098.23,7.16,0.66,1527.46,-28.1,True,1,18671,-1098.23,-3521687.72,20505052.33,16983364.61
2002-05-17,1106.59,8.36,0.76,1527.46,-27.55,True,1,18672,-1106.59,-3522794.31,20662248.48,17139454.17
2002-05-20,1091.88,-14.71,-1.33,1527.46,-28.52,True,1,18673,-1091.88,-3523886.19,20388675.24,16864789.05
2002-05-21,1079.88,-12.0,-1.1,1527.46,-29.3,True,1,18674,-1079.88,-3524966.07,20165679.12,16640713.05
2002-05-22,1086.02,6.14,0.57,1527.46,-28.9,True,1,18675,-1086.02,-3526052.09,20281423.5,16755371.41
2002-05-23,1097.08,11.06,1.02,1527.46,-28.18,True,1,18676,-1097.08,-3527149.17,20489066.08,16961916.91
2002-05-24,1083.82,-13.26,-1.21,1527.46,-29.04,True,1,18677,-1083.82,-3528232.99,20242506.14,16714273.15
2002-05-28,1074.55,-9.27,-0.86,1527.46,-29.65,True,1,18678,-1074.55,-3529307.54,20070444.9,16541137.36
2002-05-29,1067.66,-6.89,-0.64,1527.46,-30.1,True,1,18679,-1067.66,-3530375.2,19942821.14,16412445.94
2002-05-30,1064.66,-3.0,-0.28,1527.46,-30.3,True,1,18680,-1064.66,-3531439.86,19887848.8,16356408.94
2002-05-31,1067.14,2.48,0.23,1527.46,-30.14,True,1,18681,-1067.14,-3532507.0,19935242.34,16402735.34
2002-06-03,1040.68,-26.46,-2.48,1527.46,-31.87,True,1,18682,-1040.68,-3533547.68,19441983.76,15908436.08
2002-06-04,1040.69,0.01,0.0,1527.46,-31.87,True,1,18683,-1040.69,-3534588.37,19443211.27,15908622.9
2002-06-05,1049.9,9.21,0.88,1527.46,-31.26,True,1,18684,-1049.9,-3535638.27,19616331.6,16080693.33
2002-06-06,1029.15,-20.75,-1.98,1527.46,-32.62,True,1,18685,-1029.15,-3536667.42,19229667.75,15693000.33
2002-06-07,1027.53,-1.62,-0.16,1527.46,-32.73,True,1,18686,-1027.53,-3537694.95,19200425.58,15662730.63
2002-06-10,1030.74,3.21,0.31,1527.46,-32.52,True,1,18687,-1030.74,-3538725.69,19261438.38,15722712.69
2002-06-11,1013.6,-17.14,-1.66,1527.46,-33.64,True,1,18688,-1013.6,-3539739.29,18942156.8,15402417.51
2002-06-12,1020.26,6.66,0.66,1527.46,-33.2,True,1,18689,-1020.26,-3540759.55,19067639.14,15526879.59
2002-06-13,1009.56,-10.7,-1.05,1527.46,-33.91,True,1,18690,-1009.56,-3541769.11,18868676.4,15326907.29
2002-06-14,1007.27,-2.29,-0.23,1527.46,-34.06,True,1,18691,-1007.27,-3542776.38,18826883.57,15284107.19
2002-06-17,1036.17,28.9,2.87,1527.46,-32.16,True,1,18692,-1036.17,-3543812.55,19368089.64,15824277.09
2002-06-18,1037.14,0.97,0.09,1527.46,-32.1,True,1,18693,-1037.14,-3544849.69,19387258.02,15842408.33
2002-06-19,1019.99,-17.15,-1.65,1527.46,-33.22,True,1,18694,-1019.99,-3545869.68,19067693.06,15521823.38
2002-06-20,1006.29,-13.7,-1.34,1527.46,-34.12,True,1,18695,-1006.29,-3546875.97,18812591.55,15265715.58
2002-06-21,989.14,-17.15,-1.7,1527.46,-35.24,True,1,18696,-989.14,-3547865.11,18492961.44,14945096.33
2002-06-24,992.72,3.58,0.36,1527.46,-35.01,True,1,18697,-992.72,-3548857.83,18560885.84,15012028.01
2002-06-25,976.14,-16.58,-1.67,1527.46,-36.09,True,1,18698,-976.14,-3549833.97,18251865.72,14702031.75
2002-06-26,973.53,-2.61,-0.27,1527.46,-36.26,True,1,18699,-973.53,-3550807.5,18204037.47,14653229.97
2002-06-27,990.64,17.11,1.76,1527.46,-35.15,True,1,18700,-990.64,-3551798.14,18524968.0,14973169.86
2002-06-28,989.82,-0.82,-0.08,1527.46,-35.2,True,1,18701,-989.82,-3552787.96,18510623.82,14957835.86
2002-07-01,968.65,-21.17,-2.14,1527.46,-36.58,True,1,18702,-968.65,-3553756.61,18115692.3,14561935.69
2002-07-02,948.09,-20.56,-2.12,1527.46,-37.93,True,1,18703,-948.09,-3554704.7,17732127.27,14177422.57
2002-07-03,953.99,5.9,0.62,1527.46,-37.54,True,1,18704,-953.99,-3555658.69,17843428.96,14287770.27
2002-07-05,989.03,35.04,3.67,1527.46,-35.25,True,1,18705,-989.03,-3556647.72,18499806.15,14943158.43
2002-07-08,976.98,-12.05,-1.22,1527.46,-36.04,True,1,18706,-976.98,-3557624.7,18275387.88,14717763.18
2002-07-09,952.83,-24.15,-2.47,1527.46,-37.62,True,1,18707,-952.83,-3558577.53,17824590.81,14266013.28
2002-07-10,920.47,-32.36,-3.4,1527.46,-39.74,True,1,18708,-920.47,-3559498.0,17220152.76,13660654.76
2002-07-11,927.37,6.9,0.75,1527.46,-39.29,True,1,18709,-927.37,-3560425.37,17350165.33,13789739.96
2002-07-12,921.39,-5.98,-0.64,1527.46,-39.68,True,1,18710,-921.39,-3561346.76,17239206.9,13677860.14
2002-07-15,917.93,-3.46,-0.38,1527.46,-39.9,True,1,18711,-917.93,-3562264.69,17175388.23,13613123.54
2002-07-16,900.94,-16.99,-1.85,1527.46,-41.02,True,1,18712,-900.94,-3563165.63,16858389.28,13295223.65
2002-07-17,906.04,5.1,0.57,1527.46,-40.68,True,1,18713,-906.04,-3564071.67,16954726.52,13390654.85
2002-07-18,881.56,-24.48,-2.7,1527.46,-42.29,True,1,18714,-881.56,-3564953.23,16497513.84,12932560.61
2002-07-19,847.75,-33.81,-3.84,1527.46,-44.5,True,1,18715,-847.75,-3565800.98,15865641.25,12299840.27
2002-07-22,819.85,-27.9,-3.29,1527.46,-46.33,True,1,18716,-819.85,-3566620.83,15344312.6,11777691.77
2002-07-23,797.7,-22.15,-2.7,1527.46,-47.78,True,1,18717,-797.7,-3567418.53,14930550.9,11363132.37
2002-07-24,843.43,45.73,5.73,1527.46,-44.78,True,1,18718,-843.43,-3568261.96,15787322.74,12219060.78
2002-07-25,838.68,-4.75,-0.56,1527.46,-45.09,True,1,18719,-838.68,-3569100.64,15699250.92,12130150.28
2002-07-26,852.84,14.16,1.69,1527.46,-44.17,True,1,18720,-852.84,-3569953.48,15965164.8,12395211.32
2002-07-29,898.96,46.12,5.41,1527.46,-41.15,True,1,18721,-898.96,-3570852.44,16829430.16,13258577.72
2002-07-30,902.78,3.82,0.42,1527.46,-40.9,True,1,18722,-902.78,-3571755.22,16901847.16,13330091.94
2002-07-31,911.62,8.84,0.98,1527.46,-40.32,True,1,18723,-911.62,-3572666.84,17068261.26,13495594.42
2002-08-01,884.66,-26.96,-2.96,1527.46,-42.08,True,1,18724,-884.66,-3573551.5,16564373.84,12990822.34
2002-08-02,864.24,-20.42,-2.31,1527.46,-43.42,True,1,18725,-864.24,-3574415.74,16182894.0,12608478.26
2002-08-05,834.6,-29.64,-3.43,1527.46,-45.36,True,1,18726,-834.6,-3575250.34,15628719.6,12053469.26
2002-08-06,859.57,24.97,2.99,1527.46,-43.73,True,1,18727,-859.57,-3576109.91,16097167.39,12521057.48
2002-08-07,876.77,17.2,2.0,1527.46,-42.6,True,1,18728,-876.77,-3576986.68,16420148.56,12843161.88
2002-08-08,905.46,28.69,3.27,1527.46,-40.72,True,1,18729,-905.46,-3577892.14,16958360.34,13380468.2
2002-08-09,908.64,3.18,0.35,1527.46,-40.51,True,1,18730,-908.64,-3578800.78,17018827.2,13440026.42
2002-08-12,903.8,-4.84,-0.53,1527.46,-40.83,True,1,18731,-903.8,-3579704.58,16929077.8,13349373.22
2002-08-13,884.21,-19.59,-2.17,1527.46,-42.11,True,1,18732,-884.21,-3580588.79,16563021.72,12982432.93
2002-08-14,919.62,35.41,4.0,1527.46,-39.79,True,1,18733,-919.62,-3581508.41,17227241.46,13645733.05
2002-08-15,930.25,10.63,1.16,1527.46,-39.1,True,1,18734,-930.25,-3582438.66,17427303.5,13844864.84
2002-08-16,928.77,-1.48,-0.16,1527.46,-39.2,True,1,18735,-928.77,-3583367.43,17400505.95,13817138.52
2002-08-19,950.7,21.93,2.36,1527.46,-37.76,True,1,18736,-950.7,-3584318.13,17812315.2,14227997.07
2002-08-20,937.43,-13.27,-1.4,1527.46,-38.63,True,1,18737,-937.43,-3585255.56,17564625.91,13979370.35
2002-08-21,949.36,11.93,1.27,1527.46,-37.85,True,1,18738,-949.36,-3586204.92,17789107.68,14202902.76
2002-08-22,962.7,13.34,1.4,1527.46,-36.97,True,1,18739,-962.7,-3587167.62,18040035.3,14452867.68
2002-08-23,940.86,-21.84,-2.27,1527.46,-38.4,True,1,18740,-940.86,-3588108.48,17631716.4,14043607.92
2002-08-26,947.95,7.09,0.75,1527.46,-37.94,True,1,18741,-947.95,-3589056.43,17765530.95,14176474.52
2002-08-27,934.82,-13.13,-1.38,1527.46,-38.8,True,1,18742,-934.82,-3589991.25,17520396.44,13930405.19
2002-08-28,917.87,-16.95,-1.81,1527.46,-39.91,True,1,18743,-917.87,-3590909.12,17203637.41,13612728.29
2002-08-29,917.8,-0.07,-0.01,1527.46,-39.91,True,1,18744,-917.8,-3591826.92,17203243.2,13611416.28
2002-08-30,916.07,-1.73,-0.19,1527.46,-40.03,True,1,18745,-916.07,-3592742.99,17171732.15,13578989.16
2002-09-03,878.02,-38.05,-4.15,1527.46,-42.52,True,1,18746,-878.02,-3593621.01,16459362.92,12865741.91
2002-09-04,893.4,15.38,1.75,1527.46,-41.51,True,1,18747,-893.4,-3594514.41,16748569.8,13154055.39
2002-09-05,879.15,-14.25,-1.6,1527.46,-42.44,True,1,18748,-879.15,-3595393.56,16482304.2,12886910.64
2002-09-06,893.92,14.77,1.68,1527.46,-41.48,True,1,18749,-893.92,-3596287.48,16760106.08,13163818.6
2002-09-09,902.96,9.04,1.01,1527.46,-40.88,True,1,18750,-902.96,-3597190.44,16930500.0,13333309.56
2002-09-10,909.58,6.62,0.73,1527.46,-40.45,True,1,18751,-909.58,-3598100.02,17055534.58,13457434.56
2002-09-11,909.45,-0.13,-0.01,1527.46,-40.46,True,1,18752,-909.45,-3599009.47,17054006.4,13454996.93
2002-09-12,886.91,-22.54,-2.48,1527.46,-41.94,True,1,18753,-886.91,-3599896.38,16632223.23,13032326.85
2002-09-13,889.81,2.9,0.33,1527.46,-41.75,True,1,18754,-889.81,-3600786.19,16687496.74,13086710.55
2002-09-16,891.1,1.29,0.14,1527.46,-41.66,True,1,18755,-891.1,-3601677.29,16712580.5,13110903.21
2002-09-17,873.52,-17.58,-1.97,1527.46,-42.81,True,1,18756,-873.52,-3602550.81,16383741.12,12781190.31
2002-09-18,869.46,-4.06,-0.46,1527.46,-43.08,True,1,18757,-869.46,-3603420.27,16308461.22,12705040.95
2002-09-19,843.32,-26.14,-3.01,1527.46,-44.79,True,1,18758,-843.32,-3604263.59,15818996.56,12214732.97
2002-09-20,845.39,2.07,0.24,1527.46,-44.65,True,1,18759,-845.39,-3605108.98,15858671.01,12253562.03
2002-09-23,833.7,-11.69,-1.38,1527.46,-45.42,True,1,18760,-833.7,-3605942.68,15640212.0,12034269.32
2002-09-24,819.29,-14.41,-1.73,1527.46,-46.36,True,1,18761,-819.29,-3606761.97,15370699.69,11763937.72
2002-09-25,839.66,20.37,2.49,1527.46,-45.03,True,1,18762,-839.66,-3607601.63,15753700.92,12146099.29
2002-09-26,854.95,15.29,1.82,1527.46,-44.03,True,1,18763,-854.95,-3608456.58,16041426.85,12432970.27
2002-09-27,827.37,-27.58,-3.23,1527.46,-45.83,True,1,18764,-827.37,-3609283.95,15524770.68,11915486.73
2002-09-30,815.28,-12.09,-1.46,1527.46,-46.62,True,1,18765,-815.28,-3610099.23,15298729.2,11688629.97
2002-10-01,847.91,32.63,4.0,1527.46,-44.49,True,1,18766,-847.91,-3610947.14,15911879.06,12300931.92
2002-10-02,827.91,-20.0,-2.36,1527.46,-45.8,True,1,18767,-827.91,-3611775.05,15537386.97,11925611.92
2002-10-03,818.95,-8.96,-1.08,1527.46,-46.38,True,1,18768,-818.95,-3612594.0,15370053.6,11757459.6
2002-10-04,800.58,-18.37,-2.24,1527.46,-47.59,True,1,18769,-800.58,-3613394.58,15026086.02,11412691.44
2002-10-07,785.28,-15.3,-1.91,1527.46,-48.59,True,1,18770,-785.28,-3614179.86,14739705.6,11125525.74
2002-10-08,798.55,13.27,1.69,1527.46,-47.72,True,1,18771,-798.55,-3614978.41,14989582.05,11374603.64
2002-10-09,776.76,-21.79,-2.73,1527.46,-49.15,True,1,18772,-776.76,-3615755.17,14581338.72,10965583.55
2002-10-10,803.92,27.16,3.5,1527.46,-47.37,True,1,18773,-803.92,-3616559.09,15091990.16,11475431.07
2002-10-11,835.32,31.4,3.91,1527.46,-45.31,True,1,18774,-835.32,-3617394.41,15682297.68,12064903.27
2002-10-14,841.44,6.12,0.73,1527.46,-44.91,True,1,18775,-841.44,-3618235.85,15798036.0,12179800.15
2002-10-15,881.27,39.83,4.73,1527.46,-42.3,True,1,18776,-881.27,-3619117.12,16546725.52,12927608.4
2002-10-16,860.02,-21.25,-2.41,1527.46,-43.7,True,1,18777,-860.02,-3619977.14,16148595.54,12528618.4
2002-10-17,879.2,19.18,2.23,1527.46,-42.44,True,1,18778,-879.2,-3620856.34,16509617.6,12888761.26
2002-10-18,884.39,5.19,0.59,1527.46,-42.1,True,1,18779,-884.39,-3621740.73,16607959.81,12986219.08
2002-10-21,899.72,15.33,1.73,1527.46,-41.1,True,1,18780,-899.72,-3622640.45,16896741.6,13274101.15
2002-10-22,890.16,-9.56,-1.06,1527.46,-41.72,True,1,18781,-890.16,-3623530.61,16718094.96,13094564.35
2002-10-23,896.14,5.98,0.67,1527.46,-41.33,True,1,18782,-896.14,-3624426.75,16831301.48,13206874.73
2002-10-24,882.5,-13.64,-1.52,1527.46,-42.22,True,1,18783,-882.5,-3625309.25,16575997.5,12950688.25
2002-10-25,897.65,15.15,1.72,1527.46,-41.23,True,1,18784,-897.65,-3626206.9,16861457.6,13235250.7
2002-10-28,890.23,-7.42,-0.83,1527.46,-41.72,True,1,18785,-890.23,-3627097.13,16722970.55,13095873.42
2002-10-29,882.15,-8.08,-0.91,1527.46,-42.25,True,1,18786,-882.15,-3627979.28,16572069.9,12944090.62
2002-10-30,890.71,8.56,0.97,1527.46,-41.69,True,1,18787,-890.71,-3628869.99,16733768.77,13104898.78
2002-10-31,885.76,-4.95,-0.56,1527.46,-42.01,True,1,18788,-885.76,-3629755.75,16641658.88,13011903.13
2002-11-01,900.96,15.2,1.72,1527.46,-41.02,True,1,18789,-900.96,-3630656.71,16928137.44,13297480.73
2002-11-04,908.35,7.39,0.82,1527.46,-40.53,True,1,18790,-908.35,-3631565.06,17067896.5,13436331.44
2002-11-05,915.39,7.04,0.78,1527.46,-40.07,True,1,18791,-915.39,-3632480.45,17201093.49,13568613.04
2002-11-06,923.76,8.37,0.91,1527.46,-39.52,True,1,18792,-923.76,-3633404.21,17359297.92,13725893.71
2002-11-07,902.65,-21.11,-2.28,1527.46,-40.9,True,1,18793,-902.65,-3634306.86,16963501.45,13329194.59
2002-11-08,894.74,-7.91,-0.88,1527.46,-41.42,True,1,18794,-894.74,-3635201.6,16815743.56,13180541.96
2002-11-11,876.19,-18.55,-2.07,1527.46,-42.64,True,1,18795,-876.19,-3636077.79,16467991.05,12831913.26
2002-11-12,882.95,6.76,0.77,1527.46,-42.2,True,1,18796,-882.95,-3636960.74,16595928.2,12958967.46
2002-11-13,882.53,-0.42,-0.05,1527.46,-42.22,True,1,18797,-882.53,-3637843.27,16588916.41,12951073.14
2002-11-14,904.27,21.74,2.46,1527.46,-40.8,True,1,18798,-904.27,-3638747.54,16998467.46,13359719.92
2002-11-15,909.83,5.56,0.62,1527.46,-40.44,True,1,18799,-909.83,-3639657.37,17103894.17,13464236.8
2002-11-18,900.36,-9.47,-1.04,1527.46,-41.06,True,1,18800,-900.36,-3640557.73,16926768.0,13286210.27
2002-11-19,896.74,-3.62,-0.4,1527.46,-41.29,True,1,18801,-896.74,-3641454.47,16859608.74,13218154.27
2002-11-20,914.15,17.41,1.94,1527.46,-40.15,True,1,18802,-914.15,-3642368.62,17187848.3,13545479.68
2002-11-21,933.76,19.61,2.14,1527.46,-38.87,True,1,18803,-933.76,-3643302.38,17557489.28,13914186.9
2002-11-22,930.55,-3.21,-0.34,1527.46,-39.08,True,1,18804,-930.55,-3644232.93,17498062.2,13853829.27
2002-11-25,932.87,2.32,0.25,1527.46,-38.93,True,1,18805,-932.87,-3645165.8,17542620.35,13897454.55
2002-11-26,913.31,-19.56,-2.1,1527.46,-40.21,True,1,18806,-913.31,-3646079.11,17175707.86,13529628.75
2002-11-27,938.87,25.56,2.8,1527.46,-38.53,True,1,18807,-938.87,-3647017.98,17657328.09,14010310.11
2002-11-29,936.31,-2.56,-0.27,1527.46,-38.7,True,1,18808,-936.31,-3647954.29,17610118.48,13962164.19
2002-12-02,934.53,-1.78,-0.19,1527.46,-38.82,True,1,18809,-934.53,-3648888.82,17577574.77,13928685.95
2002-12-03,920.75,-13.78,-1.48,1527.46,-39.72,True,1,18810,-920.75,-3649809.57,17319307.5,13669497.93
2002-12-04,917.58,-3.17,-0.34,1527.46,-39.93,True,1,18811,-917.58,-3650727.15,17260597.38,13609870.23
2002-12-05,906.55,-11.03,-1.2,1527.46,-40.65,True,1,18812,-906.55,-3651633.7,17054018.6,13402384.9
2002-12-06,912.23,5.68,0.63,1527.46,-40.28,True,1,18813,-912.23,-3652545.93,17161782.99,13509237.06
2002-12-09,892.0,-20.23,-2.22,1527.46,-41.6,True,1,18814,-892.0,-3653437.93,16782088.0,13128650.07
2002-12-10,904.45,12.45,1.4,1527.46,-40.79,True,1,18815,-904.45,-3654342.38,17017226.75,13362884.37
2002-12-11,904.96,0.51,0.06,1527.46,-40.75,True,1,18816,-904.96,-3655247.34,17027727.36,13372480.02
2002-12-12,901.58,-3.38,-0.37,1527.46,-40.98,True,1,18817,-901.58,-3656148.92,16965030.86,13308881.94
2002-12-13,889.48,-12.1,-1.34,1527.46,-41.77,True,1,18818,-889.48,-3657038.4,16738234.64,13081196.24
2002-12-16,910.4,20.92,2.35,1527.46,-40.4,True,1,18819,-910.4,-3657948.8,17132817.6,13474868.8
2002-12-17,902.99,-7.41,-0.81,1527.46,-40.88,True,1,18820,-902.99,-3658851.79,16994271.8,13335420.01
2002-12-18,891.12,-11.87,-1.32,1527.46,-41.66,True,1,18821,-891.12,-3659742.91,16771769.52,13112026.61
2002-12-19,884.25,-6.87,-0.77,1527.46,-42.11,True,1,18822,-884.25,-3660627.16,16643353.5,12982726.34
2002-12-20,895.76,11.51,1.3,1527.46,-41.36,True,1,18823,-895.76,-3661522.92,16860890.48,13199367.56
2002-12-23,897.38,1.62,0.18,1527.46,-41.25,True,1,18824,-897.38,-3662420.3,16892281.12,13229860.82
2002-12-24,892.47,-4.91,-0.55,1527.46,-41.57,True,1,18825,-892.47,-3663312.77,16800747.75,13137434.98
2002-12-26,889.66,-2.81,-0.32,1527.46,-41.76,True,1,18826,-889.66,-3664202.43,16748739.16,13084536.73
2002-12-27,875.4,-14.26,-1.6,1527.46,-42.69,True,1,18827,-875.4,-3665077.83,16481155.8,12816077.97
2002-12-30,879.39,3.99,0.46,1527.46,-42.43,True,1,18828,-879.39,-3665957.22,16557154.92,12891197.7
2002-12-31,879.82,0.43,0.05,1527.46,-42.4,True,1,18829,-879.82,-3666837.04,16566130.78,12899293.74
2003-01-02,909.03,29.21,3.32,1527.46,-40.49,True,1,18830,-909.03,-3667746.07,17117034.9,13449288.83
2003-01-03,908.59,-0.44,-0.05,1527.46,-40.52,True,1,18831,-908.59,-3668654.66,17109658.29,13441003.63
2003-01-06,929.01,20.42,2.25,1527.46,-39.18,True,1,18832,-929.01,-3669583.67,17495116.32,13825532.65
2003-01-07,922.93,-6.08,-0.65,1527.46,-39.58,True,1,18833,-922.93,-3670506.6,17381540.69,13711034.09
2003-01-08,909.93,-13.0,-1.41,1527.46,-40.43,True,1,18834,-909.93,-3671416.53,17137621.62,13466205.09
2003-01-09,927.57,17.64,1.94,1527.46,-39.27,True,1,18835,-927.57,-3672344.1,17470780.95,13798436.85
2003-01-10,927.57,0.0,0.0,1527.46,-39.27,True,1,18836,-927.57,-3673271.67,17471708.52,13798436.85
2003-01-13,926.26,-1.31,-0.14,1527.46,-39.36,True,1,18837,-926.26,-3674197.93,17447959.62,13773761.69
2003-01-14,931.66,5.4,0.58,1527.46,-39.01,True,1,18838,-931.66,-3675129.59,17550611.08,13875481.49
2003-01-15,918.22,-13.44,-1.44,1527.46,-39.89,True,1,18839,-918.22,-3676047.81,17298346.58,13622298.77
2003-01-16,914.6,-3.62,-0.39,1527.46,-40.12,True,1,18840,-914.6,-3676962.41,17231064.0,13554101.59
2003-01-17,901.78,-12.82,-1.4,1527.46,-40.96,True,1,18841,-901.78,-3677864.19,16990436.98,13312572.79
2003-01-21,887.62,-14.16,-1.57,1527.46,-41.89,True,1,18842,-887.62,-3678751.81,16724536.04,13045784.23
2003-01-22,878.36,-9.26,-1.04,1527.46,-42.5,True,1,18843,-878.36,-3679630.17,16550937.48,12871307.31
2003-01-23,887.34,8.98,1.02,1527.46,-41.91,True,1,18844,-887.34,-3680517.51,16721034.96,13040517.45
2003-01-24,861.4,-25.94,-2.92,1527.46,-43.61,True,1,18845,-861.4,-3681378.91,16233083.0,12551704.09
2003-01-27,847.48,-13.92,-1.62,1527.46,-44.52,True,1,18846,-847.48,-3682226.39,15971608.08,12289381.69
2003-01-28,858.54,11.06,1.3,1527.46,-43.79,True,1,18847,-858.54,-3683084.93,16180903.38,12497818.45
2003-01-29,864.36,5.82,0.68,1527.46,-43.41,True,1,18848,-864.36,-3683949.29,16291457.28,12607507.99
2003-01-30,844.61,-19.75,-2.28,1527.46,-44.7,True,1,18849,-844.61,-3684793.9,15920053.89,12235259.99
2003-01-31,855.7,11.09,1.31,1527.46,-43.98,True,1,18850,-855.7,-3685649.6,16129945.0,12444295.4
2003-02-03,860.32,4.62,0.54,1527.46,-43.68,True,1,18851,-860.32,-3686509.92,16217892.32,12531382.4
2003-02-04,848.2,-12.12,-1.41,1527.46,-44.47,True,1,18852,-848.2,-3687358.12,15990266.4,12302908.28
2003-02-05,843.59,-4.61,-0.54,1527.46,-44.77,True,1,18853,-843.59,-3688201.71,15904202.27,12216000.56
2003-02-06,838.15,-5.44,-0.64,1527.46,-45.13,True,1,18854,-838.15,-3689039.86,15802480.1,12113440.24
2003-02-07,829.69,-8.46,-1.01,1527.46,-45.68,True,1,18855,-829.69,-3689869.55,15643804.95,11953935.4
2003-02-10,835.97,6.28,0.76,1527.46,-45.27,True,1,18856,-835.97,-3690705.52,15763050.32,12072344.8
2003-02-11,829.2,-6.77,-0.81,1527.46,-45.71,True,1,18857,-829.2,-3691534.72,15636224.4,11944689.68
2003-02-12,818.68,-10.52,-1.27,1527.46,-46.4,True,1,18858,-818.68,-3692353.4,15438667.44,11746314.04
2003-02-13,817.37,-1.31,-0.16,1527.46,-46.49,True,1,18859,-817.37,-3693170.77,15414780.83,11721610.06
2003-02-14,834.89,17.52,2.14,1527.46,-45.34,True,1,18860,-834.89,-3694005.66,15746025.4,12052019.74
2003-02-18,851.17,16.28,1.95,1527.46,-44.28,True,1,18861,-851.17,-3694856.83,16053917.37,12359060.54
2003-02-19,845.13,-6.04,-0.71,1527.46,-44.67,True,1,18862,-845.13,-3695701.96,15940842.06,12245140.1
2003-02-20,837.1,-8.03,-0.95,1527.46,-45.2,True,1,18863,-837.1,-3696539.06,15790217.3,12093678.24
2003-02-21,848.17,11.07,1.32,1527.46,-44.47,True,1,18864,-848.17,-3697387.23,15999878.88,12302491.65
2003-02-24,832.58,-15.59,-1.84,1527.46,-45.49,True,1,18865,-832.58,-3698219.81,15706621.7,12008401.89
2003-02-25,838.57,5.99,0.72,1527.46,-45.1,True,1,18866,-838.57,-3699058.38,15820461.62,12121403.24
2003-02-26,827.55,-11.02,-1.31,1527.46,-45.82,True,1,18867,-827.55,-3699885.93,15613385.85,11913499.92
2003-02-27,837.28,9.73,1.18,1527.46,-45.18,True,1,18868,-837.28,-3700723.21,15797799.04,12097075.83
2003-02-28,841.15,3.87,0.46,1527.46,-44.93,True,1,18869,-841.15,-3701564.36,15871659.35,12170094.99
2003-03-03,834.81,-6.34,-0.75,1527.46,-45.35,True,1,18870,-834.81,-3702399.17,15752864.7,12050465.53
2003-03-04,821.99,-12.82,-1.54,1527.46,-46.19,True,1,18871,-821.99,-3703221.16,15511773.29,11808552.13
2003-03-05,829.85,7.86,0.96,1527.46,-45.67,True,1,18872,-829.85,-3704051.01,15660929.2,11956878.19
2003-03-06,822.1,-7.75,-0.93,1527.46,-46.18,True,1,18873,-822.1,-3704873.11,15515493.3,11810620.19
2003-03-07,828.89,6.79,0.83,1527.46,-45.73,True,1,18874,-828.89,-3705702.0,15644469.86,11938767.86
2003-03-10,807.48,-21.41,-2.58,1527.46,-47.14,True,1,18875,-807.48,-3706509.48,15241185.0,11534675.52
2003-03-11,800.73,-6.75,-0.84,1527.46,-47.58,True,1,18876,-800.73,-3707310.21,15114579.48,11407269.27
2003-03-12,804.19,3.46,0.43,1527.46,-47.35,True,1,18877,-804.19,-3708114.4,15180694.63,11472580.23
2003-03-13,831.9,27.71,3.45,1527.46,-45.54,True,1,18878,-831.9,-3708946.3,15704608.2,11995661.9
2003-03-14,833.27,1.37,0.16,1527.46,-45.45,True,1,18879,-833.27,-3709779.57,15731304.33,12021524.76
2003-03-17,862.79,29.52,3.54,1527.46,-43.52,True,1,18880,-862.79,-3710642.36,16289475.2,12578832.84
2003-03-18,866.45,3.66,0.42,1527.46,-43.28,True,1,18881,-866.45,-3711508.81,16359442.45,12647933.64
2003-03-19,874.02,7.57,0.87,1527.46,-42.78,True,1,18882,-874.02,-3712382.83,16503245.64,12790862.81
2003-03-20,875.67,1.65,0.19,1527.46,-42.67,True,1,18883,-875.67,-3713258.5,16535276.61,12822018.11
2003-03-21,895.79,20.12,2.3,1527.46,-41.35,True,1,18884,-895.79,-3714154.29,16916098.36,13201944.07
2003-03-24,864.23,-31.56,-3.52,1527.46,-43.42,True,1,18885,-864.23,-3715018.52,16320983.55,12605965.03
2003-03-25,874.74,10.51,1.22,1527.46,-42.73,True,1,18886,-874.74,-3715893.26,16520339.64,12804446.38
2003-03-26,869.95,-4.79,-0.55,1527.46,-43.05,True,1,18887,-869.95,-3716763.21,16430745.65,12713982.44
2003-03-27,868.52,-1.43,-0.16,1527.46,-43.14,True,1,18888,-868.52,-3717631.73,16404605.76,12686974.03
2003-03-28,863.5,-5.02,-0.58,1527.46,-43.47,True,1,18889,-863.5,-3718495.23,16310651.5,12592156.27
2003-03-31,848.18,-15.32,-1.77,1527.46,-44.47,True,1,18890,-848.18,-3719343.41,16022120.2,12302776.79
2003-04-01,858.48,10.3,1.21,1527.46,-43.8,True,1,18891,-858.48,-3720201.89,16217545.68,12497343.79
2003-04-02,880.9,22.42,2.61,1527.46,-42.33,True,1,18892,-880.9,-3721082.79,16641962.8,12920880.01
2003-04-03,876.45,-4.45,-0.5,1527.46,-42.62,True,1,18893,-876.45,-3721959.24,16558769.85,12836810.61
2003-04-04,878.85,2.4,0.27,1527.46,-42.46,True,1,18894,-878.85,-3722838.09,16604991.9,12882153.81
2003-04-07,879.93,1.08,0.12,1527.46,-42.39,True,1,18895,-879.93,-3723718.02,16626277.35,12902559.33
2003-04-08,878.29,-1.64,-0.19,1527.46,-42.5,True,1,18896,-878.29,-3724596.31,16596167.84,12871571.53
2003-04-09,865.99,-12.3,-1.4,1527.46,-43.3,True,1,18897,-865.99,-3725462.3,16364613.03,12639150.73
2003-04-10,871.58,5.59,0.65,1527.46,-42.94,True,1,18898,-871.58,-3726333.88,16471118.84,12744784.96
2003-04-11,868.3,-3.28,-0.38,1527.46,-43.15,True,1,18899,-868.3,-3727202.18,16410001.7,12682799.52
2003-04-14,885.23,16.93,1.95,1527.46,-42.05,True,1,18900,-885.23,-3728087.41,16730847.0,13002759.59
2003-04-15,890.81,5.58,0.63,1527.46,-41.68,True,1,18901,-890.81,-3728978.22,16837199.81,13108221.59
2003-04-16,879.91,-10.9,-1.22,1527.46,-42.39,True,1,18902,-879.91,-3729858.13,16632058.82,12902200.69
2003-04-17,893.58,13.67,1.55,1527.46,-41.5,True,1,18903,-893.58,-3730751.71,16891342.74,13160591.03
2003-04-21,892.01,-1.57,-0.18,1527.46,-41.6,True,1,18904,-892.01,-3731643.72,16862557.04,13130913.32
2003-04-22,911.37,19.36,2.17,1527.46,-40.33,True,1,18905,-911.37,-3732555.09,17229449.85,13496894.76
2003-04-23,919.02,7.65,0.84,1527.46,-39.83,True,1,18906,-919.02,-3733474.11,17374992.12,13641518.01
2003-04-24,911.43,-7.59,-0.83,1527.46,-40.33,True,1,18907,-911.43,-3734385.54,17232407.01,13498021.47
2003-04-25,898.81,-12.62,-1.38,1527.46,-41.16,True,1,18908,-898.81,-3735284.35,16994699.48,13259415.13
2003-04-28,914.84,16.03,1.78,1527.46,-40.11,True,1,18909,-914.84,-3736199.19,17298709.56,13562510.37
2003-04-29,917.84,3.0,0.33,1527.46,-39.91,True,1,18910,-917.84,-3737117.03,17356354.4,13619237.37
2003-04-30,916.92,-0.92,-0.1,1527.46,-39.97,True,1,18911,-916.92,-3738033.95,17339874.12,13601840.17
2003-05-01,916.3,-0.62,-0.07,1527.46,-40.01,True,1,18912,-916.3,-3738950.25,17329065.6,13590115.35
2003-05-02,930.08,13.78,1.5,1527.46,-39.11,True,1,18913,-930.08,-3739880.33,17590603.04,13850722.71
2003-05-05,926.55,-3.53,-0.38,1527.46,-39.34,True,1,18914,-926.55,-3740806.88,17524766.7,13783959.82
2003-05-06,934.39,7.84,0.85,1527.46,-38.83,True,1,18915,-934.39,-3741741.27,17673986.85,13932245.58
2003-05-07,929.62,-4.77,-0.51,1527.46,-39.14,True,1,18916,-929.62,-3742670.89,17584691.92,13842021.03
2003-05-08,920.27,-9.35,-1.01,1527.46,-39.75,True,1,18917,-920.27,-3743591.16,17408747.59,13665156.43
2003-05-09,933.41,13.14,1.43,1527.46,-38.89,True,1,18918,-933.41,-3744524.57,17658250.38,13913725.81
2003-05-12,945.11,11.7,1.25,1527.46,-38.12,True,1,18919,-945.11,-3745469.68,17880536.09,14135066.41
2003-05-13,942.3,-2.81,-0.3,1527.46,-38.31,True,1,18920,-942.3,-3746411.98,17828316.0,14081904.02
2003-05-14,939.28,-3.02,-0.32,1527.46,-38.51,True,1,18921,-939.28,-3747351.26,17772116.88,14024765.62
2003-05-15,946.67,7.39,0.79,1527.46,-38.02,True,1,18922,-946.67,-3748297.93,17912889.74,14164591.81
2003-05-16,944.3,-2.37,-0.25,1527.46,-38.18,True,1,18923,-944.3,-3749242.23,17868988.9,14119746.67
2003-05-19,920.77,-23.53,-2.49,1527.46,-39.72,True,1,18924,-920.77,-3750163.0,17424651.48,13674488.48
2003-05-20,919.73,-1.04,-0.11,1527.46,-39.79,True,1,18925,-919.73,-3751082.73,17405890.25,13654807.52
2003-05-21,923.42,3.69,0.4,1527.46,-39.54,True,1,18926,-923.42,-3752006.15,17476646.92,13724640.77
2003-05-22,931.87,8.45,0.92,1527.46,-38.99,True,1,18927,-931.87,-3752938.02,17637503.49,13884565.47
2003-05-23,933.22,1.35,0.14,1527.46,-38.9,True,1,18928,-933.22,-3753871.24,17663988.16,13910116.92
2003-05-27,951.48,18.26,1.96,1527.46,-37.71,True,1,18929,-951.48,-3754822.72,18010564.92,14255742.2
2003-05-28,953.22,1.74,0.18,1527.46,-37.59,True,1,18930,-953.22,-3755775.94,18044454.6,14288678.66
2003-05-29,949.64,-3.58,-0.38,1527.46,-37.83,True,1,18931,-949.64,-3756725.58,17977634.84,14220909.26
2003-05-30,963.59,13.95,1.47,1527.46,-36.92,True,1,18932,-963.59,-3757689.17,18242685.88,14484996.71
2003-06-02,967.0,3.41,0.35,1527.46,-36.69,True,1,18933,-967.0,-3758656.17,18308211.0,14549554.83
2003-06-03,971.56,4.56,0.47,1527.46,-36.39,True,1,18934,-971.56,-3759627.73,18395517.04,14635889.31
2003-06-04,986.24,14.68,1.51,1527.46,-35.43,True,1,18935,-986.24,-3760613.97,18674454.4,14913840.43
2003-06-05,990.14,3.9,0.4,1527.46,-35.18,True,1,18936,-990.14,-3761604.11,18749291.04,14987686.93
2003-06-06,987.76,-2.38,-0.24,1527.46,-35.33,True,1,18937,-987.76,-3762591.87,18705211.12,14942619.25
2003-06-09,975.93,-11.83,-1.2,1527.46,-36.11,True,1,18938,-975.93,-3763567.8,18482162.34,14718594.54
2003-06-10,984.84,8.91,0.91,1527.46,-35.52,True,1,18939,-984.84,-3764552.64,18651884.76,14887332.12
2003-06-11,997.48,12.64,1.28,1527.46,-34.7,True,1,18940,-997.48,-3765550.12,18892271.2,15126721.08
2003-06-12,998.51,1.03,0.1,1527.46,-34.63,True,1,18941,-998.51,-3766548.63,18912777.91,15146229.28
2003-06-13,988.61,-9.9,-0.99,1527.46,-35.28,True,1,18942,-988.61,-3767537.24,18726250.62,14958713.38
2003-06-16,1010.74,22.13,2.24,1527.46,-33.83,True,1,18943,-1010.74,-3768547.98,19146447.82,15377899.84
2003-06-17,1011.66,0.92,0.09,1527.46,-33.77,True,1,18944,-1011.66,-3769559.64,19164887.04,15395327.4
2003-06-18,1010.09,-1.57,-0.16,1527.46,-33.87,True,1,18945,-1010.09,-3770569.73,19136155.05,15365585.32
2003-06-19,994.7,-15.39,-1.52,1527.46,-34.88,True,1,18946,-994.7,-3771564.43,18845586.2,15074021.77
2003-06-20,995.69,0.99,0.1,1527.46,-34.81,True,1,18947,-995.69,-3772560.12,18865338.43,15092778.31
2003-06-23,981.64,-14.05,-1.41,1527.46,-35.73,True,1,18948,-981.64,-3773541.76,18600114.72,14826572.96
2003-06-24,983.45,1.81,0.18,1527.46,-35.62,True,1,18949,-983.45,-3774525.21,18635394.05,14860868.84
2003-06-25,975.32,-8.13,-0.83,1527.46,-36.15,True,1,18950,-975.32,-3775500.53,18482314.0,14706813.47
2003-06-26,985.82,10.5,1.08,1527.46,-35.46,True,1,18951,-985.82,-3776486.35,18682274.82,14905788.47
2003-06-27,976.22,-9.6,-0.97,1527.46,-36.09,True,1,18952,-976.22,-3777462.57,18501321.44,14723858.87
2003-06-30,974.5,-1.72,-0.18,1527.46,-36.2,True,1,18953,-974.5,-3778437.07,18469698.5,14691261.43
2003-07-01,982.32,7.82,0.8,1527.46,-35.69,True,1,18954,-982.32,-3779419.39,18618893.28,14839473.89
2003-07-02,993.75,11.43,1.16,1527.46,-34.94,True,1,18955,-993.75,-3780413.14,18836531.25,15056118.11
2003-07-03,985.7,-8.05,-0.81,1527.46,-35.47,True,1,18956,-985.7,-3781398.84,18684929.2,14903530.36
2003-07-07,1004.42,18.72,1.9,1527.46,-34.24,True,1,18957,-1004.42,-3782403.26,19040789.94,15258386.68
2003-07-08,1007.84,3.42,0.34,1527.46,-34.02,True,1,18958,-1007.84,-3783411.1,19106630.72,15323219.62
2003-07-09,1002.21,-5.63,-0.56,1527.46,-34.39,True,1,18959,-1002.21,-3784413.31,19000899.39,15216486.08
2003-07-10,988.7,-13.51,-1.35,1527.46,-35.27,True,1,18960,-988.7,-3785402.01,18745752.0,14960349.99
2003-07-11,998.14,9.44,0.96,1527.46,-34.65,True,1,18961,-998.14,-3786400.15,18925732.54,15139332.39
2003-07-14,1003.86,5.72,0.57,1527.46,-34.28,True,1,18962,-1003.86,-3787404.01,19035193.32,15247789.31
2003-07-15,1000.42,-3.44,-0.34,1527.46,-34.5,True,1,18963,-1000.42,-3788404.43,18970964.46,15182560.03
2003-07-16,994.09,-6.33,-0.63,1527.46,-34.92,True,1,18964,-994.09,-3789398.52,18851922.76,15062524.24
2003-07-17,981.73,-12.36,-1.24,1527.46,-35.73,True,1,18965,-981.73,-3790380.25,18618509.45,14828129.2
2003-07-18,993.32,11.59,1.18,1527.46,-34.97,True,1,18966,-993.32,-3791373.57,18839307.12,15047933.55
2003-07-21,978.8,-14.52,-1.46,1527.46,-35.92,True,1,18967,-978.8,-3792352.37,18564899.6,14772547.23
2003-07-22,988.11,9.31,0.95,1527.46,-35.31,True,1,18968,-988.11,-3793340.48,18742470.48,14949130.0
2003-07-23,988.61,0.5,0.05,1527.46,-35.28,True,1,18969,-988.61,-3794329.09,18752943.09,14958614.0
2003-07-24,981.6,-7.01,-0.71,1527.46,-35.74,True,1,18970,-981.6,-3795310.69,18620952.0,14825641.31
2003-07-25,998.68,17.08,1.74,1527.46,-34.62,True,1,18971,-998.68,-3796309.37,18945958.28,15149648.91
2003-07-28,996.52,-2.16,-0.22,1527.46,-34.76,True,1,18972,-996.52,-3797305.89,18905977.44,15108671.55
2003-07-29,989.28,-7.24,-0.73,1527.46,-35.23,True,1,18973,-989.28,-3798295.17,18769609.44,14971314.27
2003-07-30,987.49,-1.79,-0.18,1527.46,-35.35,True,1,18974,-987.49,-3799282.66,18736635.26,14937352.6
2003-07-31,990.31,2.82,0.29,1527.46,-35.17,True,1,18975,-990.31,-3800272.97,18791132.25,14990859.28
2003-08-01,980.15,-10.16,-1.03,1527.46,-35.83,True,1,18976,-980.15,-3801253.12,18599326.4,14798073.28
2003-08-04,982.82,2.67,0.27,1527.46,-35.66,True,1,18977,-982.82,-3802235.94,18650975.14,14848739.2
2003-08-05,965.46,-17.36,-1.77,1527.46,-36.79,True,1,18978,-965.46,-3803201.4,18322499.88,14519298.48
2003-08-06,967.08,1.62,0.17,1527.46,-36.69,True,1,18979,-967.08,-3804168.48,18354211.32,14550042.84
2003-08-07,974.12,7.04,0.73,1527.46,-36.23,True,1,18980,-974.12,-3805142.6,18488797.6,14683655.0
2003-08-08,977.59,3.47,0.36,1527.46,-36.0,True,1,18981,-977.59,-3806120.19,18555635.79,14749515.6
2003-08-11,980.59,3.0,0.31,1527.46,-35.8,True,1,18982,-980.59,-3807100.78,18613559.38,14806458.6
2003-08-12,990.35,9.76,1.0,1527.46,-35.16,True,1,18983,-990.35,-3808091.13,18799814.05,14991722.92
2003-08-13,984.03,-6.32,-0.64,1527.46,-35.58,True,1,18984,-984.03,-3809075.16,18680825.52,14871750.36
2003-08-14,990.51,6.48,0.66,1527.46,-35.15,True,1,18985,-990.51,-3810065.67,18804832.35,14994766.68
2003-08-15,990.67,0.16,0.02,1527.46,-35.14,True,1,18986,-990.67,-3811056.34,18808860.62,14997804.28
2003-08-18,999.74,9.07,0.92,1527.46,-34.55,True,1,18987,-999.74,-3812056.08,18982063.38,15170007.3
2003-08-19,1002.35,2.61,0.26,1527.46,-34.38,True,1,18988,-1002.35,-3813058.43,19032621.8,15219563.37
2003-08-20,1000.3,-2.05,-0.2,1527.46,-34.51,True,1,18989,-1000.3,-3814058.73,18994696.7,15180637.97
2003-08-21,1003.27,2.97,0.3,1527.46,-34.32,True,1,18990,-1003.27,-3815062.0,19052097.3,15237035.3
2003-08-22,993.06,-10.21,-1.02,1527.46,-34.99,True,1,18991,-993.06,-3816055.06,18859202.46,15043147.4
2003-08-25,993.71,0.65,0.06,1527.46,-34.94,True,1,18992,-993.71,-3817048.77,18872540.32,15055491.55
2003-08-26,996.73,3.02,0.3,1527.46,-34.75,True,1,18993,-996.73,-3818045.5,18930892.89,15112847.39
2003-08-27,996.79,0.06,0.01,1527.46,-34.74,True,1,18994,-996.79,-3819042.29,18933029.26,15113986.97
2003-08-28,1002.84,6.05,0.61,1527.46,-34.35,True,1,18995,-1002.84,-3820045.13,19048945.8,15228900.67
2003-08-29,1008.01,5.17,0.52,1527.46,-34.01,True,1,18996,-1008.01,-3821053.14,19148157.96,15327104.82
2003-09-02,1021.99,13.98,1.39,1527.46,-33.09,True,1,18997,-1021.99,-3822075.13,19414744.03,15592668.9
2003-09-03,1026.27,4.28,0.42,1527.46,-32.81,True,1,18998,-1026.27,-3823101.4,19497077.46,15673976.06
2003-09-04,1027.97,1.7,0.17,1527.46,-32.7,True,1,18999,-1027.97,-3824129.37,19530402.03,15706272.66
2003-09-05,1021.39,-6.58,-0.64,1527.46,-33.13,True,1,19000,-1021.39,-3825150.76,19406410.0,15581259.24
2003-09-08,1031.64,10.25,1.0,1527.46,-32.46,True,1,19001,-1031.64,-3826182.4,19602191.64,15776009.24
2003-09-09,1023.17,-8.47,-0.82,1527.46,-33.02,True,1,19002,-1023.17,-3827205.57,19442276.34,15615070.77
2003-09-10,1010.92,-12.25,-1.2,1527.46,-33.82,True,1,19003,-1010.92,-3828216.49,19210512.76,15382296.27
2003-09-11,1016.42,5.5,0.54,1527.46,-33.46,True,1,19004,-1016.42,-3829232.91,19316045.68,15486812.77
2003-09-12,1018.63,2.21,0.22,1527.46,-33.31,True,1,19005,-1018.63,-3830251.54,19359063.15,15528811.61
2003-09-15,1014.81,-3.82,-0.38,1527.46,-33.56,True,1,19006,-1014.81,-3831266.35,19287478.86,15456212.51
2003-09-16,1029.32,14.51,1.43,1527.46,-32.61,True,1,19007,-1029.32,-3832295.67,19564285.24,15731989.57
2003-09-17,1025.97,-3.35,-0.32,1527.46,-32.83,True,1,19008,-1025.97,-3833321.64,19501637.76,15668316.12
2003-09-18,1039.58,13.61,1.33,1527.46,-31.94,True,1,19009,-1039.58,-3834361.22,19761376.22,15927015.0
2003-09-19,1036.3,-3.28,-0.32,1527.46,-32.16,True,1,19010,-1036.3,-3835397.52,19700063.0,15864665.48
2003-09-22,1022.82,-13.48,-1.3,1527.46,-33.04,True,1,19011,-1022.82,-3836420.34,19444831.02,15608410.68
2003-09-23,1029.03,6.21,0.61,1527.46,-32.63,True,1,19012,-1029.03,-3837449.37,19563918.36,15726468.99
2003-09-24,1009.38,-19.65,-1.91,1527.46,-33.92,True,1,19013,-1009.38,-3838458.75,19191341.94,15352883.19
2003-09-25,1003.27,-6.11,-0.6,1527.46,-34.32,True,1,19014,-1003.27,-3839462.02,19076175.78,15236713.76
2003-09-26,996.85,-6.42,-0.64,1527.46,-34.74,True,1,19015,-996.85,-3840458.87,18955102.75,15114643.88
2003-09-29,1006.58,9.73,0.98,1527.46,-34.1,True,1,19016,-1006.58,-3841465.45,19141125.28,15299659.83
2003-09-30,995.97,-10.61,-1.05,1527.46,-34.8,True,1,19017,-995.97,-3842461.42,18940361.49,15097900.07
2003-10-01,1018.22,22.25,2.23,1527.46,-33.34,True,1,19018,-1018.22,-3843479.64,19364507.96,15521028.32
2003-10-02,1020.24,2.02,0.2,1527.46,-33.21,True,1,19019,-1020.24,-3844499.88,19403944.56,15559444.68
2003-10-03,1029.85,9.61,0.94,1527.46,-32.58,True,1,19020,-1029.85,-3845529.73,19587747.0,15742217.27
2003-10-06,1034.35,4.5,0.44,1527.46,-32.28,True,1,19021,-1034.35,-3846564.08,19674371.35,15827807.27
2003-10-07,1039.25,4.9,0.47,1527.46,-31.96,True,1,19022,-1039.25,-3847603.33,19768613.5,15921010.17
2003-10-08,1033.78,-5.47,-0.53,1527.46,-32.32,True,1,19023,-1033.78,-3848637.11,19665596.94,15816959.83
2003-10-09,1038.73,4.95,0.48,1527.46,-32.0,True,1,19024,-1038.73,-3849675.84,19760799.52,15911123.68
2003-10-10,1038.06,-0.67,-0.06,1527.46,-32.04,True,1,19025,-1038.06,-3850713.9,19749091.5,15898377.6
2003-10-13,1045.35,7.29,0.7,1527.46,-31.56,True,1,19026,-1045.35,-3851759.25,19888829.1,16037069.85
2003-10-14,1049.48,4.13,0.4,1527.46,-31.29,True,1,19027,-1049.48,-3852808.73,19968455.96,16115647.23
2003-10-15,1046.76,-2.72,-0.26,1527.46,-31.47,True,1,19028,-1046.76,-3853855.49,19917749.28,16063893.79
2003-10-16,1050.07,3.31,0.32,1527.46,-31.25,True,1,19029,-1050.07,-3854905.56,19981782.03,16126876.47
2003-10-17,1039.32,-10.75,-1.02,1527.46,-31.96,True,1,19030,-1039.32,-3855944.88,19778259.6,15922314.72
2003-10-20,1044.68,5.36,0.52,1527.46,-31.61,True,1,19031,-1044.68,-3856989.56,19881305.08,16024315.52
2003-10-21,1046.03,1.35,0.13,1527.46,-31.52,True,1,19032,-1046.03,-3858035.59,19908042.96,16050007.37
2003-10-22,1030.36,-15.67,-1.5,1527.46,-32.54,True,1,19033,-1030.36,-3859065.95,19610841.88,15751775.93
2003-10-23,1033.77,3.41,0.33,1527.46,-32.32,True,1,19034,-1033.77,-3860099.72,19676778.18,15816678.46
2003-10-24,1028.91,-4.86,-0.47,1527.46,-32.64,True,1,19035,-1028.91,-3861128.63,19585301.85,15724173.22
2003-10-27,1031.13,2.22,0.22,1527.46,-32.49,True,1,19036,-1031.13,-3862159.76,19628590.68,15766430.92
2003-10-28,1046.79,15.66,1.52,1527.46,-31.47,True,1,19037,-1046.79,-3863206.55,19927741.23,16064534.68
2003-10-29,1048.11,1.32,0.13,1527.46,-31.38,True,1,19038,-1048.11,-3864254.66,19953918.18,16089663.52
2003-10-30,1046.94,-1.17,-0.11,1527.46,-31.46,True,1,19039,-1046.94,-3865301.6,19932690.66,16067389.06
2003-10-31,1050.71,3.77,0.36,1527.46,-31.21,True,1,19040,-1050.71,-3866352.31,20005518.4,16139166.09
2003-11-03,1059.02,8.31,0.79,1527.46,-30.67,True,1,19041,-1059.02,-3867411.33,20164799.82,16297388.49
2003-11-04,1053.25,-5.77,-0.55,1527.46,-31.05,True,1,19042,-1053.25,-3868464.58,20055986.5,16187521.92
2003-11-05,1051.81,-1.44,-0.14,1527.46,-31.14,True,1,19043,-1051.81,-3869516.39,20029617.83,16160101.44
2003-11-06,1058.05,6.24,0.59,1527.46,-30.73,True,1,19044,-1058.05,-3870574.44,20149504.2,16278929.76
2003-11-07,1053.21,-4.84,-0.46,1527.46,-31.05,True,1,19045,-1053.21,-3871627.65,20058384.45,16186756.8
2003-11-10,1047.11,-6.1,-0.58,1527.46,-31.45,True,1,19046,-1047.11,-3872674.76,19943257.06,16070582.3
2003-11-11,1046.57,-0.54,-0.05,1527.46,-31.48,True,1,19047,-1046.57,-3873721.33,19934018.79,16060297.46
2003-11-12,1058.53,11.96,1.14,1527.46,-30.7,True,1,19048,-1058.53,-3874779.86,20162879.44,16288099.58
2003-11-13,1058.41,-0.12,-0.01,1527.46,-30.71,True,1,19049,-1058.41,-3875838.27,20161652.09,16285813.82
2003-11-14,1050.35,-8.06,-0.76,1527.46,-31.24,True,1,19050,-1050.35,-3876888.62,20009167.5,16132278.88
2003-11-17,1043.63,-6.72,-0.64,1527.46,-31.68,True,1,19051,-1043.63,-3877932.25,19882195.13,16004262.88
2003-11-18,1034.15,-9.48,-0.91,1527.46,-32.3,True,1,19052,-1034.15,-3878966.4,19702625.8,15823659.4
2003-11-19,1042.44,8.29,0.8,1527.46,-31.75,True,1,19053,-1042.44,-3880008.84,19861609.32,15981600.48
2003-11-20,1033.65,-8.79,-0.84,1527.46,-32.33,True,1,19054,-1033.65,-3881042.49,19695167.1,15814124.61
2003-11-21,1035.28,1.63,0.16,1527.46,-32.22,True,1,19055,-1035.28,-3882077.77,19727260.4,15845182.63
2003-11-24,1052.08,16.8,1.62,1527.46,-31.12,True,1,19056,-1052.08,-3883129.85,20048436.48,16165306.63
2003-11-25,1053.89,1.81,0.17,1527.46,-31.0,True,1,19057,-1053.89,-3884183.74,20083981.73,16199797.99
2003-11-26,1058.45,4.56,0.43,1527.46,-30.7,True,1,19058,-1058.45,-3885242.19,20171940.1,16286697.91
2003-11-28,1058.2,-0.25,-0.02,1527.46,-30.72,True,1,19059,-1058.2,-3886300.39,20168233.8,16281933.41
2003-12-01,1070.12,11.92,1.13,1527.46,-29.94,True,1,19060,-1070.12,-3887370.51,20396487.2,16509116.69
2003-12-02,1066.62,-3.5,-0.33,1527.46,-30.17,True,1,19061,-1066.62,-3888437.13,20330843.82,16442406.69
2003-12-03,1064.73,-1.89,-0.18,1527.46,-30.29,True,1,19062,-1064.73,-3889501.86,20295883.26,16406381.4
2003-12-04,1069.72,4.99,0.47,1527.46,-29.97,True,1,19063,-1069.72,-3890571.58,20392072.36,16501500.78
2003-12-05,1061.5,-8.22,-0.77,1527.46,-30.51,True,1,19064,-1061.5,-3891633.08,20236436.0,16344802.92
2003-12-08,1069.3,7.8,0.74,1527.46,-30.0,True,1,19065,-1069.3,-3892702.38,20386204.5,16493502.12
2003-12-09,1060.18,-9.12,-0.85,1527.46,-30.59,True,1,19066,-1060.18,-3893762.56,20213391.88,16319629.32
2003-12-10,1059.05,-1.13,-0.11,1527.46,-30.67,True,1,19067,-1059.05,-3894821.61,20192906.35,16298084.74
2003-12-11,1071.21,12.16,1.15,1527.46,-29.87,True,1,19068,-1071.21,-3895892.82,20425832.28,16529939.46
2003-12-12,1074.14,2.93,0.27,1527.46,-29.68,True,1,19069,-1074.14,-3896966.96,20482775.66,16585808.7
2003-12-15,1068.04,-6.1,-0.57,1527.46,-30.08,True,1,19070,-1068.04,-3898035.0,20367522.8,16469487.8
2003-12-16,1075.13,7.09,0.66,1527.46,-29.61,True,1,19071,-1075.13,-3899110.13,20503804.23,16604694.1
2003-12-17,1076.48,1.35,0.13,1527.46,-29.52,True,1,19072,-1076.48,-3900186.61,20530626.56,16630439.95
2003-12-18,1089.18,12.7,1.18,1527.46,-28.69,True,1,19073,-1089.18,-3901275.79,20773930.14,16872654.35
2003-12-19,1088.66,-0.52,-0.05,1527.46,-28.73,True,1,19074,-1088.66,-3902364.45,20765100.84,16862736.39
2003-12-22,1092.94,4.28,0.39,1527.46,-28.45,True,1,19075,-1092.94,-3903457.39,20847830.5,16944373.11
2003-12-23,1096.02,3.08,0.28,1527.46,-28.25,True,1,19076,-1096.02,-3904553.41,20907677.52,17003124.11
2003-12-24,1094.04,-1.98,-0.18,1527.46,-28.38,True,1,19077,-1094.04,-3905647.45,20871001.08,16965353.63
2003-12-26,1095.89,1.85,0.17,1527.46,-28.25,True,1,19078,-1095.89,-3906743.34,20907389.42,17000646.08
2003-12-29,1109.48,13.59,1.24,1527.46,-27.36,True,1,19079,-1109.48,-3907852.82,21167768.92,17259916.1
2003-12-30,1109.64,0.16,0.01,1527.46,-27.35,True,1,19080,-1109.64,-3908962.46,21171931.2,17262968.74
2003-12-31,1111.92,2.28,0.2,1527.46,-27.2,True,1,19081,-1111.92,-3910074.38,21216545.52,17306471.14
2004-01-02,1108.48,-3.44,-0.31,1527.46,-27.43,True,1,19082,-1108.48,-3911182.86,21152015.36,17240832.5
2004-01-05,1122.22,13.74,1.24,1527.46,-26.53,True,1,19083,-1122.22,-3912305.08,21415324.26,17503019.18
2004-01-06,1123.67,1.45,0.13,1527.46,-26.44,True,1,19084,-1123.67,-3913428.75,21444118.28,17530689.53
2004-01-07,1126.33,2.66,0.24,1527.46,-26.26,True,1,19085,-1126.33,-3914555.08,21496008.05,17581452.97
2004-01-08,1131.92,5.59,0.5,1527.46,-25.9,True,1,19086,-1131.92,-3915687.0,21603825.12,17688138.12
2004-01-09,1121.86,-10.06,-0.89,1527.46,-26.55,True,1,19087,-1121.86,-3916808.86,21412941.82,17496132.96
2004-01-12,1127.23,5.37,0.48,1527.46,-26.2,True,1,19088,-1127.23,-3917936.09,21516566.24,17598630.15
2004-01-13,1121.22,-6.01,-0.53,1527.46,-26.6,True,1,19089,-1121.22,-3919057.31,21402968.58,17483911.27
2004-01-14,1130.52,9.3,0.83,1527.46,-25.99,True,1,19090,-1130.52,-3920187.83,21581626.8,17661438.97
2004-01-15,1132.05,1.53,0.14,1527.46,-25.89,True,1,19091,-1132.05,-3921319.88,21611966.55,17690646.67
2004-01-16,1139.83,7.78,0.69,1527.46,-25.38,True,1,19092,-1139.83,-3922459.71,21761634.36,17839174.65
2004-01-20,1138.77,-1.06,-0.09,1527.46,-25.45,True,1,19093,-1138.77,-3923598.48,21742535.61,17818937.13
2004-01-21,1147.62,8.85,0.78,1527.46,-24.87,True,1,19094,-1147.62,-3924746.1,21912656.28,17987910.18
2004-01-22,1143.94,-3.68,-0.32,1527.46,-25.11,True,1,19095,-1143.94,-3925890.04,21843534.3,17917644.26
2004-01-23,1141.55,-2.39,-0.21,1527.46,-25.26,True,1,19096,-1141.55,-3927031.59,21799038.8,17872007.21
2004-01-26,1155.37,13.82,1.21,1527.46,-24.36,True,1,19097,-1155.37,-3928186.96,22064100.89,18135913.93
2004-01-27,1144.05,-11.32,-0.98,1527.46,-25.1,True,1,19098,-1144.05,-3929331.01,21849066.9,17919735.89
2004-01-28,1128.48,-15.57,-1.36,1527.46,-26.12,True,1,19099,-1128.48,-3930459.49,21552839.52,17622380.03
2004-01-29,1134.11,5.63,0.5,1527.46,-25.75,True,1,19100,-1134.11,-3931593.6,21661501.0,17729907.4
2004-01-30,1131.13,-2.98,-0.26,1527.46,-25.95,True,1,19101,-1131.13,-3932724.73,21605714.13,17672989.4
2004-02-02,1135.26,4.13,0.36,1527.46,-25.68,True,1,19102,-1135.26,-3933859.99,21685736.52,17751876.53
2004-02-03,1136.03,0.77,0.07,1527.46,-25.63,True,1,19103,-1136.03,-3934996.02,21701581.09,17766585.07
2004-02-04,1126.52,-9.51,-0.84,1527.46,-26.25,True,1,19104,-1126.52,-3936122.54,21521038.08,17584915.54
2004-02-05,1128.59,2.07,0.18,1527.46,-26.11,True,1,19105,-1128.59,-3937251.13,21561711.95,17624460.82
2004-02-06,1142.76,14.17,1.26,1527.46,-25.19,True,1,19106,-1142.76,-3938393.89,21833572.56,17895178.67
2004-02-09,1139.81,-2.95,-0.26,1527.46,-25.38,True,1,19107,-1139.81,-3939533.7,21778349.67,17838815.97
2004-02-10,1145.54,5.73,0.5,1527.46,-25.0,True,1,19108,-1145.54,-3940679.24,21888978.32,17948299.08
2004-02-11,1157.76,12.22,1.07,1527.46,-24.2,True,1,19109,-1157.76,-3941837.0,22123635.84,18181798.84
2004-02-12,1152.11,-5.65,-0.49,1527.46,-24.57,True,1,19110,-1152.11,-3942989.11,22016822.1,18073832.99
2004-02-13,1145.81,-6.3,-0.55,1527.46,-24.99,True,1,19111,-1145.81,-3944134.92,21897574.91,17953439.99
2004-02-17,1156.99,11.18,0.98,1527.46,-24.25,True,1,19112,-1156.99,-3945291.91,22112392.88,18167100.97
2004-02-18,1151.82,-5.17,-0.45,1527.46,-24.59,True,1,19113,-1151.82,-3946443.73,22014735.66,18068291.93
2004-02-19,1147.06,-4.76,-0.41,1527.46,-24.9,True,1,19114,-1147.06,-3947590.79,21924904.84,17977314.05
2004-02-20,1144.11,-2.95,-0.26,1527.46,-25.1,True,1,19115,-1144.11,-3948734.9,21869662.65,17920927.75
2004-02-23,1140.99,-3.12,-0.27,1527.46,-25.3,True,1,19116,-1140.99,-3949875.89,21811164.84,17861288.95
2004-02-24,1139.09,-1.9,-0.17,1527.46,-25.43,True,1,19117,-1139.09,-3951014.98,21775983.53,17824968.55
2004-02-25,1143.67,4.58,0.4,1527.46,-25.13,True,1,19118,-1143.67,-3952158.65,21864683.06,17912524.41
2004-02-26,1144.91,1.24,0.11,1527.46,-25.04,True,1,19119,-1144.91,-3953303.56,21889534.29,17936230.73
2004-02-27,1144.94,0.03,0.0,1527.46,-25.04,True,1,19120,-1144.94,-3954448.5,21891252.8,17936804.3
2004-03-01,1155.97,11.03,0.96,1527.46,-24.32,True,1,19121,-1155.97,-3955604.47,22103302.37,18147697.9
2004-03-02,1149.1,-6.87,-0.59,1527.46,-24.77,True,1,19122,-1149.1,-3956753.57,21973090.2,18016336.63
2004-03-03,1151.03,1.93,0.17,1527.46,-24.64,True,1,19123,-1151.03,-3957904.6,22011146.69,18053242.09
2004-03-04,1154.87,3.84,0.33,1527.46,-24.39,True,1,19124,-1154.87,-3959059.47,22085733.88,18126674.41
2004-03-05,1156.86,1.99,0.17,1527.46,-24.26,True,1,19125,-1156.86,-3960216.33,22124947.5,18164731.17
2004-03-08,1147.2,-9.66,-0.84,1527.46,-24.9,True,1,19126,-1147.2,-3961363.53,21941347.2,17979983.67
2004-03-09,1140.58,-6.62,-0.58,1527.46,-25.33,True,1,19127,-1140.58,-3962504.11,21815873.66,17853369.55
2004-03-10,1123.89,-16.69,-1.46,1527.46,-26.42,True,1,19128,-1123.89,-3963628.0,21497767.92,17534139.92
2004-03-11,1106.78,-17.11,-1.52,1527.46,-27.54,True,1,19129,-1106.78,-3964734.78,21171594.62,17206859.84
2004-03-12,1120.57,13.79,1.25,1527.46,-26.64,True,1,19130,-1120.57,-3965855.35,21436504.1,17470648.75
2004-03-15,1104.49,-16.08,-1.44,1527.46,-27.69,True,1,19131,-1104.49,-3966959.84,21129998.19,17163038.35
2004-03-16,1110.7,6.21,0.56,1527.46,-27.28,True,1,19132,-1110.7,-3968070.54,21249912.4,17281841.86
2004-03-17,1123.75,13.05,1.18,1527.46,-26.43,True,1,19133,-1123.75,-3969194.29,21500708.75,17531514.46
2004-03-18,1122.32,-1.43,-0.13,1527.46,-26.52,True,1,19134,-1122.32,-3970316.61,21474470.88,17504154.27
2004-03-19,1109.78,-12.54,-1.12,1527.46,-27.34,True,1,19135,-1109.78,-3971426.39,21235640.3,17264213.91
2004-03-22,1095.4,-14.38,-1.3,1527.46,-28.29,True,1,19136,-1095.4,-3972521.79,20961574.4,16989052.61
2004-03-23,1093.95,-1.45,-0.13,1527.46,-28.38,True,1,19137,-1093.95,-3973615.74,20934921.15,16961305.41
2004-03-24,1091.33,-2.62,-0.24,1527.46,-28.55,True,1,19138,-1091.33,-3974707.07,20885873.54,16911166.47
2004-03-25,1109.19,17.86,1.64,1527.46,-27.38,True,1,19139,-1109.19,-3975816.26,21228787.41,17252971.15
2004-03-26,1108.06,-1.13,-0.1,1527.46,-27.46,True,1,19140,-1108.06,-3976924.32,21208268.4,17231344.08
2004-03-29,1122.47,14.41,1.3,1527.46,-26.51,True,1,19141,-1122.47,-3978046.79,21485198.27,17507151.48
2004-03-30,1127.0,4.53,0.4,1527.46,-26.22,True,1,19142,-1127.0,-3979173.79,21573034.0,17593860.21
2004-03-31,1126.21,-0.79,-0.07,1527.46,-26.27,True,1,19143,-1126.21,-3980300.0,21559038.03,17578738.03
2004-04-01,1132.17,5.96,0.53,1527.46,-25.88,True,1,19144,-1132.17,-3981432.17,21674262.48,17692830.31
2004-04-02,1141.81,9.64,0.85,1527.46,-25.25,True,1,19145,-1141.81,-3982573.98,21859952.45,17877378.47
2004-04-05,1150.57,8.76,0.77,1527.46,-24.67,True,1,19146,-1150.57,-3983724.55,22028813.22,18045088.67
2004-04-06,1148.16,-2.41,-0.21,1527.46,-24.83,True,1,19147,-1148.16,-3984872.71,21983819.52,17998946.81
2004-04-07,1140.53,-7.63,-0.66,1527.46,-25.33,True,1,19148,-1140.53,-3986013.24,21838868.44,17852855.2
2004-04-08,1139.32,-1.21,-0.11,1527.46,-25.41,True,1,19149,-1139.32,-3987152.56,21816838.68,17829686.12
2004-04-12,1145.2,5.88,0.52,1527.46,-25.03,True,1,19150,-1145.2,-3988297.76,21930580.0,17942282.24
2004-04-13,1129.44,-15.76,-1.38,1527.46,-26.06,True,1,19151,-1129.44,-3989427.2,21629905.44,17640478.24
2004-04-14,1128.17,-1.27,-0.11,1527.46,-26.14,True,1,19152,-1128.17,-3990555.37,21606711.84,17616156.47
2004-04-15,1128.84,0.67,0.06,1527.46,-26.1,True,1,19153,-1128.84,-3991684.21,21620672.52,17628988.31
2004-04-16,1134.61,5.77,0.51,1527.46,-25.72,True,1,19154,-1134.61,-3992818.82,21732319.94,17739501.12
2004-04-19,1135.82,1.21,0.11,1527.46,-25.64,True,1,19155,-1135.82,-3993954.64,21756632.1,17762677.46
2004-04-20,1118.15,-17.67,-1.56,1527.46,-26.8,True,1,19156,-1118.15,-3995072.79,21419281.4,17424208.61
2004-04-21,1124.09,5.94,0.53,1527.46,-26.41,True,1,19157,-1124.09,-3996196.88,21534192.13,17537995.25
2004-04-22,1139.93,15.84,1.41,1527.46,-25.37,True,1,19158,-1139.93,-3997336.81,21838778.94,17841442.13
2004-04-23,1140.6,0.67,0.06,1527.46,-25.33,True,1,19159,-1140.6,-3998477.41,21852755.4,17854277.99
2004-04-26,1135.53,-5.07,-0.44,1527.46,-25.66,True,1,19160,-1135.53,-3999612.94,21756754.8,17757141.86
2004-04-27,1138.11,2.58,0.23,1527.46,-25.49,True,1,19161,-1138.11,-4000751.05,21807325.71,17806574.66
2004-04-28,1122.41,-15.7,-1.38,1527.46,-26.52,True,1,19162,-1122.41,-4001873.46,21507620.42,17505746.96
2004-04-29,1113.89,-8.52,-0.76,1527.46,-27.08,True,1,19163,-1113.89,-4002987.35,21345474.07,17342486.72
2004-04-30,1107.3,-6.59,-0.59,1527.46,-27.51,True,1,19164,-1107.3,-4004094.65,21220297.2,17216202.55
2004-05-03,1117.49,10.19,0.92,1527.46,-26.84,True,1,19165,-1117.49,-4005212.14,21416695.85,17411483.71
2004-05-04,1119.55,2.06,0.18,1527.46,-26.7,True,1,19166,-1119.55,-4006331.69,21457295.3,17450963.61
2004-05-05,1121.53,1.98,0.18,1527.46,-26.58,True,1,19167,-1121.53,-4007453.22,21496365.51,17488912.29
2004-05-06,1113.99,-7.54,-0.67,1527.46,-27.07,True,1,19168,-1113.99,-4008567.21,21352960.32,17344393.11
2004-05-07,1098.7,-15.29,-1.37,1527.46,-28.07,True,1,19169,-1098.7,-4009665.91,21060980.3,17051314.39
2004-05-10,1087.12,-11.58,-1.05,1527.46,-28.83,True,1,19170,-1087.12,-4010753.03,20840090.4,16829337.37
2004-05-11,1095.45,8.33,0.77,1527.46,-28.28,True,1,19171,-1095.45,-4011848.48,21000871.95,16989023.47
2004-05-12,1097.28,1.83,0.17,1527.46,-28.16,True,1,19172,-1097.28,-4012945.76,21037052.16,17024106.4
2004-05-13,1096.44,-0.84,-0.08,1527.46,-28.22,True,1,19173,-1096.44,-4014042.2,21022044.12,17008001.92
2004-05-14,1095.7,-0.74,-0.07,1527.46,-28.27,True,1,19174,-1095.7,-4015137.9,21008951.8,16993813.9
2004-05-17,1084.1,-11.6,-1.06,1527.46,-29.03,True,1,19175,-1084.1,-4016222.0,20787617.5,16771395.5
2004-05-18,1091.49,7.39,0.68,1527.46,-28.54,True,1,19176,-1091.49,-4017313.49,20930412.24,16913098.75
2004-05-19,1088.68,-2.81,-0.26,1527.46,-28.73,True,1,19177,-1088.68,-4018402.17,20877616.36,16859214.19
2004-05-20,1089.19,0.51,0.05,1527.46,-28.69,True,1,19178,-1089.19,-4019491.36,20888485.82,16868994.46
2004-05-21,1093.56,4.37,0.4,1527.46,-28.41,True,1,19179,-1093.56,-4020584.92,20973387.24,16952802.32
2004-05-24,1095.41,1.85,0.17,1527.46,-28.29,True,1,19180,-1095.41,-4021680.33,21009963.8,16988283.47
2004-05-25,1113.05,17.64,1.61,1527.46,-27.13,True,1,19181,-1113.05,-4022793.38,21349412.05,17326618.67
2004-05-26,1114.94,1.89,0.17,1527.46,-27.01,True,1,19182,-1114.94,-4023908.32,21386779.08,17362870.76
2004-05-27,1121.28,6.34,0.57,1527.46,-26.59,True,1,19183,-1121.28,-4025029.6,21509514.24,17484484.64
2004-05-28,1120.68,-0.6,-0.05,1527.46,-26.63,True,1,19184,-1120.68,-4026150.28,21499125.12,17472974.84
2004-06-01,1121.2,0.52,0.05,1527.46,-26.6,True,1,19185,-1121.2,-4027271.48,21510222.0,17482950.52
2004-06-02,1124.99,3.79,0.34,1527.46,-26.35,True,1,19186,-1124.99,-4028396.47,21584058.14,17555661.67
2004-06-03,1116.64,-8.35,-0.74,1527.46,-26.9,True,1,19187,-1116.64,-4029513.11,21424971.68,17395458.57
2004-06-04,1122.5,5.86,0.52,1527.46,-26.51,True,1,19188,-1122.5,-4030635.61,21538530.0,17507894.39
2004-06-07,1140.42,17.92,1.6,1527.46,-25.34,True,1,19189,-1140.42,-4031776.03,21883519.38,17851743.35
2004-06-08,1142.18,1.76,0.15,1527.46,-25.22,True,1,19190,-1142.18,-4032918.21,21918434.2,17885515.99
2004-06-09,1131.33,-10.85,-0.95,1527.46,-25.93,True,1,19191,-1131.33,-4034049.54,21711354.03,17677304.49
2004-06-10,1136.47,5.14,0.45,1527.46,-25.6,True,1,19192,-1136.47,-4035186.01,21811132.24,17775946.23
2004-06-14,1125.29,-11.18,-0.98,1527.46,-26.33,True,1,19193,-1125.29,-4036311.3,21597690.97,17561379.67
2004-06-15,1132.01,6.72,0.6,1527.46,-25.89,True,1,19194,-1132.01,-4037443.31,21727799.94,17690356.63
2004-06-16,1133.56,1.55,0.14,1527.46,-25.79,True,1,19195,-1133.56,-4038576.87,21758684.2,17720107.33
2004-06-17,1132.05,-1.51,-0.13,1527.46,-25.89,True,1,19196,-1132.05,-4039708.92,21730831.8,17691122.88
2004-06-18,1135.02,2.97,0.26,1527.46,-25.69,True,1,19197,-1135.02,-4040843.94,21788978.94,17748135.0
2004-06-21,1130.3,-4.72,-0.42,1527.46,-26.0,True,1,19198,-1130.3,-4041974.24,21699499.4,17657525.16
2004-06-22,1134.41,4.11,0.36,1527.46,-25.73,True,1,19199,-1134.41,-4043108.65,21779537.59,17736428.94
2004-06-23,1144.06,9.65,0.85,1527.46,-25.1,True,1,19200,-1144.06,-4044252.71,21965952.0,17921699.29
2004-06-24,1140.65,-3.41,-0.3,1527.46,-25.32,True,1,19201,-1140.65,-4045393.36,21901620.65,17856227.29
2004-06-25,1134.43,-6.22,-0.55,1527.46,-25.73,True,1,19202,-1134.43,-4046527.79,21783324.86,17736797.07
2004-06-28,1133.35,-1.08,-0.1,1527.46,-25.8,True,1,19203,-1133.35,-4047661.14,21763720.05,17716058.91
2004-06-29,1136.2,2.85,0.25,1527.46,-25.62,True,1,19204,-1136.2,-4048797.34,21819584.8,17770787.46
2004-06-30,1140.84,4.64,0.41,1527.46,-25.31,True,1,19205,-1140.84,-4049938.18,21909832.2,17859894.02
2004-07-01,1128.94,-11.9,-1.04,1527.46,-26.09,True,1,19206,-1128.94,-4051067.12,21682421.64,17631354.52
2004-07-02,1125.38,-3.56,-0.32,1527.46,-26.32,True,1,19207,-1125.38,-4052192.5,21615173.66,17562981.16
2004-07-06,1116.21,-9.17,-0.82,1527.46,-26.92,True,1,19208,-1116.21,-4053308.71,21440161.68,17386852.97
2004-07-07,1118.33,2.12,0.19,1527.46,-26.78,True,1,19209,-1118.33,-4054427.04,21482000.97,17427573.93
2004-07-08,1109.11,-9.22,-0.82,1527.46,-27.39,True,1,19210,-1109.11,-4055536.15,21306003.1,17250466.95
2004-07-09,1112.81,3.7,0.33,1527.46,-27.15,True,1,19211,-1112.81,-4056648.96,21378192.91,17321543.95
2004-07-12,1114.35,1.54,0.14,1527.46,-27.05,True,1,19212,-1114.35,-4057763.31,21408892.2,17351128.89
2004-07-13,1115.14,0.79,0.07,1527.46,-26.99,True,1,19213,-1115.14,-4058878.45,21425184.82,17366306.37
2004-07-14,1111.47,-3.67,-0.33,1527.46,-27.23,True,1,19214,-1111.47,-4059989.92,21355784.58,17295794.66
2004-07-15,1106.69,-4.78,-0.43,1527.46,-27.55,True,1,19215,-1106.69,-4061096.61,21265048.35,17203951.74
2004-07-16,1101.39,-5.3,-0.48,1527.46,-27.89,True,1,19216,-1101.39,-4062198.0,21164310.24,17102112.24
2004-07-19,1100.9,-0.49,-0.04,1527.46,-27.93,True,1,19217,-1100.9,-4063298.9,21155995.3,17092696.4
2004-07-20,1108.67,7.77,0.71,1527.46,-27.42,True,1,19218,-1108.67,-4064407.57,21306420.06,17242012.49
2004-07-21,1093.88,-14.79,-1.33,1527.46,-28.39,True,1,19219,-1093.88,-4065501.45,21023279.72,16957778.27
2004-07-22,1096.84,2.96,0.27,1527.46,-28.19,True,1,19220,-1096.84,-4066598.29,21081264.8,17014666.51
2004-07-23,1086.2,-10.64,-0.97,1527.46,-28.89,True,1,19221,-1086.2,-4067684.49,20877850.2,16810165.71
2004-07-26,1084.07,-2.13,-0.2,1527.46,-29.03,True,1,19222,-1084.07,-4068768.56,20837993.54,16769224.98
2004-07-27,1094.83,10.76,0.99,1527.46,-28.32,True,1,19223,-1094.83,-4069863.39,21045917.09,16976053.7
2004-07-28,1095.42,0.59,0.05,1527.46,-28.28,True,1,19224,-1095.42,-4070958.81,21058354.08,16987395.27
2004-07-29,1100.43,5.01,0.46,1527.46,-27.96,True,1,19225,-1100.43,-4072059.24,21155766.75,17083707.51
2004-07-30,1101.72,1.29,0.12,1527.46,-27.87,True,1,19226,-1101.72,-4073160.96,21181668.72,17108507.76
2004-08-02,1106.62,4.9,0.44,1527.46,-27.55,True,1,19227,-1106.62,-4074267.58,21276982.74,17202715.16
2004-08-03,1099.69,-6.93,-0.63,1527.46,-28.0,True,1,19228,-1099.69,-4075367.27,21144839.32,17069472.05
2004-08-04,1098.63,-1.06,-0.1,1527.46,-28.08,True,1,19229,-1098.63,-4076465.9,21125556.27,17049090.37
2004-08-05,1080.7,-17.93,-1.63,1527.46,-29.25,True,1,19230,-1080.7,-4077546.6,20781861.0,16704314.4
2004-08-06,1063.97,-16.73,-1.55,1527.46,-30.34,True,1,19231,-1063.97,-4078610.57,20461207.07,16382596.5
2004-08-09,1065.22,1.25,0.12,1527.46,-30.26,True,1,19232,-1065.22,-4079675.79,20486311.04,16406635.25
2004-08-10,1079.04,13.82,1.3,1527.46,-29.36,True,1,19233,-1079.04,-4080754.83,20753176.32,16672421.49
2004-08-11,1075.79,-3.25,-0.3,1527.46,-29.57,True,1,19234,-1075.79,-4081830.62,20691744.86,16609914.24
2004-08-12,1063.23,-12.56,-1.17,1527.46,-30.39,True,1,19235,-1063.23,-4082893.85,20451229.05,16368335.2
2004-08-13,1064.8,1.57,0.15,1527.46,-30.29,True,1,19236,-1064.8,-4083958.65,20482492.8,16398534.15
2004-08-16,1079.34,14.54,1.37,1527.46,-29.34,True,1,19237,-1079.34,-4085037.99,20763263.58,16678225.59
2004-08-17,1081.71,2.37,0.22,1527.46,-29.18,True,1,19238,-1081.71,-4086119.7,20809936.98,16723817.28
2004-08-18,1095.17,13.46,1.24,1527.46,-28.3,True,1,19239,-1095.17,-4087214.87,21069975.63,16982760.76
2004-08-19,1091.23,-3.94,-0.36,1527.46,-28.56,True,1,19240,-1091.23,-4088306.1,20995265.2,16906959.1
2004-08-20,1098.35,7.12,0.65,1527.46,-28.09,True,1,19241,-1098.35,-4089404.45,21133352.35,17043947.9
2004-08-23,1095.68,-2.67,-0.24,1527.46,-28.27,True,1,19242,-1095.68,-4090500.13,21083074.56,16992574.43
2004-08-24,1096.19,0.51,0.05,1527.46,-28.23,True,1,19243,-1096.19,-4091596.32,21093984.17,17002387.85
2004-08-25,1104.96,8.77,0.8,1527.46,-27.66,True,1,19244,-1104.96,-4092701.28,21263850.24,17171148.96
2004-08-26,1105.09,0.13,0.01,1527.46,-27.65,True,1,19245,-1105.09,-4093806.37,21267457.05,17173650.68
2004-08-27,1107.77,2.68,0.24,1527.46,-27.48,True,1,19246,-1107.77,-4094914.14,21320141.42,17225227.28
2004-08-30,1099.15,-8.62,-0.78,1527.46,-28.04,True,1,19247,-1099.15,-4096013.29,21155340.05,17059326.76
2004-08-31,1104.24,5.09,0.46,1527.46,-27.71,True,1,19248,-1104.24,-4097117.53,21254411.52,17157293.99
2004-09-01,1105.91,1.67,0.15,1527.46,-27.6,True,1,19249,-1105.91,-4098223.44,21287661.59,17189438.15
2004-09-02,1118.31,12.4,1.12,1527.46,-26.79,True,1,19250,-1118.31,-4099341.75,21527467.5,17428125.75
2004-09-03,1113.63,-4.68,-0.42,1527.46,-27.09,True,1,19251,-1113.63,-4100455.38,21438491.13,17338035.75
2004-09-07,1121.3,7.67,0.69,1527.46,-26.59,True,1,19252,-1121.3,-4101576.68,21587267.6,17485690.92
2004-09-08,1116.27,-5.03,-0.45,1527.46,-26.92,True,1,19253,-1116.27,-4102692.95,21491546.31,17388853.36
2004-09-09,1118.38,2.11,0.19,1527.46,-26.78,True,1,19254,-1118.38,-4103811.33,21533288.52,17429477.19
2004-09-10,1123.92,5.54,0.5,1527.46,-26.42,True,1,19255,-1123.92,-4104935.25,21641079.6,17536144.35
2004-09-13,1125.82,1.9,0.17,1527.46,-26.3,True,1,19256,-1125.82,-4106061.07,21678789.92,17572728.85
2004-09-14,1128.33,2.51,0.22,1527.46,-26.13,True,1,19257,-1128.33,-4107189.4,21728250.81,17621061.41
2004-09-15,1120.37,-7.96,-0.7,1527.46,-26.65,True,1,19258,-1120.37,-4108309.77,21576085.46,17467775.69
2004-09-16,1123.5,3.13,0.28,1527.46,-26.45,True,1,19259,-1123.5,-4109433.27,21637486.5,17528053.23
2004-09-17,1128.55,5.05,0.45,1527.46,-26.12,True,1,19260,-1128.55,-4110561.82,21735873.0,17625311.18
2004-09-20,1122.2,-6.35,-0.56,1527.46,-26.53,True,1,19261,-1122.2,-4111684.02,21614694.2,17503010.18
2004-09-21,1129.3,7.1,0.63,1527.46,-26.07,True,1,19262,-1129.3,-4112813.32,21752576.6,17639763.28
2004-09-22,1113.56,-15.74,-1.39,1527.46,-27.1,True,1,19263,-1113.56,-4113926.88,21450506.28,17336579.4
2004-09-23,1108.36,-5.2,-0.47,1527.46,-27.44,True,1,19264,-1108.36,-4115035.24,21351447.04,17236411.8
2004-09-24,1110.11,1.75,0.16,1527.46,-27.32,True,1,19265,-1110.11,-4116145.35,21386269.15,17270123.8
2004-09-27,1103.52,-6.59,-0.59,1527.46,-27.76,True,1,19266,-1103.52,-4117248.87,21260416.32,17143167.45
2004-09-28,1110.06,6.54,0.59,1527.46,-27.33,True,1,19267,-1110.06,-4118358.93,21387526.02,17269167.09
2004-09-29,1114.8,4.74,0.43,1527.46,-27.02,True,1,19268,-1114.8,-4119473.73,21479966.4,17360492.67
2004-09-30,1114.58,-0.22,-0.02,1527.46,-27.03,True,1,19269,-1114.58,-4120588.31,21476842.02,17356253.71
2004-10-01,1131.5,16.92,1.52,1527.46,-25.92,True,1,19270,-1131.5,-4121719.81,21804005.0,17682285.19
2004-10-04,1135.17,3.67,0.32,1527.46,-25.68,True,1,19271,-1135.17,-4122854.98,21875861.07,17753006.09
2004-10-05,1134.48,-0.69,-0.06,1527.46,-25.73,True,1,19272,-1134.48,-4123989.46,21863698.56,17739709.1
2004-10-06,1142.05,7.57,0.67,1527.46,-25.23,True,1,19273,-1142.05,-4125131.51,22010729.65,17885598.14
2004-10-07,1130.65,-11.4,-1.0,1527.46,-25.98,True,1,19274,-1130.65,-4126262.16,21792148.1,17665885.94
2004-10-08,1122.14,-8.51,-0.75,1527.46,-26.54,True,1,19275,-1122.14,-4127384.3,21629248.5,17501864.2
2004-10-11,1124.39,2.25,0.2,1527.46,-26.39,True,1,19276,-1124.39,-4128508.69,21673741.64,17545232.95
2004-10-12,1121.84,-2.55,-0.23,1527.46,-26.56,True,1,19277,-1121.84,-4129630.53,21625709.68,17496079.15
2004-10-13,1113.65,-8.19,-0.73,1527.46,-27.09,True,1,19278,-1113.65,-4130744.18,21468944.7,17338200.52
2004-10-14,1103.29,-10.36,-0.93,1527.46,-27.77,True,1,19279,-1103.29,-4131847.47,21270327.91,17138480.44
2004-10-15,1108.2,4.91,0.44,1527.46,-27.45,True,1,19280,-1108.2,-4132955.67,21366096.0,17233140.33
2004-10-18,1114.02,5.82,0.52,1527.46,-27.07,True,1,19281,-1114.02,-4134069.69,21479419.62,17345349.93
2004-10-19,1103.23,-10.79,-0.97,1527.46,-27.77,True,1,19282,-1103.23,-4135172.92,21272480.86,17137307.94
2004-10-20,1103.66,0.43,0.04,1527.46,-27.74,True,1,19283,-1103.66,-4136276.58,21281875.78,17145599.2
2004-10-21,1106.49,2.83,0.26,1527.46,-27.56,True,1,19284,-1106.49,-4137383.07,21337553.16,17200170.09
2004-10-22,1095.74,-10.75,-0.97,1527.46,-28.26,True,1,19285,-1095.74,-4138478.81,21131345.9,16992867.09
2004-10-25,1094.8,-0.94,-0.09,1527.46,-28.32,True,1,19286,-1094.8,-4139573.61,21114312.8,16974739.19
2004-10-26,1111.09,16.29,1.49,1527.46,-27.26,True,1,19287,-1111.09,-4140684.7,21429592.83,17288908.13
2004-10-27,1125.4,14.31,1.29,1527.46,-26.32,True,1,19288,-1125.4,-4141810.1,21706715.2,17564905.1
2004-10-28,1127.44,2.04,0.18,1527.46,-26.19,True,1,19289,-1127.44,-4142937.54,21747190.16,17604252.62
2004-10-29,1130.2,2.76,0.24,1527.46,-26.01,True,1,19290,-1130.2,-4144067.74,21801558.0,17657490.26
2004-11-01,1130.51,0.31,0.03,1527.46,-25.99,True,1,19291,-1130.51,-4145198.25,21808668.41,17663470.16
2004-11-02,1130.56,0.05,0.0,1527.46,-25.98,True,1,19292,-1130.56,-4146328.81,21810763.52,17664434.71
2004-11-03,1143.2,12.64,1.12,1527.46,-25.16,True,1,19293,-1143.2,-4147472.01,22055757.6,17908285.59
2004-11-04,1161.67,18.47,1.62,1527.46,-23.95,True,1,19294,-1161.67,-4148633.68,22413260.98,18264627.3
2004-11-05,1166.17,4.5,0.39,1527.46,-23.65,True,1,19295,-1166.17,-4149799.85,22501250.15,18351450.3
2004-11-08,1164.89,-1.28,-0.11,1527.46,-23.74,True,1,19296,-1164.89,-4150964.74,22477717.44,18326752.7
2004-11-09,1164.08,-0.81,-0.07,1527.46,-23.79,True,1,19297,-1164.08,-4152128.82,22463251.76,18311122.94
2004-11-10,1162.91,-1.17,-0.1,1527.46,-23.87,True,1,19298,-1162.91,-4153291.73,22441837.18,18288545.45
2004-11-11,1173.48,10.57,0.91,1527.46,-23.17,True,1,19299,-1173.48,-4154465.21,22646990.52,18492525.31
2004-11-12,1184.17,10.69,0.91,1527.46,-22.48,True,1,19300,-1184.17,-4155649.38,22854481.0,18698831.62
2004-11-15,1183.81,-0.36,-0.03,1527.46,-22.5,True,1,19301,-1183.81,-4156833.19,22848716.81,18691883.62
2004-11-16,1175.43,-8.38,-0.71,1527.46,-23.05,True,1,19302,-1175.43,-4158008.62,22688149.86,18530141.24
2004-11-17,1181.94,6.51,0.55,1527.46,-22.62,True,1,19303,-1181.94,-4159190.56,22814987.82,18655797.26
2004-11-18,1183.55,1.61,0.14,1527.46,-22.52,True,1,19304,-1183.55,-4160374.11,22847249.2,18686875.09
2004-11-19,1170.34,-13.21,-1.12,1527.46,-23.38,True,1,19305,-1170.34,-4161544.45,22593413.7,18431869.25
2004-11-22,1177.24,6.9,0.59,1527.46,-22.93,True,1,19306,-1177.24,-4162721.69,22727795.44,18565073.75
2004-11-23,1176.94,-0.3,-0.02,1527.46,-22.95,True,1,19307,-1176.94,-4163898.63,22723180.58,18559281.95
2004-11-24,1181.76,4.82,0.41,1527.46,-22.63,True,1,19308,-1181.76,-4165080.39,22817422.08,18652341.69
2004-11-26,1182.65,0.89,0.08,1527.46,-22.57,True,1,19309,-1182.65,-4166263.04,22835788.85,18669525.81
2004-11-29,1178.57,-4.08,-0.34,1527.46,-22.84,True,1,19310,-1178.57,-4167441.61,22758186.7,18590745.09
2004-11-30,1173.82,-4.75,-0.4,1527.46,-23.15,True,1,19311,-1173.82,-4168615.43,22667638.02,18499022.59
2004-12-01,1191.37,17.55,1.5,1527.46,-22.0,True,1,19312,-1191.37,-4169806.8,23007737.44,18837930.64
2004-12-02,1190.33,-1.04,-0.09,1527.46,-22.07,True,1,19313,-1190.33,-4170997.13,22988843.29,18817846.16
2004-12-03,1191.17,0.84,0.07,1527.46,-22.02,True,1,19314,-1191.17,-4172188.3,23006257.38,18834069.08
2004-12-06,1190.25,-0.92,-0.08,1527.46,-22.08,True,1,19315,-1190.25,-4173378.55,22989678.75,18816300.2
2004-12-07,1177.07,-13.18,-1.11,1527.46,-22.94,True,1,19316,-1177.07,-4174555.62,22736284.12,18561728.5
2004-12-08,1182.81,5.74,0.49,1527.46,-22.56,True,1,19317,-1182.81,-4175738.43,22848340.77,18672602.34
2004-12-09,1189.24,6.43,0.54,1527.46,-22.14,True,1,19318,-1189.24,-4176927.67,22973738.32,18796810.65
2004-12-10,1188.0,-1.24,-0.1,1527.46,-22.22,True,1,19319,-1188.0,-4178115.67,22950972.0,18772856.33
2004-12-13,1198.68,10.68,0.9,1527.46,-21.52,True,1,19320,-1198.68,-4179314.35,23158497.6,18979183.25
2004-12-14,1203.38,4.7,0.39,1527.46,-21.22,True,1,19321,-1203.38,-4180517.73,23250504.98,19069987.25
2004-12-15,1205.72,2.34,0.19,1527.46,-21.06,True,1,19322,-1205.72,-4181723.45,23296921.84,19115198.39
2004-12-16,1203.21,-2.51,-0.21,1527.46,-21.23,True,1,19323,-1203.21,-4182926.66,23249626.83,19066700.17
2004-12-17,1194.2,-9.01,-0.75,1527.46,-21.82,True,1,19324,-1194.2,-4184120.86,23076720.8,18892599.94
2004-12-20,1194.65,0.45,0.04,1527.46,-21.79,True,1,19325,-1194.65,-4185315.51,23086611.25,18901295.74
2004-12-21,1205.45,10.8,0.9,1527.46,-21.08,True,1,19326,-1205.45,-4186520.96,23296526.7,19110005.74
2004-12-22,1209.57,4.12,0.34,1527.46,-20.81,True,1,19327,-1209.57,-4187730.53,23377359.39,19189628.86
2004-12-23,1210.13,0.56,0.05,1527.46,-20.78,True,1,19328,-1210.13,-4188940.66,23389392.64,19200451.98
2004-12-27,1204.92,-5.21,-0.43,1527.46,-21.12,True,1,19329,-1204.92,-4190145.58,23289898.68,19099753.1
2004-12-28,1213.54,8.62,0.72,1527.46,-20.55,True,1,19330,-1213.54,-4191359.12,23457728.2,19266369.08
2004-12-29,1213.45,-0.09,-0.01,1527.46,-20.56,True,1,19331,-1213.45,-4192572.57,23457201.95,19264629.38
2004-12-30,1213.55,0.1,0.01,1527.46,-20.55,True,1,19332,-1213.55,-4193786.12,23460348.6,19266562.48
2004-12-31,1211.92,-1.63,-0.13,1527.46,-20.66,True,1,19333,-1211.92,-4194998.04,23430049.36,19235051.32
2005-01-03,1202.08,-9.84,-0.81,1527.46,-21.3,True,1,19334,-1202.08,-4196200.12,23241014.72,19044814.6
2005-01-04,1188.05,-14.03,-1.17,1527.46,-22.22,True,1,19335,-1188.05,-4197388.17,22970946.75,18773558.58
2005-01-05,1183.74,-4.31,-0.36,1527.46,-22.5,True,1,19336,-1183.74,-4198571.91,22888796.64,18690224.73
2005-01-06,1187.89,4.15,0.35,1527.46,-22.23,True,1,19337,-1187.89,-4199759.8,22970228.93,18770469.13
2005-01-07,1186.19,-1.7,-0.14,1527.46,-22.34,True,1,19338,-1186.19,-4200945.99,22938542.22,18737596.23
2005-01-10,1190.25,4.06,0.34,1527.46,-22.08,True,1,19339,-1190.25,-4202136.24,23018244.75,18816108.51
2005-01-11,1182.99,-7.26,-0.61,1527.46,-22.55,True,1,19340,-1182.99,-4203319.23,22879026.6,18675707.37
2005-01-12,1187.7,4.71,0.4,1527.46,-22.24,True,1,19341,-1187.7,-4204506.93,22971305.7,18766798.77
2005-01-13,1177.45,-10.25,-0.86,1527.46,-22.92,True,1,19342,-1177.45,-4205684.38,22774237.9,18568553.52
2005-01-14,1184.52,7.07,0.6,1527.46,-22.45,True,1,19343,-1184.52,-4206868.9,22912170.36,18705301.46
2005-01-18,1195.98,11.46,0.97,1527.46,-21.7,True,1,19344,-1195.98,-4208064.88,23135037.12,18926972.24
2005-01-19,1184.63,-11.35,-0.95,1527.46,-22.44,True,1,19345,-1184.63,-4209249.51,22916667.35,18707417.84
2005-01-20,1175.41,-9.22,-0.78,1527.46,-23.05,True,1,19346,-1175.41,-4210424.92,22739481.86,18529056.94
2005-01-21,1167.87,-7.54,-0.64,1527.46,-23.54,True,1,19347,-1167.87,-4211592.79,22594780.89,18383188.1
2005-01-24,1163.75,-4.12,-0.35,1527.46,-23.81,True,1,19348,-1163.75,-4212756.54,22516235.0,18303478.46
2005-01-25,1168.41,4.66,0.4,1527.46,-23.51,True,1,19349,-1168.41,-4213924.95,22607565.09,18393640.14
2005-01-26,1174.07,5.66,0.48,1527.46,-23.14,True,1,19350,-1174.07,-4215099.02,22718254.5,18503155.48
2005-01-27,1174.55,0.48,0.04,1527.46,-23.1,True,1,19351,-1174.55,-4216273.57,22728717.05,18512443.48
2005-01-28,1171.36,-3.19,-0.27,1527.46,-23.31,True,1,19352,-1171.36,-4217444.93,22668158.72,18450713.79
2005-01-31,1181.27,9.91,0.85,1527.46,-22.66,True,1,19353,-1181.27,-4218626.2,22861118.31,18642492.11
2005-02-01,1189.41,8.14,0.69,1527.46,-22.13,True,1,19354,-1189.41,-4219815.61,23019841.14,18800025.53
2005-02-02,1193.19,3.78,0.32,1527.46,-21.88,True,1,19355,-1193.19,-4221008.8,23094192.45,18873183.65
2005-02-03,1189.89,-3.3,-0.28,1527.46,-22.1,True,1,19356,-1189.89,-4222198.69,23031510.84,18809312.15
2005-02-04,1203.03,13.14,1.1,1527.46,-21.24,True,1,19357,-1203.03,-4223401.72,23287051.71,19063649.99
2005-02-07,1201.72,-1.31,-0.11,1527.46,-21.33,True,1,19358,-1201.72,-4224603.44,23262895.76,19038292.32
2005-02-08,1202.3,0.58,0.05,1527.46,-21.29,True,1,19359,-1202.3,-4225805.74,23275325.7,19049519.96
2005-02-09,1191.99,-10.31,-0.86,1527.46,-21.96,True,1,19360,-1191.99,-4226997.73,23076926.4,18849928.67
2005-02-10,1197.01,5.02,0.42,1527.46,-21.63,True,1,19361,-1197.01,-4228194.74,23175310.61,18947115.87
2005-02-11,1205.3,8.29,0.69,1527.46,-21.09,True,1,19362,-1205.3,-4229400.04,23337018.6,19107618.56
2005-02-14,1206.14,0.84,0.07,1527.46,-21.04,True,1,19363,-1206.14,-4230606.18,23354488.82,19123882.64
2005-02-15,1210.12,3.98,0.33,1527.46,-20.78,True,1,19364,-1210.12,-4231816.3,23432763.68,19200947.38
2005-02-16,1210.34,0.22,0.02,1527.46,-20.76,True,1,19365,-1210.34,-4233026.64,23438234.1,19205207.46
2005-02-17,1200.75,-9.59,-0.79,1527.46,-21.39,True,1,19366,-1200.75,-4234227.39,23253724.5,19019497.11
2005-02-18,1201.59,0.84,0.07,1527.46,-21.33,True,1,19367,-1201.59,-4235428.98,23271193.53,19035764.55
2005-02-22,1184.16,-17.43,-1.45,1527.46,-22.48,True,1,19368,-1184.16,-4236613.14,22934810.88,18698197.74
2005-02-23,1190.8,6.64,0.56,1527.46,-22.04,True,1,19369,-1190.8,-4237803.94,23064605.2,18826801.26
2005-02-24,1200.2,9.4,0.79,1527.46,-21.42,True,1,19370,-1200.2,-4239004.14,23247874.0,19008869.86
2005-02-25,1211.37,11.17,0.93,1527.46,-20.69,True,1,19371,-1211.37,-4240215.51,23465448.27,19225232.76
2005-02-28,1203.6,-7.77,-0.64,1527.46,-21.2,True,1,19372,-1203.6,-4241419.11,23316139.2,19074720.09
2005-03-01,1210.41,6.81,0.57,1527.46,-20.76,True,1,19373,-1210.41,-4242629.52,23449272.93,19206643.41
2005-03-02,1210.08,-0.33,-0.03,1527.46,-20.78,True,1,19374,-1210.08,-4243839.6,23444089.92,19200250.32
2005-03-03,1210.47,0.39,0.03,1527.46,-20.75,True,1,19375,-1210.47,-4245050.07,23452856.25,19207806.18
2005-03-04,1222.12,11.65,0.96,1527.46,-19.99,True,1,19376,-1222.12,-4246272.19,23679797.12,19433524.93
2005-03-07,1225.31,3.19,0.26,1527.46,-19.78,True,1,19377,-1225.31,-4247497.5,23742831.87,19495334.37
2005-03-08,1219.43,-5.88,-0.48,1527.46,-20.17,True,1,19378,-1219.43,-4248716.93,23630114.54,19381397.61
2005-03-09,1207.01,-12.42,-1.02,1527.46,-20.98,True,1,19379,-1207.01,-4249923.94,23390646.79,19140722.85
2005-03-10,1209.25,2.24,0.19,1527.46,-20.83,True,1,19380,-1209.25,-4251133.19,23435265.0,19184131.81
2005-03-11,1200.08,-9.17,-0.76,1527.46,-21.43,True,1,19381,-1200.08,-4252333.27,23258750.48,19006417.21
2005-03-14,1206.83,6.75,0.56,1527.46,-20.99,True,1,19382,-1206.83,-4253540.1,23390779.06,19137238.96
2005-03-15,1197.75,-9.08,-0.75,1527.46,-21.59,True,1,19383,-1197.75,-4254737.85,23215988.25,18961250.4
2005-03-16,1188.07,-9.68,-0.81,1527.46,-22.22,True,1,19384,-1188.07,-4255925.92,23029548.88,18773622.96
2005-03-17,1190.21,2.14,0.18,1527.46,-22.08,True,1,19385,-1190.21,-4257116.13,23072220.85,18815104.72
2005-03-18,1189.65,-0.56,-0.05,1527.46,-22.12,True,1,19386,-1189.65,-4258305.78,23062554.9,18804249.12
2005-03-21,1183.78,-5.87,-0.49,1527.46,-22.5,True,1,19387,-1183.78,-4259489.56,22949942.86,18690453.3
2005-03-22,1171.71,-12.07,-1.02,1527.46,-23.29,True,1,19388,-1171.71,-4260661.27,22717113.48,18456452.21
2005-03-23,1172.53,0.82,0.07,1527.46,-23.24,True,1,19389,-1172.53,-4261833.8,22734184.17,18472350.37
2005-03-24,1171.42,-1.11,-0.1,1527.46,-23.31,True,1,19390,-1171.42,-4263005.22,22713833.8,18450828.58
2005-03-28,1174.28,2.86,0.24,1527.46,-23.12,True,1,19391,-1174.28,-4264179.5,22770463.48,18506283.98
2005-03-29,1165.36,-8.92,-0.76,1527.46,-23.71,True,1,19392,-1165.36,-4265344.86,22598661.12,18333316.26
2005-03-30,1181.41,16.05,1.38,1527.46,-22.66,True,1,19393,-1181.41,-4266526.27,22911084.13,18644557.86
2005-03-31,1180.59,-0.82,-0.07,1527.46,-22.71,True,1,19394,-1180.59,-4267706.86,22896362.46,18628655.6
2005-04-01,1172.92,-7.67,-0.65,1527.46,-23.21,True,1,19395,-1172.92,-4268879.78,22748783.4,18479903.62
2005-04-04,1176.12,3.2,0.27,1527.46,-23.0,True,1,19396,-1176.12,-4270055.9,22812023.52,18541967.62
2005-04-05,1181.39,5.27,0.45,1527.46,-22.66,True,1,19397,-1181.39,-4271237.29,22915421.83,18644184.54
2005-04-06,1184.07,2.68,0.23,1527.46,-22.48,True,1,19398,-1184.07,-4272421.36,22968589.86,18696168.5
2005-04-07,1191.14,7.07,0.6,1527.46,-22.02,True,1,19399,-1191.14,-4273612.5,23106924.86,18833312.36
2005-04-08,1181.2,-9.94,-0.84,1527.46,-22.67,True,1,19400,-1181.2,-4274793.7,22915280.0,18640486.3
2005-04-11,1181.21,0.01,0.0,1527.46,-22.67,True,1,19401,-1181.21,-4275974.91,22916655.21,18640680.3
2005-04-12,1187.76,6.55,0.56,1527.46,-22.24,True,1,19402,-1187.76,-4277162.67,23044919.52,18767756.85
2005-04-13,1173.79,-13.97,-1.18,1527.46,-23.15,True,1,19403,-1173.79,-4278336.46,22775047.37,18496710.91
2005-04-14,1162.05,-11.74,-1.0,1527.46,-23.92,True,1,19404,-1162.05,-4279498.51,22548418.2,18268919.69
2005-04-15,1142.62,-19.43,-1.67,1527.46,-25.2,True,1,19405,-1142.62,-4280641.13,22172541.1,17891899.97
2005-04-18,1145.98,3.36,0.29,1527.46,-24.98,True,1,19406,-1145.98,-4281787.11,22238887.88,17957100.77
2005-04-19,1152.78,6.8,0.59,1527.46,-24.53,True,1,19407,-1152.78,-4282939.89,22372001.46,18089061.57
2005-04-20,1137.5,-15.28,-1.32,1527.46,-25.53,True,1,19408,-1137.5,-4284077.39,22076600.0,17792522.61
2005-04-21,1159.95,22.45,1.97,1527.46,-24.06,True,1,19409,-1159.95,-4285237.34,22513469.55,18228232.21
2005-04-22,1152.12,-7.83,-0.68,1527.46,-24.57,True,1,19410,-1152.12,-4286389.46,22362649.2,18076259.74
2005-04-25,1162.1,9.98,0.87,1527.46,-23.92,True,1,19411,-1162.1,-4287551.56,22557523.1,18269971.54
2005-04-26,1151.83,-10.27,-0.88,1527.46,-24.59,True,1,19412,-1151.83,-4288703.39,22359323.96,18070620.57
2005-04-27,1156.38,4.55,0.4,1527.46,-24.29,True,1,19413,-1156.38,-4289859.77,22448804.94,18158945.17
2005-04-28,1143.22,-13.16,-1.14,1527.46,-25.16,True,1,19414,-1143.22,-4291002.99,22194473.08,17903470.09
2005-04-29,1156.85,13.63,1.19,1527.46,-24.26,True,1,19415,-1156.85,-4292159.84,22460242.75,18168082.91
2005-05-02,1162.16,5.31,0.46,1527.46,-23.92,True,1,19416,-1162.16,-4293322.0,22564498.56,18271176.56
2005-05-03,1161.17,-0.99,-0.08,1527.46,-23.98,True,1,19417,-1161.17,-4294483.17,22546437.89,18251954.72
2005-05-04,1175.65,14.48,1.25,1527.46,-23.03,True,1,19418,-1175.65,-4295658.82,22828771.7,18533112.88
2005-05-05,1172.63,-3.02,-0.26,1527.46,-23.23,True,1,19419,-1172.63,-4296831.45,22771301.97,18474470.52
2005-05-06,1171.35,-1.28,-0.11,1527.46,-23.31,True,1,19420,-1171.35,-4298002.8,22747617.0,18449614.2
2005-05-09,1178.84,7.49,0.64,1527.46,-22.82,True,1,19421,-1178.84,-4299181.64,22894251.64,18595070.0
2005-05-10,1166.22,-12.62,-1.07,1527.46,-23.65,True,1,19422,-1166.22,-4300347.86,22650324.84,18349976.98
2005-05-11,1171.11,4.89,0.42,1527.46,-23.33,True,1,19423,-1171.11,-4301518.97,22746469.53,18444950.56
2005-05-12,1159.36,-11.75,-1.0,1527.46,-24.1,True,1,19424,-1159.36,-4302678.33,22519408.64,18216730.31
2005-05-13,1154.05,-5.31,-0.46,1527.46,-24.45,True,1,19425,-1154.05,-4303832.38,22417421.25,18113588.87
2005-05-16,1165.69,11.64,1.01,1527.46,-23.68,True,1,19426,-1165.69,-4304998.07,22644693.94,18339695.87
2005-05-17,1173.8,8.11,0.7,1527.46,-23.15,True,1,19427,-1173.8,-4306171.87,22803412.6,18497240.73
2005-05-18,1185.56,11.76,1.0,1527.46,-22.38,True,1,19428,-1185.56,-4307357.43,23033059.68,18725702.25
2005-05-19,1191.08,5.52,0.47,1527.46,-22.02,True,1,19429,-1191.08,-4308548.51,23141493.32,18832944.81
2005-05-20,1189.28,-1.8,-0.15,1527.46,-22.14,True,1,19430,-1189.28,-4309737.79,23107710.4,18797972.61
2005-05-23,1193.86,4.58,0.38,1527.46,-21.84,True,1,19431,-1193.86,-4310931.65,23197893.66,18886962.01
2005-05-24,1194.07,0.21,0.02,1527.46,-21.83,True,1,19432,-1194.07,-4312125.72,23203168.24,18891042.52
2005-05-25,1190.01,-4.06,-0.34,1527.46,-22.09,True,1,19433,-1190.01,-4313315.73,23125464.33,18812148.6
2005-05-26,1197.62,7.61,0.64,1527.46,-21.59,True,1,19434,-1197.62,-4314513.35,23274547.08,18960033.73
2005-05-27,1198.78,1.16,0.1,1527.46,-21.52,True,1,19435,-1198.78,-4315712.13,23298289.3,18982577.17
2005-05-31,1191.5,-7.28,-0.61,1527.46,-22.0,True,1,19436,-1191.5,-4316903.63,23157994.0,18841090.37
2005-06-01,1202.22,10.72,0.9,1527.46,-21.29,True,1,19437,-1202.22,-4318105.85,23367550.14,19049444.29
2005-06-02,1204.29,2.07,0.17,1527.46,-21.16,True,1,19438,-1204.29,-4319310.14,23408989.02,19089678.88
2005-06-03,1196.02,-8.27,-0.69,1527.46,-21.7,True,1,19439,-1196.02,-4320506.16,23249432.78,18928926.62
2005-06-06,1197.51,1.49,0.12,1527.46,-21.6,True,1,19440,-1197.51,-4321703.67,23279594.4,18957890.73
2005-06-07,1197.26,-0.25,-0.02,1527.46,-21.62,True,1,19441,-1197.26,-4322900.93,23275931.66,18953030.73
2005-06-08,1194.67,-2.59,-0.22,1527.46,-21.79,True,1,19442,-1194.67,-4324095.6,23226774.14,18902678.54
2005-06-09,1200.93,6.26,0.52,1527.46,-21.38,True,1,19443,-1200.93,-4325296.53,23349681.99,19024385.46
2005-06-10,1198.11,-2.82,-0.24,1527.46,-21.56,True,1,19444,-1198.11,-4326494.64,23296050.84,18969556.2
2005-06-13,1200.82,2.71,0.23,1527.46,-21.38,True,1,19445,-1200.82,-4327695.46,23349944.9,19022249.44
2005-06-14,1203.91,3.09,0.26,1527.46,-21.18,True,1,19446,-1203.91,-4328899.37,23411233.86,19082334.49
2005-06-15,1206.58,2.67,0.22,1527.46,-21.01,True,1,19447,-1206.58,-4330105.95,23464361.26,19134255.31
2005-06-16,1210.96,4.38,0.36,1527.46,-20.72,True,1,19448,-1210.96,-4331316.91,23550750.08,19219433.17
2005-06-17,1216.96,6.0,0.5,1527.46,-20.33,True,1,19449,-1216.96,-4332533.87,23668655.04,19336121.17
2005-06-20,1216.1,-0.86,-0.07,1527.46,-20.38,True,1,19450,-1216.1,-4333749.97,23653145.0,19319395.03
2005-06-21,1213.61,-2.49,-0.2,1527.46,-20.55,True,1,19451,-1213.61,-4334963.58,23605928.11,19270964.53
2005-06-22,1213.88,0.27,0.02,1527.46,-20.53,True,1,19452,-1213.88,-4336177.46,23612393.76,19276216.3
2005-06-23,1200.73,-13.15,-1.08,1527.46,-21.39,True,1,19453,-1200.73,-4337378.19,23357800.69,19020422.5
2005-06-24,1191.57,-9.16,-0.76,1527.46,-21.99,True,1,19454,-1191.57,-4338569.76,23180802.78,18842233.02
2005-06-27,1190.69,-0.88,-0.07,1527.46,-22.05,True,1,19455,-1190.69,-4339760.45,23164873.95,18825113.5
2005-06-28,1201.57,10.88,0.91,1527.46,-21.34,True,1,19456,-1201.57,-4340962.02,23377745.92,19036783.9
2005-06-29,1199.85,-1.72,-0.14,1527.46,-21.45,True,1,19457,-1199.85,-4342161.87,23345481.45,19003319.58
2005-06-30,1191.33,-8.52,-0.71,1527.46,-22.01,True,1,19458,-1191.33,-4343353.2,23180899.14,18837545.94
2005-07-01,1194.44,3.11,0.26,1527.46,-21.8,True,1,19459,-1194.44,-4344547.64,23242607.96,18898060.32
2005-07-05,1204.99,10.55,0.88,1527.46,-21.11,True,1,19460,-1204.99,-4345752.63,23449105.4,19103352.77
2005-07-06,1194.94,-10.05,-0.83,1527.46,-21.77,True,1,19461,-1194.94,-4346947.57,23254727.34,18907779.77
2005-07-07,1197.87,2.93,0.24,1527.46,-21.58,True,1,19462,-1197.87,-4348145.44,23312945.94,18964800.5
2005-07-08,1211.86,13.99,1.17,1527.46,-20.66,True,1,19463,-1211.86,-4349357.3,23586431.18,19237073.88
2005-07-11,1219.44,7.58,0.62,1527.46,-20.17,True,1,19464,-1219.44,-4350576.74,23735180.16,19384603.42
2005-07-12,1222.21,2.77,0.23,1527.46,-19.98,True,1,19465,-1222.21,-4351798.95,23790317.65,19438518.7
2005-07-13,1223.29,1.08,0.09,1527.46,-19.91,True,1,19466,-1223.29,-4353022.24,23812563.14,19459540.9
2005-07-14,1226.5,3.21,0.26,1527.46,-19.7,True,1,19467,-1226.5,-4354248.74,23876275.5,19522026.76
2005-07-15,1227.92,1.42,0.12,1527.46,-19.61,True,1,19468,-1227.92,-4355476.66,23905146.56,19549669.9
2005-07-18,1221.13,-6.79,-0.55,1527.46,-20.06,True,1,19469,-1221.13,-4356697.79,23774179.97,19417482.18
2005-07-19,1229.35,8.22,0.67,1527.46,-19.52,True,1,19470,-1229.35,-4357927.14,23935444.5,19577517.36
2005-07-20,1235.2,5.85,0.48,1527.46,-19.13,True,1,19471,-1235.2,-4359162.34,24050579.2,19691416.86
2005-07-21,1227.04,-8.16,-0.66,1527.46,-19.67,True,1,19472,-1227.04,-4360389.38,23892922.88,19532533.5
2005-07-22,1233.68,6.64,0.54,1527.46,-19.23,True,1,19473,-1233.68,-4361623.06,24023450.64,19661827.58
2005-07-25,1229.03,-4.65,-0.38,1527.46,-19.54,True,1,19474,-1229.03,-4362852.09,23934130.22,19571278.13
2005-07-26,1231.16,2.13,0.17,1527.46,-19.4,True,1,19475,-1231.16,-4364083.25,23976841.0,19612757.75
2005-07-27,1236.79,5.63,0.46,1527.46,-19.03,True,1,19476,-1236.79,-4365320.04,24087722.04,19722402.0
2005-07-28,1243.72,6.93,0.56,1527.46,-18.58,True,1,19477,-1243.72,-4366563.76,24223934.44,19857370.68
2005-07-29,1234.18,-9.54,-0.77,1527.46,-19.2,True,1,19478,-1234.18,-4367797.94,24039358.04,19671560.1
2005-08-01,1235.35,1.17,0.1,1527.46,-19.12,True,1,19479,-1235.35,-4369033.29,24063382.65,19694349.36
2005-08-02,1244.12,8.77,0.71,1527.46,-18.55,True,1,19480,-1244.12,-4370277.41,24235457.6,19865180.19
2005-08-03,1245.04,0.92,0.07,1527.46,-18.49,True,1,19481,-1245.04,-4371522.45,24254624.24,19883101.79
2005-08-04,1235.86,-9.18,-0.74,1527.46,-19.09,True,1,19482,-1235.86,-4372758.31,24077024.52,19704266.21
2005-08-05,1226.42,-9.44,-0.76,1527.46,-19.71,True,1,19483,-1226.42,-4373984.73,23894340.86,19520356.13
2005-08-08,1223.13,-3.29,-0.27,1527.46,-19.92,True,1,19484,-1223.13,-4375207.86,23831464.92,19456257.06
2005-08-09,1231.38,8.25,0.67,1527.46,-19.38,True,1,19485,-1231.38,-4376439.24,23993439.3,19617000.06
2005-08-10,1229.13,-2.25,-0.18,1527.46,-19.53,True,1,19486,-1229.13,-4377668.37,23950827.18,19573158.81
2005-08-11,1237.81,8.68,0.71,1527.46,-18.96,True,1,19487,-1237.81,-4378906.18,24121203.47,19742297.29
2005-08-12,1230.39,-7.42,-0.6,1527.46,-19.45,True,1,19488,-1230.39,-4380136.57,23977840.32,19597703.75
2005-08-15,1233.87,3.48,0.28,1527.46,-19.22,True,1,19489,-1233.87,-4381370.44,24046892.43,19665521.99
2005-08-16,1219.34,-14.53,-1.18,1527.46,-20.17,True,1,19490,-1219.34,-4382589.78,23764936.6,19382346.82
2005-08-17,1220.24,0.9,0.07,1527.46,-20.11,True,1,19491,-1220.24,-4383810.02,23783697.84,19399887.82
2005-08-18,1219.02,-1.22,-0.1,1527.46,-20.19,True,1,19492,-1219.02,-4385029.04,23761137.84,19376108.8
2005-08-19,1219.71,0.69,0.06,1527.46,-20.15,True,1,19493,-1219.71,-4386248.75,23775807.03,19389558.28
2005-08-22,1221.73,2.02,0.17,1527.46,-20.02,True,1,19494,-1221.73,-4387470.48,23816404.62,19428934.14
2005-08-23,1217.59,-4.14,-0.34,1527.46,-20.29,True,1,19495,-1217.59,-4388688.07,23736917.05,19348228.98
2005-08-24,1209.59,-8.0,-0.66,1527.46,-20.81,True,1,19496,-1209.59,-4389897.66,23582166.64,19192268.98
2005-08-25,1212.37,2.78,0.23,1527.46,-20.63,True,1,19497,-1212.37,-4391110.03,23637577.89,19246467.86
2005-08-26,1205.1,-7.27,-0.6,1527.46,-21.1,True,1,19498,-1205.1,-4392315.13,23497039.8,19104724.67
2005-08-29,1212.28,7.18,0.6,1527.46,-20.63,True,1,19499,-1212.28,-4393527.41,23638247.72,19244720.31
2005-08-30,1208.41,-3.87,-0.32,1527.46,-20.89,True,1,19500,-1208.41,-4394735.82,23563995.0,19169259.18
2005-08-31,1220.33,11.92,0.99,1527.46,-20.11,True,1,19501,-1220.33,-4395956.15,23797655.33,19401699.18
2005-09-01,1221.59,1.26,0.1,1527.46,-20.02,True,1,19502,-1221.59,-4397177.74,23823448.18,19426270.44
2005-09-02,1218.02,-3.57,-0.29,1527.46,-20.26,True,1,19503,-1218.02,-4398395.76,23755044.06,19356648.3
2005-09-06,1233.39,15.37,1.26,1527.46,-19.25,True,1,19504,-1233.39,-4399629.15,24056038.56,19656409.41
2005-09-07,1236.36,2.97,0.24,1527.46,-19.06,True,1,19505,-1236.36,-4400865.51,24115201.8,19714336.29
2005-09-08,1231.67,-4.69,-0.38,1527.46,-19.36,True,1,19506,-1231.67,-4402097.18,24024955.02,19622857.84
2005-09-09,1241.48,9.81,0.8,1527.46,-18.72,True,1,19507,-1241.48,-4403338.66,24217550.36,19814211.7
2005-09-12,1240.56,-0.92,-0.07,1527.46,-18.78,True,1,19508,-1240.56,-4404579.22,24200844.48,19796265.26
2005-09-13,1231.2,-9.36,-0.76,1527.46,-19.4,True,1,19509,-1231.2,-4405810.42,24019480.8,19613670.38
2005-09-14,1227.16,-4.04,-0.33,1527.46,-19.66,True,1,19510,-1227.16,-4407037.58,23941891.6,19534854.02
2005-09-15,1227.73,0.57,0.05,1527.46,-19.62,True,1,19511,-1227.73,-4408265.31,23954240.03,19545974.72
2005-09-16,1237.91,10.18,0.83,1527.46,-18.96,True,1,19512,-1237.91,-4409503.22,24154099.92,19744596.7
2005-09-19,1231.02,-6.89,-0.56,1527.46,-19.41,True,1,19513,-1231.02,-4410734.24,24020893.26,19610159.02
2005-09-20,1221.34,-9.68,-0.79,1527.46,-20.04,True,1,19514,-1221.34,-4411955.58,23833228.76,19421273.18
2005-09-21,1210.2,-11.14,-0.91,1527.46,-20.77,True,1,19515,-1210.2,-4413165.78,23617053.0,19203887.22
2005-09-22,1214.62,4.42,0.36,1527.46,-20.48,True,1,19516,-1214.62,-4414380.4,23704523.92,19290143.52
2005-09-23,1215.29,0.67,0.06,1527.46,-20.44,True,1,19517,-1215.29,-4415595.69,23718814.93,19303219.24
2005-09-26,1215.63,0.34,0.03,1527.46,-20.42,True,1,19518,-1215.63,-4416811.32,23726666.34,19309855.02
2005-09-27,1215.66,0.03,0.0,1527.46,-20.41,True,1,19519,-1215.66,-4418026.98,23728467.54,19310440.56
2005-09-28,1216.89,1.23,0.1,1527.46,-20.33,True,1,19520,-1216.89,-4419243.87,23753692.8,19334448.93
2005-09-29,1227.68,10.79,0.89,1527.46,-19.63,True,1,19521,-1227.68,-4420471.55,23965541.28,19545069.73
2005-09-30,1228.81,1.13,0.09,1527.46,-19.55,True,1,19522,-1228.81,-4421700.36,23988828.82,19567128.46
2005-10-03,1226.7,-2.11,-0.17,1527.46,-19.69,True,1,19523,-1226.7,-4422927.06,23948864.1,19525937.04
2005-10-04,1214.47,-12.23,-1.0,1527.46,-20.49,True,1,19524,-1214.47,-4424141.53,23711312.28,19287170.75
2005-10-05,1196.39,-18.08,-1.49,1527.46,-21.68,True,1,19525,-1196.39,-4425337.92,23359514.75,18934176.83
2005-10-06,1191.49,-4.9,-0.41,1527.46,-22.0,True,1,19526,-1191.49,-4426529.41,23265033.74,18838504.33
2005-10-07,1195.9,4.41,0.37,1527.46,-21.71,True,1,19527,-1195.9,-4427725.31,23352339.3,18924613.99
2005-10-10,1187.33,-8.57,-0.72,1527.46,-22.27,True,1,19528,-1187.33,-4428912.64,23186180.24,18757267.6
2005-10-11,1184.87,-2.46,-0.21,1527.46,-22.43,True,1,19529,-1184.87,-4430097.51,23139326.23,18709228.72
2005-10-12,1177.68,-7.19,-0.61,1527.46,-22.9,True,1,19530,-1177.68,-4431275.19,23000090.4,18568815.21
2005-10-13,1176.84,-0.84,-0.07,1527.46,-22.95,True,1,19531,-1176.84,-4432452.03,22984862.04,18552410.01
2005-10-14,1186.57,9.73,0.83,1527.46,-22.32,True,1,19532,-1186.57,-4433638.6,23176085.24,18742446.64
2005-10-17,1190.1,3.53,0.3,1527.46,-22.09,True,1,19533,-1190.1,-4434828.7,23246223.3,18811394.6
2005-10-18,1178.14,-11.96,-1.0,1527.46,-22.87,True,1,19534,-1178.14,-4436006.84,23013786.76,18577779.92
2005-10-19,1195.76,17.62,1.5,1527.46,-21.72,True,1,19535,-1195.76,-4437202.6,23359171.6,18921969.0
2005-10-20,1177.8,-17.96,-1.5,1527.46,-22.89,True,1,19536,-1177.8,-4438380.4,23009500.8,18571120.4
2005-10-21,1179.59,1.79,0.15,1527.46,-22.77,True,1,19537,-1179.59,-4439559.99,23045649.83,18606089.84
2005-10-24,1199.38,19.79,1.68,1527.46,-21.48,True,1,19538,-1199.38,-4440759.37,23433486.44,18992727.07
2005-10-25,1196.54,-2.84,-0.24,1527.46,-21.66,True,1,19539,-1196.54,-4441955.91,23379195.06,18937239.15
2005-10-26,1191.38,-5.16,-0.43,1527.46,-22.0,True,1,19540,-1191.38,-4443147.29,23279565.2,18836417.91
2005-10-27,1178.9,-12.48,-1.05,1527.46,-22.82,True,1,19541,-1178.9,-4444326.19,23036884.9,18592558.71
2005-10-28,1198.41,19.51,1.66,1527.46,-21.54,True,1,19542,-1198.41,-4445524.6,23419328.22,18973803.62
2005-10-31,1207.01,8.6,0.72,1527.46,-20.98,True,1,19543,-1207.01,-4446731.61,23588596.43,19141864.82
2005-11-01,1202.76,-4.25,-0.35,1527.46,-21.26,True,1,19544,-1202.76,-4447934.37,23506741.44,19058807.07
2005-11-02,1214.76,12.0,1.0,1527.46,-20.47,True,1,19545,-1214.76,-4449149.13,23742484.2,19293335.07
2005-11-03,1219.94,5.18,0.43,1527.46,-20.13,True,1,19546,-1219.94,-4450369.07,23844947.24,19394578.17
2005-11-04,1220.14,0.2,0.02,1527.46,-20.12,True,1,19547,-1220.14,-4451589.21,23850076.58,19398487.37
2005-11-07,1222.81,2.67,0.22,1527.46,-19.94,True,1,19548,-1222.81,-4452812.02,23903489.88,19450677.86
2005-11-08,1218.59,-4.22,-0.34,1527.46,-20.22,True,1,19549,-1218.59,-4454030.61,23822215.91,19368185.3
2005-11-09,1220.65,2.06,0.17,1527.46,-20.09,True,1,19550,-1220.65,-4455251.26,23863707.5,19408456.24
2005-11-10,1230.96,10.31,0.84,1527.46,-19.41,True,1,19551,-1230.96,-4456482.22,24066498.96,19610016.74
2005-11-11,1234.72,3.76,0.3,1527.46,-19.16,True,1,19552,-1234.72,-4457716.94,24141245.44,19683528.5
2005-11-14,1233.76,-0.96,-0.08,1527.46,-19.23,True,1,19553,-1233.76,-4458950.7,24123709.28,19664758.58
2005-11-15,1229.01,-4.75,-0.38,1527.46,-19.54,True,1,19554,-1229.01,-4460179.71,24032061.54,19571881.83
2005-11-16,1231.21,2.2,0.18,1527.46,-19.4,True,1,19555,-1231.21,-4461410.92,24076311.55,19614900.63
2005-11-17,1242.8,11.59,0.94,1527.46,-18.64,True,1,19556,-1242.8,-4462653.72,24304196.8,19841543.08
2005-11-18,1248.27,5.47,0.44,1527.46,-18.28,True,1,19557,-1248.27,-4463901.99,24412416.39,19948514.4
2005-11-21,1254.85,6.58,0.53,1527.46,-17.85,True,1,19558,-1254.85,-4465156.84,24542356.3,20077199.46
2005-11-22,1261.23,6.38,0.51,1527.46,-17.43,True,1,19559,-1261.23,-4466418.07,24668397.57,20201979.5
2005-11-23,1265.61,4.38,0.35,1527.46,-17.14,True,1,19560,-1265.61,-4467683.68,24755331.6,20287647.92
2005-11-25,1268.25,2.64,0.21,1527.46,-16.97,True,1,19561,-1268.25,-4468951.93,24808238.25,20339286.32
2005-11-28,1257.46,-10.79,-0.85,1527.46,-17.68,True,1,19562,-1257.46,-4470209.39,24598432.52,20128223.13
2005-11-29,1257.48,0.02,0.0,1527.46,-17.68,True,1,19563,-1257.48,-4471466.87,24600081.24,20128614.37
2005-11-30,1249.48,-8.0,-0.64,1527.46,-18.2,True,1,19564,-1249.48,-4472716.35,24444826.72,19972110.37
2005-12-01,1264.67,15.19,1.22,1527.46,-17.2,True,1,19565,-1264.67,-4473981.02,24743268.55,20269287.53
2005-12-02,1265.08,0.41,0.03,1527.46,-17.18,True,1,19566,-1265.08,-4475246.1,24752555.28,20277309.18
2005-12-05,1262.09,-2.99,-0.24,1527.46,-17.37,True,1,19567,-1262.09,-4476508.19,24695315.03,20218806.84
2005-12-06,1263.7,1.61,0.13,1527.46,-17.27,True,1,19568,-1263.7,-4477771.89,24728081.6,20250309.71
2005-12-07,1257.37,-6.33,-0.5,1527.46,-17.68,True,1,19569,-1257.37,-4479029.26,24605473.53,20126444.27
2005-12-08,1255.84,-1.53,-0.12,1527.46,-17.78,True,1,19570,-1255.84,-4480285.1,24576788.8,20096503.7
2005-12-09,1259.37,3.53,0.28,1527.46,-17.55,True,1,19571,-1259.37,-4481544.47,24647130.27,20165585.8
2005-12-12,1260.43,1.06,0.08,1527.46,-17.48,True,1,19572,-1260.43,-4482804.9,24669135.96,20186331.06
2005-12-13,1267.43,7.0,0.56,1527.46,-17.02,True,1,19573,-1267.43,-4484072.33,24807407.39,20323335.06
2005-12-14,1272.74,5.31,0.42,1527.46,-16.68,True,1,19574,-1272.74,-4485345.07,24912612.76,20427267.69
2005-12-15,1270.94,-1.8,-0.14,1527.46,-16.79,True,1,19575,-1270.94,-4486616.01,24878650.5,20392034.49
2005-12-16,1267.32,-3.62,-0.28,1527.46,-17.03,True,1,19576,-1267.32,-4487883.33,24809056.32,20321172.99
2005-12-19,1259.92,-7.4,-0.58,1527.46,-17.52,True,1,19577,-1259.92,-4489143.25,24665453.84,20176310.59
2005-12-20,1259.62,-0.3,-0.02,1527.46,-17.54,True,1,19578,-1259.62,-4490402.87,24660840.36,20170437.49
2005-12-21,1262.79,3.17,0.25,1527.46,-17.33,True,1,19579,-1262.79,-4491665.66,24724165.41,20232499.75
2005-12-22,1268.12,5.33,0.42,1527.46,-16.98,True,1,19580,-1268.12,-4492933.78,24829789.6,20336855.82
2005-12-23,1268.66,0.54,0.04,1527.46,-16.94,True,1,19581,-1268.66,-4494202.44,24841631.46,20347429.02
2005-12-27,1256.54,-12.12,-0.96,1527.46,-17.74,True,1,19582,-1256.54,-4495458.98,24605566.28,20110107.3
2005-12-28,1258.17,1.63,0.13,1527.46,-17.63,True,1,19583,-1258.17,-4496717.15,24638743.11,20142025.96
2005-12-29,1254.42,-3.75,-0.3,1527.46,-17.88,True,1,19584,-1254.42,-4497971.57,24566561.28,20068589.71
2005-12-30,1248.29,-6.13,-0.49,1527.46,-18.28,True,1,19585,-1248.29,-4499219.86,24447759.65,19948539.79
2006-01-03,1268.8,20.51,1.64,1527.46,-16.93,True,1,19586,-1268.8,-4500488.66,24850716.8,20350228.14
2006-01-04,1273.46,4.66,0.37,1527.46,-16.63,True,1,19587,-1273.46,-4501762.12,24943261.02,20441498.9
2006-01-05,1273.48,0.02,0.0,1527.46,-16.63,True,1,19588,-1273.48,-4503035.6,24944926.24,20441890.64
2006-01-06,1285.45,11.97,0.94,1527.46,-15.84,True,1,19589,-1285.45,-4504321.05,25180680.05,20676359.0
2006-01-09,1290.15,4.7,0.37,1527.46,-15.54,True,1,19590,-1290.15,-4505611.2,25274038.5,20768427.3
2006-01-10,1289.69,-0.46,-0.04,1527.46,-15.57,True,1,19591,-1289.69,-4506900.89,25266316.79,20759415.9
2006-01-11,1294.18,4.49,0.35,1527.46,-15.27,True,1,19592,-1294.18,-4508195.07,25355574.56,20847379.49
2006-01-12,1286.06,-8.12,-0.63,1527.46,-15.8,True,1,19593,-1286.06,-4509481.13,25197773.58,20688292.45
2006-01-13,1287.61,1.55,0.12,1527.46,-15.7,True,1,19594,-1287.61,-4510768.74,25229430.34,20718661.6
2006-01-17,1282.93,-4.68,-0.36,1527.46,-16.01,True,1,19595,-1282.93,-4512051.67,25139013.35,20626961.68
2006-01-18,1277.93,-5.0,-0.39,1527.46,-16.34,True,1,19596,-1277.93,-4513329.6,25042316.28,20528986.68
2006-01-19,1285.04,7.11,0.56,1527.46,-15.87,True,1,19597,-1285.04,-4514614.64,25182928.88,20668314.24
2006-01-20,1261.49,-23.55,-1.83,1527.46,-17.41,True,1,19598,-1261.49,-4515876.13,24722681.02,20206804.89
2006-01-23,1263.82,2.33,0.18,1527.46,-17.26,True,1,19599,-1263.82,-4517139.95,24769608.18,20252468.23
2006-01-24,1266.86,3.04,0.24,1527.46,-17.06,True,1,19600,-1266.86,-4518406.81,24830456.0,20312049.19
2006-01-25,1264.68,-2.18,-0.17,1527.46,-17.2,True,1,19601,-1264.68,-4519671.49,24788992.68,20269321.19
2006-01-26,1273.83,9.15,0.72,1527.46,-16.6,True,1,19602,-1273.83,-4520945.32,24969615.66,20448670.34
2006-01-27,1283.72,9.89,0.78,1527.46,-15.96,True,1,19603,-1283.72,-4522229.04,25164763.16,20642534.12
2006-01-30,1285.19,1.47,0.12,1527.46,-15.86,True,1,19604,-1285.19,-4523514.23,25194864.76,20671350.53
2006-01-31,1280.08,-5.11,-0.4,1527.46,-16.2,True,1,19605,-1280.08,-4524794.31,25095968.4,20571174.09
2006-02-01,1282.46,2.38,0.19,1527.46,-16.04,True,1,19606,-1282.46,-4526076.77,25143910.76,20617833.99
2006-02-02,1270.84,-11.62,-0.91,1527.46,-16.8,True,1,19607,-1270.84,-4527347.61,24917359.88,20390012.27
2006-02-03,1264.03,-6.81,-0.54,1527.46,-17.25,True,1,19608,-1264.03,-4528611.64,24785100.24,20256488.6
2006-02-06,1265.02,0.99,0.08,1527.46,-17.18,True,1,19609,-1265.02,-4529876.66,24805777.18,20275900.52
2006-02-07,1254.78,-10.24,-0.81,1527.46,-17.85,True,1,19610,-1254.78,-4531131.44,24606235.8,20075104.36
2006-02-08,1265.65,10.87,0.87,1527.46,-17.14,True,1,19611,-1265.65,-4532397.09,24820662.15,20288265.06
2006-02-09,1263.78,-1.87,-0.15,1527.46,-17.26,True,1,19612,-1263.78,-4533660.87,24785253.36,20251592.49
2006-02-10,1266.99,3.21,0.25,1527.46,-17.05,True,1,19613,-1266.99,-4534927.86,24849474.87,20314547.01
2006-02-13,1262.86,-4.13,-0.33,1527.46,-17.32,True,1,19614,-1262.86,-4536190.72,24769736.04,20233545.32
2006-02-14,1275.53,12.67,1.0,1527.46,-16.49,True,1,19615,-1275.53,-4537466.25,25019520.95,20482054.7
2006-02-15,1280.0,4.47,0.35,1527.46,-16.2,True,1,19616,-1280.0,-4538746.25,25108480.0,20569733.75
2006-02-16,1289.38,9.38,0.73,1527.46,-15.59,True,1,19617,-1289.38,-4540035.63,25293767.46,20753731.83
2006-02-17,1287.24,-2.14,-0.17,1527.46,-15.73,True,1,19618,-1287.24,-4541322.87,25253074.32,20711751.45
2006-02-21,1283.03,-4.21,-0.33,1527.46,-16.0,True,1,19619,-1283.03,-4542605.9,25171765.57,20629159.67
2006-02-22,1292.67,9.64,0.75,1527.46,-15.37,True,1,19620,-1292.67,-4543898.57,25362185.4,20818286.83
2006-02-23,1287.79,-4.88,-0.38,1527.46,-15.69,True,1,19621,-1287.79,-4545186.36,25267727.59,20722541.23
2006-02-24,1289.43,1.64,0.13,1527.46,-15.58,True,1,19622,-1289.43,-4546475.79,25301195.46,20754719.67
2006-02-27,1294.12,4.69,0.36,1527.46,-15.28,True,1,19623,-1294.12,-4547769.91,25394516.76,20846746.85
2006-02-28,1280.66,-13.46,-1.04,1527.46,-16.16,True,1,19624,-1280.66,-4549050.57,25131671.84,20582621.27
2006-03-01,1291.24,10.58,0.83,1527.46,-15.46,True,1,19625,-1291.24,-4550341.81,25340585.0,20790243.19
2006-03-02,1289.14,-2.1,-0.16,1527.46,-15.6,True,1,19626,-1289.14,-4551630.95,25300661.64,20749030.69
2006-03-03,1287.23,-1.91,-0.15,1527.46,-15.73,True,1,19627,-1287.23,-4552918.18,25264463.21,20711545.03
2006-03-06,1278.26,-8.97,-0.7,1527.46,-16.32,True,1,19628,-1278.26,-4554196.44,25089687.28,20535490.84
2006-03-07,1275.88,-2.38,-0.19,1527.46,-16.47,True,1,19629,-1275.88,-4555472.32,25044248.52,20488776.2
2006-03-08,1278.47,2.59,0.2,1527.46,-16.3,True,1,19630,-1278.47,-4556750.79,25096366.1,20539615.31
2006-03-09,1272.23,-6.24,-0.49,1527.46,-16.71,True,1,19631,-1272.23,-4558023.02,24975147.13,20417124.11
2006-03-10,1281.42,9.19,0.72,1527.46,-16.11,True,1,19632,-1281.42,-4559304.44,25156837.44,20597533.0
2006-03-13,1284.13,2.71,0.21,1527.46,-15.93,True,1,19633,-1284.13,-4560588.57,25211324.29,20650735.72
2006-03-14,1297.48,13.35,1.04,1527.46,-15.06,True,1,19634,-1297.48,-4561886.05,25474722.32,20912836.27
2006-03-15,1303.02,5.54,0.43,1527.46,-14.69,True,1,19635,-1303.02,-4563189.07,25584797.7,21021608.63
2006-03-16,1305.33,2.31,0.18,1527.46,-14.54,True,1,19636,-1305.33,-4564494.4,25631459.88,21066965.48
2006-03-17,1307.25,1.92,0.15,1527.46,-14.42,True,1,19637,-1307.25,-4565801.65,25670468.25,21104666.6
2006-03-20,1305.08,-2.17,-0.17,1527.46,-14.56,True,1,19638,-1305.08,-4567106.73,25629161.04,21062054.31
2006-03-21,1297.23,-7.85,-0.6,1527.46,-15.07,True,1,19639,-1297.23,-4568403.96,25476299.97,20907896.01
2006-03-22,1305.04,7.81,0.6,1527.46,-14.56,True,1,19640,-1305.04,-4569709.0,25630985.6,21061276.6
2006-03-23,1301.67,-3.37,-0.26,1527.46,-14.78,True,1,19641,-1301.67,-4571010.67,25566100.47,20995089.8
2006-03-24,1302.95,1.28,0.1,1527.46,-14.7,True,1,19642,-1302.95,-4572313.62,25592543.9,21020230.28
2006-03-27,1301.61,-1.34,-0.1,1527.46,-14.79,True,1,19643,-1301.61,-4573615.23,25567525.23,20993910.0
2006-03-28,1293.23,-8.38,-0.64,1527.46,-15.34,True,1,19644,-1293.23,-4574908.46,25404210.12,20829301.66
2006-03-29,1302.89,9.66,0.75,1527.46,-14.7,True,1,19645,-1302.89,-4576211.35,25595274.05,21019062.7
2006-03-30,1300.25,-2.64,-0.2,1527.46,-14.88,True,1,19646,-1300.25,-4577511.6,25544711.5,20967199.9
2006-03-31,1294.87,-5.38,-0.41,1527.46,-15.23,True,1,19647,-1294.87,-4578806.47,25440310.89,20861504.42
2006-04-03,1297.81,2.94,0.23,1527.46,-15.04,True,1,19648,-1297.81,-4580104.28,25499370.88,20919266.6
2006-04-04,1305.93,8.12,0.63,1527.46,-14.5,True,1,19649,-1305.93,-4581410.21,25660218.57,21078808.36
2006-04-05,1311.56,5.63,0.43,1527.46,-14.14,True,1,19650,-1311.56,-4582721.77,25772154.0,21189432.23
2006-04-06,1309.04,-2.52,-0.19,1527.46,-14.3,True,1,19651,-1309.04,-4584030.81,25723945.04,21139914.23
2006-04-07,1295.5,-13.54,-1.03,1527.46,-15.19,True,1,19652,-1295.5,-4585326.31,25459166.0,20873839.69
2006-04-10,1296.62,1.12,0.09,1527.46,-15.11,True,1,19653,-1296.62,-4586622.93,25482472.86,20895849.93
2006-04-11,1286.57,-10.05,-0.78,1527.46,-15.77,True,1,19654,-1286.57,-4587909.5,25286246.78,20698337.28
2006-04-12,1288.12,1.55,0.12,1527.46,-15.67,True,1,19655,-1288.12,-4589197.62,25317998.6,20728800.98
2006-04-13,1289.12,1.0,0.08,1527.46,-15.6,True,1,19656,-1289.12,-4590486.74,25338942.72,20748455.98
2006-04-17,1285.33,-3.79,-0.29,1527.46,-15.85,True,1,19657,-1285.33,-4591772.07,25265731.81,20673959.74
2006-04-18,1307.28,21.95,1.71,1527.46,-14.42,True,1,19658,-1307.28,-4593079.35,25698510.24,21105430.89
2006-04-19,1309.93,2.65,0.2,1527.46,-14.24,True,1,19659,-1309.93,-4594389.28,25751913.87,21157524.59
2006-04-20,1311.46,1.53,0.12,1527.46,-14.14,True,1,19660,-1311.46,-4595700.74,25783303.6,21187602.86
2006-04-21,1311.28,-0.18,-0.01,1527.46,-14.15,True,1,19661,-1311.28,-4597012.02,25781076.08,21184064.06
2006-04-24,1308.11,-3.17,-0.24,1527.46,-14.36,True,1,19662,-1308.11,-4598320.13,25720058.82,21121738.69
2006-04-25,1301.74,-6.37,-0.49,1527.46,-14.78,True,1,19663,-1301.74,-4599621.87,25596113.62,20996491.75
2006-04-26,1305.41,3.67,0.28,1527.46,-14.54,True,1,19664,-1305.41,-4600927.28,25669582.24,21068654.96
2006-04-27,1309.72,4.31,0.33,1527.46,-14.26,True,1,19665,-1309.72,-4602237.0,25755643.8,21153406.8
2006-04-28,1310.61,0.89,0.07,1527.46,-14.2,True,1,19666,-1310.61,-4603547.61,25774456.26,21170908.65
2006-05-01,1305.19,-5.42,-0.41,1527.46,-14.55,True,1,19667,-1305.19,-4604852.8,25669171.73,21064318.93
2006-05-02,1313.21,8.02,0.61,1527.46,-14.03,True,1,19668,-1313.21,-4606166.01,25828214.28,21222048.27
2006-05-03,1308.12,-5.09,-0.39,1527.46,-14.36,True,1,19669,-1308.12,-4607474.13,25729412.28,21121938.15
2006-05-04,1312.25,4.13,0.32,1527.46,-14.09,True,1,19670,-1312.25,-4608786.38,25811957.5,21203171.12
2006-05-05,1325.76,13.51,1.03,1527.46,-13.2,True,1,19671,-1325.76,-4610112.14,26079024.96,21468912.82
2006-05-08,1324.66,-1.1,-0.08,1527.46,-13.28,True,1,19672,-1324.66,-4611436.8,26058711.52,21447274.72
2006-05-09,1325.14,0.48,0.04,1527.46,-13.25,True,1,19673,-1325.14,-4612761.94,26069479.22,21456717.28
2006-05-10,1322.85,-2.29,-0.17,1527.46,-13.4,True,1,19674,-1322.85,-4614084.79,26025750.9,21411666.11
2006-05-11,1305.92,-16.93,-1.28,1527.46,-14.5,True,1,19675,-1305.92,-4615390.71,25693976.0,21078585.29
2006-05-12,1291.24,-14.68,-1.12,1527.46,-15.46,True,1,19676,-1291.24,-4616681.95,25406438.24,20789756.29
2006-05-15,1294.5,3.26,0.25,1527.46,-15.25,True,1,19677,-1294.5,-4617976.45,25471876.5,20853900.05
2006-05-16,1292.08,-2.42,-0.19,1527.46,-15.41,True,1,19678,-1292.08,-4619268.53,25425550.24,20806281.71
2006-05-17,1270.32,-21.76,-1.68,1527.46,-16.83,True,1,19679,-1270.32,-4620538.85,24998627.28,20378088.43
2006-05-18,1261.81,-8.51,-0.67,1527.46,-17.39,True,1,19680,-1261.81,-4621800.66,24832420.8,20210620.14
2006-05-19,1267.03,5.22,0.41,1527.46,-17.05,True,1,19681,-1267.03,-4623067.69,24936417.43,20313349.74
2006-05-22,1262.07,-4.96,-0.39,1527.46,-17.38,True,1,19682,-1262.07,-4624329.76,24840061.74,20215731.98
2006-05-23,1256.58,-5.49,-0.44,1527.46,-17.73,True,1,19683,-1256.58,-4625586.34,24733264.14,20107677.8
2006-05-24,1258.57,1.99,0.16,1527.46,-17.6,True,1,19684,-1258.57,-4626844.91,24773691.88,20146846.97
2006-05-25,1272.88,14.31,1.14,1527.46,-16.67,True,1,19685,-1272.88,-4628117.79,25056642.8,20428525.01
2006-05-26,1280.16,7.28,0.57,1527.46,-16.19,True,1,19686,-1280.16,-4629397.95,25201229.76,20571831.81
2006-05-30,1259.87,-20.29,-1.58,1527.46,-17.52,True,1,19687,-1259.87,-4630657.82,24803060.69,20172402.87
2006-05-31,1270.09,10.22,0.81,1527.46,-16.85,True,1,19688,-1270.09,-4631927.91,25005531.92,20373604.01
2006-06-01,1285.71,15.62,1.23,1527.46,-15.83,True,1,19689,-1285.71,-4633213.62,25314344.19,20681130.57
2006-06-02,1288.22,2.51,0.2,1527.46,-15.66,True,1,19690,-1288.22,-4634501.84,25365051.8,20730549.96
2006-06-05,1265.29,-22.93,-1.78,1527.46,-17.16,True,1,19691,-1265.29,-4635767.13,24914825.39,20279058.26
2006-06-06,1263.85,-1.44,-0.11,1527.46,-17.26,True,1,19692,-1263.85,-4637030.98,24887734.2,20250703.22
2006-06-07,1256.15,-7.7,-0.61,1527.46,-17.76,True,1,19693,-1256.15,-4638287.13,24737361.95,20099074.82
2006-06-08,1257.93,1.78,0.14,1527.46,-17.65,True,1,19694,-1257.93,-4639545.06,24773673.42,20134128.36
2006-06-09,1252.3,-5.63,-0.45,1527.46,-18.01,True,1,19695,-1252.3,-4640797.36,24664048.5,20023251.14
2006-06-12,1237.44,-14.86,-1.19,1527.46,-18.99,True,1,19696,-1237.44,-4642034.8,24372618.24,19730583.44
2006-06-13,1223.69,-13.75,-1.11,1527.46,-19.89,True,1,19697,-1223.69,-4643258.49,24103021.93,19459763.44
2006-06-14,1230.04,6.35,0.52,1527.46,-19.47,True,1,19698,-1230.04,-4644488.53,24229327.92,19584839.39
2006-06-15,1256.16,26.12,2.12,1527.46,-17.76,True,1,19699,-1256.16,-4645744.69,24745095.84,20099351.15
2006-06-16,1251.54,-4.62,-0.37,1527.46,-18.06,True,1,19700,-1251.54,-4646996.23,24655338.0,20008341.77
2006-06-19,1240.13,-11.41,-0.91,1527.46,-18.81,True,1,19701,-1240.13,-4648236.36,24431801.13,19783564.77
2006-06-20,1240.12,-0.01,-0.0,1527.46,-18.81,True,1,19702,-1240.12,-4649476.48,24432844.24,19783367.76
2006-06-21,1252.2,12.08,0.97,1527.46,-18.02,True,1,19703,-1252.2,-4650728.68,24672096.6,20021367.92
2006-06-22,1245.6,-6.6,-0.53,1527.46,-18.45,True,1,19704,-1245.6,-4651974.28,24543302.4,19891328.12
2006-06-23,1244.5,-1.1,-0.09,1527.46,-18.52,True,1,19705,-1244.5,-4653218.78,24522872.5,19869653.72
2006-06-26,1250.56,6.06,0.49,1527.46,-18.13,True,1,19706,-1250.56,-4654469.34,24643535.36,19989066.02
2006-06-27,1239.2,-11.36,-0.91,1527.46,-18.87,True,1,19707,-1239.2,-4655708.54,24420914.4,19765205.86
2006-06-28,1246.0,6.8,0.55,1527.46,-18.43,True,1,19708,-1246.0,-4656954.54,24556168.0,19899213.46
2006-06-29,1272.87,26.87,2.16,1527.46,-16.67,True,1,19709,-1272.87,-4658227.41,25086994.83,20428767.42
2006-06-30,1270.2,-2.67,-0.21,1527.46,-16.84,True,1,19710,-1270.2,-4659497.61,25035642.0,20376144.39
2006-07-03,1280.19,9.99,0.79,1527.46,-16.19,True,1,19711,-1280.19,-4660777.8,25233825.09,20573047.29
2006-07-05,1270.91,-9.28,-0.72,1527.46,-16.8,True,1,19712,-1270.91,-4662048.71,25052177.92,20390129.21
2006-07-06,1274.08,3.17,0.25,1527.46,-16.59,True,1,19713,-1274.08,-4663322.79,25115939.04,20452616.25
2006-07-07,1265.48,-8.6,-0.68,1527.46,-17.15,True,1,19714,-1265.48,-4664588.27,24947672.72,20283084.45
2006-07-10,1267.34,1.86,0.15,1527.46,-17.03,True,1,19715,-1267.34,-4665855.61,24985608.1,20319752.49
2006-07-11,1272.43,5.09,0.4,1527.46,-16.7,True,1,19716,-1272.43,-4667128.04,25087229.88,20420101.84
2006-07-12,1258.6,-13.83,-1.09,1527.46,-17.6,True,1,19717,-1258.6,-4668386.64,24815816.2,20147429.56
2006-07-13,1242.28,-16.32,-1.3,1527.46,-18.67,True,1,19718,-1242.28,-4669628.92,24495277.04,19825648.12
2006-07-14,1236.2,-6.08,-0.49,1527.46,-19.07,True,1,19719,-1236.2,-4670865.12,24376627.8,19705762.68
2006-07-17,1234.49,-1.71,-0.14,1527.46,-19.18,True,1,19720,-1234.49,-4672099.61,24344142.8,19672043.19
2006-07-18,1236.86,2.37,0.19,1527.46,-19.02,True,1,19721,-1236.86,-4673336.47,24392116.06,19718779.59
2006-07-19,1259.81,22.95,1.86,1527.46,-17.52,True,1,19722,-1259.81,-4674596.28,24845972.82,20171376.54
2006-07-20,1249.13,-10.68,-0.85,1527.46,-18.22,True,1,19723,-1249.13,-4675845.41,24636590.99,19960745.58
2006-07-21,1240.29,-8.84,-0.71,1527.46,-18.8,True,1,19724,-1240.29,-4677085.7,24463479.96,19786394.26
2006-07-24,1260.91,20.62,1.66,1527.46,-17.45,True,1,19725,-1260.91,-4678346.61,24871449.75,20193103.14
2006-07-25,1268.88,7.97,0.63,1527.46,-16.93,True,1,19726,-1268.88,-4679615.49,25029926.88,20350311.39
2006-07-26,1268.4,-0.48,-0.04,1527.46,-16.96,True,1,19727,-1268.4,-4680883.89,25021726.8,20340842.91
2006-07-27,1263.2,-5.2,-0.41,1527.46,-17.3,True,1,19728,-1263.2,-4682147.09,24920409.6,20238262.51
2006-07-28,1278.55,15.35,1.22,1527.46,-16.3,True,1,19729,-1278.55,-4683425.64,25224512.95,20541087.31
2006-07-31,1276.66,-1.89,-0.15,1527.46,-16.42,True,1,19730,-1276.66,-4684702.3,25188501.8,20503799.5
2006-08-01,1270.92,-5.74,-0.45,1527.46,-16.8,True,1,19731,-1270.92,-4685973.22,25076522.52,20390549.3
2006-08-02,1277.41,6.49,0.51,1527.46,-16.37,True,1,19732,-1277.41,-4687250.63,25205854.12,20518603.49
2006-08-03,1280.27,2.86,0.22,1527.46,-16.18,True,1,19733,-1280.27,-4688530.9,25263567.91,20575037.01
2006-08-04,1279.36,-0.91,-0.07,1527.46,-16.24,True,1,19734,-1279.36,-4689810.26,25246890.24,20557079.98
2006-08-07,1275.77,-3.59,-0.28,1527.46,-16.48,True,1,19735,-1275.77,-4691086.03,25177320.95,20486234.92
2006-08-08,1271.48,-4.29,-0.34,1527.46,-16.76,True,1,19736,-1271.48,-4692357.51,25093929.28,20401571.77
2006-08-09,1265.95,-5.53,-0.44,1527.46,-17.12,True,1,19737,-1265.95,-4693623.46,24986055.15,20292431.69
2006-08-10,1271.81,5.86,0.46,1527.46,-16.74,True,1,19738,-1271.81,-4694895.27,25102985.78,20408090.51
2006-08-11,1266.74,-5.07,-0.4,1527.46,-17.07,True,1,19739,-1266.74,-4696162.01,25004180.86,20308018.85
2006-08-14,1268.21,1.47,0.12,1527.46,-16.97,True,1,19740,-1268.21,-4697430.22,25034465.4,20337035.18
2006-08-15,1285.58,17.37,1.37,1527.46,-15.84,True,1,19741,-1285.58,-4698715.8,25378634.78,20679918.98
2006-08-16,1295.43,9.85,0.77,1527.46,-15.19,True,1,19742,-1295.43,-4700011.23,25574379.06,20874367.83
2006-08-17,1297.48,2.05,0.16,1527.46,-15.06,True,1,19743,-1297.48,-4701308.71,25616147.64,20914838.93
2006-08-18,1302.3,4.82,0.37,1527.46,-14.74,True,1,19744,-1302.3,-4702611.01,25712611.2,21010000.19
2006-08-21,1297.52,-4.78,-0.37,1527.46,-15.05,True,1,19745,-1297.52,-4703908.53,25619532.4,20915623.87
2006-08-22,1298.82,1.3,0.1,1527.46,-14.97,True,1,19746,-1298.82,-4705207.35,25646499.72,20941292.37
2006-08-23,1292.99,-5.83,-0.45,1527.46,-15.35,True,1,19747,-1292.99,-4706500.34,25532673.53,20826173.19
2006-08-24,1296.06,3.07,0.24,1527.46,-15.15,True,1,19748,-1296.06,-4707796.4,25594592.88,20886796.48
2006-08-25,1295.09,-0.97,-0.08,1527.46,-15.21,True,1,19749,-1295.09,-4709091.49,25576732.41,20867640.92
2006-08-28,1301.78,6.69,0.52,1527.46,-14.78,True,1,19750,-1301.78,-4710393.27,25710155.0,20999761.73
2006-08-29,1304.28,2.5,0.19,1527.46,-14.61,True,1,19751,-1304.28,-4711697.55,25760834.28,21049136.73
2006-08-30,1305.37,1.09,0.08,1527.46,-14.54,True,1,19752,-1305.37,-4713002.92,25783668.24,21070665.32
2006-08-31,1303.82,-1.55,-0.12,1527.46,-14.64,True,1,19753,-1303.82,-4714306.74,25754356.46,21040049.72
2006-09-01,1311.01,7.19,0.55,1527.46,-14.17,True,1,19754,-1311.01,-4715617.75,25897691.54,21182073.79
2006-09-05,1313.25,2.24,0.17,1527.46,-14.02,True,1,19755,-1313.25,-4716931.0,25943253.75,21226322.75
2006-09-06,1300.26,-12.99,-0.99,1527.46,-14.87,True,1,19756,-1300.26,-4718231.26,25687936.56,20969705.3
2006-09-07,1294.02,-6.24,-0.48,1527.46,-15.28,True,1,19757,-1294.02,-4719525.28,25565953.14,20846427.86
2006-09-08,1298.92,4.9,0.38,1527.46,-14.96,True,1,19758,-1298.92,-4720824.2,25664061.36,20943237.16
2006-09-11,1299.54,0.62,0.05,1527.46,-14.92,True,1,19759,-1299.54,-4722123.74,25677610.86,20955487.12
2006-09-12,1313.0,13.46,1.04,1527.46,-14.04,True,1,19760,-1313.0,-4723436.74,25944880.0,21221443.26
2006-09-13,1318.07,5.07,0.39,1527.46,-13.71,True,1,19761,-1318.07,-4724754.81,26046381.27,21321626.46
2006-09-14,1316.28,-1.79,-0.14,1527.46,-13.83,True,1,19762,-1316.28,-4726071.09,26012325.36,21286254.27
2006-09-15,1319.66,3.38,0.26,1527.46,-13.6,True,1,19763,-1319.66,-4727390.75,26080440.58,21353049.83
2006-09-18,1321.18,1.52,0.12,1527.46,-13.5,True,1,19764,-1321.18,-4728711.93,26111801.52,21383089.59
2006-09-19,1317.64,-3.54,-0.27,1527.46,-13.74,True,1,19765,-1317.64,-4730029.57,26043154.6,21313125.03
2006-09-20,1325.18,7.54,0.57,1527.46,-13.24,True,1,19766,-1325.18,-4731354.75,26193507.88,21462153.13
2006-09-21,1318.03,-7.15,-0.54,1527.46,-13.71,True,1,19767,-1318.03,-4732672.78,26053499.01,21320826.23
2006-09-22,1314.78,-3.25,-0.25,1527.46,-13.92,True,1,19768,-1314.78,-4733987.56,25990571.04,21256583.48
2006-09-25,1326.37,11.59,0.88,1527.46,-13.16,True,1,19769,-1326.37,-4735313.93,26221008.53,21485694.6
2006-09-26,1336.35,9.98,0.75,1527.46,-12.51,True,1,19770,-1336.35,-4736650.28,26419639.5,21682989.22
2006-09-27,1336.59,0.24,0.02,1527.46,-12.5,True,1,19771,-1336.59,-4737986.87,26425720.89,21687734.02
2006-09-28,1338.88,2.29,0.17,1527.46,-12.35,True,1,19772,-1338.88,-4739325.75,26472335.36,21733009.61
2006-09-29,1335.85,-3.03,-0.23,1527.46,-12.54,True,1,19773,-1335.85,-4740661.6,26413762.05,21673100.45
2006-10-02,1331.32,-4.53,-0.34,1527.46,-12.84,True,1,19774,-1331.32,-4741992.92,26325521.68,21583528.76
2006-10-03,1334.11,2.79,0.21,1527.46,-12.66,True,1,19775,-1334.11,-4743327.03,26382025.25,21638698.22
2006-10-04,1350.2,16.09,1.21,1527.46,-11.6,True,1,19776,-1350.2,-4744677.23,26701555.2,21956877.97
2006-10-05,1353.22,3.02,0.22,1527.46,-11.41,True,1,19777,-1353.22,-4746030.45,26762631.94,22016601.49
2006-10-06,1349.59,-3.63,-0.27,1527.46,-11.64,True,1,19778,-1349.59,-4747380.04,26692191.02,21944810.98
2006-10-09,1350.66,1.07,0.08,1527.46,-11.58,True,1,19779,-1350.66,-4748730.7,26714704.14,21965973.44
2006-10-10,1353.42,2.76,0.2,1527.46,-11.39,True,1,19780,-1353.42,-4750084.12,26770647.6,22020563.48
2006-10-11,1349.95,-3.47,-0.26,1527.46,-11.62,True,1,19781,-1349.95,-4751434.07,26703360.95,21951926.88
2006-10-12,1362.83,12.88,0.95,1527.46,-10.78,True,1,19782,-1362.83,-4752796.9,26959503.06,22206706.16
2006-10-13,1365.62,2.79,0.2,1527.46,-10.6,True,1,19783,-1365.62,-4754162.52,27016060.46,22261897.94
2006-10-16,1369.06,3.44,0.25,1527.46,-10.37,True,1,19784,-1369.06,-4755531.58,27085483.04,22329951.46
2006-10-17,1364.05,-5.01,-0.37,1527.46,-10.7,True,1,19785,-1364.05,-4756895.63,26987729.25,22230833.62
2006-10-18,1365.8,1.75,0.13,1527.46,-10.58,True,1,19786,-1365.8,-4758261.43,27023718.8,22265457.37
2006-10-19,1366.96,1.16,0.08,1527.46,-10.51,True,1,19787,-1366.96,-4759628.39,27048037.52,22288409.13
2006-10-20,1368.6,1.64,0.12,1527.46,-10.4,True,1,19788,-1368.6,-4760996.99,27081856.8,22320859.81
2006-10-23,1377.02,8.42,0.62,1527.46,-9.85,True,1,19789,-1377.02,-4762374.01,27249848.78,22487474.77
2006-10-24,1377.38,0.36,0.03,1527.46,-9.82,True,1,19790,-1377.38,-4763751.39,27258350.2,22494598.81
2006-10-25,1382.22,4.84,0.35,1527.46,-9.51,True,1,19791,-1382.22,-4765133.61,27355516.02,22590382.41
2006-10-26,1389.08,6.86,0.5,1527.46,-9.06,True,1,19792,-1389.08,-4766522.69,27492671.36,22726148.67
2006-10-27,1377.34,-11.74,-0.84,1527.46,-9.83,True,1,19793,-1377.34,-4767900.03,27261690.62,22493790.59
2006-10-30,1377.93,0.59,0.04,1527.46,-9.79,True,1,19794,-1377.93,-4769277.96,27274746.42,22505468.46
2006-10-31,1377.94,0.01,0.0,1527.46,-9.79,True,1,19795,-1377.94,-4770655.9,27276322.3,22505666.4
2006-11-01,1367.81,-10.13,-0.74,1527.46,-10.45,True,1,19796,-1367.81,-4772023.71,27077166.76,22305143.05
2006-11-02,1367.34,-0.47,-0.03,1527.46,-10.48,True,1,19797,-1367.34,-4773391.05,27069229.98,22295838.93
2006-11-03,1364.3,-3.04,-0.22,1527.46,-10.68,True,1,19798,-1364.3,-4774755.35,27010411.4,22235656.05
2006-11-06,1379.78,15.48,1.14,1527.46,-9.67,True,1,19799,-1379.78,-4776135.13,27318264.22,22542129.09
2006-11-07,1382.84,3.06,0.22,1527.46,-9.47,True,1,19800,-1382.84,-4777517.97,27380232.0,22602714.03
2006-11-08,1385.72,2.88,0.21,1527.46,-9.28,True,1,19801,-1385.72,-4778903.69,27438641.72,22659738.03
2006-11-09,1378.33,-7.39,-0.53,1527.46,-9.76,True,1,19802,-1378.33,-4780282.02,27293690.66,22513408.64
2006-11-10,1380.9,2.57,0.19,1527.46,-9.6,True,1,19803,-1380.9,-4781662.92,27345962.7,22564299.78
2006-11-13,1384.42,3.52,0.26,1527.46,-9.36,True,1,19804,-1384.42,-4783047.34,27417053.68,22634006.34
2006-11-14,1393.22,8.8,0.64,1527.46,-8.79,True,1,19805,-1393.22,-4784440.56,27592722.1,22808281.54
2006-11-15,1396.57,3.35,0.24,1527.46,-8.57,True,1,19806,-1396.57,-4785837.13,27660465.42,22874628.29
2006-11-16,1399.76,3.19,0.23,1527.46,-8.36,True,1,19807,-1399.76,-4787236.89,27725046.32,22937809.43
2006-11-17,1401.2,1.44,0.1,1527.46,-8.27,True,1,19808,-1401.2,-4788638.09,27754969.6,22966331.51
2006-11-20,1400.5,-0.7,-0.05,1527.46,-8.31,True,1,19809,-1400.5,-4790038.59,27742504.5,22952465.91
2006-11-21,1402.81,2.31,0.16,1527.46,-8.16,True,1,19810,-1402.81,-4791441.4,27789666.1,22998224.7
2006-11-22,1406.09,3.28,0.23,1527.46,-7.95,True,1,19811,-1406.09,-4792847.49,27856048.99,23063201.5
2006-11-24,1400.95,-5.14,-0.37,1527.46,-8.28,True,1,19812,-1400.95,-4794248.44,27755621.4,22961372.96
2006-11-27,1381.96,-18.99,-1.36,1527.46,-9.53,True,1,19813,-1381.96,-4795630.4,27380773.48,22585143.08
2006-11-28,1386.72,4.76,0.34,1527.46,-9.21,True,1,19814,-1386.72,-4797017.12,27476470.08,22679452.96
2006-11-29,1399.48,12.76,0.92,1527.46,-8.38,True,1,19815,-1399.48,-4798416.6,27730696.2,22932279.6
2006-11-30,1400.63,1.15,0.08,1527.46,-8.3,True,1,19816,-1400.63,-4799817.23,27754884.08,22955066.85
2006-12-01,1396.71,-3.92,-0.28,1527.46,-8.56,True,1,19817,-1396.71,-4801213.94,27678602.07,22877388.13
2006-12-04,1409.12,12.41,0.89,1527.46,-7.75,True,1,19818,-1409.12,-4802623.06,27925940.16,23123317.1
2006-12-05,1414.76,5.64,0.4,1527.46,-7.38,True,1,19819,-1414.76,-4804037.82,28039128.44,23235090.62
2006-12-06,1412.9,-1.86,-0.13,1527.46,-7.5,True,1,19820,-1412.9,-4805450.72,28003678.0,23198227.28
2006-12-07,1407.29,-5.61,-0.4,1527.46,-7.87,True,1,19821,-1407.29,-4806858.01,27893895.09,23087037.08
2006-12-08,1409.84,2.55,0.18,1527.46,-7.7,True,1,19822,-1409.84,-4808267.85,27945848.48,23137580.63
2006-12-11,1413.04,3.2,0.23,1527.46,-7.49,True,1,19823,-1413.04,-4809680.89,28010691.92,23201011.03
2006-12-12,1411.56,-1.48,-0.1,1527.46,-7.59,True,1,19824,-1411.56,-4811092.45,27982765.44,23171672.99
2006-12-13,1413.21,1.65,0.12,1527.46,-7.48,True,1,19825,-1413.21,-4812505.66,28016888.25,23204382.59
2006-12-14,1425.49,12.28,0.87,1527.46,-6.68,True,1,19826,-1425.49,-4813931.15,28261764.74,23447833.59
2006-12-15,1427.09,1.6,0.11,1527.46,-6.57,True,1,19827,-1427.09,-4815358.24,28294913.43,23479555.19
2006-12-18,1422.48,-4.61,-0.32,1527.46,-6.87,True,1,19828,-1422.48,-4816780.72,28204933.44,23388152.72
2006-12-19,1425.55,3.07,0.22,1527.46,-6.67,True,1,19829,-1425.55,-4818206.27,28267230.95,23449024.68
2006-12-20,1423.53,-2.02,-0.14,1527.46,-6.8,True,1,19830,-1423.53,-4819629.8,28228599.9,23408970.1
2006-12-21,1418.3,-5.23,-0.37,1527.46,-7.15,True,1,19831,-1418.3,-4821048.1,28126307.3,23305259.2
2006-12-22,1410.76,-7.54,-0.53,1527.46,-7.64,True,1,19832,-1410.76,-4822458.86,27978192.32,23155733.46
2006-12-26,1416.9,6.14,0.44,1527.46,-7.24,True,1,19833,-1416.9,-4823875.76,28101377.7,23277501.94
2006-12-27,1426.84,9.94,0.7,1527.46,-6.59,True,1,19834,-1426.84,-4825302.6,28299944.56,23474641.96
2006-12-28,1424.73,-2.11,-0.15,1527.46,-6.73,True,1,19835,-1424.73,-4826727.33,28259519.55,23432792.22
2006-12-29,1418.3,-6.43,-0.45,1527.46,-7.15,True,1,19836,-1418.3,-4828145.63,28133398.8,23305253.17
2007-01-03,1416.6,-1.7,-0.12,1527.46,-7.26,True,1,19837,-1416.6,-4829562.23,28101094.2,23271531.97
2007-01-04,1418.34,1.74,0.12,1527.46,-7.14,True,1,19838,-1418.34,-4830980.57,28137028.92,23306048.35
2007-01-05,1409.71,-8.63,-0.61,1527.46,-7.71,True,1,19839,-1409.71,-4832390.28,27967236.69,23134846.41
2007-01-08,1412.84,3.13,0.22,1527.46,-7.5,True,1,19840,-1412.84,-4833803.12,28030745.6,23196942.48
2007-01-09,1412.11,-0.73,-0.05,1527.46,-7.55,True,1,19841,-1412.11,-4835215.23,28017674.51,23182459.28
2007-01-10,1414.85,2.74,0.19,1527.46,-7.37,True,1,19842,-1414.85,-4836630.08,28073453.7,23236823.62
2007-01-11,1423.82,8.97,0.63,1527.46,-6.78,True,1,19843,-1423.82,-4838053.9,28252860.26,23414806.36
2007-01-12,1430.73,6.91,0.48,1527.46,-6.33,True,1,19844,-1430.73,-4839484.63,28391406.12,23551921.49
2007-01-16,1431.9,1.17,0.08,1527.46,-6.26,True,1,19845,-1431.9,-4840916.53,28416055.5,23575138.97
2007-01-17,1430.62,-1.28,-0.09,1527.46,-6.34,True,1,19846,-1430.62,-4842347.15,28392084.52,23549737.37
2007-01-18,1426.37,-4.25,-0.3,1527.46,-6.62,True,1,19847,-1426.37,-4843773.52,28309165.39,23465391.87
2007-01-19,1430.5,4.13,0.29,1527.46,-6.35,True,1,19848,-1430.5,-4845204.02,28392564.0,23547359.98
2007-01-22,1422.95,-7.55,-0.53,1527.46,-6.84,True,1,19849,-1422.95,-4846626.97,28244134.55,23397507.58
2007-01-23,1427.99,5.04,0.35,1527.46,-6.51,True,1,19850,-1427.99,-4848054.96,28345601.5,23497546.54
2007-01-24,1440.13,12.14,0.85,1527.46,-5.72,True,1,19851,-1440.13,-4849495.09,28588020.63,23738525.54
2007-01-25,1423.9,-16.23,-1.13,1527.46,-6.78,True,1,19852,-1423.9,-4850918.99,28267262.8,23416343.81
2007-01-26,1422.18,-1.72,-0.12,1527.46,-6.89,True,1,19853,-1422.18,-4852341.17,28234539.54,23382198.37
2007-01-29,1420.62,-1.56,-0.11,1527.46,-7.0,True,1,19854,-1420.62,-4853761.79,28204989.48,23351227.69
2007-01-30,1428.82,8.2,0.58,1527.46,-6.46,True,1,19855,-1428.82,-4855190.61,28369221.1,23514030.49
2007-01-31,1438.24,9.42,0.66,1527.46,-5.84,True,1,19856,-1438.24,-4856628.85,28557693.44,23701064.59
2007-02-01,1445.94,7.7,0.54,1527.46,-5.34,True,1,19857,-1445.94,-4858074.79,28712030.58,23853955.79
2007-02-02,1448.39,2.45,0.17,1527.46,-5.18,True,1,19858,-1448.39,-4859523.18,28762128.62,23902605.44
2007-02-05,1446.99,-1.4,-0.1,1527.46,-5.27,True,1,19859,-1446.99,-4860970.17,28735774.41,23874804.24
2007-02-06,1448.0,1.01,0.07,1527.46,-5.2,True,1,19860,-1448.0,-4862418.17,28757280.0,23894861.83
2007-02-07,1450.02,2.02,0.14,1527.46,-5.07,True,1,19861,-1450.02,-4863868.19,28798847.22,23934979.03
2007-02-08,1448.31,-1.71,-0.12,1527.46,-5.18,True,1,19862,-1448.31,-4865316.5,28766333.22,23901016.72
2007-02-09,1438.06,-10.25,-0.71,1527.46,-5.85,True,1,19863,-1438.06,-4866754.56,28564185.78,23697431.22
2007-02-12,1433.37,-4.69,-0.33,1527.46,-6.16,True,1,19864,-1433.37,-4868187.93,28472461.68,23604273.75
2007-02-13,1444.26,10.89,0.76,1527.46,-5.45,True,1,19865,-1444.26,-4869632.19,28690224.9,23820592.71
2007-02-14,1455.3,11.04,0.76,1527.46,-4.72,True,1,19866,-1455.3,-4871087.49,28910989.8,24039902.31
2007-02-15,1456.81,1.51,0.1,1527.46,-4.62,True,1,19867,-1456.81,-4872544.3,28942444.27,24069899.97
2007-02-16,1455.54,-1.27,-0.09,1527.46,-4.71,True,1,19868,-1455.54,-4873999.84,28918668.72,24044668.88
2007-02-20,1459.68,4.14,0.28,1527.46,-4.44,True,1,19869,-1459.68,-4875459.52,29002381.92,24126922.4
2007-02-21,1457.63,-2.05,-0.14,1527.46,-4.57,True,1,19870,-1457.63,-4876917.15,28963108.1,24086190.95
2007-02-22,1456.38,-1.25,-0.09,1527.46,-4.65,True,1,19871,-1456.38,-4878373.53,28939726.98,24061353.45
2007-02-23,1451.19,-5.19,-0.36,1527.46,-4.99,True,1,19872,-1451.19,-4879824.72,28838047.68,23958222.96
2007-02-26,1449.37,-1.82,-0.12,1527.46,-5.11,True,1,19873,-1449.37,-4881274.09,28803330.01,23922055.92
2007-02-27,1399.04,-50.33,-3.47,1527.46,-8.41,True,1,19874,-1399.04,-4882673.13,27804520.96,22921847.83
2007-02-28,1406.82,7.78,0.56,1527.46,-7.9,True,1,19875,-1406.82,-4884079.95,27960547.5,23076467.55
2007-03-01,1403.17,-3.65,-0.26,1527.46,-8.14,True,1,19876,-1403.17,-4885483.12,27889406.92,23003923.8
2007-03-02,1387.17,-16.0,-1.14,1527.46,-9.18,True,1,19877,-1387.17,-4886870.29,27572778.09,22685907.8
2007-03-05,1374.12,-13.05,-0.94,1527.46,-10.04,True,1,19878,-1374.12,-4888244.41,27314757.36,22426512.95
2007-03-06,1395.41,21.29,1.55,1527.46,-8.64,True,1,19879,-1395.41,-4889639.82,27739355.39,22849715.57
2007-03-07,1391.97,-3.44,-0.25,1527.46,-8.87,True,1,19880,-1391.97,-4891031.79,27672363.6,22781331.81
2007-03-08,1401.89,9.92,0.71,1527.46,-8.22,True,1,19881,-1401.89,-4892433.68,27870975.09,22978541.41
2007-03-09,1402.84,0.95,0.07,1527.46,-8.16,True,1,19882,-1402.84,-4893836.52,27891264.88,22997428.36
2007-03-12,1406.6,3.76,0.27,1527.46,-7.91,True,1,19883,-1406.6,-4895243.12,27967427.8,23072184.68
2007-03-13,1377.95,-28.65,-2.04,1527.46,-9.79,True,1,19884,-1377.95,-4896621.07,27399157.8,22502536.73
2007-03-14,1387.17,9.22,0.67,1527.46,-9.18,True,1,19885,-1387.17,-4898008.24,27583875.45,22685867.21
2007-03-15,1392.28,5.11,0.37,1527.46,-8.85,True,1,19886,-1392.28,-4899400.52,27686880.08,22787479.56
2007-03-16,1386.95,-5.33,-0.38,1527.46,-9.2,True,1,19887,-1386.95,-4900787.47,27582274.65,22681487.18
2007-03-19,1402.06,15.11,1.09,1527.46,-8.21,True,1,19888,-1402.06,-4902189.53,27884169.28,22981979.75
2007-03-20,1410.94,8.88,0.63,1527.46,-7.63,True,1,19889,-1410.94,-4903600.47,28062185.66,23158585.19
2007-03-21,1435.04,24.1,1.71,1527.46,-6.05,True,1,19890,-1435.04,-4905035.51,28542945.6,23637910.09
2007-03-22,1434.54,-0.5,-0.04,1527.46,-6.08,True,1,19891,-1434.54,-4906470.05,28534435.14,23627965.09
2007-03-23,1436.11,1.57,0.11,1527.46,-5.98,True,1,19892,-1436.11,-4907906.16,28567100.12,23659193.96
2007-03-26,1437.5,1.39,0.1,1527.46,-5.89,True,1,19893,-1437.5,-4909343.66,28596187.5,23686843.84
2007-03-27,1428.61,-8.89,-0.62,1527.46,-6.47,True,1,19894,-1428.61,-4910772.27,28420767.34,23509995.07
2007-03-28,1417.23,-11.38,-0.8,1527.46,-7.22,True,1,19895,-1417.23,-4912189.5,28195790.85,23283601.35
2007-03-29,1422.53,5.3,0.37,1527.46,-6.87,True,1,19896,-1422.53,-4913612.03,28302656.88,23389044.85
2007-03-30,1420.86,-1.67,-0.12,1527.46,-6.98,True,1,19897,-1420.86,-4915032.89,28270851.42,23355818.53
2007-04-02,1424.55,3.69,0.26,1527.46,-6.74,True,1,19898,-1424.55,-4916457.44,28345695.9,23429238.46
2007-04-03,1437.77,13.22,0.93,1527.46,-5.87,True,1,19899,-1437.77,-4917895.21,28610185.23,23692290.02
2007-04-04,1439.37,1.6,0.11,1527.46,-5.77,True,1,19900,-1439.37,-4919334.58,28643463.0,23724128.42
2007-04-05,1443.76,4.39,0.3,1527.46,-5.48,True,1,19901,-1443.76,-4920778.34,28732267.76,23811489.42
2007-04-09,1444.61,0.85,0.06,1527.46,-5.42,True,1,19902,-1444.61,-4922222.95,28750628.22,23828405.27
2007-04-10,1448.39,3.78,0.26,1527.46,-5.18,True,1,19903,-1448.39,-4923671.34,28827306.17,23903634.83
2007-04-11,1438.87,-9.52,-0.66,1527.46,-5.8,True,1,19904,-1438.87,-4925110.21,28639268.48,23714158.27
2007-04-12,1447.8,8.93,0.62,1527.46,-5.22,True,1,19905,-1447.8,-4926558.01,28818459.0,23891900.99
2007-04-13,1452.85,5.05,0.35,1527.46,-4.88,True,1,19906,-1452.85,-4928010.86,28920432.1,23992421.24
2007-04-16,1468.33,15.48,1.06,1527.46,-3.87,True,1,19907,-1468.33,-4929479.19,29230045.31,24300566.12
2007-04-17,1471.48,3.15,0.22,1527.46,-3.66,True,1,19908,-1471.48,-4930950.67,29294223.84,24363273.17
2007-04-18,1472.5,1.02,0.07,1527.46,-3.6,True,1,19909,-1472.5,-4932423.17,29316002.5,24383579.33
2007-04-19,1470.73,-1.77,-0.12,1527.46,-3.71,True,1,19910,-1470.73,-4933893.9,29282234.3,24348340.4
2007-04-20,1484.35,13.62,0.93,1527.46,-2.82,True,1,19911,-1484.35,-4935378.25,29554892.85,24619514.6
2007-04-23,1480.93,-3.42,-0.23,1527.46,-3.05,True,1,19912,-1480.93,-4936859.18,29488278.16,24551418.98
2007-04-24,1480.41,-0.52,-0.04,1527.46,-3.08,True,1,19913,-1480.41,-4938339.59,29479404.33,24541064.74
2007-04-25,1495.42,15.01,1.01,1527.46,-2.1,True,1,19914,-1495.42,-4939835.01,29779793.88,24839958.87
2007-04-26,1494.25,-1.17,-0.08,1527.46,-2.17,True,1,19915,-1494.25,-4941329.26,29757988.75,24816659.49
2007-04-27,1494.07,-0.18,-0.01,1527.46,-2.19,True,1,19916,-1494.07,-4942823.33,29755898.12,24813074.79
2007-04-30,1482.37,-11.7,-0.78,1527.46,-2.95,True,1,19917,-1482.37,-4944305.7,29524363.29,24580057.59
2007-05-01,1486.3,3.93,0.26,1527.46,-2.7,True,1,19918,-1486.3,-4945792.0,29604123.4,24658331.4
2007-05-02,1495.92,9.62,0.65,1527.46,-2.06,True,1,19919,-1495.92,-4947287.92,29797230.48,24849942.56
2007-05-03,1502.39,6.47,0.43,1527.46,-1.64,True,1,19920,-1502.39,-4948790.31,29927608.8,24978818.49
2007-05-04,1505.62,3.23,0.22,1527.46,-1.43,True,1,19921,-1505.62,-4950295.93,29993456.02,25043160.09
2007-05-07,1509.48,3.86,0.26,1527.46,-1.18,True,1,19922,-1509.48,-4951805.41,30071860.56,25120055.15
2007-05-08,1507.72,-1.76,-0.12,1527.46,-1.29,True,1,19923,-1507.72,-4953313.13,30038305.56,25084992.43
2007-05-09,1512.58,4.86,0.32,1527.46,-0.97,True,1,19924,-1512.58,-4954825.71,30136643.92,25181818.21
2007-05-10,1491.47,-21.11,-1.4,1527.46,-2.36,True,1,19925,-1491.47,-4956317.18,29717539.75,24761222.57
2007-05-11,1505.85,14.38,0.96,1527.46,-1.42,True,1,19926,-1505.85,-4957823.03,30005567.1,25047744.07
2007-05-14,1503.15,-2.7,-0.18,1527.46,-1.59,True,1,19927,-1503.15,-4959326.18,29953270.05,24993943.87
2007-05-15,1501.19,-1.96,-0.13,1527.46,-1.72,True,1,19928,-1501.19,-4960827.37,29915714.32,24954886.95
2007-05-16,1514.14,12.95,0.86,1527.46,-0.87,True,1,19929,-1514.14,-4962341.51,30175296.06,25212954.55
2007-05-17,1512.75,-1.39,-0.09,1527.46,-0.96,True,1,19930,-1512.75,-4963854.26,30149107.5,25185253.24
2007-05-18,1522.75,10.0,0.66,1527.46,-0.31,True,1,19931,-1522.75,-4965377.01,30349930.25,25384553.24
2007-05-21,1525.1,2.35,0.15,1527.46,-0.16,True,1,19932,-1525.1,-4966902.11,30398293.2,25431391.09
2007-05-22,1524.12,-0.98,-0.06,1527.46,-0.22,True,1,19933,-1524.12,-4968426.23,30380283.96,25411857.73
2007-05-23,1522.28,-1.84,-0.12,1527.46,-0.34,True,1,19934,-1522.28,-4969948.51,30345129.52,25375181.01
2007-05-24,1507.51,-14.77,-0.97,1527.46,-1.31,True,1,19935,-1507.51,-4971456.02,30052211.85,25080755.83
2007-05-25,1515.73,8.22,0.55,1527.46,-0.77,True,1,19936,-1515.73,-4972971.75,30217593.28,25244621.53
2007-05-29,1518.11,2.38,0.16,1527.46,-0.61,True,1,19937,-1518.11,-4974489.86,30266559.07,25292069.21
2007-05-30,1530.23,12.12,0.8,1530.23,0.0,True,1,19938,-1530.23,-4976020.09,30509725.74,25533705.65
2007-05-31,1530.62,0.39,0.02,1530.62,0.0,True,1,19939,-1530.62,-4977550.71,30519032.18,25541481.47
2007-06-01,1536.34,5.72,0.37,1536.34,0.0,True,1,19940,-1536.34,-4979087.05,30634619.6,25655532.55
2007-06-04,1539.18,2.84,0.18,1539.18,0.0,True,1,19941,-1539.18,-4980626.23,30692788.38,25712162.15
2007-06-05,1530.95,-8.23,-0.54,1539.18,-0.54,True,1,19942,-1530.95,-4982157.18,30530204.9,25548047.72
2007-06-06,1517.38,-13.57,-0.89,1539.18,-1.42,True,1,19943,-1517.38,-4983674.56,30261109.34,25277434.78
2007-06-07,1490.72,-26.66,-1.76,1539.18,-3.15,True,1,19944,-1490.72,-4985165.28,29730919.68,24745754.4
2007-06-08,1507.67,16.95,1.14,1539.18,-2.05,True,1,19945,-1507.67,-4986672.95,30070478.15,25083805.2
2007-06-11,1509.12,1.45,0.1,1539.18,-1.95,True,1,19946,-1509.12,-4988182.07,30100907.52,25112725.45
2007-06-12,1493.0,-16.12,-1.07,1539.18,-3.0,True,1,19947,-1493.0,-4989675.07,29780871.0,24791195.93
2007-06-13,1515.67,22.67,1.52,1539.18,-1.53,True,1,19948,-1515.67,-4991190.74,30234585.16,25243394.42
2007-06-14,1522.97,7.3,0.48,1539.18,-1.05,True,1,19949,-1522.97,-4992713.71,30381728.53,25389014.82
2007-06-15,1532.91,9.94,0.65,1539.18,-0.41,True,1,19950,-1532.91,-4994246.62,30581554.5,25587307.88
2007-06-18,1531.05,-1.86,-0.12,1539.18,-0.53,True,1,19951,-1531.05,-4995777.67,30545978.55,25550200.88
2007-06-19,1533.7,2.65,0.17,1539.18,-0.36,True,1,19952,-1533.7,-4997311.37,30600382.4,25603071.03
2007-06-20,1512.84,-20.86,-1.36,1539.18,-1.71,True,1,19953,-1512.84,-4998824.21,30185696.52,25186872.31
2007-06-21,1522.19,9.35,0.62,1539.18,-1.1,True,1,19954,-1522.19,-5000346.4,30373779.26,25373432.86
2007-06-22,1502.56,-19.63,-1.29,1539.18,-2.38,True,1,19955,-1502.56,-5001848.96,29983584.8,24981735.84
2007-06-25,1497.74,-4.82,-0.32,1539.18,-2.69,True,1,19956,-1497.74,-5003346.7,29888899.44,24885552.74
2007-06-26,1492.89,-4.85,-0.32,1539.18,-3.01,True,1,19957,-1492.89,-5004839.59,29793605.73,24788766.14
2007-06-27,1506.34,13.45,0.9,1539.18,-2.13,True,1,19958,-1506.34,-5006345.93,30063533.72,25057187.79
2007-06-28,1505.71,-0.63,-0.04,1539.18,-2.17,True,1,19959,-1505.71,-5007851.64,30052465.89,25044614.25
2007-06-29,1503.35,-2.36,-0.16,1539.18,-2.33,True,1,19960,-1503.35,-5009354.99,30006866.0,24997511.01
2007-07-02,1519.43,16.08,1.07,1539.18,-1.28,True,1,19961,-1519.43,-5010874.42,30329342.23,25318467.81
2007-07-03,1524.87,5.44,0.36,1539.18,-0.93,True,1,19962,-1524.87,-5012399.29,30439454.94,25427055.65
2007-07-05,1525.4,0.53,0.04,1539.18,-0.9,True,1,19963,-1525.4,-5013924.69,30451560.2,25437635.51
2007-07-06,1530.44,5.04,0.33,1539.18,-0.57,True,1,19964,-1530.44,-5015455.13,30553704.16,25538249.03
2007-07-09,1531.85,1.41,0.09,1539.18,-0.48,True,1,19965,-1531.85,-5016986.98,30583385.25,25566398.27
2007-07-10,1510.12,-21.73,-1.42,1539.18,-1.89,True,1,19966,-1510.12,-5018497.1,30151055.92,25132558.82
2007-07-11,1518.76,8.64,0.57,1539.18,-1.33,True,1,19967,-1518.76,-5020015.86,30325080.92,25305065.06
2007-07-12,1547.7,28.94,1.9,1547.7,0.0,True,1,19968,-1547.7,-5021563.56,30904473.6,25882910.04
2007-07-13,1552.5,4.8,0.31,1552.5,0.0,True,1,19969,-1552.5,-5023116.06,31001872.5,25978756.44
2007-07-16,1549.52,-2.98,-0.19,1552.5,-0.19,True,1,19970,-1549.52,-5024665.58,30943914.4,25919248.82
2007-07-17,1549.37,-0.15,-0.01,1552.5,-0.2,True,1,19971,-1549.37,-5026214.95,30942468.27,25916253.32
2007-07-18,1546.17,-3.2,-0.21,1552.5,-0.41,True,1,19972,-1546.17,-5027761.12,30880107.24,25852346.12
2007-07-19,1553.08,6.91,0.45,1553.08,0.0,True,1,19973,-1553.08,-5029314.2,31019666.84,25990352.64
2007-07-20,1534.1,-18.98,-1.22,1553.08,-1.22,True,1,19974,-1534.1,-5030848.3,30642113.4,25611265.1
2007-07-23,1541.57,7.47,0.49,1553.08,-0.74,True,1,19975,-1541.57,-5032389.87,30792860.75,25760470.88
2007-07-24,1511.04,-30.53,-1.98,1553.08,-2.71,True,1,19976,-1511.04,-5033900.91,30184535.04,25150634.13
2007-07-25,1518.09,7.05,0.47,1553.08,-2.25,True,1,19977,-1518.09,-5035419.0,30326883.93,25291464.93
2007-07-26,1482.66,-35.43,-2.33,1553.08,-4.53,True,1,19978,-1482.66,-5036901.66,29620581.48,24583679.82
2007-07-27,1458.95,-23.71,-1.6,1553.08,-6.06,True,1,19979,-1458.95,-5038360.61,29148362.05,24110001.44
2007-07-30,1473.91,14.96,1.02,1553.08,-5.1,True,1,19980,-1473.91,-5039834.52,29448721.8,24408887.28
2007-07-31,1455.27,-18.64,-1.26,1553.08,-6.3,True,1,19981,-1455.27,-5041289.79,29077749.87,24036460.08
2007-08-01,1465.81,10.54,0.72,1553.08,-5.62,True,1,19982,-1465.81,-5042755.6,29289815.42,24247059.82
2007-08-02,1472.2,6.39,0.44,1553.08,-5.21,True,1,19983,-1472.2,-5044227.8,29418972.6,24374744.8
2007-08-03,1433.06,-39.14,-2.66,1553.08,-7.73,True,1,19984,-1433.06,-5045660.86,28638271.04,23592610.18
2007-08-06,1467.67,34.61,2.42,1553.08,-5.5,True,1,19985,-1467.67,-5047128.53,29331384.95,24284256.42
2007-08-07,1476.71,9.04,0.62,1553.08,-4.92,True,1,19986,-1476.71,-5048605.24,29513526.06,24464920.82
2007-08-08,1497.49,20.78,1.41,1553.08,-3.58,True,1,19987,-1497.49,-5050102.73,29930332.63,24880229.9
2007-08-09,1453.09,-44.4,-2.96,1553.08,-6.44,True,1,19988,-1453.09,-5051555.82,29044362.92,23992807.1
2007-08-10,1453.64,0.55,0.04,1553.08,-6.4,True,1,19989,-1453.64,-5053009.46,29056809.96,24003800.5
2007-08-13,1452.92,-0.72,-0.05,1553.08,-6.45,True,1,19990,-1452.92,-5054462.38,29043870.8,23989408.42
2007-08-14,1426.54,-26.38,-1.82,1553.08,-8.15,True,1,19991,-1426.54,-5055888.92,28517961.14,23462072.22
2007-08-15,1406.7,-19.84,-1.39,1553.08,-9.43,True,1,19992,-1406.7,-5057295.62,28122746.4,23065450.78
2007-08-16,1411.27,4.57,0.32,1553.08,-9.13,True,1,19993,-1411.27,-5058706.89,28215521.11,23156814.22
2007-08-17,1445.94,34.67,2.46,1553.08,-6.9,True,1,19994,-1445.94,-5060152.83,28910124.36,23849971.53
2007-08-20,1445.55,-0.39,-0.03,1553.08,-6.92,True,1,19995,-1445.55,-5061598.38,28903772.25,23842173.87
2007-08-21,1447.12,1.57,0.11,1553.08,-6.82,True,1,19996,-1447.12,-5063045.5,28936611.52,23873566.02
2007-08-22,1464.07,16.95,1.17,1553.08,-5.73,True,1,19997,-1464.07,-5064509.57,29277007.79,24212498.22
2007-08-23,1462.5,-1.57,-0.11,1553.08,-5.83,True,1,19998,-1462.5,-5065972.07,29247075.0,24181102.93
2007-08-24,1479.37,16.87,1.15,1553.08,-4.75,True,1,19999,-1479.37,-5067451.44,29585920.63,24518469.19
2007-08-27,1466.79,-12.58,-0.85,1553.08,-5.56,True,1,20000,-1466.79,-5068918.23,29335800.0,24266881.77
2007-08-28,1432.36,-34.43,-2.35,1553.08,-7.77,True,1,20001,-1432.36,-5070350.59,28648632.36,23578281.77
2007-08-29,1463.76,31.4,2.19,1553.08,-5.75,True,1,20002,-1463.76,-5071814.35,29278127.52,24206313.17
2007-08-30,1457.64,-6.12,-0.42,1553.08,-6.14,True,1,20003,-1457.64,-5073271.99,29157172.92,24083900.93
2007-08-31,1473.99,16.35,1.12,1553.08,-5.09,True,1,20004,-1473.99,-5074745.98,29485695.96,24410949.98
2007-09-04,1489.42,15.43,1.05,1553.08,-4.1,True,1,20005,-1489.42,-5076235.4,29795847.1,24719611.7
2007-09-05,1472.29,-17.13,-1.15,1553.08,-5.2,True,1,20006,-1472.29,-5077707.69,29454633.74,24376926.05
2007-09-06,1478.55,6.26,0.42,1553.08,-4.8,True,1,20007,-1478.55,-5079186.24,29581349.85,24502163.61
2007-09-07,1453.55,-25.0,-1.69,1553.08,-6.41,True,1,20008,-1453.55,-5080639.79,29082628.4,24001988.61
2007-09-10,1451.7,-1.85,-0.13,1553.08,-6.53,True,1,20009,-1451.7,-5082091.49,29047065.3,23964973.81
2007-09-11,1471.49,19.79,1.36,1553.08,-5.25,True,1,20010,-1471.49,-5083562.98,29444514.9,24360951.92
2007-09-12,1471.56,0.07,0.0,1553.08,-5.25,True,1,20011,-1471.56,-5085034.54,29447387.16,24362352.62
2007-09-13,1483.95,12.39,0.84,1553.08,-4.45,True,1,20012,-1483.95,-5086518.49,29696807.4,24610288.91
2007-09-14,1484.25,0.3,0.02,1553.08,-4.43,True,1,20013,-1484.25,-5088002.74,29704295.25,24616292.51
2007-09-17,1476.65,-7.6,-0.51,1553.08,-4.92,True,1,20014,-1476.65,-5089479.39,29553673.1,24464193.71
2007-09-18,1519.78,43.13,2.92,1553.08,-2.14,True,1,20015,-1519.78,-5090999.17,30418396.7,25327397.53
2007-09-19,1529.03,9.25,0.61,1553.08,-1.55,True,1,20016,-1529.03,-5092528.2,30605064.48,25512536.28
2007-09-20,1518.75,-10.28,-0.67,1553.08,-2.21,True,1,20017,-1518.75,-5094046.95,30400818.75,25306771.8
2007-09-21,1525.75,7.0,0.46,1553.08,-1.76,True,1,20018,-1525.75,-5095572.7,30542463.5,25446890.8
2007-09-24,1517.73,-8.02,-0.53,1553.08,-2.28,True,1,20019,-1517.73,-5097090.43,30383436.87,25286346.44
2007-09-25,1517.21,-0.52,-0.03,1553.08,-2.31,True,1,20020,-1517.21,-5098607.64,30374544.2,25275936.56
2007-09-26,1525.42,8.21,0.54,1553.08,-1.78,True,1,20021,-1525.42,-5100133.06,30540433.82,25440300.76
2007-09-27,1531.38,5.96,0.39,1553.08,-1.4,True,1,20022,-1531.38,-5101664.44,30661290.36,25559625.92
2007-09-28,1526.75,-4.63,-0.3,1553.08,-1.7,True,1,20023,-1526.75,-5103191.19,30570115.25,25466924.06
2007-10-01,1547.04,20.29,1.33,1553.08,-0.39,True,1,20024,-1547.04,-5104738.23,30977928.96,25873190.73
2007-10-02,1546.63,-0.41,-0.03,1553.08,-0.42,True,1,20025,-1546.63,-5106284.86,30971265.75,25864980.89
2007-10-03,1539.59,-7.04,-0.46,1553.08,-0.87,True,1,20026,-1539.59,-5107824.45,30831829.34,25724004.89
2007-10-04,1542.84,3.25,0.21,1553.08,-0.66,True,1,20027,-1542.84,-5109367.29,30898456.68,25789089.39
2007-10-05,1557.59,14.75,0.96,1557.59,0.0,True,1,20028,-1557.59,-5110924.88,31195412.52,26084487.64
2007-10-08,1552.58,-5.01,-0.32,1557.59,-0.32,True,1,20029,-1552.58,-5112477.46,31096624.82,25984147.36
2007-10-09,1565.15,12.57,0.81,1565.15,0.0,True,1,20030,-1565.15,-5114042.61,31349954.5,26235911.89
2007-10-10,1562.47,-2.68,-0.17,1565.15,-0.17,True,1,20031,-1562.47,-5115605.08,31297836.57,26182231.49
2007-10-11,1554.41,-8.06,-0.52,1565.15,-0.69,True,1,20032,-1554.41,-5117159.49,31137941.12,26020781.63
2007-10-12,1561.8,7.39,0.48,1565.15,-0.21,True,1,20033,-1561.8,-5118721.29,31287539.4,26168818.11
2007-10-15,1548.71,-13.09,-0.84,1565.15,-1.05,True,1,20034,-1548.71,-5120270.0,31026856.14,25906586.14
2007-10-16,1538.53,-10.18,-0.66,1565.15,-1.7,True,1,20035,-1538.53,-5121808.53,30824448.55,25702640.02
2007-10-17,1541.24,2.71,0.18,1565.15,-1.53,True,1,20036,-1541.24,-5123349.77,30880284.64,25756934.87
2007-10-18,1540.08,-1.16,-0.08,1565.15,-1.6,True,1,20037,-1540.08,-5124889.85,30858582.96,25733693.11
2007-10-19,1500.63,-39.45,-2.56,1565.15,-4.12,True,1,20038,-1500.63,-5126390.48,30069623.94,24943233.46
2007-10-22,1506.33,5.7,0.38,1565.15,-3.76,True,1,20039,-1506.33,-5127896.81,30185346.87,25057450.06
2007-10-23,1519.59,13.26,0.88,1565.15,-2.91,True,1,20040,-1519.59,-5129416.4,30452583.6,25323167.2
2007-10-24,1515.88,-3.71,-0.24,1565.15,-3.15,True,1,20041,-1515.88,-5130932.28,30379751.08,25248818.8
2007-10-25,1514.4,-1.48,-0.1,1565.15,-3.24,True,1,20042,-1514.4,-5132446.68,30351604.8,25219158.12
2007-10-26,1535.28,20.88,1.38,1565.15,-1.91,True,1,20043,-1535.28,-5133981.96,30771617.04,25637635.08
2007-10-29,1540.98,5.7,0.37,1565.15,-1.54,True,1,20044,-1540.98,-5135522.94,30887403.12,25751880.18
2007-10-30,1531.02,-9.96,-0.65,1565.15,-2.18,True,1,20045,-1531.02,-5137053.96,30689295.9,25552241.94
2007-10-31,1549.38,18.36,1.2,1565.15,-1.01,True,1,20046,-1549.38,-5138603.34,31058871.48,25920268.14
2007-11-01,1508.44,-40.94,-2.64,1565.15,-3.62,True,1,20047,-1508.44,-5140111.78,30239696.68,25099584.9
2007-11-02,1509.65,1.21,0.08,1565.15,-3.55,True,1,20048,-1509.65,-5141621.43,30265463.2,25123841.77
2007-11-05,1502.17,-7.48,-0.5,1565.15,-4.02,True,1,20049,-1502.17,-5143123.6,30117006.33,24973882.73
2007-11-06,1520.27,18.1,1.2,1565.15,-2.87,True,1,20050,-1520.27,-5144643.87,30481413.5,25336769.63
2007-11-07,1475.62,-44.65,-2.94,1565.15,-5.72,True,1,20051,-1475.62,-5146119.49,29587656.62,24441537.13
2007-11-08,1474.77,-0.85,-0.06,1565.15,-5.78,True,1,20052,-1474.77,-5147594.26,29572088.04,24424493.78
2007-11-09,1453.7,-21.07,-1.43,1565.15,-7.12,True,1,20053,-1453.7,-5149047.96,29151046.1,24001998.14
2007-11-12,1439.18,-14.52,-1.0,1565.15,-8.05,True,1,20054,-1439.18,-5150487.14,28861315.72,23710828.58
2007-11-13,1481.05,41.87,2.91,1565.15,-5.37,True,1,20055,-1481.05,-5151968.19,29702457.75,24550489.56
2007-11-14,1470.58,-10.47,-0.71,1565.15,-6.04,True,1,20056,-1470.58,-5153438.77,29493952.48,24340513.71
2007-11-15,1451.15,-19.43,-1.32,1565.15,-7.28,True,1,20057,-1451.15,-5154889.92,29105715.55,23950825.63
2007-11-16,1458.74,7.59,0.52,1565.15,-6.8,True,1,20058,-1458.74,-5156348.66,29259406.92,24103058.26
2007-11-19,1433.27,-25.47,-1.75,1565.15,-8.43,True,1,20059,-1433.27,-5157781.93,28749962.93,23592181.0
2007-11-20,1439.7,6.43,0.45,1565.15,-8.02,True,1,20060,-1439.7,-5159221.63,28880382.0,23721160.37
2007-11-21,1416.77,-22.93,-1.59,1565.15,-9.48,True,1,20061,-1416.77,-5160638.4,28421822.97,23261184.57
2007-11-23,1440.7,23.93,1.69,1565.15,-7.95,True,1,20062,-1440.7,-5162079.1,28903323.4,23741244.3
2007-11-26,1407.22,-33.48,-2.32,1565.15,-10.09,True,1,20063,-1407.22,-5163486.32,28233054.86,23069568.54
2007-11-27,1428.23,21.01,1.49,1565.15,-8.75,True,1,20064,-1428.23,-5164914.55,28656006.72,23491092.17
2007-11-28,1469.02,40.79,2.86,1565.15,-6.14,True,1,20065,-1469.02,-5166383.57,29475886.3,24309502.73
2007-11-29,1469.72,0.7,0.05,1565.15,-6.1,True,1,20066,-1469.72,-5167853.29,29491401.52,24323548.23
2007-11-30,1481.14,11.42,0.78,1565.15,-5.37,True,1,20067,-1481.14,-5169334.43,29722036.38,24552701.95
2007-12-03,1472.42,-8.72,-0.59,1565.15,-5.92,True,1,20068,-1472.42,-5170806.85,29548524.56,24377717.71
2007-12-04,1462.79,-9.63,-0.65,1565.15,-6.54,True,1,20069,-1462.79,-5172269.64,29356732.51,24184462.87
2007-12-05,1485.01,22.22,1.52,1565.15,-5.12,True,1,20070,-1485.01,-5173754.65,29804150.7,24630396.05
2007-12-06,1507.34,22.33,1.5,1565.15,-3.69,True,1,20071,-1507.34,-5175261.99,30253821.14,25078559.15
2007-12-07,1504.66,-2.68,-0.18,1565.15,-3.86,True,1,20072,-1504.66,-5176766.65,30201535.52,25024768.87
2007-12-10,1515.96,11.3,0.75,1565.15,-3.14,True,1,20073,-1515.96,-5178282.61,30429865.08,25251582.47
2007-12-11,1477.65,-38.31,-2.53,1565.15,-5.59,True,1,20074,-1477.65,-5179760.26,29662346.1,24482585.84
2007-12-12,1486.59,8.94,0.6,1565.15,-5.02,True,1,20075,-1486.59,-5181246.85,29843294.25,24662047.4
2007-12-13,1488.41,1.82,0.12,1565.15,-4.9,True,1,20076,-1488.41,-5182735.26,29881319.16,24698583.9
2007-12-14,1467.95,-20.46,-1.38,1565.15,-6.21,True,1,20077,-1467.95,-5184203.21,29472032.15,24287828.94
2007-12-17,1445.9,-22.05,-1.5,1565.15,-7.62,True,1,20078,-1445.9,-5185649.11,29030780.2,23845131.09
2007-12-18,1454.98,9.08,0.63,1565.15,-7.04,True,1,20079,-1454.98,-5187104.09,29214543.42,24027439.33
2007-12-19,1453.0,-1.98,-0.14,1565.15,-7.16,True,1,20080,-1453.0,-5188557.09,29176240.0,23987682.91
2007-12-20,1460.12,7.12,0.49,1565.15,-6.71,True,1,20081,-1460.12,-5190017.21,29320669.72,24130652.51
2007-12-21,1484.46,24.34,1.67,1565.15,-5.16,True,1,20082,-1484.46,-5191501.67,29810925.72,24619424.05
2007-12-24,1496.45,11.99,0.81,1565.15,-4.39,True,1,20083,-1496.45,-5192998.12,30053205.35,24860207.23
2007-12-26,1497.66,1.21,0.08,1565.15,-4.31,True,1,20084,-1497.66,-5194495.78,30079003.44,24884507.66
2007-12-27,1476.27,-21.39,-1.43,1565.15,-5.68,True,1,20085,-1476.27,-5195972.05,29650882.95,24454910.9
2007-12-28,1478.49,2.22,0.15,1565.15,-5.54,True,1,20086,-1478.49,-5197450.54,29696950.14,24499499.6
2007-12-31,1468.36,-10.13,-0.68,1565.15,-6.18,True,1,20087,-1468.36,-5198918.9,29494947.32,24296028.42
2008-01-02,1447.16,-21.2,-1.44,1565.15,-7.54,True,1,20088,-1447.16,-5200366.06,29070550.08,23870184.02
2008-01-03,1447.16,0.0,0.0,1565.15,-7.54,True,1,20089,-1447.16,-5201813.22,29071997.24,23870184.02
2008-01-04,1411.63,-35.53,-2.46,1565.15,-9.81,True,1,20090,-1411.63,-5203224.85,28359646.7,23156421.85
2008-01-07,1416.18,4.55,0.32,1565.15,-9.52,True,1,20091,-1416.18,-5204641.03,28452472.38,23247831.35
2008-01-08,1390.19,-25.99,-1.84,1565.15,-11.18,True,1,20092,-1390.19,-5206031.22,27931697.48,22725666.26
2008-01-09,1409.13,18.94,1.36,1565.15,-9.97,True,1,20093,-1409.13,-5207440.35,28313649.09,23106208.74
2008-01-10,1420.33,11.2,0.8,1565.15,-9.25,True,1,20094,-1420.33,-5208860.68,28540111.02,23331250.34
2008-01-11,1401.02,-19.31,-1.36,1565.15,-10.49,True,1,20095,-1401.02,-5210261.7,28153496.9,22943235.2
2008-01-14,1416.25,15.23,1.09,1565.15,-9.51,True,1,20096,-1416.25,-5211677.95,28460960.0,23249282.05
2008-01-15,1380.95,-35.3,-2.49,1565.15,-11.77,True,1,20097,-1380.95,-5213058.9,27752952.15,22539893.25
2008-01-16,1373.2,-7.75,-0.56,1565.15,-12.26,True,1,20098,-1373.2,-5214432.1,27598573.6,22384141.5
2008-01-17,1333.25,-39.95,-2.91,1565.15,-14.82,True,1,20099,-1333.25,-5215765.35,26796991.75,21581226.4
2008-01-18,1325.19,-8.06,-0.6,1565.15,-15.33,True,1,20100,-1325.19,-5217090.54,26636319.0,21419228.46
2008-01-22,1310.5,-14.69,-1.11,1565.15,-16.27,True,1,20101,-1310.5,-5218401.04,26342360.5,21123959.46
2008-01-23,1338.6,28.1,2.14,1565.15,-14.48,True,1,20102,-1338.6,-5219739.64,26908537.2,21688797.56
2008-01-24,1352.07,13.47,1.01,1565.15,-13.61,True,1,20103,-1352.07,-5221091.71,27180663.21,21959571.5
2008-01-25,1330.61,-21.46,-1.59,1565.15,-14.98,True,1,20104,-1330.61,-5222422.32,26750583.44,21528161.12
2008-01-28,1353.96,23.35,1.76,1565.15,-13.49,True,1,20105,-1353.96,-5223776.28,27221365.8,21997589.52
2008-01-29,1362.3,8.34,0.62,1565.15,-12.96,True,1,20106,-1362.3,-5225138.58,27390403.8,22165265.22
2008-01-30,1355.81,-6.49,-0.48,1565.15,-13.38,True,1,20107,-1355.81,-5226494.39,27261271.67,22034777.28
2008-01-31,1378.55,22.74,1.68,1565.15,-11.92,True,1,20108,-1378.55,-5227872.94,27719883.4,22492010.46
2008-02-01,1395.42,16.87,1.22,1565.15,-10.84,True,1,20109,-1395.42,-5229268.36,28060500.78,22831232.42
2008-02-04,1380.82,-14.6,-1.05,1565.15,-11.78,True,1,20110,-1380.82,-5230649.18,27768290.2,22537641.02
2008-02-05,1336.64,-44.18,-3.2,1565.15,-14.6,True,1,20111,-1336.64,-5231985.82,26881167.04,21649181.22
2008-02-06,1326.45,-10.19,-0.76,1565.15,-15.25,True,1,20112,-1326.45,-5233312.27,26677562.4,21444250.13
2008-02-07,1336.91,10.46,0.79,1565.15,-14.58,True,1,20113,-1336.91,-5234649.18,26889270.83,21654621.65
2008-02-08,1331.29,-5.62,-0.42,1565.15,-14.94,True,1,20114,-1331.29,-5235980.47,26777567.06,21541586.59
2008-02-11,1339.13,7.84,0.59,1565.15,-14.44,True,1,20115,-1339.13,-5237319.6,26936599.95,21699280.35
2008-02-12,1348.86,9.73,0.73,1565.15,-13.82,True,1,20116,-1348.86,-5238668.46,27133667.76,21894999.3
2008-02-13,1367.21,18.35,1.36,1565.15,-12.65,True,1,20117,-1367.21,-5240035.67,27504163.57,22264127.9
2008-02-14,1348.86,-18.35,-1.34,1565.15,-13.82,True,1,20118,-1348.86,-5241384.53,27136365.48,21894980.95
2008-02-15,1349.99,1.13,0.08,1565.15,-13.75,True,1,20119,-1349.99,-5242734.52,27160448.81,21917714.29
2008-02-19,1348.78,-1.21,-0.09,1565.15,-13.82,True,1,20120,-1348.78,-5244083.3,27137453.6,21893370.3
2008-02-20,1360.03,11.25,0.83,1565.15,-13.1,True,1,20121,-1360.03,-5245443.33,27365163.63,22119720.3
2008-02-21,1342.53,-17.5,-1.29,1565.15,-14.22,True,1,20122,-1342.53,-5246785.86,27014388.66,21767602.8
2008-02-22,1353.11,10.58,0.79,1565.15,-13.55,True,1,20123,-1353.11,-5248138.97,27228632.53,21980493.56
2008-02-25,1371.8,18.69,1.38,1565.15,-12.35,True,1,20124,-1371.8,-5249510.77,27606103.2,22356592.43
2008-02-26,1381.29,9.49,0.69,1565.15,-11.75,True,1,20125,-1381.29,-5250892.06,27798461.25,22547569.19
2008-02-27,1380.02,-1.27,-0.09,1565.15,-11.83,True,1,20126,-1380.02,-5252272.08,27774282.52,22522010.44
2008-02-28,1367.68,-12.34,-0.89,1565.15,-12.62,True,1,20127,-1367.68,-5253639.76,27527295.36,22273655.6
2008-02-29,1330.63,-37.05,-2.71,1565.15,-14.98,True,1,20128,-1330.63,-5254970.39,26782920.64,21527950.25
2008-03-03,1331.34,0.71,0.05,1565.15,-14.94,True,1,20129,-1331.34,-5256301.73,26798542.86,21542241.13
2008-03-04,1326.75,-4.59,-0.34,1565.15,-15.23,True,1,20130,-1326.75,-5257628.48,26707477.5,21449849.02
2008-03-05,1333.7,6.95,0.52,1565.15,-14.79,True,1,20131,-1333.7,-5258962.18,26848714.7,21589752.52
2008-03-06,1304.34,-29.36,-2.2,1565.15,-16.66,True,1,20132,-1304.34,-5260266.52,26258972.88,20998706.36
2008-03-07,1293.37,-10.97,-0.84,1565.15,-17.36,True,1,20133,-1293.37,-5261559.89,26039418.21,20777858.32
2008-03-10,1273.37,-20.0,-1.55,1565.15,-18.64,True,1,20134,-1273.37,-5262833.26,25638031.58,20375198.32
2008-03-11,1320.65,47.28,3.71,1565.15,-15.62,True,1,20135,-1320.65,-5264153.91,26591287.75,21327133.84
2008-03-12,1308.77,-11.88,-0.9,1565.15,-16.38,True,1,20136,-1308.77,-5265462.68,26353392.72,21087930.04
2008-03-13,1315.48,6.71,0.51,1565.15,-15.95,True,1,20137,-1315.48,-5266778.16,26489820.76,21223042.6
2008-03-14,1288.14,-27.34,-2.08,1565.15,-17.7,True,1,20138,-1288.14,-5268066.3,25940563.32,20672497.02
2008-03-17,1276.6,-11.54,-0.9,1565.15,-18.44,True,1,20139,-1276.6,-5269342.9,25709447.4,20440104.5
2008-03-18,1330.74,54.14,4.24,1565.15,-14.98,True,1,20140,-1330.74,-5270673.64,26801103.6,21530429.96
2008-03-19,1298.42,-32.32,-2.43,1565.15,-17.04,True,1,20141,-1298.42,-5271972.06,26151477.22,20879505.16
2008-03-20,1329.51,31.09,2.39,1565.15,-15.06,True,1,20142,-1329.51,-5273301.57,26778990.42,21505688.85
2008-03-24,1349.88,20.37,1.53,1565.15,-13.75,True,1,20143,-1349.88,-5274651.45,27190632.84,21915981.39
2008-03-25,1352.99,3.11,0.23,1565.15,-13.56,True,1,20144,-1352.99,-5276004.44,27254630.56,21978626.12
2008-03-26,1341.13,-11.86,-0.88,1565.15,-14.31,True,1,20145,-1341.13,-5277345.57,27017063.85,21739718.28
2008-03-27,1325.76,-15.37,-1.15,1565.15,-15.3,True,1,20146,-1325.76,-5278671.33,26708760.96,21430089.63
2008-03-28,1315.22,-10.54,-0.8,1565.15,-15.97,True,1,20147,-1315.22,-5279986.55,26497737.34,21217750.79
2008-03-31,1322.7,7.48,0.57,1565.15,-15.49,True,1,20148,-1322.7,-5281309.25,26649759.6,21368450.35
2008-04-01,1370.18,47.48,3.59,1565.15,-12.46,True,1,20149,-1370.18,-5282679.43,27607756.82,22325077.39
2008-04-02,1367.53,-2.65,-0.19,1565.15,-12.63,True,1,20150,-1367.53,-5284046.96,27555729.5,22271682.54
2008-04-03,1369.31,1.78,0.13,1565.15,-12.51,True,1,20151,-1369.31,-5285416.27,27592965.81,22307549.54
2008-04-04,1370.4,1.09,0.08,1565.15,-12.44,True,1,20152,-1370.4,-5286786.67,27616300.8,22329514.13
2008-04-07,1372.54,2.14,0.16,1565.15,-12.31,True,1,20153,-1372.54,-5288159.21,27660798.62,22372639.41
2008-04-08,1365.54,-7.0,-0.51,1565.15,-12.75,True,1,20154,-1365.54,-5289524.75,27521093.16,22231568.41
2008-04-09,1354.49,-11.05,-0.81,1565.15,-13.46,True,1,20155,-1354.49,-5290879.24,27299745.95,22008866.71
2008-04-10,1360.55,6.06,0.45,1565.15,-13.07,True,1,20156,-1360.55,-5292239.79,27423245.8,22131006.01
2008-04-11,1332.83,-27.72,-2.04,1565.15,-14.84,True,1,20157,-1332.83,-5293572.62,26865854.31,21572281.69
2008-04-14,1328.32,-4.51,-0.34,1565.15,-15.13,True,1,20158,-1328.32,-5294900.94,26776274.56,21481373.62
2008-04-15,1334.43,6.11,0.46,1565.15,-14.74,True,1,20159,-1334.43,-5296235.37,26900774.37,21604539.0
2008-04-16,1364.71,30.28,2.27,1565.15,-12.81,True,1,20160,-1364.71,-5297600.08,27512553.6,22214953.52
2008-04-17,1365.56,0.85,0.06,1565.15,-12.75,True,1,20161,-1365.56,-5298965.64,27531055.16,22232089.52
2008-04-18,1390.33,24.77,1.81,1565.15,-11.17,True,1,20162,-1390.33,-5300355.97,28031833.46,22731477.49
2008-04-21,1388.17,-2.16,-0.16,1565.15,-11.31,True,1,20163,-1388.17,-5301744.14,27989671.71,22687927.57
2008-04-22,1375.94,-12.23,-0.88,1565.15,-12.09,True,1,20164,-1375.94,-5303120.08,27744454.16,22441334.08
2008-04-23,1379.93,3.99,0.29,1565.15,-11.83,True,1,20165,-1379.93,-5304500.01,27826288.45,22521788.44
2008-04-24,1388.82,8.89,0.64,1565.15,-11.27,True,1,20166,-1388.82,-5305888.83,28006944.12,22701055.29
2008-04-25,1397.84,9.02,0.65,1565.15,-10.69,True,1,20167,-1397.84,-5307286.67,28190239.28,22882952.61
2008-04-28,1396.37,-1.47,-0.1,1565.15,-10.78,True,1,20168,-1396.37,-5308683.04,28161990.16,22853307.12
2008-04-29,1390.94,-5.43,-0.39,1565.15,-11.13,True,1,20169,-1390.94,-5310073.98,28053868.86,22743794.88
2008-04-30,1385.59,-5.35,-0.38,1565.15,-11.47,True,1,20170,-1385.59,-5311459.57,27947350.3,22635890.73
2008-05-01,1409.34,23.75,1.71,1565.15,-9.96,True,1,20171,-1409.34,-5312868.91,28427797.14,23114928.23
2008-05-02,1413.9,4.56,0.32,1565.15,-9.66,True,1,20172,-1413.9,-5314282.81,28521190.8,23206907.99
2008-05-05,1407.49,-6.41,-0.45,1565.15,-10.07,True,1,20173,-1407.49,-5315690.3,28393295.77,23077605.47
2008-05-06,1418.26,10.77,0.76,1565.15,-9.38,True,1,20174,-1418.26,-5317108.56,28611977.24,23294868.68
2008-05-07,1392.57,-25.69,-1.81,1565.15,-11.03,True,1,20175,-1392.57,-5318501.13,28095099.75,22776598.62
2008-05-08,1397.68,5.11,0.37,1565.15,-10.7,True,1,20176,-1397.68,-5319898.81,28199591.68,22879692.87
2008-05-09,1388.28,-9.4,-0.67,1565.15,-11.3,True,1,20177,-1388.28,-5321287.09,28011325.56,22690038.47
2008-05-12,1403.58,15.3,1.1,1565.15,-10.32,True,1,20178,-1403.58,-5322690.67,28321437.24,22998746.57
2008-05-13,1403.04,-0.54,-0.04,1565.15,-10.36,True,1,20179,-1403.04,-5324093.71,28311944.16,22987850.45
2008-05-14,1408.66,5.62,0.4,1565.15,-10.0,True,1,20180,-1408.66,-5325502.37,28426758.8,23101256.43
2008-05-15,1423.57,14.91,1.06,1565.15,-9.05,True,1,20181,-1423.57,-5326925.94,28729066.17,23402140.23
2008-05-16,1425.35,1.78,0.12,1565.15,-8.93,True,1,20182,-1425.35,-5328351.29,28766413.7,23438062.41
2008-05-19,1426.63,1.28,0.09,1565.15,-8.85,True,1,20183,-1426.63,-5329777.92,28793673.29,23463895.37
2008-05-20,1413.4,-13.23,-0.93,1565.15,-9.7,True,1,20184,-1413.4,-5331191.32,28528065.6,23196874.28
2008-05-21,1390.71,-22.69,-1.6,1565.15,-11.14,True,1,20185,-1390.71,-5332582.03,28071481.35,22738899.32
2008-05-22,1394.35,3.64,0.26,1565.15,-10.91,True,1,20186,-1394.35,-5333976.38,28146349.1,22812372.72
2008-05-23,1375.93,-18.42,-1.32,1565.15,-12.09,True,1,20187,-1375.93,-5335352.31,27775898.91,22440546.6
2008-05-27,1385.35,9.42,0.68,1565.15,-11.49,True,1,20188,-1385.35,-5336737.66,27967445.8,22630708.14
2008-05-28,1390.84,5.49,0.4,1565.15,-11.14,True,1,20189,-1390.84,-5338128.5,28079668.76,22741540.26
2008-05-29,1398.26,7.42,0.53,1565.15,-10.66,True,1,20190,-1398.26,-5339526.76,28230869.4,22891342.64
2008-05-30,1400.38,2.12,0.15,1565.15,-10.53,True,1,20191,-1400.38,-5340927.14,28275072.58,22934145.44
2008-06-02,1385.67,-14.71,-1.05,1565.15,-11.47,True,1,20192,-1385.67,-5342312.81,27979448.64,22637135.83
2008-06-03,1377.65,-8.02,-0.58,1565.15,-11.98,True,1,20193,-1377.65,-5343690.46,27818886.45,22475195.99
2008-06-04,1377.2,-0.45,-0.03,1565.15,-12.01,True,1,20194,-1377.2,-5345067.66,27811176.8,22466109.14
2008-06-05,1404.05,26.85,1.95,1565.15,-10.29,True,1,20195,-1404.05,-5346471.71,28354789.75,23008318.04
2008-06-06,1360.68,-43.37,-3.09,1565.15,-13.06,True,1,20196,-1360.68,-5347832.39,27480293.28,22132460.89
2008-06-09,1361.76,1.08,0.08,1565.15,-13.0,True,1,20197,-1361.76,-5349194.15,27503466.72,22154272.57
2008-06-10,1358.44,-3.32,-0.24,1565.15,-13.21,True,1,20198,-1358.44,-5350552.59,27437771.12,22087218.53
2008-06-11,1335.49,-22.95,-1.69,1565.15,-14.67,True,1,20199,-1335.49,-5351888.08,26975562.51,21623674.43
2008-06-12,1339.87,4.38,0.33,1565.15,-14.39,True,1,20200,-1339.87,-5353227.95,27065374.0,21712146.05
2008-06-13,1360.03,20.16,1.5,1565.15,-13.1,True,1,20201,-1360.03,-5354587.98,27473966.03,22119378.05
2008-06-16,1360.14,0.11,0.01,1565.15,-13.1,True,1,20202,-1360.14,-5355948.12,27477548.28,22121600.16
2008-06-17,1350.93,-9.21,-0.68,1565.15,-13.69,True,1,20203,-1350.93,-5357299.05,27292838.79,21935539.74
2008-06-18,1337.81,-13.12,-0.97,1565.15,-14.52,True,1,20204,-1337.81,-5358636.86,27029113.24,21670476.38
2008-06-19,1342.83,5.02,0.38,1565.15,-14.2,True,1,20205,-1342.83,-5359979.69,27131880.15,21771900.46
2008-06-20,1317.93,-24.9,-1.85,1565.15,-15.8,True,1,20206,-1317.93,-5361297.62,26630093.58,21268795.96
2008-06-23,1318.0,0.07,0.0,1565.15,-15.79,True,1,20207,-1318.0,-5362615.62,26632826.0,21270210.38
2008-06-24,1314.29,-3.71,-0.28,1565.15,-16.03,True,1,20208,-1314.29,-5363929.91,26559172.32,21195242.41
2008-06-25,1321.97,7.68,0.58,1565.15,-15.54,True,1,20209,-1321.97,-5365251.88,26715691.73,21350439.85
2008-06-26,1283.15,-38.82,-2.94,1565.15,-18.02,True,1,20210,-1283.15,-5366535.03,25932461.5,20565926.47
2008-06-27,1278.38,-4.77,-0.37,1565.15,-18.32,True,1,20211,-1278.38,-5367813.41,25837338.18,20469524.77
2008-06-30,1280.0,1.62,0.13,1565.15,-18.22,True,1,20212,-1280.0,-5369093.41,25871360.0,20502266.59
2008-07-01,1284.91,4.91,0.38,1565.15,-17.9,True,1,20213,-1284.91,-5370378.32,25971885.83,20601507.51
2008-07-02,1261.52,-23.39,-1.82,1565.15,-19.4,True,1,20214,-1261.52,-5371639.84,25500365.28,20128725.44
2008-07-03,1262.9,1.38,0.11,1565.15,-19.31,True,1,20215,-1262.9,-5372902.74,25529523.5,20156620.76
2008-07-07,1252.31,-10.59,-0.84,1565.15,-19.99,True,1,20216,-1252.31,-5374155.05,25316698.96,19942543.91
2008-07-08,1273.7,21.39,1.71,1565.15,-18.62,True,1,20217,-1273.7,-5375428.75,25750392.9,20374964.15
2008-07-09,1244.69,-29.01,-2.28,1565.15,-20.48,True,1,20218,-1244.69,-5376673.44,25165142.42,19788468.98
2008-07-10,1253.39,8.7,0.7,1565.15,-19.92,True,1,20219,-1253.39,-5377926.83,25342292.41,19964365.58
2008-07-11,1239.49,-13.9,-1.11,1565.15,-20.81,True,1,20220,-1239.49,-5379166.32,25062487.8,19683321.48
2008-07-14,1228.3,-11.19,-0.9,1565.15,-21.52,True,1,20221,-1228.3,-5380394.62,24837454.3,19457059.68
2008-07-15,1214.91,-13.39,-1.09,1565.15,-22.38,True,1,20222,-1214.91,-5381609.53,24567910.02,19186300.49
2008-07-16,1245.36,30.45,2.51,1565.15,-20.43,True,1,20223,-1245.36,-5382854.89,25184915.28,19802060.39
2008-07-17,1260.32,14.96,1.2,1565.15,-19.48,True,1,20224,-1260.32,-5384115.21,25488711.68,20104596.47
2008-07-18,1260.68,0.36,0.03,1565.15,-19.45,True,1,20225,-1260.68,-5385375.89,25497253.0,20111877.11
2008-07-21,1260.0,-0.68,-0.05,1565.15,-19.5,True,1,20226,-1260.0,-5386635.89,25484760.0,20098124.11
2008-07-22,1277.0,17.0,1.35,1565.15,-18.41,True,1,20227,-1277.0,-5387912.89,25829879.0,20441966.11
2008-07-23,1282.19,5.19,0.41,1565.15,-18.08,True,1,20228,-1282.19,-5389195.08,25936139.32,20546944.24
2008-07-24,1252.54,-29.65,-2.31,1565.15,-19.97,True,1,20229,-1252.54,-5390447.62,25337631.66,19947184.04
2008-07-25,1257.76,5.22,0.42,1565.15,-19.64,True,1,20230,-1257.76,-5391705.38,25444484.8,20052779.42
2008-07-28,1234.37,-23.39,-1.86,1565.15,-21.13,True,1,20231,-1234.37,-5392939.75,24972539.47,19579599.72
2008-07-29,1263.2,28.83,2.34,1565.15,-19.29,True,1,20232,-1263.2,-5394202.95,25557062.4,20162859.45
2008-07-30,1284.26,21.06,1.67,1565.15,-17.95,True,1,20233,-1284.26,-5395487.21,25984432.58,20588945.37
2008-07-31,1267.38,-16.88,-1.31,1565.15,-19.02,True,1,20234,-1267.38,-5396754.59,25644166.92,20247412.33
2008-08-01,1260.31,-7.07,-0.56,1565.15,-19.48,True,1,20235,-1260.31,-5398014.9,25502372.85,20104357.95
2008-08-04,1249.01,-11.3,-0.9,1565.15,-20.2,True,1,20236,-1249.01,-5399263.91,25274966.36,19875702.45
2008-08-05,1284.88,35.87,2.87,1565.15,-17.91,True,1,20237,-1284.88,-5400548.79,26002116.56,20601567.77
2008-08-06,1289.19,4.31,0.34,1565.15,-17.63,True,1,20238,-1289.19,-5401837.98,26090627.22,20688789.24
2008-08-07,1266.07,-23.12,-1.79,1565.15,-19.11,True,1,20239,-1266.07,-5403104.05,25623990.73,20220886.68
2008-08-08,1296.32,30.25,2.39,1565.15,-17.18,True,1,20240,-1296.32,-5404400.37,26237516.8,20833116.43
2008-08-11,1305.32,9.0,0.69,1565.15,-16.6,True,1,20241,-1305.32,-5405705.69,26420982.12,21015276.43
2008-08-12,1289.59,-15.73,-1.2,1565.15,-17.61,True,1,20242,-1289.59,-5406995.28,26103880.78,20696885.5
2008-08-13,1285.83,-3.76,-0.29,1565.15,-17.85,True,1,20243,-1285.83,-5408281.11,26029056.69,20620775.58
2008-08-14,1292.93,7.1,0.55,1565.15,-17.39,True,1,20244,-1292.93,-5409574.04,26174074.92,20764500.88
2008-08-15,1298.2,5.27,0.41,1565.15,-17.06,True,1,20245,-1298.2,-5410872.24,26282059.0,20871186.76
2008-08-18,1278.6,-19.6,-1.51,1565.15,-18.31,True,1,20246,-1278.6,-5412150.84,25886535.6,20474384.76
2008-08-19,1266.69,-11.91,-0.93,1565.15,-19.07,True,1,20247,-1266.69,-5413417.53,25646672.43,20233254.9
2008-08-20,1274.54,7.85,0.62,1565.15,-18.57,True,1,20248,-1274.54,-5414692.07,25806885.92,20392193.85
2008-08-21,1277.72,3.18,0.25,1565.15,-18.36,True,1,20249,-1277.72,-5415969.79,25872552.28,20456582.49
2008-08-22,1292.2,14.48,1.13,1565.15,-17.44,True,1,20250,-1292.2,-5417261.99,26167050.0,20749788.01
2008-08-25,1266.84,-25.36,-1.96,1565.15,-19.06,True,1,20251,-1266.84,-5418528.83,25654776.84,20236248.01
2008-08-26,1271.51,4.67,0.37,1565.15,-18.76,True,1,20252,-1271.51,-5419800.34,25750620.52,20330820.18
2008-08-27,1281.66,10.15,0.8,1565.15,-18.11,True,1,20253,-1281.66,-5421082.0,25957459.98,20536377.98
2008-08-28,1300.68,19.02,1.48,1565.15,-16.9,True,1,20254,-1300.68,-5422382.68,26343972.72,20921590.04
2008-08-29,1282.83,-17.85,-1.37,1565.15,-18.04,True,1,20255,-1282.83,-5423665.51,25983721.65,20560056.14
2008-09-02,1277.58,-5.25,-0.41,1565.15,-18.37,True,1,20256,-1277.58,-5424943.09,25878660.48,20453717.39
2008-09-03,1274.98,-2.6,-0.2,1565.15,-18.54,True,1,20257,-1274.98,-5426218.07,25827269.86,20401051.79
2008-09-04,1236.83,-38.15,-2.99,1565.15,-20.98,True,1,20258,-1236.83,-5427454.9,25055702.14,19628247.24
2008-09-05,1242.31,5.48,0.44,1565.15,-20.63,True,1,20259,-1242.31,-5428697.21,25167958.29,19739261.08
2008-09-08,1267.79,25.48,2.05,1565.15,-19.0,True,1,20260,-1267.79,-5429965.0,25685425.4,20255460.4
2008-09-09,1224.51,-43.28,-3.41,1565.15,-21.76,True,1,20261,-1224.51,-5431189.51,24809797.11,19378607.6
2008-09-10,1232.04,7.53,0.62,1565.15,-21.28,True,1,20262,-1232.04,-5432421.55,24963594.48,19531172.93
2008-09-11,1249.05,17.01,1.38,1565.15,-20.2,True,1,20263,-1249.05,-5433670.6,25309500.15,19875829.55
2008-09-12,1251.7,2.65,0.21,1565.15,-20.03,True,1,20264,-1251.7,-5434922.3,25364448.8,19929526.5
2008-09-15,1192.7,-59.0,-4.71,1565.15,-23.8,True,1,20265,-1192.7,-5436115.0,24170065.5,18733950.5
2008-09-16,1213.6,20.9,1.75,1565.15,-22.46,True,1,20266,-1213.6,-5437328.6,24594817.6,19157489.0
2008-09-17,1156.39,-57.21,-4.71,1565.15,-26.12,True,1,20267,-1156.39,-5438484.99,23436556.13,17998071.14
2008-09-18,1206.51,50.12,4.33,1565.15,-22.91,True,1,20268,-1206.51,-5439691.5,24453544.68,19013853.18
2008-09-19,1255.08,48.57,4.03,1565.15,-19.81,True,1,20269,-1255.08,-5440946.58,25439216.52,19998269.94
2008-09-22,1207.09,-47.99,-3.82,1565.15,-22.88,True,1,20270,-1207.09,-5442153.67,24467714.3,19025560.63
2008-09-23,1188.22,-18.87,-1.56,1565.15,-24.08,True,1,20271,-1188.22,-5443341.89,24086407.62,18643065.73
2008-09-24,1185.87,-2.35,-0.2,1565.15,-24.23,True,1,20272,-1185.87,-5444527.76,24039956.64,18595428.88
2008-09-25,1209.18,23.31,1.97,1565.15,-22.74,True,1,20273,-1209.18,-5445736.94,24513706.14,19067969.2
2008-09-26,1213.27,4.09,0.34,1565.15,-22.48,True,1,20274,-1213.27,-5446950.21,24597835.98,19150885.77
2008-09-29,1106.42,-106.85,-8.81,1565.15,-29.31,True,1,20275,-1106.42,-5448056.63,22432665.5,16984608.87
2008-09-30,1166.36,59.94,5.42,1565.15,-25.48,True,1,20276,-1166.36,-5449222.99,23649115.36,18199892.37
2008-10-01,1161.06,-5.3,-0.45,1565.15,-25.82,True,1,20277,-1161.06,-5450384.05,23542813.62,18092429.57
2008-10-02,1114.28,-46.78,-4.03,1565.15,-28.81,True,1,20278,-1114.28,-5451498.33,22595369.84,17143871.51
2008-10-03,1099.23,-15.05,-1.35,1565.15,-29.77,True,1,20279,-1099.23,-5452597.56,22291285.17,16838687.61
2008-10-06,1056.89,-42.34,-3.85,1565.15,-32.47,True,1,20280,-1056.89,-5453654.45,21433729.2,15980074.75
2008-10-07,996.23,-60.66,-5.74,1565.15,-36.35,True,1,20281,-996.23,-5454650.68,20204540.63,14749889.95
2008-10-08,984.94,-11.29,-1.13,1565.15,-37.07,True,1,20282,-984.94,-5455635.62,19976553.08,14520917.46
2008-10-09,909.92,-75.02,-7.62,1565.15,-41.86,True,1,20283,-909.92,-5456545.54,18455907.36,12999361.82
2008-10-10,899.22,-10.7,-1.18,1565.15,-42.55,True,1,20284,-899.22,-5457444.76,18239778.48,12782333.72
2008-10-13,1003.35,104.13,11.58,1565.15,-35.89,True,1,20285,-1003.35,-5458448.11,20352954.75,14894506.64
2008-10-14,998.01,-5.34,-0.53,1565.15,-36.24,True,1,20286,-998.01,-5459446.12,20245630.86,14786184.74
2008-10-15,907.84,-90.17,-9.04,1565.15,-42.0,True,1,20287,-907.84,-5460353.96,18417350.08,12956996.12
2008-10-16,946.43,38.59,4.25,1565.15,-39.53,True,1,20288,-946.43,-5461300.39,19201171.84,13739871.45
2008-10-17,940.55,-5.88,-0.62,1565.15,-39.91,True,1,20289,-940.55,-5462240.94,19082818.95,13620578.01
2008-10-20,985.4,44.85,4.77,1565.15,-37.04,True,1,20290,-985.4,-5463226.34,19993766.0,14530539.66
2008-10-21,955.05,-30.35,-3.08,1565.15,-38.98,True,1,20291,-955.05,-5464181.39,19378919.55,13914738.16
2008-10-22,896.78,-58.27,-6.1,1565.15,-42.7,True,1,20292,-896.78,-5465078.17,18197459.76,12732381.59
2008-10-23,908.11,11.33,1.26,1565.15,-41.98,True,1,20293,-908.11,-5465986.28,18428276.23,12962289.95
2008-10-24,876.77,-31.34,-3.45,1565.15,-43.98,True,1,20294,-876.77,-5466863.05,17793170.38,12326307.33
2008-10-27,848.92,-27.85,-3.18,1565.15,-45.76,True,1,20295,-848.92,-5467711.97,17228831.4,11761119.43
2008-10-28,940.51,91.59,10.79,1565.15,-39.91,True,1,20296,-940.51,-5468652.48,19088590.96,13619938.48
2008-10-29,930.09,-10.42,-1.11,1565.15,-40.58,True,1,20297,-930.09,-5469582.57,18878036.73,13408454.16
2008-10-30,954.09,24.0,2.58,1565.15,-39.04,True,1,20298,-954.09,-5470536.66,19366118.82,13895582.16
2008-10-31,968.75,14.66,1.54,1565.15,-38.1,True,1,20299,-968.75,-5471505.41,19664656.25,14193150.84
2008-11-03,966.3,-2.45,-0.25,1565.15,-38.26,True,1,20300,-966.3,-5472471.71,19615890.0,14143418.29
2008-11-04,1005.75,39.45,4.08,1565.15,-35.74,True,1,20301,-1005.75,-5473477.46,20417730.75,14944253.29
2008-11-05,952.77,-52.98,-5.27,1565.15,-39.13,True,1,20302,-952.77,-5474430.23,19343136.54,13868706.31
2008-11-06,904.88,-47.89,-5.03,1565.15,-42.19,True,1,20303,-904.88,-5475335.11,18371778.64,12896443.53
2008-11-07,930.99,26.11,2.88,1565.15,-40.52,True,1,20304,-930.99,-5476266.1,18902820.96,13426554.86
2008-11-10,919.21,-11.78,-1.26,1565.15,-41.27,True,1,20305,-919.21,-5477185.31,18664559.05,13187373.74
2008-11-11,898.95,-20.26,-2.2,1565.15,-42.56,True,1,20306,-898.95,-5478084.26,18254078.7,12775994.44
2008-11-12,852.3,-46.65,-5.19,1565.15,-45.54,True,1,20307,-852.3,-5478936.56,17307656.1,11828719.54
2008-11-13,911.29,58.99,6.92,1565.15,-41.78,True,1,20308,-911.29,-5479847.85,18506477.32,13026629.47
2008-11-14,873.29,-38.0,-4.17,1565.15,-44.2,True,1,20309,-873.29,-5480721.14,17735646.61,12254925.47
2008-11-17,850.75,-22.54,-2.58,1565.15,-45.64,True,1,20310,-850.75,-5481571.89,17278732.5,11797160.61
2008-11-18,859.12,8.37,0.98,1565.15,-45.11,True,1,20311,-859.12,-5482431.01,17449586.32,11967155.31
2008-11-19,806.58,-52.54,-6.12,1565.15,-48.47,True,1,20312,-806.58,-5483237.59,16383252.96,10900015.37
2008-11-20,752.44,-54.14,-6.71,1565.15,-51.92,True,1,20313,-752.44,-5483990.03,15284313.72,9800323.69
2008-11-21,800.03,47.59,6.32,1565.15,-48.88,True,1,20314,-800.03,-5484790.06,16251809.42,10767019.36
2008-11-24,851.81,51.78,6.47,1565.15,-45.58,True,1,20315,-851.81,-5485641.87,17304520.15,11818878.28
2008-11-25,857.39,5.58,0.66,1565.15,-45.22,True,1,20316,-857.39,-5486499.26,17418735.24,11932235.98
2008-11-26,887.68,30.29,3.53,1565.15,-43.28,True,1,20317,-887.68,-5487386.94,18034994.56,12547607.62
2008-11-28,896.24,8.56,0.96,1565.15,-42.74,True,1,20318,-896.24,-5488283.18,18209804.32,12721521.14
2008-12-01,816.21,-80.03,-8.93,1565.15,-47.85,True,1,20319,-816.21,-5489099.39,16584570.99,11095471.6
2008-12-02,848.81,32.6,3.99,1565.15,-45.77,True,1,20320,-848.81,-5489948.2,17247819.2,11757871.0
2008-12-03,870.74,21.93,2.58,1565.15,-44.37,True,1,20321,-870.74,-5490818.94,17694307.54,12203488.6
2008-12-04,845.22,-25.52,-2.93,1565.15,-46.0,True,1,20322,-845.22,-5491664.16,17176560.84,11684896.68
2008-12-05,876.07,30.85,3.65,1565.15,-44.03,True,1,20323,-876.07,-5492540.23,17804370.61,12311830.38
2008-12-08,909.7,33.63,3.84,1565.15,-41.88,True,1,20324,-909.7,-5493449.93,18488742.8,12995292.87
2008-12-09,888.67,-21.03,-2.31,1565.15,-43.22,True,1,20325,-888.67,-5494338.6,18062217.75,12567879.15
2008-12-10,899.24,10.57,1.19,1565.15,-42.55,True,1,20326,-899.24,-5495237.84,18277952.24,12782714.4
2008-12-11,873.59,-25.65,-2.85,1565.15,-44.18,True,1,20327,-873.59,-5496111.43,17757463.93,12261352.5
2008-12-12,879.73,6.14,0.7,1565.15,-43.79,True,1,20328,-879.73,-5496991.16,17883151.44,12386160.28
2008-12-15,868.57,-11.16,-1.27,1565.15,-44.51,True,1,20329,-868.57,-5497859.73,17657159.53,12159299.8
2008-12-16,913.18,44.61,5.14,1565.15,-41.66,True,1,20330,-913.18,-5498772.91,18564949.4,13066176.49
2008-12-17,904.42,-8.76,-0.96,1565.15,-42.22,True,1,20331,-904.42,-5499677.33,18387763.02,12888085.69
2008-12-18,885.28,-19.14,-2.12,1565.15,-43.44,True,1,20332,-885.28,-5500562.61,17999512.96,12498950.35
2008-12-19,887.88,2.6,0.29,1565.15,-43.27,True,1,20333,-887.88,-5501450.49,18053264.04,12551813.55
2008-12-22,871.63,-16.25,-1.83,1565.15,-44.31,True,1,20334,-871.63,-5502322.12,17723724.42,12221402.3
2008-12-23,863.16,-8.47,-0.97,1565.15,-44.85,True,1,20335,-863.16,-5503185.28,17552358.6,12049173.32
2008-12-24,868.15,4.99,0.58,1565.15,-44.53,True,1,20336,-868.15,-5504053.43,17654698.4,12150644.97
2008-12-26,872.8,4.65,0.54,1565.15,-44.24,True,1,20337,-872.8,-5504926.23,17750133.6,12245207.37
2008-12-29,869.42,-3.38,-0.39,1565.15,-44.45,True,1,20338,-869.42,-5505795.65,17682263.96,12176468.31
2008-12-30,890.64,21.22,2.44,1565.15,-43.1,True,1,20339,-890.64,-5506686.29,18114726.96,12608040.67
2008-12-31,903.25,12.61,1.42,1565.15,-42.29,True,1,20340,-903.25,-5507589.54,18372105.0,12864515.46
2009-01-02,931.8,28.55,3.16,1565.15,-40.47,True,1,20341,-931.8,-5508521.34,18953743.8,13445222.46
2009-01-05,927.45,-4.35,-0.47,1565.15,-40.74,True,1,20342,-927.45,-5509448.79,18866187.9,13356739.11
2009-01-06,934.7,7.25,0.78,1565.15,-40.28,True,1,20343,-934.7,-5510383.49,19014602.1,13504218.61
2009-01-07,906.65,-28.05,-3.0,1565.15,-42.07,True,1,20344,-906.65,-5511290.14,18444887.6,12933597.46
2009-01-08,909.73,3.08,0.34,1565.15,-41.88,True,1,20345,-909.73,-5512199.87,18508456.85,12996256.98
2009-01-09,890.35,-19.38,-2.13,1565.15,-43.11,True,1,20346,-890.35,-5513090.22,18115061.1,12601970.88
2009-01-12,870.26,-20.09,-2.26,1565.15,-44.4,True,1,20347,-870.26,-5513960.48,17707180.22,12193219.74
2009-01-13,871.79,1.53,0.18,1565.15,-44.3,True,1,20348,-871.79,-5514832.27,17739182.92,12224350.65
2009-01-14,842.62,-29.17,-3.35,1565.15,-46.16,True,1,20349,-842.62,-5515674.89,17146474.38,11630799.49
2009-01-15,843.74,1.12,0.13,1565.15,-46.09,True,1,20350,-843.74,-5516518.63,17170109.0,11653590.37
2009-01-16,850.12,6.38,0.76,1565.15,-45.68,True,1,20351,-850.12,-5517368.75,17300792.12,11783423.37
2009-01-20,805.22,-44.9,-5.28,1565.15,-48.55,True,1,20352,-805.22,-5518173.97,16387837.44,10869663.47
2009-01-21,840.24,35.02,4.35,1565.15,-46.32,True,1,20353,-840.24,-5519014.21,17101404.72,11582390.51
2009-01-22,827.5,-12.74,-1.52,1565.15,-47.13,True,1,20354,-827.5,-5519841.71,16842935.0,11323093.29
2009-01-23,831.95,4.45,0.54,1565.15,-46.84,True,1,20355,-831.95,-5520673.66,16934342.25,11413668.59
2009-01-26,836.57,4.62,0.56,1565.15,-46.55,True,1,20356,-836.57,-5521510.23,17029218.92,11507708.69
2009-01-27,845.71,9.14,1.09,1565.15,-45.97,True,1,20357,-845.71,-5522355.94,17216118.47,11693762.53
2009-01-28,874.09,28.38,3.36,1565.15,-44.15,True,1,20358,-874.09,-5523230.03,17794724.22,12271494.19
2009-01-29,845.14,-28.95,-3.31,1565.15,-46.0,True,1,20359,-845.14,-5524075.17,17206205.26,11682130.09
2009-01-30,825.88,-19.26,-2.28,1565.15,-47.23,True,1,20360,-825.88,-5524901.05,16814916.8,11290015.75
2009-02-02,825.44,-0.44,-0.05,1565.15,-47.26,True,1,20361,-825.44,-5525726.49,16806783.84,11281057.35
2009-02-03,838.51,13.07,1.58,1565.15,-46.43,True,1,20362,-838.51,-5526565.0,17073740.62,11547175.62
2009-02-04,832.23,-6.28,-0.75,1565.15,-46.83,True,1,20363,-832.23,-5527397.23,16946699.49,11419302.26
2009-02-05,845.85,13.62,1.64,1565.15,-45.96,True,1,20364,-845.85,-5528243.08,17224889.4,11696646.32
2009-02-06,868.6,22.75,2.69,1565.15,-44.5,True,1,20365,-868.6,-5529111.68,17689039.0,12159927.32
2009-02-09,869.89,1.29,0.15,1565.15,-44.42,True,1,20366,-869.89,-5529981.57,17716179.74,12186198.17
2009-02-10,827.16,-42.73,-4.91,1565.15,-47.15,True,1,20367,-827.16,-5530808.73,16846767.72,11315958.99
2009-02-11,833.74,6.58,0.8,1565.15,-46.73,True,1,20368,-833.74,-5531642.47,16981616.32,11449973.85
2009-02-12,835.19,1.45,0.17,1565.15,-46.64,True,1,20369,-835.19,-5532477.66,17011985.11,11479507.45
2009-02-13,826.84,-8.35,-1.0,1565.15,-47.17,True,1,20370,-826.84,-5533304.5,16842730.8,11309426.3
2009-02-17,789.17,-37.67,-4.56,1565.15,-49.58,True,1,20371,-789.17,-5534093.67,16076182.07,10542088.4
2009-02-18,788.42,-0.75,-0.1,1565.15,-49.63,True,1,20372,-788.42,-5534882.09,16061692.24,10526810.15
2009-02-19,778.94,-9.48,-1.2,1565.15,-50.23,True,1,20373,-778.94,-5535661.03,15869344.62,10333683.59
2009-02-20,770.05,-8.89,-1.14,1565.15,-50.8,True,1,20374,-770.05,-5536431.08,15688998.7,10152567.62
2009-02-23,743.33,-26.72,-3.47,1565.15,-52.51,True,1,20375,-743.33,-5537174.41,15145348.75,9608174.34
2009-02-24,773.14,29.81,4.01,1565.15,-50.6,True,1,20376,-773.14,-5537947.55,15753500.64,10215553.09
2009-02-25,764.9,-8.24,-1.07,1565.15,-51.13,True,1,20377,-764.9,-5538712.45,15586367.3,10047654.85
2009-02-26,752.83,-12.07,-1.58,1565.15,-51.9,True,1,20378,-752.83,-5539465.28,15341169.74,9801704.46
2009-02-27,735.09,-17.74,-2.36,1565.15,-53.03,True,1,20379,-735.09,-5540200.37,14980399.11,9440198.74
2009-03-02,700.82,-34.27,-4.66,1565.15,-55.22,True,1,20380,-700.82,-5540901.19,14282711.6,8741810.41
2009-03-03,696.33,-4.49,-0.64,1565.15,-55.51,True,1,20381,-696.33,-5541597.52,14191901.73,8650304.21
2009-03-04,712.87,16.54,2.38,1565.15,-54.45,True,1,20382,-712.87,-5542310.39,14529716.34,8987405.95
2009-03-05,682.55,-30.32,-4.25,1565.15,-56.39,True,1,20383,-682.55,-5542992.94,13912416.65,8369423.71
2009-03-06,683.38,0.83,0.12,1565.15,-56.34,True,1,20384,-683.38,-5543676.32,13930017.92,8386341.6
2009-03-09,676.53,-6.85,-1.0,1565.15,-56.78,True,1,20385,-676.53,-5544352.85,13791064.05,8246711.2
2009-03-10,719.6,43.07,6.37,1565.15,-54.02,True,1,20386,-719.6,-5545072.45,14669765.6,9124693.15
2009-03-11,721.36,1.76,0.24,1565.15,-53.91,True,1,20387,-721.36,-5545793.81,14706366.32,9160572.51
2009-03-12,750.74,29.38,4.07,1565.15,-52.03,True,1,20388,-750.74,-5546544.55,15306087.12,9759542.57
2009-03-13,756.55,5.81,0.77,1565.15,-51.66,True,1,20389,-756.55,-5547301.1,15425297.95,9877996.85
2009-03-16,753.89,-2.66,-0.35,1565.15,-51.83,True,1,20390,-753.89,-5548054.99,15371817.1,9823762.11
2009-03-17,778.12,24.23,3.21,1565.15,-50.28,True,1,20391,-778.12,-5548833.11,15866644.92,10317811.81
2009-03-18,794.35,16.23,2.09,1565.15,-49.25,True,1,20392,-794.35,-5549627.46,16198385.2,10648757.74
2009-03-19,784.04,-10.31,-1.3,1565.15,-49.91,True,1,20393,-784.04,-5550411.5,15988927.72,10438516.22
2009-03-20,768.54,-15.5,-1.98,1565.15,-50.9,True,1,20394,-768.54,-5551180.04,15673604.76,10122424.72
2009-03-23,822.92,54.38,7.08,1565.15,-47.42,True,1,20395,-822.92,-5552002.96,16783453.4,11231450.44
2009-03-24,806.12,-16.8,-2.04,1565.15,-48.5,True,1,20396,-806.12,-5552809.08,16441623.52,10888814.44
2009-03-25,813.88,7.76,0.96,1565.15,-48.0,True,1,20397,-813.88,-5553622.96,16600710.36,11047087.4
2009-03-26,832.86,18.98,2.33,1565.15,-46.79,True,1,20398,-832.86,-5554455.82,16988678.28,11434222.46
2009-03-27,815.94,-16.92,-2.03,1565.15,-47.87,True,1,20399,-815.94,-5555271.76,16644360.06,11089088.3
2009-03-30,787.53,-28.41,-3.48,1565.15,-49.68,True,1,20400,-787.53,-5556059.29,16065612.0,10509552.71
2009-03-31,797.87,10.34,1.31,1565.15,-49.02,True,1,20401,-797.87,-5556857.16,16277345.87,10720488.71
2009-04-01,811.08,13.21,1.66,1565.15,-48.18,True,1,20402,-811.08,-5557668.24,16547654.16,10989985.92
2009-04-02,834.38,23.3,2.87,1565.15,-46.69,True,1,20403,-834.38,-5558502.62,17023855.14,11465352.52
2009-04-03,842.5,8.12,0.97,1565.15,-46.17,True,1,20404,-842.5,-5559345.12,17190370.0,11631024.88
2009-04-06,835.48,-7.02,-0.83,1565.15,-46.62,True,1,20405,-835.48,-5560180.6,17047969.4,11487788.8
2009-04-07,815.55,-19.93,-2.38,1565.15,-47.89,True,1,20406,-815.55,-5560996.15,16642113.3,11081117.15
2009-04-08,825.16,9.61,1.18,1565.15,-47.28,True,1,20407,-825.16,-5561821.31,16839040.12,11277218.81
2009-04-09,856.56,31.4,3.8,1565.15,-45.27,True,1,20408,-856.56,-5562677.87,17480676.48,11917998.61
2009-04-13,858.73,2.17,0.25,1565.15,-45.13,True,1,20409,-858.73,-5563536.6,17525820.57,11962283.97
2009-04-14,841.5,-17.23,-2.01,1565.15,-46.24,True,1,20410,-841.5,-5564378.1,17175015.0,11610636.9
2009-04-15,852.06,10.56,1.25,1565.15,-45.56,True,1,20411,-852.06,-5565230.16,17391396.66,11826166.5
2009-04-16,865.3,13.24,1.55,1565.15,-44.72,True,1,20412,-865.3,-5566095.46,17662503.6,12096408.14
2009-04-17,869.6,4.3,0.5,1565.15,-44.44,True,1,20413,-869.6,-5566965.06,17751144.8,12184179.74
2009-04-20,832.39,-37.21,-4.28,1565.15,-46.82,True,1,20414,-832.39,-5567797.45,16992409.46,11424612.01
2009-04-21,850.08,17.69,2.12,1565.15,-45.69,True,1,20415,-850.08,-5568647.53,17354383.2,11785735.67
2009-04-22,843.55,-6.53,-0.77,1565.15,-46.1,True,1,20416,-843.55,-5569491.08,17221916.8,11652425.72
2009-04-23,851.92,8.37,0.99,1565.15,-45.57,True,1,20417,-851.92,-5570343.0,17393650.64,11823307.64
2009-04-24,866.23,14.31,1.68,1565.15,-44.66,True,1,20418,-866.23,-5571209.23,17686684.14,12115474.91
2009-04-27,857.51,-8.72,-1.01,1565.15,-45.21,True,1,20419,-857.51,-5572066.74,17509496.69,11937429.95
2009-04-28,855.16,-2.35,-0.27,1565.15,-45.36,True,1,20420,-855.16,-5572921.9,17462367.2,11889445.3
2009-04-29,873.64,18.48,2.16,1565.15,-44.18,True,1,20421,-873.64,-5573795.54,17840602.44,12266806.9
2009-04-30,872.81,-0.83,-0.1,1565.15,-44.24,True,1,20422,-872.81,-5574668.35,17824525.82,12249857.47
2009-05-01,877.52,4.71,0.54,1565.15,-43.93,True,1,20423,-877.52,-5575545.87,17921590.96,12346045.09
2009-05-04,907.24,29.72,3.39,1565.15,-42.04,True,1,20424,-907.24,-5576453.11,18529469.76,12953016.65
2009-05-05,903.8,-3.44,-0.38,1565.15,-42.26,True,1,20425,-903.8,-5577356.91,18460115.0,12882758.09
2009-05-06,919.53,15.73,1.74,1565.15,-41.25,True,1,20426,-919.53,-5578276.44,18782319.78,13204043.34
2009-05-07,907.39,-12.14,-1.32,1565.15,-42.02,True,1,20427,-907.39,-5579183.83,18535255.53,12956071.7
2009-05-08,929.23,21.84,2.41,1565.15,-40.63,True,1,20428,-929.23,-5580113.06,18982310.44,13402197.38
2009-05-11,909.24,-19.99,-2.15,1565.15,-41.91,True,1,20429,-909.24,-5581022.3,18574863.96,12993841.66
2009-05-12,908.35,-0.89,-0.1,1565.15,-41.96,True,1,20430,-908.35,-5581930.65,18557590.5,12975659.85
2009-05-13,883.92,-24.43,-2.69,1565.15,-43.52,True,1,20431,-883.92,-5582814.57,18059369.52,12476554.95
2009-05-14,893.07,9.15,1.03,1565.15,-42.94,True,1,20432,-893.07,-5583707.64,18247206.24,12663498.6
2009-05-15,882.88,-10.19,-1.14,1565.15,-43.59,True,1,20433,-882.88,-5584590.52,18039887.04,12455296.52
2009-05-18,909.71,26.83,3.04,1565.15,-41.88,True,1,20434,-909.71,-5585500.23,18589014.14,13003513.91
2009-05-19,908.13,-1.58,-0.17,1565.15,-41.98,True,1,20435,-908.13,-5586408.36,18557636.55,12971228.19
2009-05-20,903.47,-4.66,-0.51,1565.15,-42.28,True,1,20436,-903.47,-5587311.83,18463312.92,12876001.09
2009-05-21,888.33,-15.14,-1.68,1565.15,-43.24,True,1,20437,-888.33,-5588200.16,18154800.21,12566600.05
2009-05-22,887.0,-1.33,-0.15,1565.15,-43.33,True,1,20438,-887.0,-5589087.16,18128506.0,12539418.84
2009-05-26,910.33,23.33,2.63,1565.15,-41.84,True,1,20439,-910.33,-5589997.49,18606234.87,13016237.38
2009-05-27,893.06,-17.27,-1.9,1565.15,-42.94,True,1,20440,-893.06,-5590890.55,18254146.4,12663255.85
2009-05-28,906.83,13.77,1.54,1565.15,-42.06,True,1,20441,-906.83,-5591797.38,18536512.03,12944714.65
2009-05-29,919.14,12.31,1.36,1565.15,-41.28,True,1,20442,-919.14,-5592716.52,18789059.88,13196343.36
2009-06-01,942.87,23.73,2.58,1565.15,-39.76,True,1,20443,-942.87,-5593659.39,19275091.41,13681432.02
2009-06-02,944.74,1.87,0.2,1565.15,-39.64,True,1,20444,-944.74,-5594604.13,19314264.56,13719660.43
2009-06-03,931.76,-12.98,-1.37,1565.15,-40.47,True,1,20445,-931.76,-5595535.89,19049833.2,13454297.31
2009-06-04,942.46,10.7,1.15,1565.15,-39.78,True,1,20446,-942.46,-5596478.35,19269537.16,13673058.81
2009-06-05,940.09,-2.37,-0.25,1565.15,-39.94,True,1,20447,-940.09,-5597418.44,19222020.23,13624601.79
2009-06-08,939.14,-0.95,-0.1,1565.15,-40.0,True,1,20448,-939.14,-5598357.58,19203534.72,13605177.14
2009-06-09,942.43,3.29,0.35,1565.15,-39.79,True,1,20449,-942.43,-5599300.01,19271751.07,13672451.06
2009-06-10,939.15,-3.28,-0.35,1565.15,-40.0,True,1,20450,-939.15,-5600239.16,19205617.5,13605378.34
2009-06-11,944.89,5.74,0.61,1565.15,-39.63,True,1,20451,-944.89,-5601184.05,19323945.39,13722761.34
2009-06-12,946.21,1.32,0.14,1565.15,-39.54,True,1,20452,-946.21,-5602130.26,19351886.92,13749756.66
2009-06-15,923.72,-22.49,-2.38,1565.15,-40.98,True,1,20453,-923.72,-5603053.98,18892845.16,13289791.18
2009-06-16,911.97,-11.75,-1.27,1565.15,-41.73,True,1,20454,-911.97,-5603965.95,18653434.38,13049468.43
2009-06-17,910.71,-1.26,-0.14,1565.15,-41.81,True,1,20455,-910.71,-5604876.66,18628573.05,13023696.39
2009-06-18,918.37,7.66,0.84,1565.15,-41.32,True,1,20456,-918.37,-5605795.03,18786176.72,13180381.69
2009-06-19,921.23,2.86,0.31,1565.15,-41.14,True,1,20457,-921.23,-5606716.26,18845602.11,13238885.85
2009-06-22,893.04,-28.19,-3.06,1565.15,-42.94,True,1,20458,-893.04,-5607609.3,18269812.32,12662203.02
2009-06-23,895.1,2.06,0.23,1565.15,-42.81,True,1,20459,-895.1,-5608504.4,18312850.9,12704346.5
2009-06-24,900.94,5.84,0.65,1565.15,-42.44,True,1,20460,-900.94,-5609405.34,18433232.4,12823827.06
2009-06-25,920.26,19.32,2.14,1565.15,-41.2,True,1,20461,-920.26,-5610325.6,18829439.86,13219114.26
2009-06-26,918.9,-1.36,-0.15,1565.15,-41.29,True,1,20462,-918.9,-5611244.5,18802531.8,13191287.3
2009-06-29,927.23,8.33,0.91,1565.15,-40.76,True,1,20463,-927.23,-5612171.73,18973907.49,13361735.76
2009-06-30,919.32,-7.91,-0.85,1565.15,-41.26,True,1,20464,-919.32,-5613091.05,18812964.48,13199873.43
2009-07-01,923.33,4.01,0.44,1565.15,-41.01,True,1,20465,-923.33,-5614014.38,18895948.45,13281934.07
2009-07-02,896.42,-26.91,-2.91,1565.15,-42.73,True,1,20466,-896.42,-5614910.8,18346131.72,12731220.92
2009-07-06,898.72,2.3,0.26,1565.15,-42.58,True,1,20467,-898.72,-5615809.52,18394102.24,12778292.72
2009-07-07,881.03,-17.69,-1.97,1565.15,-43.71,True,1,20468,-881.03,-5616690.55,18032922.04,12416231.49
2009-07-08,879.56,-1.47,-0.17,1565.15,-43.8,True,1,20469,-879.56,-5617570.11,18003713.64,12386143.53
2009-07-09,882.68,3.12,0.36,1565.15,-43.6,True,1,20470,-882.68,-5618452.79,18068459.6,12450006.81
2009-07-10,879.13,-3.55,-0.4,1565.15,-43.83,True,1,20471,-879.13,-5619331.92,17996670.23,12377338.31
2009-07-13,901.05,21.92,2.49,1565.15,-42.43,True,1,20472,-901.05,-5620232.97,18446295.6,12826062.63
2009-07-14,905.84,4.79,0.53,1565.15,-42.12,True,1,20473,-905.84,-5621138.81,18545262.32,12924123.51
2009-07-15,932.68,26.84,2.96,1565.15,-40.41,True,1,20474,-932.68,-5622071.49,19095690.32,13473618.83
2009-07-16,940.74,8.06,0.86,1565.15,-39.9,True,1,20475,-940.74,-5623012.23,19261651.5,13638639.27
2009-07-17,940.38,-0.36,-0.04,1565.15,-39.92,True,1,20476,-940.38,-5623952.61,19255220.88,13631268.27
2009-07-20,951.13,10.75,1.14,1565.15,-39.23,True,1,20477,-951.13,-5624903.74,19476289.01,13851385.27
2009-07-21,954.58,3.45,0.36,1565.15,-39.01,True,1,20478,-954.58,-5625858.32,19547889.24,13922030.92
2009-07-22,954.07,-0.51,-0.05,1565.15,-39.04,True,1,20479,-954.07,-5626812.39,19538399.53,13911587.14
2009-07-23,976.29,22.22,2.33,1565.15,-37.62,True,1,20480,-976.29,-5627788.68,19994419.2,14366630.52
2009-07-24,979.26,2.97,0.3,1565.15,-37.43,True,1,20481,-979.26,-5628767.94,20056224.06,14427456.12
2009-07-27,982.18,2.92,0.3,1565.15,-37.25,True,1,20482,-982.18,-5629750.12,20117010.76,14487260.64
2009-07-28,979.62,-2.56,-0.26,1565.15,-37.41,True,1,20483,-979.62,-5630729.74,20065556.46,14434826.72
2009-07-29,975.15,-4.47,-0.46,1565.15,-37.7,True,1,20484,-975.15,-5631704.89,19974972.6,14343267.71
2009-07-30,986.75,11.6,1.19,1565.15,-36.96,True,1,20485,-986.75,-5632691.64,20213573.75,14580882.11
2009-07-31,987.48,0.73,0.07,1565.15,-36.91,True,1,20486,-987.48,-5633679.12,20229515.28,14595836.16
2009-08-03,1002.63,15.15,1.53,1565.15,-35.94,True,1,20487,-1002.63,-5634681.75,20540880.81,14906199.06
2009-08-04,1005.65,3.02,0.3,1565.15,-35.75,True,1,20488,-1005.65,-5635687.4,20603757.2,14968069.8
2009-08-05,1002.72,-2.93,-0.29,1565.15,-35.94,True,1,20489,-1002.72,-5636690.12,20544730.08,14908039.96
2009-08-06,997.08,-5.64,-0.56,1565.15,-36.3,True,1,20490,-997.08,-5637687.2,20430169.2,14792482.0
2009-08-07,1010.48,13.4,1.34,1565.15,-35.44,True,1,20491,-1010.48,-5638697.68,20705745.68,15067048.0
2009-08-10,1007.1,-3.38,-0.33,1565.15,-35.66,True,1,20492,-1007.1,-5639704.78,20637493.2,14997788.42
2009-08-11,994.35,-12.75,-1.27,1565.15,-36.47,True,1,20493,-994.35,-5640699.13,20377214.55,14736515.42
2009-08-12,1005.81,11.46,1.15,1565.15,-35.74,True,1,20494,-1005.81,-5641704.94,20613070.14,14971365.2
2009-08-13,1012.73,6.92,0.69,1565.15,-35.3,True,1,20495,-1012.73,-5642717.67,20755901.35,15113183.68
2009-08-14,1004.09,-8.64,-0.85,1565.15,-35.85,True,1,20496,-1004.09,-5643721.76,20579828.64,14936106.88
2009-08-17,979.73,-24.36,-2.43,1565.15,-37.4,True,1,20497,-979.73,-5644701.49,20081525.81,14436824.32
2009-08-18,989.67,9.94,1.01,1565.15,-36.77,True,1,20498,-989.67,-5645691.16,20286255.66,14640564.5
2009-08-19,996.46,6.79,0.69,1565.15,-36.34,True,1,20499,-996.46,-5646687.62,20426433.54,14779745.92
2009-08-20,1007.37,10.91,1.1,1565.15,-35.64,True,1,20500,-1007.37,-5647694.99,20651085.0,15003390.01
2009-08-21,1026.13,18.76,1.86,1565.15,-34.44,True,1,20501,-1026.13,-5648721.12,21036691.13,15387970.01
2009-08-24,1025.57,-0.56,-0.06,1565.15,-34.48,True,1,20502,-1025.57,-5649746.69,21026236.14,15376489.45
2009-08-25,1028.0,2.43,0.24,1565.15,-34.32,True,1,20503,-1028.0,-5650774.69,21077084.0,15426309.31
2009-08-26,1028.12,0.12,0.01,1565.15,-34.31,True,1,20504,-1028.12,-5651802.81,21080572.48,15428769.67
2009-08-27,1030.98,2.86,0.28,1565.15,-34.13,True,1,20505,-1030.98,-5652833.79,21140244.9,15487411.11
2009-08-28,1028.93,-2.05,-0.2,1565.15,-34.26,True,1,20506,-1028.93,-5653862.72,21099238.58,15445375.86
2009-08-31,1020.62,-8.31,-0.81,1565.15,-34.79,True,1,20507,-1020.62,-5654883.34,20929854.34,15274971.0
2009-09-01,998.04,-22.58,-2.21,1565.15,-36.23,True,1,20508,-998.04,-5655881.38,20467804.32,14811922.94
2009-09-02,994.75,-3.29,-0.33,1565.15,-36.44,True,1,20509,-994.75,-5656876.13,20401327.75,14744451.62
2009-09-03,1003.24,8.49,0.85,1565.15,-35.9,True,1,20510,-1003.24,-5657879.37,20576452.4,14918573.03
2009-09-04,1016.4,13.16,1.31,1565.15,-35.06,True,1,20511,-1016.4,-5658895.77,20847380.4,15188484.63
2009-09-08,1025.39,8.99,0.88,1565.15,-34.49,True,1,20512,-1025.39,-5659921.16,21032799.68,15372878.52
2009-09-09,1033.37,7.98,0.78,1565.15,-33.98,True,1,20513,-1033.37,-5660954.53,21197518.81,15536564.28
2009-09-10,1044.14,10.77,1.04,1565.15,-33.29,True,1,20514,-1044.14,-5661998.67,21419487.96,15757489.29
2009-09-11,1042.73,-1.41,-0.14,1565.15,-33.38,True,1,20515,-1042.73,-5663041.4,21391605.95,15728564.55
2009-09-14,1049.34,6.61,0.63,1565.15,-32.96,True,1,20516,-1049.34,-5664090.74,21528259.44,15864168.7
2009-09-15,1052.63,3.29,0.31,1565.15,-32.75,True,1,20517,-1052.63,-5665143.37,21596809.71,15931666.34
2009-09-16,1068.76,16.13,1.53,1565.15,-31.72,True,1,20518,-1068.76,-5666212.13,21928817.68,16262605.55
2009-09-17,1065.49,-3.27,-0.31,1565.15,-31.92,True,1,20519,-1065.49,-5667277.62,21862789.31,16195511.69
2009-09-18,1068.3,2.81,0.26,1565.15,-31.74,True,1,20520,-1068.3,-5668345.92,21921516.0,16253170.08
2009-09-21,1064.66,-3.64,-0.34,1565.15,-31.98,True,1,20521,-1064.66,-5669410.58,21847887.86,16178477.28
2009-09-22,1071.66,7.0,0.66,1565.15,-31.53,True,1,20522,-1071.66,-5670482.24,21992606.52,16322124.28
2009-09-23,1060.87,-10.79,-1.01,1565.15,-32.22,True,1,20523,-1060.87,-5671543.11,21772235.01,16100691.9
2009-09-24,1050.78,-10.09,-0.95,1565.15,-32.86,True,1,20524,-1050.78,-5672593.89,21566208.72,15893614.83
2009-09-25,1044.38,-6.4,-0.61,1565.15,-33.27,True,1,20525,-1044.38,-5673638.27,21435899.5,15762261.23
2009-09-28,1062.98,18.6,1.78,1565.15,-32.08,True,1,20526,-1062.98,-5674701.25,21818727.48,16144026.23
2009-09-29,1060.61,-2.37,-0.22,1565.15,-32.24,True,1,20527,-1060.61,-5675761.86,21771141.47,16095379.61
2009-09-30,1057.08,-3.53,-0.33,1565.15,-32.46,True,1,20528,-1057.08,-5676818.94,21699738.24,16022919.3
2009-10-01,1029.85,-27.23,-2.58,1565.15,-34.2,True,1,20529,-1029.85,-5677848.79,21141790.65,15463941.86
2009-10-02,1025.21,-4.64,-0.45,1565.15,-34.5,True,1,20530,-1025.21,-5678874.0,21047561.3,15368687.3
2009-10-05,1040.46,15.25,1.49,1565.15,-33.52,True,1,20531,-1040.46,-5679914.46,21361684.26,15681769.8
2009-10-06,1054.72,14.26,1.37,1565.15,-32.61,True,1,20532,-1054.72,-5680969.18,21655511.04,15974541.86
2009-10-07,1057.58,2.86,0.27,1565.15,-32.43,True,1,20533,-1057.58,-5682026.76,21715290.14,16033263.38
2009-10-08,1065.48,7.9,0.75,1565.15,-31.92,True,1,20534,-1065.48,-5683092.24,21878566.32,16195474.08
2009-10-09,1071.49,6.01,0.56,1565.15,-31.54,True,1,20535,-1071.49,-5684163.73,22003047.15,16318883.42
2009-10-12,1076.19,4.7,0.44,1565.15,-31.24,True,1,20536,-1076.19,-5685239.92,22100637.84,16415397.92
2009-10-13,1073.19,-3.0,-0.28,1565.15,-31.43,True,1,20537,-1073.19,-5686313.11,22040103.03,16353789.92
2009-10-14,1092.02,18.83,1.76,1565.15,-30.23,True,1,20538,-1092.02,-5687405.13,22427906.76,16740501.63
2009-10-15,1096.56,4.54,0.42,1565.15,-29.94,True,1,20539,-1096.56,-5688501.69,22522245.84,16833744.15
2009-10-16,1087.68,-8.88,-0.81,1565.15,-30.51,True,1,20540,-1087.68,-5689589.37,22340947.2,16651357.83
2009-10-19,1097.91,10.23,0.94,1565.15,-29.85,True,1,20541,-1097.91,-5690687.28,22552169.31,16861482.03
2009-10-20,1091.06,-6.85,-0.62,1565.15,-30.29,True,1,20542,-1091.06,-5691778.34,22412554.52,16720776.18
2009-10-21,1081.4,-9.66,-0.88,1565.15,-30.91,True,1,20543,-1081.4,-5692859.74,22215200.2,16522340.46
2009-10-22,1092.91,11.51,1.06,1565.15,-30.17,True,1,20544,-1092.91,-5693952.65,22452743.04,16758790.39
2009-10-23,1079.6,-13.31,-1.22,1565.15,-31.02,True,1,20545,-1079.6,-5695032.25,22180382.0,16485349.75
2009-10-26,1066.95,-12.65,-1.17,1565.15,-31.83,True,1,20546,-1066.95,-5696099.2,21921554.7,16225455.5
2009-10-27,1063.41,-3.54,-0.33,1565.15,-32.06,True,1,20547,-1063.41,-5697162.61,21849885.27,16152722.66
2009-10-28,1042.63,-20.78,-1.95,1565.15,-33.38,True,1,20548,-1042.63,-5698205.24,21423961.24,15725756.0
2009-10-29,1066.11,23.48,2.25,1565.15,-31.88,True,1,20549,-1066.11,-5699271.35,21907494.39,16208223.04
2009-10-30,1036.19,-29.92,-2.81,1565.15,-33.8,True,1,20550,-1036.19,-5700307.54,21293704.5,15593396.96
2009-11-02,1042.88,6.69,0.65,1565.15,-33.37,True,1,20551,-1042.88,-5701350.42,21432226.88,15730876.46
2009-11-03,1045.41,2.53,0.24,1565.15,-33.21,True,1,20552,-1045.41,-5702395.83,21485266.32,15782870.49
2009-11-04,1046.5,1.09,0.1,1565.15,-33.14,True,1,20553,-1046.5,-5703442.33,21508714.5,15805272.17
2009-11-05,1066.63,20.13,1.92,1565.15,-31.85,True,1,20554,-1066.63,-5704508.96,21923513.02,16219004.06
2009-11-06,1069.3,2.67,0.25,1565.15,-31.68,True,1,20555,-1069.3,-5705578.26,21979461.5,16273883.24
2009-11-09,1093.08,23.78,2.22,1565.15,-30.16,True,1,20556,-1093.08,-5706671.34,22469352.48,16762681.14
2009-11-10,1093.01,-0.07,-0.01,1565.15,-30.17,True,1,20557,-1093.01,-5707764.35,22469006.57,16761242.22
2009-11-11,1098.51,5.5,0.5,1565.15,-29.81,True,1,20558,-1098.51,-5708862.86,22583168.58,16874305.72
2009-11-12,1087.24,-11.27,-1.03,1565.15,-30.53,True,1,20559,-1087.24,-5709950.1,22352567.16,16642617.06
2009-11-13,1093.48,6.24,0.57,1565.15,-30.14,True,1,20560,-1093.48,-5711043.58,22481948.8,16770905.22
2009-11-16,1109.3,15.82,1.45,1565.15,-29.12,True,1,20561,-1109.3,-5712152.88,22808317.3,17096164.42
2009-11-17,1110.32,1.02,0.09,1565.15,-29.06,True,1,20562,-1110.32,-5713263.2,22830399.84,17117136.64
2009-11-18,1109.8,-0.52,-0.05,1565.15,-29.09,True,1,20563,-1109.8,-5714373.0,22820817.4,17106444.4
2009-11-19,1094.9,-14.9,-1.34,1565.15,-30.04,True,1,20564,-1094.9,-5715467.9,22515523.6,16800055.7
2009-11-20,1091.38,-3.52,-0.32,1565.15,-30.27,True,1,20565,-1091.38,-5716559.28,22444229.7,16727670.42
2009-11-23,1106.24,14.86,1.36,1565.15,-29.32,True,1,20566,-1106.24,-5717665.52,22750931.84,17033266.32
2009-11-24,1105.65,-0.59,-0.05,1565.15,-29.36,True,1,20567,-1105.65,-5718771.17,22739903.55,17021132.38
2009-11-25,1110.63,4.98,0.45,1565.15,-29.04,True,1,20568,-1110.63,-5719881.8,22843437.84,17123556.04
2009-11-27,1091.49,-19.14,-1.72,1565.15,-30.26,True,1,20569,-1091.49,-5720973.29,22450857.81,16729884.52
2009-11-30,1095.63,4.14,0.38,1565.15,-30.0,True,1,20570,-1095.63,-5722068.92,22537109.1,16815040.18
2009-12-01,1108.86,13.23,1.21,1565.15,-29.15,True,1,20571,-1108.86,-5723177.78,22810359.06,17087181.28
2009-12-02,1109.24,0.38,0.03,1565.15,-29.13,True,1,20572,-1109.24,-5724287.02,22819285.28,17094998.26
2009-12-03,1099.92,-9.32,-0.84,1565.15,-29.72,True,1,20573,-1099.92,-5725386.94,22628654.16,16903267.22
2009-12-04,1105.98,6.06,0.55,1565.15,-29.34,True,1,20574,-1105.98,-5726492.92,22754432.52,17027939.6
2009-12-07,1103.25,-2.73,-0.25,1565.15,-29.51,True,1,20575,-1103.25,-5727596.17,22699368.75,16971772.58
2009-12-08,1091.94,-11.31,-1.02,1565.15,-30.23,True,1,20576,-1091.94,-5728688.11,22467757.44,16739069.33
2009-12-09,1095.95,4.01,0.37,1565.15,-29.98,True,1,20577,-1095.95,-5729784.06,22551363.15,16821579.09
2009-12-10,1102.35,6.4,0.58,1565.15,-29.57,True,1,20578,-1102.35,-5730886.41,22684158.3,16953271.89
2009-12-11,1106.41,4.06,0.37,1565.15,-29.31,True,1,20579,-1106.41,-5731992.82,22768811.39,17036818.57
2009-12-14,1114.11,7.7,0.7,1565.15,-28.82,True,1,20580,-1114.11,-5733106.93,22928383.8,17195276.87
2009-12-15,1107.93,-6.18,-0.56,1565.15,-29.21,True,1,20581,-1107.93,-5734214.86,22802307.33,17068092.47
2009-12-16,1109.18,1.25,0.11,1565.15,-29.13,True,1,20582,-1109.18,-5735324.04,22829142.76,17093818.72
2009-12-17,1096.08,-13.1,-1.18,1565.15,-29.97,True,1,20583,-1096.08,-5736420.12,22560614.64,16824194.52
2009-12-18,1102.47,6.39,0.58,1565.15,-29.56,True,1,20584,-1102.47,-5737522.59,22693242.48,16955719.89
2009-12-21,1114.05,11.58,1.05,1565.15,-28.82,True,1,20585,-1114.05,-5738636.64,22932719.25,17194082.61
2009-12-22,1118.02,3.97,0.36,1565.15,-28.57,True,1,20586,-1118.02,-5739754.66,23015559.72,17275805.06
2009-12-23,1120.59,2.57,0.23,1565.15,-28.4,True,1,20587,-1120.59,-5740875.25,23069586.33,17328711.08
2009-12-24,1126.48,5.89,0.53,1565.15,-28.03,True,1,20588,-1126.48,-5742001.73,23191970.24,17449968.51
2009-12-28,1127.78,1.3,0.12,1565.15,-27.94,True,1,20589,-1127.78,-5743129.51,23219862.42,17476732.91
2009-12-29,1126.2,-1.58,-0.14,1565.15,-28.04,True,1,20590,-1126.2,-5744255.71,23188458.0,17444202.29
2009-12-30,1126.42,0.22,0.02,1565.15,-28.03,True,1,20591,-1126.42,-5745382.13,23194114.22,17448732.09
2009-12-31,1115.1,-11.32,-1.0,1565.15,-28.75,True,1,20592,-1115.1,-5746497.23,22962139.2,17215641.97
2010-01-04,1132.99,17.89,1.6,1565.15,-27.61,True,1,20593,-1132.99,-5747630.22,23331663.07,17584032.85
2010-01-05,1136.52,3.53,0.31,1565.15,-27.39,True,1,20594,-1136.52,-5748766.74,23405492.88,17656726.14
2010-01-06,1137.14,0.62,0.06,1565.15,-27.35,True,1,20595,-1137.14,-5749903.88,23419398.3,17669494.42
2010-01-07,1141.69,4.55,0.4,1565.15,-27.06,True,1,20596,-1141.69,-5751045.57,23514247.24,17763201.67
2010-01-08,1144.98,3.29,0.29,1565.15,-26.84,True,1,20597,-1144.98,-5752190.55,23583153.06,17830962.51
2010-01-11,1146.98,2.0,0.18,1565.15,-26.72,True,1,20598,-1146.98,-5753337.53,23625494.04,17872156.51
2010-01-12,1136.22,-10.76,-0.94,1565.15,-27.4,True,1,20599,-1136.22,-5754473.75,23404995.78,17650522.03
2010-01-13,1145.68,9.46,0.83,1565.15,-26.8,True,1,20600,-1145.68,-5755619.43,23601008.0,17845388.57
2010-01-14,1148.46,2.78,0.24,1565.15,-26.62,True,1,20601,-1148.46,-5756767.89,23659424.46,17902656.57
2010-01-15,1136.03,-12.43,-1.08,1565.15,-27.42,True,1,20602,-1136.03,-5757903.92,23404490.06,17646586.14
2010-01-19,1150.23,14.2,1.25,1565.15,-26.51,True,1,20603,-1150.23,-5759054.15,23698188.69,17939134.54
2010-01-20,1138.04,-12.19,-1.06,1565.15,-27.29,True,1,20604,-1138.04,-5760192.19,23448176.16,17687983.97
2010-01-21,1116.48,-21.56,-1.89,1565.15,-28.67,True,1,20605,-1116.48,-5761308.67,23005070.4,17243761.73
2010-01-22,1091.76,-24.72,-2.21,1565.15,-30.25,True,1,20606,-1091.76,-5762400.43,22496806.56,16734406.13
2010-01-25,1096.78,5.02,0.46,1565.15,-29.92,True,1,20607,-1096.78,-5763497.21,22601345.46,16837848.25
2010-01-26,1092.17,-4.61,-0.42,1565.15,-30.22,True,1,20608,-1092.17,-5764589.38,22507439.36,16742849.98
2010-01-27,1097.5,5.33,0.49,1565.15,-29.88,True,1,20609,-1097.5,-5765686.88,22618377.5,16852690.62
2010-01-28,1084.53,-12.97,-1.18,1565.15,-30.71,True,1,20610,-1084.53,-5766771.41,22352163.3,16585391.89
2010-01-29,1073.87,-10.66,-0.98,1565.15,-31.39,True,1,20611,-1073.87,-5767845.28,22133534.57,16365689.29
2010-02-01,1089.19,15.32,1.43,1565.15,-30.41,True,1,20612,-1089.19,-5768934.47,22450384.28,16681449.81
2010-02-02,1103.32,14.13,1.3,1565.15,-29.51,True,1,20613,-1103.32,-5770037.79,22742735.16,16972697.37
2010-02-03,1097.28,-6.04,-0.55,1565.15,-29.89,True,1,20614,-1097.28,-5771135.07,22619329.92,16848194.85
2010-02-04,1063.11,-34.17,-3.11,1565.15,-32.08,True,1,20615,-1063.11,-5772198.18,21916012.65,16143814.47
2010-02-05,1066.19,3.08,0.29,1565.15,-31.88,True,1,20616,-1066.19,-5773264.37,21980573.04,16207308.67
2010-02-08,1056.74,-9.45,-0.89,1565.15,-32.48,True,1,20617,-1056.74,-5774321.11,21786808.58,16012487.47
2010-02-09,1070.52,13.78,1.3,1565.15,-31.6,True,1,20618,-1070.52,-5775391.63,22071981.36,16296589.73
2010-02-10,1068.13,-2.39,-0.22,1565.15,-31.76,True,1,20619,-1068.13,-5776459.76,22023772.47,16247312.71
2010-02-11,1078.47,10.34,0.97,1565.15,-31.1,True,1,20620,-1078.47,-5777538.23,22238051.4,16460513.17
2010-02-12,1075.51,-2.96,-0.27,1565.15,-31.28,True,1,20621,-1075.51,-5778613.74,22178091.71,16399477.97
2010-02-16,1094.87,19.36,1.8,1565.15,-30.05,True,1,20622,-1094.87,-5779708.61,22578409.14,16798700.53
2010-02-17,1099.51,4.64,0.42,1565.15,-29.75,True,1,20623,-1099.51,-5780808.12,22675194.73,16894386.61
2010-02-18,1106.75,7.24,0.66,1565.15,-29.29,True,1,20624,-1106.75,-5781914.87,22825612.0,17043697.13
2010-02-19,1109.17,2.42,0.22,1565.15,-29.13,True,1,20625,-1109.17,-5783024.04,22876631.25,17093607.21
2010-02-22,1108.01,-1.16,-0.1,1565.15,-29.21,True,1,20626,-1108.01,-5784132.05,22853814.26,17069682.21
2010-02-23,1094.6,-13.41,-1.21,1565.15,-30.06,True,1,20627,-1094.6,-5785226.65,22578314.2,16793087.55
2010-02-24,1105.24,10.64,0.97,1565.15,-29.38,True,1,20628,-1105.24,-5786331.89,22798890.72,17012558.83
2010-02-25,1102.94,-2.3,-0.21,1565.15,-29.53,True,1,20629,-1102.94,-5787434.83,22752549.26,16965114.43
2010-02-26,1104.49,1.55,0.14,1565.15,-29.43,True,1,20630,-1104.49,-5788539.32,22785628.7,16997089.38
2010-03-01,1115.71,11.22,1.02,1565.15,-28.72,True,1,20631,-1115.71,-5789655.03,23018213.01,17228557.98
2010-03-02,1118.31,2.6,0.23,1565.15,-28.55,True,1,20632,-1118.31,-5790773.34,23072971.92,17282198.58
2010-03-03,1118.79,0.48,0.04,1565.15,-28.52,True,1,20633,-1118.79,-5791892.13,23083994.07,17292101.94
2010-03-04,1122.97,4.18,0.37,1565.15,-28.25,True,1,20634,-1122.97,-5793015.1,23171362.98,17378347.88
2010-03-05,1138.7,15.73,1.4,1565.15,-27.25,True,1,20635,-1138.7,-5794153.8,23497074.5,17702920.7
2010-03-08,1138.5,-0.2,-0.02,1565.15,-27.26,True,1,20636,-1138.5,-5795292.3,23494086.0,17698793.7
2010-03-09,1140.45,1.95,0.17,1565.15,-27.14,True,1,20637,-1140.45,-5796432.75,23535466.65,17739033.9
2010-03-10,1145.61,5.16,0.45,1565.15,-26.8,True,1,20638,-1145.61,-5797578.36,23643099.18,17845520.82
2010-03-11,1150.24,4.63,0.4,1565.15,-26.51,True,1,20639,-1150.24,-5798728.6,23739803.36,17941074.76
2010-03-12,1149.99,-0.25,-0.02,1565.15,-26.52,True,1,20640,-1149.99,-5799878.59,23735793.6,17935915.01
2010-03-15,1150.51,0.52,0.04,1565.15,-26.49,True,1,20641,-1150.51,-5801029.1,23747676.91,17946647.81
2010-03-16,1159.46,8.95,0.78,1565.15,-25.92,True,1,20642,-1159.46,-5802188.56,23933573.32,18131384.76
2010-03-17,1166.21,6.75,0.58,1565.15,-25.49,True,1,20643,-1166.21,-5803354.77,24074073.03,18270718.26
2010-03-18,1165.83,-0.38,-0.03,1565.15,-25.51,True,1,20644,-1165.83,-5804520.6,24067394.52,18262873.92
2010-03-19,1159.9,-5.93,-0.51,1565.15,-25.89,True,1,20645,-1159.9,-5805680.5,23946135.5,18140455.0
2010-03-22,1165.81,5.91,0.51,1565.15,-25.51,True,1,20646,-1165.81,-5806846.31,24069313.26,18262466.95
2010-03-23,1174.17,8.36,0.72,1565.15,-24.98,True,1,20647,-1174.17,-5808020.48,24243087.99,18435067.51
2010-03-24,1167.72,-6.45,-0.55,1565.15,-25.39,True,1,20648,-1167.72,-5809188.2,24111082.56,18301894.36
2010-03-25,1165.73,-1.99,-0.17,1565.15,-25.52,True,1,20649,-1165.73,-5810353.93,24071158.77,18260804.84
2010-03-26,1166.59,0.86,0.07,1565.15,-25.46,True,1,20650,-1166.59,-5811520.52,24090083.5,18278562.98
2010-03-29,1173.22,6.63,0.57,1565.15,-25.04,True,1,20651,-1173.22,-5812693.74,24228166.22,18415472.48
2010-03-30,1173.27,0.05,0.0,1565.15,-25.04,True,1,20652,-1173.27,-5813867.01,24230372.04,18416505.03
2010-03-31,1169.43,-3.84,-0.33,1565.15,-25.28,True,1,20653,-1169.43,-5815036.44,24152237.79,18337201.35
2010-04-01,1178.1,8.67,0.74,1565.15,-24.73,True,1,20654,-1178.1,-5816214.54,24332477.4,18516262.86
2010-04-05,1187.44,9.34,0.79,1565.15,-24.13,True,1,20655,-1187.44,-5817401.98,24526573.2,18709171.22
2010-04-06,1189.44,2.0,0.17,1565.15,-24.0,True,1,20656,-1189.44,-5818591.42,24569072.64,18750481.22
2010-04-07,1182.45,-6.99,-0.59,1565.15,-24.45,True,1,20657,-1182.45,-5819773.87,24425869.65,18606095.78
2010-04-08,1186.44,3.99,0.34,1565.15,-24.2,True,1,20658,-1186.44,-5820960.31,24509477.52,18688517.21
2010-04-09,1194.37,7.93,0.67,1565.15,-23.69,True,1,20659,-1194.37,-5822154.68,24674489.83,18852335.15
2010-04-12,1196.48,2.11,0.18,1565.15,-23.56,True,1,20660,-1196.48,-5823351.16,24719276.8,18895925.64
2010-04-13,1197.3,0.82,0.07,1565.15,-23.5,True,1,20661,-1197.3,-5824548.46,24737415.3,18912866.84
2010-04-14,1210.65,13.35,1.12,1565.15,-22.65,True,1,20662,-1210.65,-5825759.11,25014450.3,19188691.19
2010-04-15,1211.67,1.02,0.08,1565.15,-22.58,True,1,20663,-1211.67,-5826970.78,25036737.21,19209766.43
2010-04-16,1192.13,-19.54,-1.61,1565.15,-23.83,True,1,20664,-1192.13,-5828162.91,24634174.32,18806011.41
2010-04-19,1197.52,5.39,0.45,1565.15,-23.49,True,1,20665,-1197.52,-5829360.43,24746750.8,18917390.37
2010-04-20,1207.17,9.65,0.81,1565.15,-22.87,True,1,20666,-1207.17,-5830567.6,24947375.22,19116807.62
2010-04-21,1205.94,-1.23,-0.1,1565.15,-22.95,True,1,20667,-1205.94,-5831773.54,24923161.98,19091388.44
2010-04-22,1208.67,2.73,0.23,1565.15,-22.78,True,1,20668,-1208.67,-5832982.21,24980791.56,19147809.35
2010-04-23,1217.28,8.61,0.71,1565.15,-22.23,True,1,20669,-1217.28,-5834199.49,25159960.32,19325760.83
2010-04-26,1212.05,-5.23,-0.43,1565.15,-22.56,True,1,20670,-1212.05,-5835411.54,25053073.5,19217661.96
2010-04-27,1183.71,-28.34,-2.34,1565.15,-24.37,True,1,20671,-1183.71,-5836595.25,24468469.41,18631874.16
2010-04-28,1191.36,7.65,0.65,1565.15,-23.88,True,1,20672,-1191.36,-5837786.61,24627793.92,18790007.31
2010-04-29,1206.78,15.42,1.29,1565.15,-22.9,True,1,20673,-1206.78,-5838993.39,24947762.94,19108769.55
2010-04-30,1186.69,-20.09,-1.66,1565.15,-24.18,True,1,20674,-1186.69,-5840180.08,24533629.06,18693448.98
2010-05-03,1202.26,15.57,1.31,1565.15,-23.19,True,1,20675,-1202.26,-5841382.34,24856725.5,19015343.16
2010-05-04,1173.6,-28.66,-2.38,1565.15,-25.02,True,1,20676,-1173.6,-5842555.94,24265353.6,18422797.66
2010-05-05,1165.87,-7.73,-0.66,1565.15,-25.51,True,1,20677,-1165.87,-5843721.81,24106693.99,18262972.18
2010-05-06,1128.15,-37.72,-3.24,1565.15,-27.92,True,1,20678,-1128.15,-5844849.96,23327885.7,17483035.74
2010-05-07,1110.88,-17.27,-1.53,1565.15,-29.02,True,1,20679,-1110.88,-5845960.84,22971887.52,17125926.68
2010-05-10,1159.73,48.85,4.4,1565.15,-25.9,True,1,20680,-1159.73,-5847120.57,23983216.4,18136095.83
2010-05-11,1155.79,-3.94,-0.34,1565.15,-26.16,True,1,20681,-1155.79,-5848276.36,23902892.99,18054616.63
2010-05-12,1171.67,15.88,1.37,1565.15,-25.14,True,1,20682,-1171.67,-5849448.03,24232478.94,18383030.91
2010-05-13,1157.44,-14.23,-1.22,1565.15,-26.05,True,1,20683,-1157.44,-5850605.47,23939331.52,18088726.05
2010-05-14,1135.68,-21.76,-1.88,1565.15,-27.44,True,1,20684,-1135.68,-5851741.15,23490405.12,17638663.97
2010-05-17,1136.94,1.26,0.11,1565.15,-27.36,True,1,20685,-1136.94,-5852878.09,23517603.9,17664725.81
2010-05-18,1120.8,-16.14,-1.42,1565.15,-28.39,True,1,20686,-1120.8,-5853998.89,23184868.8,17330869.91
2010-05-19,1115.05,-5.75,-0.51,1565.15,-28.76,True,1,20687,-1115.05,-5855113.94,23067039.35,17211925.41
2010-05-20,1071.59,-43.46,-3.9,1565.15,-31.53,True,1,20688,-1071.59,-5856185.53,22169053.92,16312868.39
2010-05-21,1087.69,16.1,1.5,1565.15,-30.51,True,1,20689,-1087.69,-5857273.22,22503218.41,16645945.19
2010-05-24,1073.65,-14.04,-1.29,1565.15,-31.4,True,1,20690,-1073.65,-5858346.87,22213818.5,16355471.63
2010-05-25,1074.03,0.38,0.04,1565.15,-31.38,True,1,20691,-1074.03,-5859420.9,22222754.73,16363333.83
2010-05-26,1067.95,-6.08,-0.57,1565.15,-31.77,True,1,20692,-1067.95,-5860488.85,22098021.4,16237532.55
2010-05-27,1103.06,35.11,3.29,1565.15,-29.52,True,1,20693,-1103.06,-5861591.91,22825620.58,16964028.67
2010-05-28,1089.41,-13.65,-1.24,1565.15,-30.4,True,1,20694,-1089.41,-5862681.32,22544250.54,16681569.22
2010-06-01,1070.71,-18.7,-1.72,1565.15,-31.59,True,1,20695,-1070.71,-5863752.03,22158343.45,16294591.42
2010-06-02,1098.38,27.67,2.58,1565.15,-29.82,True,1,20696,-1098.38,-5864850.41,22732072.48,16867222.07
2010-06-03,1102.83,4.45,0.4,1565.15,-29.54,True,1,20697,-1102.83,-5865953.24,22825272.51,16959319.27
2010-06-04,1064.88,-37.95,-3.44,1565.15,-31.96,True,1,20698,-1064.88,-5867018.12,22040886.24,16173868.12
2010-06-07,1050.47,-14.41,-1.35,1565.15,-32.88,True,1,20699,-1050.47,-5868068.59,21743678.53,15875609.94
2010-06-08,1062.0,11.53,1.1,1565.15,-32.15,True,1,20700,-1062.0,-5869130.59,21983400.0,16114269.41
2010-06-09,1055.69,-6.31,-0.59,1565.15,-32.55,True,1,20701,-1055.69,-5870186.28,21853838.69,15983652.41
2010-06-10,1086.84,31.15,2.95,1565.15,-30.56,True,1,20702,-1086.84,-5871273.12,22499761.68,16628488.56
2010-06-11,1091.6,4.76,0.44,1565.15,-30.26,True,1,20703,-1091.6,-5872364.72,22599394.8,16727030.08
2010-06-14,1089.63,-1.97,-0.18,1565.15,-30.38,True,1,20704,-1089.63,-5873454.35,22559699.52,16686245.17
2010-06-15,1115.23,25.6,2.35,1565.15,-28.75,True,1,20705,-1115.23,-5874569.58,23090837.15,17216267.57
2010-06-16,1114.61,-0.62,-0.06,1565.15,-28.79,True,1,20706,-1114.61,-5875684.19,23079114.66,17203430.47
2010-06-17,1116.04,1.43,0.13,1565.15,-28.69,True,1,20707,-1116.04,-5876800.23,23109840.28,17233040.05
2010-06-18,1117.51,1.47,0.13,1565.15,-28.6,True,1,20708,-1117.51,-5877917.74,23141397.08,17263479.34
2010-06-21,1113.2,-4.31,-0.39,1565.15,-28.88,True,1,20709,-1113.2,-5879030.94,23053258.8,17174227.86
2010-06-22,1095.31,-17.89,-1.61,1565.15,-30.02,True,1,20710,-1095.31,-5880126.25,22683870.1,16803743.85
2010-06-23,1092.04,-3.27,-0.3,1565.15,-30.23,True,1,20711,-1092.04,-5881218.29,22617240.44,16736022.15
2010-06-24,1073.69,-18.35,-1.68,1565.15,-31.4,True,1,20712,-1073.69,-5882291.98,22238267.28,16355975.3
2010-06-25,1076.76,3.07,0.29,1565.15,-31.2,True,1,20713,-1076.76,-5883368.74,22302929.88,16419561.14
2010-06-28,1074.57,-2.19,-0.2,1565.15,-31.34,True,1,20714,-1074.57,-5884443.31,22258642.98,16374199.67
2010-06-29,1041.24,-33.33,-3.1,1565.15,-33.47,True,1,20715,-1041.24,-5885484.55,21569286.6,15683802.05
2010-06-30,1030.71,-10.53,-1.01,1565.15,-34.15,True,1,20716,-1030.71,-5886515.26,21352188.36,15465673.1
2010-07-01,1027.37,-3.34,-0.32,1565.15,-34.36,True,1,20717,-1027.37,-5887542.63,21284024.29,15396481.66
2010-07-02,1022.58,-4.79,-0.47,1565.15,-34.67,True,1,20718,-1022.58,-5888565.21,21185812.44,15297247.23
2010-07-06,1028.06,5.48,0.54,1565.15,-34.32,True,1,20719,-1028.06,-5889593.27,21300375.14,15410781.87
2010-07-07,1060.27,32.21,3.13,1565.15,-32.26,True,1,20720,-1060.27,-5890653.54,21968794.4,16078140.86
2010-07-08,1070.25,9.98,0.94,1565.15,-31.62,True,1,20721,-1070.25,-5891723.79,22176650.25,16284926.46
2010-07-09,1077.96,7.71,0.72,1565.15,-31.13,True,1,20722,-1077.96,-5892801.75,22337487.12,16444685.37
2010-07-12,1078.75,0.79,0.07,1565.15,-31.08,True,1,20723,-1078.75,-5893880.5,22354936.25,16461055.75
2010-07-13,1095.34,16.59,1.54,1565.15,-30.02,True,1,20724,-1095.34,-5894975.84,22699826.16,16804850.32
2010-07-14,1095.17,-0.17,-0.02,1565.15,-30.03,True,1,20725,-1095.17,-5896071.01,22697398.25,16801327.24
2010-07-15,1096.48,1.31,0.12,1565.15,-29.94,True,1,20726,-1096.48,-5897167.49,22725644.48,16828476.99
2010-07-16,1064.88,-31.6,-2.88,1565.15,-31.96,True,1,20727,-1064.88,-5898232.37,22071767.76,16173535.39
2010-07-19,1071.25,6.37,0.6,1565.15,-31.56,True,1,20728,-1071.25,-5899303.62,22204870.0,16305566.38
2010-07-20,1083.48,12.23,1.14,1565.15,-30.78,True,1,20729,-1083.48,-5900387.1,22459456.92,16559069.82
2010-07-21,1069.59,-13.89,-1.28,1565.15,-31.66,True,1,20730,-1069.59,-5901456.69,22172600.7,16271144.01
2010-07-22,1093.67,24.08,2.25,1565.15,-30.12,True,1,20731,-1093.67,-5902550.36,22672872.77,16770322.41
2010-07-23,1102.66,8.99,0.82,1565.15,-29.55,True,1,20732,-1102.66,-5903653.02,22860347.12,16956694.1
2010-07-26,1115.01,12.35,1.12,1565.15,-28.76,True,1,20733,-1115.01,-5904768.03,23117502.33,17212734.3
2010-07-27,1113.84,-1.17,-0.1,1565.15,-28.84,True,1,20734,-1113.84,-5905881.87,23094358.56,17188476.69
2010-07-28,1106.13,-7.71,-0.69,1565.15,-29.33,True,1,20735,-1106.13,-5906988.0,22935605.55,17028617.55
2010-07-29,1101.53,-4.6,-0.42,1565.15,-29.62,True,1,20736,-1101.53,-5908089.53,22841326.08,16933236.55
2010-07-30,1101.6,0.07,0.01,1565.15,-29.62,True,1,20737,-1101.6,-5909191.13,22843879.2,16934688.07
2010-08-02,1125.86,24.26,2.2,1565.15,-28.07,True,1,20738,-1125.86,-5910316.99,23348084.68,17437767.69
2010-08-03,1120.46,-5.4,-0.48,1565.15,-28.41,True,1,20739,-1120.46,-5911437.45,23237219.94,17325782.49
2010-08-04,1127.24,6.78,0.6,1565.15,-27.98,True,1,20740,-1127.24,-5912564.69,23378957.6,17466392.91
2010-08-05,1125.81,-1.43,-0.13,1565.15,-28.07,True,1,20741,-1125.81,-5913690.5,23350425.21,17436734.71
2010-08-06,1121.64,-4.17,-0.37,1565.15,-28.34,True,1,20742,-1121.64,-5914812.14,23265056.88,17350244.74
2010-08-09,1127.79,6.15,0.55,1565.15,-27.94,True,1,20743,-1127.79,-5915939.93,23393747.97,17477808.04
2010-08-10,1121.06,-6.73,-0.6,1565.15,-28.37,True,1,20744,-1121.06,-5917060.99,23255268.64,17338207.65
2010-08-11,1089.47,-31.59,-2.82,1565.15,-30.39,True,1,20745,-1089.47,-5918150.46,22601055.15,16682904.69
2010-08-12,1083.61,-5.86,-0.54,1565.15,-30.77,True,1,20746,-1083.61,-5919234.07,22480573.06,16561338.99
2010-08-13,1079.25,-4.36,-0.4,1565.15,-31.04,True,1,20747,-1079.25,-5920313.32,22391199.75,16470886.43
2010-08-16,1079.38,0.13,0.01,1565.15,-31.04,True,1,20748,-1079.38,-5921392.7,22394976.24,16473583.54
2010-08-17,1092.54,13.16,1.22,1565.15,-30.2,True,1,20749,-1092.54,-5922485.24,22669112.46,16746627.22
2010-08-18,1094.16,1.62,0.15,1565.15,-30.09,True,1,20750,-1094.16,-5923579.4,22703820.0,16780240.6
2010-08-19,1075.63,-18.53,-1.69,1565.15,-31.28,True,1,20751,-1075.63,-5924655.03,22320398.13,16395743.1
2010-08-20,1071.69,-3.94,-0.37,1565.15,-31.53,True,1,20752,-1071.69,-5925726.72,22239710.88,16313984.16
2010-08-23,1067.36,-4.33,-0.4,1565.15,-31.8,True,1,20753,-1067.36,-5926794.08,22150922.08,16224128.0
2010-08-24,1051.87,-15.49,-1.45,1565.15,-32.79,True,1,20754,-1051.87,-5927845.95,21830509.98,15902664.03
2010-08-25,1055.33,3.46,0.33,1565.15,-32.57,True,1,20755,-1055.33,-5928901.28,21903374.15,15974472.87
2010-08-26,1047.22,-8.11,-0.77,1565.15,-33.09,True,1,20756,-1047.22,-5929948.5,21736098.32,15806149.82
2010-08-27,1064.59,17.37,1.66,1565.15,-31.98,True,1,20757,-1064.59,-5931013.09,22097694.63,16166681.54
2010-08-30,1048.92,-15.67,-1.47,1565.15,-32.98,True,1,20758,-1048.92,-5932062.01,21773481.36,15841419.35
2010-08-31,1049.33,0.41,0.04,1565.15,-32.96,True,1,20759,-1049.33,-5933111.34,21783041.47,15849930.13
2010-09-01,1080.29,30.96,2.95,1565.15,-30.98,True,1,20760,-1080.29,-5934191.63,22426820.4,16492628.77
2010-09-02,1090.1,9.81,0.91,1565.15,-30.35,True,1,20761,-1090.1,-5935281.73,22631566.1,16696284.37
2010-09-03,1104.51,14.41,1.32,1565.15,-29.43,True,1,20762,-1104.51,-5936386.24,22931836.62,16995450.38
2010-09-07,1091.84,-12.67,-1.15,1565.15,-30.24,True,1,20763,-1091.84,-5937478.08,22669873.92,16732395.84
2010-09-08,1098.87,7.03,0.64,1565.15,-29.79,True,1,20764,-1098.87,-5938576.95,22816936.68,16878359.73
2010-09-09,1104.18,5.31,0.48,1565.15,-29.45,True,1,20765,-1104.18,-5939681.13,22928297.7,16988616.57
2010-09-10,1109.55,5.37,0.49,1565.15,-29.11,True,1,20766,-1109.55,-5940790.68,23040915.3,17100124.62
2010-09-13,1121.9,12.35,1.11,1565.15,-28.32,True,1,20767,-1121.9,-5941912.58,23298497.3,17356584.72
2010-09-14,1121.1,-0.8,-0.07,1565.15,-28.37,True,1,20768,-1121.1,-5943033.68,23283004.8,17339971.12
2010-09-15,1125.07,3.97,0.35,1565.15,-28.12,True,1,20769,-1125.07,-5944158.75,23366578.83,17422420.08
2010-09-16,1124.66,-0.41,-0.04,1565.15,-28.14,True,1,20770,-1124.66,-5945283.41,23359188.2,17413904.79
2010-09-17,1125.59,0.93,0.08,1565.15,-28.08,True,1,20771,-1125.59,-5946409.0,23379629.89,17433220.89
2010-09-20,1142.71,17.12,1.52,1565.15,-26.99,True,1,20772,-1142.71,-5947551.71,23736372.12,17788820.41
2010-09-21,1139.78,-2.93,-0.26,1565.15,-27.18,True,1,20773,-1139.78,-5948691.49,23676649.94,17727958.45
2010-09-22,1134.28,-5.5,-0.48,1565.15,-27.53,True,1,20774,-1134.28,-5949825.77,23563532.72,17613706.95
2010-09-23,1124.83,-9.45,-0.83,1565.15,-28.13,True,1,20775,-1124.83,-5950950.6,23368343.25,17417392.65
2010-09-24,1148.67,23.84,2.12,1565.15,-26.61,True,1,20776,-1148.67,-5952099.27,23864767.92,17912668.65
2010-09-27,1142.16,-6.51,-0.57,1565.15,-27.03,True,1,20777,-1142.16,-5953241.43,23730658.32,17777416.89
2010-09-28,1147.7,5.54,0.48,1565.15,-26.67,True,1,20778,-1147.7,-5954389.13,23846910.6,17892521.47
2010-09-29,1144.73,-2.97,-0.26,1565.15,-26.86,True,1,20779,-1144.73,-5955533.86,23786344.67,17830810.81
2010-09-30,1141.2,-3.53,-0.31,1565.15,-27.09,True,1,20780,-1141.2,-5956675.06,23714136.0,17757460.94
2010-10-01,1146.24,5.04,0.44,1565.15,-26.76,True,1,20781,-1146.24,-5957821.3,23820013.44,17862192.14
2010-10-04,1137.03,-9.21,-0.8,1565.15,-27.35,True,1,20782,-1137.03,-5958958.33,23629757.46,17670799.13
2010-10-05,1160.75,23.72,2.09,1565.15,-25.84,True,1,20783,-1160.75,-5960119.08,24123867.25,18163748.17
2010-10-06,1159.97,-0.78,-0.07,1565.15,-25.89,True,1,20784,-1159.97,-5961279.05,24108816.48,18147537.43
2010-10-07,1158.06,-1.91,-0.16,1565.15,-26.01,True,1,20785,-1158.06,-5962437.11,24070277.1,18107839.99
2010-10-08,1165.15,7.09,0.61,1565.15,-25.56,True,1,20786,-1165.15,-5963602.26,24218807.9,18255205.64
2010-10-11,1165.32,0.17,0.02,1565.15,-25.55,True,1,20787,-1165.32,-5964767.58,24223506.84,18258739.26
2010-10-12,1169.77,4.45,0.38,1565.15,-25.26,True,1,20788,-1169.77,-5965937.35,24317178.76,18351241.41
2010-10-13,1178.1,8.33,0.71,1565.15,-24.73,True,1,20789,-1178.1,-5967115.45,24491520.9,18524405.45
2010-10-14,1173.81,-4.29,-0.36,1565.15,-25.0,True,1,20790,-1173.81,-5968289.26,24403509.9,18435220.64
2010-10-15,1176.19,2.38,0.2,1565.15,-24.85,True,1,20791,-1176.19,-5969465.45,24454166.29,18484700.84
2010-10-18,1184.71,8.52,0.72,1565.15,-24.31,True,1,20792,-1184.71,-5970650.16,24632490.32,18661840.16
2010-10-19,1165.9,-18.81,-1.59,1565.15,-25.51,True,1,20793,-1165.9,-5971816.06,24242558.7,18270742.64
2010-10-20,1178.17,12.27,1.05,1565.15,-24.72,True,1,20794,-1178.17,-5972994.23,24498866.98,18525872.75
2010-10-21,1180.26,2.09,0.18,1565.15,-24.59,True,1,20795,-1180.26,-5974174.49,24543506.7,18569332.21
2010-10-22,1183.08,2.82,0.24,1565.15,-24.41,True,1,20796,-1183.08,-5975357.57,24603331.68,18627974.11
2010-10-25,1185.62,2.54,0.22,1565.15,-24.25,True,1,20797,-1185.62,-5976543.19,24657339.14,18680795.95
2010-10-26,1185.64,0.02,0.0,1565.15,-24.25,True,1,20798,-1185.64,-5977728.83,24658940.72,18681211.89
2010-10-27,1182.45,-3.19,-0.27,1565.15,-24.45,True,1,20799,-1182.45,-5978911.28,24593777.55,18614866.27
2010-10-28,1183.78,1.33,0.11,1565.15,-24.37,True,1,20800,-1183.78,-5980095.06,24622624.0,18642528.94
2010-10-29,1183.26,-0.52,-0.04,1565.15,-24.4,True,1,20801,-1183.26,-5981278.32,24612991.26,18631712.94
2010-11-01,1184.38,1.12,0.1,1565.15,-24.33,True,1,20802,-1184.38,-5982462.7,24637472.76,18655010.06
2010-11-02,1193.57,9.19,0.78,1565.15,-23.74,True,1,20803,-1193.57,-5983656.27,24829836.71,18846180.44
2010-11-03,1197.96,4.39,0.37,1565.15,-23.46,True,1,20804,-1197.96,-5984854.23,24922359.84,18937505.61
2010-11-04,1221.06,23.1,1.93,1565.15,-21.98,True,1,20805,-1221.06,-5986075.29,25404153.3,19418078.01
2010-11-05,1225.85,4.79,0.39,1565.15,-21.68,True,1,20806,-1225.85,-5987301.14,25505035.1,19517733.96
2010-11-08,1223.25,-2.6,-0.21,1565.15,-21.84,True,1,20807,-1223.25,-5988524.39,25452162.75,19463638.36
2010-11-09,1213.4,-9.85,-0.8,1565.15,-22.47,True,1,20808,-1213.4,-5989737.79,25248427.2,19258689.41
2010-11-10,1218.71,5.31,0.44,1565.15,-22.14,True,1,20809,-1218.71,-5990956.5,25360136.39,19369179.89
2010-11-11,1213.54,-5.17,-0.42,1565.15,-22.46,True,1,20810,-1213.54,-5992170.04,25253767.4,19261597.36
2010-11-12,1199.21,-14.33,-1.18,1565.15,-23.38,True,1,20811,-1199.21,-5993369.25,24956759.31,18963390.06
2010-11-15,1197.75,-1.46,-0.12,1565.15,-23.47,True,1,20812,-1197.75,-5994567.0,24927573.0,18933006.0
2010-11-16,1178.34,-19.41,-1.62,1565.15,-24.71,True,1,20813,-1178.34,-5995745.34,24524790.42,18529045.08
2010-11-17,1178.59,0.25,0.02,1565.15,-24.7,True,1,20814,-1178.59,-5996923.93,24531172.26,18534248.33
2010-11-18,1196.69,18.1,1.54,1565.15,-23.54,True,1,20815,-1196.69,-5998120.62,24909102.35,18910981.73
2010-11-19,1199.73,3.04,0.25,1565.15,-23.35,True,1,20816,-1199.73,-5999320.35,24973579.68,18974259.33
2010-11-22,1197.84,-1.89,-0.16,1565.15,-23.47,True,1,20817,-1197.84,-6000518.19,24935435.28,18934917.09
2010-11-23,1180.73,-17.11,-1.43,1565.15,-24.56,True,1,20818,-1180.73,-6001698.92,24580437.14,18578738.22
2010-11-24,1198.35,17.62,1.49,1565.15,-23.44,True,1,20819,-1198.35,-6002897.27,24948448.65,18945551.38
2010-11-26,1189.4,-8.95,-0.75,1565.15,-24.01,True,1,20820,-1189.4,-6004086.67,24763308.0,18759221.33
2010-11-29,1187.76,-1.64,-0.14,1565.15,-24.11,True,1,20821,-1187.76,-6005274.43,24730350.96,18725076.53
2010-11-30,1180.55,-7.21,-0.61,1565.15,-24.57,True,1,20822,-1180.55,-6006454.98,24581412.1,18574957.12
2010-12-01,1206.07,25.52,2.16,1565.15,-22.94,True,1,20823,-1206.07,-6007661.05,25113995.61,19106334.56
2010-12-02,1221.53,15.46,1.28,1565.15,-21.95,True,1,20824,-1221.53,-6008882.58,25437140.72,19428258.14
2010-12-03,1224.71,3.18,0.26,1565.15,-21.75,True,1,20825,-1224.71,-6010107.29,25504585.75,19494478.46
2010-12-06,1223.12,-1.59,-0.13,1565.15,-21.85,True,1,20826,-1223.12,-6011330.41,25472697.12,19461366.71
2010-12-07,1223.75,0.63,0.05,1565.15,-21.81,True,1,20827,-1223.75,-6012554.16,25487041.25,19474487.09
2010-12-08,1228.28,4.53,0.37,1565.15,-21.52,True,1,20828,-1228.28,-6013782.44,25582615.84,19568833.4
2010-12-09,1233.0,4.72,0.38,1565.15,-21.22,True,1,20829,-1233.0,-6015015.44,25682157.0,19667141.56
2010-12-10,1240.4,7.4,0.6,1565.15,-20.75,True,1,20830,-1240.4,-6016255.84,25837532.0,19821276.16
2010-12-13,1240.46,0.06,0.0,1565.15,-20.74,True,1,20831,-1240.46,-6017496.3,25840022.26,19822525.96
2010-12-14,1241.59,1.13,0.09,1565.15,-20.67,True,1,20832,-1241.59,-6018737.89,25864802.88,19846064.99
2010-12-15,1235.23,-6.36,-0.51,1565.15,-21.08,True,1,20833,-1235.23,-6019973.12,25733546.59,19713573.47
2010-12-16,1242.87,7.64,0.62,1565.15,-20.59,True,1,20834,-1242.87,-6021215.99,25893953.58,19872737.59
2010-12-17,1243.91,1.04,0.08,1565.15,-20.52,True,1,20835,-1243.91,-6022459.9,25916864.85,19894404.95
2010-12-20,1247.08,3.17,0.26,1565.15,-20.32,True,1,20836,-1247.08,-6023706.98,25984158.88,19960451.9
2010-12-21,1254.6,7.52,0.6,1565.15,-19.84,True,1,20837,-1254.6,-6024961.58,26142100.2,20117138.62
2010-12-22,1258.84,4.24,0.34,1565.15,-19.57,True,1,20838,-1258.84,-6026220.42,26231707.92,20205487.5
2010-12-23,1256.77,-2.07,-0.16,1565.15,-19.7,True,1,20839,-1256.77,-6027477.19,26189830.03,20162352.84
2010-12-27,1257.54,0.77,0.06,1565.15,-19.65,True,1,20840,-1257.54,-6028734.73,26207133.6,20178398.87
2010-12-28,1258.51,0.97,0.08,1565.15,-19.59,True,1,20841,-1258.51,-6029993.24,26228606.91,20198613.67
2010-12-29,1259.78,1.27,0.1,1565.15,-19.51,True,1,20842,-1259.78,-6031253.02,26256334.76,20225081.74
2010-12-30,1257.88,-1.9,-0.15,1565.15,-19.63,True,1,20843,-1257.88,-6032510.9,26217992.84,20185481.94
2010-12-31,1257.64,-0.24,-0.02,1565.15,-19.65,True,1,20844,-1257.64,-6033768.54,26214248.16,20180479.62
2011-01-03,1271.87,14.23,1.13,1565.15,-18.74,True,1,20845,-1271.87,-6035040.41,26512130.15,20477089.74
2011-01-04,1270.2,-1.67,-0.13,1565.15,-18.84,True,1,20846,-1270.2,-6036310.61,26478589.2,20442278.59
2011-01-05,1276.56,6.36,0.5,1565.15,-18.44,True,1,20847,-1276.56,-6037587.17,26612446.32,20574859.15
2011-01-06,1273.85,-2.71,-0.21,1565.15,-18.61,True,1,20848,-1273.85,-6038861.02,26557224.8,20518363.78
2011-01-07,1271.5,-2.35,-0.18,1565.15,-18.76,True,1,20849,-1271.5,-6040132.52,26509503.5,20469370.98
2011-01-10,1269.75,-1.75,-0.14,1565.15,-18.87,True,1,20850,-1269.75,-6041402.27,26474287.5,20432885.23
2011-01-11,1274.48,4.73,0.37,1565.15,-18.57,True,1,20851,-1274.48,-6042676.75,26574182.48,20531505.73
2011-01-12,1285.96,11.48,0.9,1565.15,-17.84,True,1,20852,-1285.96,-6043962.71,26814837.92,20770875.21
2011-01-13,1283.76,-2.2,-0.17,1565.15,-17.98,True,1,20853,-1283.76,-6045246.47,26770247.28,20725000.81
2011-01-14,1293.24,9.48,0.74,1565.15,-17.37,True,1,20854,-1293.24,-6046539.71,26969226.96,20922687.25
2011-01-18,1295.02,1.78,0.14,1565.15,-17.26,True,1,20855,-1295.02,-6047834.73,27007642.1,20959807.37
2011-01-19,1281.92,-13.1,-1.01,1565.15,-18.1,True,1,20856,-1281.92,-6049116.65,26735723.52,20686606.87
2011-01-20,1280.26,-1.66,-0.13,1565.15,-18.2,True,1,20857,-1280.26,-6050396.91,26702382.82,20651985.91
2011-01-21,1283.35,3.09,0.24,1565.15,-18.0,True,1,20858,-1283.35,-6051680.26,26768114.3,20716434.04
2011-01-24,1290.84,7.49,0.58,1565.15,-17.53,True,1,20859,-1290.84,-6052971.1,26925631.56,20872660.46
2011-01-25,1291.18,0.34,0.03,1565.15,-17.5,True,1,20860,-1291.18,-6054262.28,26934014.8,20879752.52
2011-01-26,1296.63,5.45,0.42,1565.15,-17.16,True,1,20861,-1296.63,-6055558.91,27048998.43,20993439.52
2011-01-27,1299.54,2.91,0.22,1565.15,-16.97,True,1,20862,-1299.54,-6056858.45,27111003.48,21054145.03
2011-01-28,1276.34,-23.2,-1.78,1565.15,-18.45,True,1,20863,-1276.34,-6058134.79,26628281.42,20570146.63
2011-01-31,1286.12,9.78,0.77,1565.15,-17.83,True,1,20864,-1286.12,-6059420.91,26833607.68,20774186.77
2011-02-01,1307.59,21.47,1.67,1565.15,-16.46,True,1,20865,-1307.59,-6060728.5,27282865.35,21222136.85
2011-02-02,1304.03,-3.56,-0.27,1565.15,-16.68,True,1,20866,-1304.03,-6062032.53,27209889.98,21147857.45
2011-02-03,1307.1,3.07,0.24,1565.15,-16.49,True,1,20867,-1307.1,-6063339.63,27275255.7,21211916.07
2011-02-04,1310.87,3.77,0.29,1565.15,-16.25,True,1,20868,-1310.87,-6064650.5,27355235.16,21290584.66
2011-02-07,1319.05,8.18,0.62,1565.15,-15.72,True,1,20869,-1319.05,-6065969.55,27527254.45,21461284.9
2011-02-08,1324.57,5.52,0.42,1565.15,-15.37,True,1,20870,-1324.57,-6067294.12,27643775.9,21576481.78
2011-02-09,1320.88,-3.69,-0.28,1565.15,-15.61,True,1,20871,-1320.88,-6068615.0,27568086.48,21499471.48
2011-02-10,1321.87,0.99,0.08,1565.15,-15.54,True,1,20872,-1321.87,-6069936.87,27590070.64,21520133.77
2011-02-11,1329.15,7.28,0.55,1565.15,-15.08,True,1,20873,-1329.15,-6071266.02,27743347.95,21672081.93
2011-02-14,1332.32,3.17,0.24,1565.15,-14.88,True,1,20874,-1332.32,-6072598.34,27810847.68,21738249.34
2011-02-15,1328.01,-4.31,-0.32,1565.15,-15.15,True,1,20875,-1328.01,-6073926.35,27722208.75,21648282.4
2011-02-16,1336.32,8.31,0.63,1565.15,-14.62,True,1,20876,-1336.32,-6075262.67,27897016.32,21821753.65
2011-02-17,1340.43,4.11,0.31,1565.15,-14.36,True,1,20877,-1340.43,-6076603.1,27984157.11,21907554.01
2011-02-18,1343.01,2.58,0.19,1565.15,-14.19,True,1,20878,-1343.01,-6077946.11,28039362.78,21961416.67
2011-02-22,1315.44,-27.57,-2.05,1565.15,-15.95,True,1,20879,-1315.44,-6079261.55,27465071.76,21385810.21
2011-02-23,1307.4,-8.04,-0.61,1565.15,-16.47,True,1,20880,-1307.4,-6080568.95,27298512.0,21217943.05
2011-02-24,1306.1,-1.3,-0.1,1565.15,-16.55,True,1,20881,-1306.1,-6081875.05,27272674.1,21190799.05
2011-02-25,1319.88,13.78,1.06,1565.15,-15.67,True,1,20882,-1319.88,-6083194.93,27561734.16,21478539.23
2011-02-28,1327.22,7.34,0.56,1565.15,-15.2,True,1,20883,-1327.22,-6084522.15,27716335.26,21631813.11
2011-03-01,1306.33,-20.89,-1.57,1565.15,-16.54,True,1,20884,-1306.33,-6085828.48,27281395.72,21195567.24
2011-03-02,1308.44,2.11,0.16,1565.15,-16.4,True,1,20885,-1308.44,-6087136.92,27326769.4,21239632.48
2011-03-03,1330.97,22.53,1.72,1565.15,-14.96,True,1,20886,-1330.97,-6088467.89,27798639.42,21710171.53
2011-03-04,1321.15,-9.82,-0.74,1565.15,-15.59,True,1,20887,-1321.15,-6089789.04,27594860.05,21505071.01
2011-03-07,1310.13,-11.02,-0.83,1565.15,-16.29,True,1,20888,-1310.13,-6091099.17,27365995.44,21274896.27
2011-03-08,1321.82,11.69,0.89,1565.15,-15.55,True,1,20889,-1321.82,-6092420.99,27611497.98,21519076.99
2011-03-09,1320.02,-1.8,-0.14,1565.15,-15.66,True,1,20890,-1320.02,-6093741.01,27575217.8,21481476.79
2011-03-10,1295.11,-24.91,-1.89,1565.15,-17.25,True,1,20891,-1295.11,-6095036.12,27056143.01,20961106.89
2011-03-11,1304.28,9.17,0.71,1565.15,-16.67,True,1,20892,-1304.28,-6096340.4,27249017.76,21152677.36
2011-03-14,1296.39,-7.89,-0.6,1565.15,-17.17,True,1,20893,-1296.39,-6097636.79,27085476.27,20987839.48
2011-03-15,1281.87,-14.52,-1.12,1565.15,-18.1,True,1,20894,-1281.87,-6098918.66,26783391.78,20684473.12
2011-03-16,1256.88,-24.99,-1.95,1565.15,-19.7,True,1,20895,-1256.88,-6100175.54,26262507.6,20162332.06
2011-03-17,1273.72,16.84,1.34,1565.15,-18.62,True,1,20896,-1273.72,-6101449.26,26615653.12,20514203.86
2011-03-18,1279.21,5.49,0.43,1565.15,-18.27,True,1,20897,-1279.21,-6102728.47,26731651.37,20628922.9
2011-03-21,1298.38,19.17,1.5,1565.15,-17.04,True,1,20898,-1298.38,-6104026.85,27133545.24,21029518.39
2011-03-22,1293.77,-4.61,-0.36,1565.15,-17.34,True,1,20899,-1293.77,-6105320.62,27038499.23,20933178.61
2011-03-23,1297.54,3.77,0.29,1565.15,-17.1,True,1,20900,-1297.54,-6106618.16,27118586.0,21011967.84
2011-03-24,1309.66,12.12,0.93,1565.15,-16.32,True,1,20901,-1309.66,-6107927.82,27373203.66,21265275.84
2011-03-25,1313.8,4.14,0.32,1565.15,-16.06,True,1,20902,-1313.8,-6109241.62,27461047.6,21351805.98
2011-03-28,1310.19,-3.61,-0.28,1565.15,-16.29,True,1,20903,-1310.19,-6110551.81,27386901.57,21276349.76
2011-03-29,1319.44,9.25,0.71,1565.15,-15.7,True,1,20904,-1319.44,-6111871.25,27581573.76,21469702.51
2011-03-30,1328.26,8.82,0.67,1565.15,-15.14,True,1,20905,-1328.26,-6113199.51,27767275.3,21654075.79
2011-03-31,1325.83,-2.43,-0.18,1565.15,-15.29,True,1,20906,-1325.83,-6114525.34,27717801.98,21603276.64
2011-04-01,1332.41,6.58,0.5,1565.15,-14.87,True,1,20907,-1332.41,-6115857.75,27856695.87,21740838.12
2011-04-04,1332.87,0.46,0.04,1565.15,-14.84,True,1,20908,-1332.87,-6117190.62,27867645.96,21750455.34
2011-04-05,1332.63,-0.24,-0.02,1565.15,-14.86,True,1,20909,-1332.63,-6118523.25,27863960.67,21745437.42
2011-04-06,1335.54,2.91,0.22,1565.15,-14.67,True,1,20910,-1335.54,-6119858.79,27926141.4,21806282.61
2011-04-07,1333.51,-2.03,-0.15,1565.15,-14.8,True,1,20911,-1333.51,-6121192.3,27885027.61,21763835.31
2011-04-08,1328.17,-5.34,-0.4,1565.15,-15.14,True,1,20912,-1328.17,-6122520.47,27774691.04,21652170.57
2011-04-11,1324.46,-3.71,-0.28,1565.15,-15.38,True,1,20913,-1324.46,-6123844.93,27698431.98,21574587.05
2011-04-12,1314.16,-10.3,-0.78,1565.15,-16.04,True,1,20914,-1314.16,-6125159.09,27484342.24,21359183.15
2011-04-13,1314.41,0.25,0.02,1565.15,-16.02,True,1,20915,-1314.41,-6126473.5,27490885.15,21364411.65
2011-04-14,1314.52,0.11,0.01,1565.15,-16.01,True,1,20916,-1314.52,-6127788.02,27494500.32,21366712.3
2011-04-15,1319.68,5.16,0.39,1565.15,-15.68,True,1,20917,-1319.68,-6129107.7,27603746.56,21474638.86
2011-04-18,1305.14,-14.54,-1.1,1565.15,-16.61,True,1,20918,-1305.14,-6130412.84,27300918.52,21170505.68
2011-04-19,1312.62,7.48,0.57,1565.15,-16.14,True,1,20919,-1312.62,-6131725.46,27458697.78,21326972.32
2011-04-20,1330.36,17.74,1.35,1565.15,-15.0,True,1,20920,-1330.36,-6133055.82,27831131.2,21698075.38
2011-04-21,1337.38,7.02,0.53,1565.15,-14.55,True,1,20921,-1337.38,-6134393.2,27979326.98,21844933.78
2011-04-25,1335.25,-2.13,-0.16,1565.15,-14.69,True,1,20922,-1335.25,-6135728.45,27936100.5,21800372.05
2011-04-26,1347.24,11.99,0.9,1565.15,-13.92,True,1,20923,-1347.24,-6137075.69,28188302.52,22051226.83
2011-04-27,1355.66,8.42,0.62,1565.15,-13.38,True,1,20924,-1355.66,-6138431.35,28365829.84,22227398.49
2011-04-28,1360.48,4.82,0.36,1565.15,-13.08,True,1,20925,-1360.48,-6139791.83,28468044.0,22328252.17
2011-04-29,1363.61,3.13,0.23,1565.15,-12.88,True,1,20926,-1363.61,-6141155.44,28534902.86,22393747.42
2011-05-02,1361.22,-2.39,-0.18,1565.15,-13.03,True,1,20927,-1361.22,-6142516.66,28486250.94,22343734.28
2011-05-03,1356.62,-4.6,-0.34,1565.15,-13.32,True,1,20928,-1356.62,-6143873.28,28391343.36,22247470.08
2011-05-04,1347.32,-9.3,-0.69,1565.15,-13.92,True,1,20929,-1347.32,-6145220.6,28198060.28,22052839.68
2011-05-05,1335.1,-12.22,-0.91,1565.15,-14.7,True,1,20930,-1335.1,-6146555.7,27943643.0,21797087.3
2011-05-06,1340.2,5.1,0.38,1565.15,-14.37,True,1,20931,-1340.2,-6147895.9,28051726.2,21903830.3
2011-05-09,1346.29,6.09,0.45,1565.15,-13.98,True,1,20932,-1346.29,-6149242.19,28180542.28,22031300.09
2011-05-10,1357.16,10.87,0.81,1565.15,-13.29,True,1,20933,-1357.16,-6150599.35,28409430.28,22258830.93
2011-05-11,1342.08,-15.08,-1.11,1565.15,-14.25,True,1,20934,-1342.08,-6151941.43,28095102.72,21943161.29
2011-05-12,1348.65,6.57,0.49,1565.15,-13.83,True,1,20935,-1348.65,-6153290.08,28233987.75,22080697.67
2011-05-13,1337.77,-10.88,-0.81,1565.15,-14.53,True,1,20936,-1337.77,-6154627.85,28007552.72,21852924.87
2011-05-16,1329.47,-8.3,-0.62,1565.15,-15.06,True,1,20937,-1329.47,-6155957.32,27835113.39,21679156.07
2011-05-17,1328.98,-0.49,-0.04,1565.15,-15.09,True,1,20938,-1328.98,-6157286.3,27826183.24,21668896.94
2011-05-18,1340.68,11.7,0.88,1565.15,-14.34,True,1,20939,-1340.68,-6158626.98,28072498.52,21913871.54
2011-05-19,1343.6,2.92,0.22,1565.15,-14.16,True,1,20940,-1343.6,-6159970.58,28134984.0,21975013.42
2011-05-20,1333.27,-10.33,-0.77,1565.15,-14.82,True,1,20941,-1333.27,-6161303.85,27920007.07,21758703.22
2011-05-23,1317.37,-15.9,-1.19,1565.15,-15.83,True,1,20942,-1317.37,-6162621.22,27588362.54,21425741.32
2011-05-24,1316.28,-1.09,-0.08,1565.15,-15.9,True,1,20943,-1316.28,-6163937.5,27566852.04,21402914.54
2011-05-25,1320.47,4.19,0.32,1565.15,-15.63,True,1,20944,-1320.47,-6165257.97,27655923.68,21490665.71
2011-05-26,1325.69,5.22,0.4,1565.15,-15.3,True,1,20945,-1325.69,-6166583.66,27766577.05,21599993.39
2011-05-27,1331.1,5.41,0.41,1565.15,-14.95,True,1,20946,-1331.1,-6167914.76,27881220.6,21713305.84
2011-05-31,1345.2,14.1,1.06,1565.15,-14.05,True,1,20947,-1345.2,-6169259.96,28177904.4,22008644.44
2011-06-01,1314.55,-30.65,-2.28,1565.15,-16.01,True,1,20948,-1314.55,-6170574.51,27537193.4,21366618.89
2011-06-02,1312.94,-1.61,-0.12,1565.15,-16.11,True,1,20949,-1312.94,-6171887.45,27504780.06,21332892.61
2011-06-03,1300.16,-12.78,-0.97,1565.15,-16.93,True,1,20950,-1300.16,-6173187.61,27238352.0,21065164.39
2011-06-06,1286.17,-13.99,-1.08,1565.15,-17.82,True,1,20951,-1286.17,-6174473.78,26946547.67,20772073.89
2011-06-07,1284.94,-1.23,-0.1,1565.15,-17.9,True,1,20952,-1284.94,-6175758.72,26922062.88,20746304.16
2011-06-08,1279.56,-5.38,-0.42,1565.15,-18.25,True,1,20953,-1279.56,-6177038.28,26810620.68,20633582.4
2011-06-09,1289.0,9.44,0.74,1565.15,-17.64,True,1,20954,-1289.0,-6178327.28,27009706.0,20831378.72
2011-06-10,1270.98,-18.02,-1.4,1565.15,-18.8,True,1,20955,-1270.98,-6179598.26,26633385.9,20453787.64
2011-06-13,1271.83,0.85,0.07,1565.15,-18.74,True,1,20956,-1271.83,-6180870.09,26652469.48,20471599.39
2011-06-14,1287.87,16.04,1.26,1565.15,-17.72,True,1,20957,-1287.87,-6182157.96,26989891.59,20807733.63
2011-06-15,1265.42,-22.45,-1.74,1565.15,-19.15,True,1,20958,-1265.42,-6183423.38,26520672.36,20337248.98
2011-06-16,1267.64,2.22,0.18,1565.15,-19.01,True,1,20959,-1267.64,-6184691.02,26568466.76,20383775.74
2011-06-17,1271.5,3.86,0.3,1565.15,-18.76,True,1,20960,-1271.5,-6185962.52,26650640.0,20464677.48
2011-06-20,1278.36,6.86,0.54,1565.15,-18.32,True,1,20961,-1278.36,-6187240.88,26795703.96,20608463.08
2011-06-21,1295.52,17.16,1.34,1565.15,-17.23,True,1,20962,-1295.52,-6188536.4,27156690.24,20968153.84
2011-06-22,1287.14,-8.38,-0.65,1565.15,-17.76,True,1,20963,-1287.14,-6189823.54,26982315.82,20792492.28
2011-06-23,1283.5,-3.64,-0.28,1565.15,-18.0,True,1,20964,-1283.5,-6191107.04,26907294.0,20716186.96
2011-06-24,1268.45,-15.05,-1.17,1565.15,-18.96,True,1,20965,-1268.45,-6192375.49,26593054.25,20400678.76
2011-06-27,1280.1,11.65,0.92,1565.15,-18.21,True,1,20966,-1280.1,-6193655.59,26838576.6,20644921.01
2011-06-28,1296.67,16.57,1.29,1565.15,-17.15,True,1,20967,-1296.67,-6194952.26,27187279.89,20992327.63
2011-06-29,1307.41,10.74,0.83,1565.15,-16.47,True,1,20968,-1307.41,-6196259.67,27413772.88,21217513.21
2011-06-30,1320.64,13.23,1.01,1565.15,-15.62,True,1,20969,-1320.64,-6197580.31,27692500.16,21494919.85
2011-07-01,1339.67,19.03,1.44,1565.15,-14.41,True,1,20970,-1339.67,-6198919.98,28092879.9,21893959.92
2011-07-05,1337.88,-1.79,-0.13,1565.15,-14.52,True,1,20971,-1337.88,-6200257.86,28056681.48,21856423.62
2011-07-06,1339.22,1.34,0.1,1565.15,-14.44,True,1,20972,-1339.22,-6201597.08,28086121.84,21884524.76
2011-07-07,1353.22,14.0,1.04,1565.15,-13.54,True,1,20973,-1353.22,-6202950.3,28381083.06,22178132.76
2011-07-08,1343.8,-9.42,-0.7,1565.15,-14.14,True,1,20974,-1343.8,-6204294.1,28184861.2,21980567.1
2011-07-11,1319.49,-24.31,-1.81,1565.15,-15.7,True,1,20975,-1319.49,-6205613.59,27676302.75,21470689.16
2011-07-12,1313.64,-5.85,-0.44,1565.15,-16.07,True,1,20976,-1313.64,-6206927.23,27554912.64,21347985.41
2011-07-13,1317.72,4.08,0.31,1565.15,-15.81,True,1,20977,-1317.72,-6208244.95,27641812.44,21433567.49
2011-07-14,1308.87,-8.85,-0.67,1565.15,-16.37,True,1,20978,-1308.87,-6209553.82,27457474.86,21247921.04
2011-07-15,1316.14,7.27,0.56,1565.15,-15.91,True,1,20979,-1316.14,-6210869.96,27611301.06,21400431.1
2011-07-18,1305.44,-10.7,-0.81,1565.15,-16.59,True,1,20980,-1305.44,-6212175.4,27388131.2,21175955.8
2011-07-19,1326.73,21.29,1.63,1565.15,-15.23,True,1,20981,-1326.73,-6213502.13,27836122.13,21622620.0
2011-07-20,1325.84,-0.89,-0.07,1565.15,-15.29,True,1,20982,-1325.84,-6214827.97,27818774.88,21603946.91
2011-07-21,1343.8,17.96,1.36,1565.15,-14.14,True,1,20983,-1343.8,-6216171.77,28196955.4,21980783.63
2011-07-22,1345.02,1.22,0.09,1565.15,-14.06,True,1,20984,-1345.02,-6217516.79,28223899.68,22006382.89
2011-07-25,1337.43,-7.59,-0.56,1565.15,-14.55,True,1,20985,-1337.43,-6218854.22,28065968.55,21847114.33
2011-07-26,1331.94,-5.49,-0.41,1565.15,-14.9,True,1,20986,-1331.94,-6220186.16,27952092.84,21731906.68
2011-07-27,1304.89,-27.05,-2.03,1565.15,-16.63,True,1,20987,-1304.89,-6221491.05,27385726.43,21164235.38
2011-07-28,1300.67,-4.22,-0.32,1565.15,-16.9,True,1,20988,-1300.67,-6222791.72,27298461.96,21075670.24
2011-07-29,1292.28,-8.39,-0.64,1565.15,-17.43,True,1,20989,-1292.28,-6224084.0,27123664.92,20899580.92
2011-08-01,1286.94,-5.34,-0.41,1565.15,-17.77,True,1,20990,-1286.94,-6225370.94,27012870.6,20787499.66
2011-08-02,1254.05,-32.89,-2.56,1565.15,-19.88,True,1,20991,-1254.05,-6226624.99,26323763.55,20097138.56
2011-08-03,1260.34,6.29,0.5,1565.15,-19.48,True,1,20992,-1260.34,-6227885.33,26457057.28,20229171.95
2011-08-04,1200.07,-60.27,-4.78,1565.15,-23.33,True,1,20993,-1200.07,-6229085.4,25193069.51,18963984.11
2011-08-05,1199.38,-0.69,-0.06,1565.15,-23.37,True,1,20994,-1199.38,-6230284.78,25179783.72,18949498.94
2011-08-08,1119.46,-79.92,-6.66,1565.15,-28.48,True,1,20995,-1119.46,-6231404.24,23503062.7,17271658.46
2011-08-09,1172.53,53.07,4.74,1565.15,-25.08,True,1,20996,-1172.53,-6232576.77,24618439.88,18385863.11
2011-08-10,1120.76,-51.77,-4.42,1565.15,-28.39,True,1,20997,-1120.76,-6233697.53,23532597.72,17298900.19
2011-08-11,1172.64,51.88,4.63,1565.15,-25.08,True,1,20998,-1172.64,-6234870.17,24623094.72,18388224.55
2011-08-12,1178.81,6.17,0.53,1565.15,-24.68,True,1,20999,-1178.81,-6236048.98,24753831.19,18517782.21
2011-08-15,1204.49,25.68,2.18,1565.15,-23.04,True,1,21000,-1204.49,-6237253.47,25294290.0,19057036.53
2011-08-16,1192.76,-11.73,-0.97,1565.15,-23.79,True,1,21001,-1192.76,-6238446.23,25049152.76,18810706.53
2011-08-17,1193.89,1.13,0.1,1565.15,-23.72,True,1,21002,-1193.89,-6239640.12,25074077.78,18834437.66
2011-08-18,1140.65,-53.24,-4.46,1565.15,-27.12,True,1,21003,-1140.65,-6240780.77,23957071.95,17716291.18
2011-08-19,1123.53,-17.12,-1.5,1565.15,-28.22,True,1,21004,-1123.53,-6241904.3,23598624.12,17356719.82
2011-08-22,1123.82,0.29,0.03,1565.15,-28.2,True,1,21005,-1123.82,-6243028.12,23605839.1,17362810.98
2011-08-23,1162.35,38.53,3.43,1565.15,-25.74,True,1,21006,-1162.35,-6244190.47,24416324.1,18172133.63
2011-08-24,1177.6,15.25,1.31,1565.15,-24.76,True,1,21007,-1177.6,-6245368.07,24737843.2,18492475.13
2011-08-25,1159.27,-18.33,-1.56,1565.15,-25.93,True,1,21008,-1159.27,-6246527.34,24353944.16,18107416.82
2011-08-26,1176.8,17.53,1.51,1565.15,-24.81,True,1,21009,-1176.8,-6247704.14,24723391.2,18475687.06
2011-08-29,1210.08,33.28,2.83,1565.15,-22.69,True,1,21010,-1210.08,-6248914.22,25423780.8,19174866.58
2011-08-30,1212.92,2.84,0.24,1565.15,-22.5,True,1,21011,-1212.92,-6250127.14,25484662.12,19234534.98
2011-08-31,1218.89,5.97,0.49,1565.15,-22.12,True,1,21012,-1218.89,-6251346.03,25611316.68,19359970.65
2011-09-01,1204.42,-14.47,-1.19,1565.15,-23.05,True,1,21013,-1204.42,-6252550.45,25308477.46,19055927.01
2011-09-02,1173.97,-30.45,-2.53,1565.15,-24.99,True,1,21014,-1173.97,-6253724.42,24669805.58,18416081.16
2011-09-06,1165.24,-8.73,-0.74,1565.15,-25.55,True,1,21015,-1165.24,-6254889.66,24487518.6,18232628.94
2011-09-07,1198.62,33.38,2.86,1565.15,-23.42,True,1,21016,-1198.62,-6256088.28,25190197.92,18934109.64
2011-09-08,1185.9,-12.72,-1.06,1565.15,-24.23,True,1,21017,-1185.9,-6257274.18,24924060.3,18666786.12
2011-09-09,1154.23,-31.67,-2.67,1565.15,-26.25,True,1,21018,-1154.23,-6258428.41,24259606.14,18001177.73
2011-09-12,1162.27,8.04,0.7,1565.15,-25.74,True,1,21019,-1162.27,-6259590.68,24429753.13,18170162.45
2011-09-13,1172.87,10.6,0.91,1565.15,-25.06,True,1,21020,-1172.87,-6260763.55,24653727.4,18392963.85
2011-09-14,1188.68,15.81,1.35,1565.15,-24.05,True,1,21021,-1188.68,-6261952.23,24987242.28,18725290.05
2011-09-15,1209.11,20.43,1.72,1565.15,-22.75,True,1,21022,-1209.11,-6263161.34,25417910.42,19154749.08
2011-09-16,1216.01,6.9,0.57,1565.15,-22.31,True,1,21023,-1216.01,-6264377.35,25564178.23,19299800.88
2011-09-19,1204.09,-11.92,-0.98,1565.15,-23.07,True,1,21024,-1204.09,-6265581.44,25314788.16,19049206.72
2011-09-20,1202.09,-2.0,-0.17,1565.15,-23.2,True,1,21025,-1202.09,-6266783.53,25273942.25,19007158.72
2011-09-21,1166.76,-35.33,-2.94,1565.15,-25.45,True,1,21026,-1166.76,-6267950.29,24532295.76,18264345.47
2011-09-22,1129.56,-37.2,-3.19,1565.15,-27.83,True,1,21027,-1129.56,-6269079.85,23751258.12,17482178.27
2011-09-23,1136.43,6.87,0.61,1565.15,-27.39,True,1,21028,-1136.43,-6270216.28,23896850.04,17626633.76
2011-09-26,1162.95,26.52,2.33,1565.15,-25.7,True,1,21029,-1162.95,-6271379.23,24455675.55,18184296.32
2011-09-27,1175.38,12.43,1.07,1565.15,-24.9,True,1,21030,-1175.38,-6272554.61,24718241.4,18445686.79
2011-09-28,1151.06,-24.32,-2.07,1565.15,-26.46,True,1,21031,-1151.06,-6273705.67,24207942.86,17934237.19
2011-09-29,1160.4,9.34,0.81,1565.15,-25.86,True,1,21032,-1160.4,-6274866.07,24405532.8,18130666.73
2011-09-30,1131.42,-28.98,-2.5,1565.15,-27.71,True,1,21033,-1131.42,-6275997.49,23797156.86,17521159.37
2011-10-03,1099.23,-32.19,-2.84,1565.15,-29.77,True,1,21034,-1099.23,-6277096.72,23121203.82,16844107.1
2011-10-04,1123.95,24.72,2.25,1565.15,-28.19,True,1,21035,-1123.95,-6278220.67,23642288.25,17364067.58
2011-10-05,1144.03,20.08,1.79,1565.15,-26.91,True,1,21036,-1144.03,-6279364.7,24065815.08,17786450.38
2011-10-06,1164.97,20.94,1.83,1565.15,-25.57,True,1,21037,-1164.97,-6280529.67,24507473.89,18226944.22
2011-10-07,1155.46,-9.51,-0.82,1565.15,-26.18,True,1,21038,-1155.46,-6281685.13,24308567.48,18026882.35
2011-10-10,1194.89,39.43,3.41,1565.15,-23.66,True,1,21039,-1194.89,-6282880.02,25139290.71,18856410.69
2011-10-11,1195.54,0.65,0.05,1565.15,-23.62,True,1,21040,-1195.54,-6284075.56,25154161.6,18870086.04
2011-10-12,1207.25,11.71,0.98,1565.15,-22.87,True,1,21041,-1207.25,-6285282.81,25401747.25,19116464.44
2011-10-13,1203.66,-3.59,-0.3,1565.15,-23.1,True,1,21042,-1203.66,-6286486.47,25327413.72,19040927.25
2011-10-14,1224.58,20.92,1.74,1565.15,-21.76,True,1,21043,-1224.58,-6287711.05,25768836.94,19481125.89
2011-10-17,1200.86,-23.72,-1.94,1565.15,-23.28,True,1,21044,-1200.86,-6288911.91,25270897.84,18981985.93
2011-10-18,1225.38,24.52,2.04,1565.15,-21.71,True,1,21045,-1225.38,-6290137.29,25788122.1,19497984.81
2011-10-19,1209.88,-15.5,-1.26,1565.15,-22.7,True,1,21046,-1209.88,-6291347.17,25463134.48,19171787.31
2011-10-20,1215.39,5.51,0.46,1565.15,-22.35,True,1,21047,-1215.39,-6292562.56,25580313.33,19287750.77
2011-10-21,1238.25,22.86,1.88,1565.15,-20.89,True,1,21048,-1238.25,-6293800.81,26062686.0,19768885.19
2011-10-24,1254.19,15.94,1.29,1565.15,-19.87,True,1,21049,-1254.19,-6295055.0,26399445.31,20104390.31
2011-10-25,1229.05,-25.14,-2.0,1565.15,-21.47,True,1,21050,-1229.05,-6296284.05,25871502.5,19575218.45
2011-10-26,1242.0,12.95,1.05,1565.15,-20.65,True,1,21051,-1242.0,-6297526.05,26145342.0,19847815.95
2011-10-27,1284.59,42.59,3.43,1565.15,-17.92,True,1,21052,-1284.59,-6298810.64,27043188.68,20744378.04
2011-10-28,1285.09,0.5,0.04,1565.15,-17.89,True,1,21053,-1285.09,-6300095.73,27054999.77,20754904.04
2011-10-31,1253.3,-31.79,-2.47,1565.15,-19.92,True,1,21054,-1253.3,-6301349.03,26386978.2,20085629.17
2011-11-01,1218.28,-35.02,-2.79,1565.15,-22.16,True,1,21055,-1218.28,-6302567.31,25650885.4,19348318.09
2011-11-02,1237.9,19.62,1.61,1565.15,-20.91,True,1,21056,-1237.9,-6303805.21,26065222.4,19761417.19
2011-11-03,1261.15,23.25,1.88,1565.15,-19.42,True,1,21057,-1261.15,-6305066.36,26556035.55,20250969.19
2011-11-04,1253.23,-7.92,-0.63,1565.15,-19.93,True,1,21058,-1253.23,-6306319.59,26390517.34,20084197.75
2011-11-07,1261.12,7.89,0.63,1565.15,-19.42,True,1,21059,-1261.12,-6307580.71,26557926.08,20250345.37
2011-11-08,1275.92,14.8,1.17,1565.15,-18.48,True,1,21060,-1275.92,-6308856.63,26870875.2,20562018.57
2011-11-09,1229.1,-46.82,-3.67,1565.15,-21.47,True,1,21061,-1229.1,-6310085.73,25886075.1,19575989.37
2011-11-10,1239.7,10.6,0.86,1565.15,-20.79,True,1,21062,-1239.7,-6311325.43,26110561.4,19799235.97
2011-11-11,1263.85,24.15,1.95,1565.15,-19.25,True,1,21063,-1263.85,-6312589.28,26620472.55,20307883.27
2011-11-14,1251.78,-12.07,-0.96,1565.15,-20.02,True,1,21064,-1251.78,-6313841.06,26367493.92,20053652.86
2011-11-15,1257.81,6.03,0.48,1565.15,-19.64,True,1,21065,-1257.81,-6315098.87,26495767.65,20180668.78
2011-11-16,1236.91,-20.9,-1.66,1565.15,-20.97,True,1,21066,-1236.91,-6316335.78,26056746.06,19740410.28
2011-11-17,1216.13,-20.78,-1.68,1565.15,-22.3,True,1,21067,-1216.13,-6317551.91,25620210.71,19302658.8
2011-11-18,1215.65,-0.48,-0.04,1565.15,-22.33,True,1,21068,-1215.65,-6318767.56,25611314.2,19292546.64
2011-11-21,1192.98,-22.67,-1.86,1565.15,-23.78,True,1,21069,-1192.98,-6319960.54,25134895.62,18814935.08
2011-11-22,1188.04,-4.94,-0.41,1565.15,-24.09,True,1,21070,-1188.04,-6321148.58,25032002.8,18710854.22
2011-11-23,1161.79,-26.25,-2.21,1565.15,-25.77,True,1,21071,-1161.79,-6322310.37,24480077.09,18157766.72
2011-11-25,1158.67,-3.12,-0.27,1565.15,-25.97,True,1,21072,-1158.67,-6323469.04,24415494.24,18092025.2
2011-11-28,1192.55,33.88,2.92,1565.15,-23.81,True,1,21073,-1192.55,-6324661.59,25130606.15,18805944.56
2011-11-29,1195.19,2.64,0.22,1565.15,-23.64,True,1,21074,-1195.19,-6325856.78,25187434.06,18861577.28
2011-11-30,1246.96,51.77,4.33,1565.15,-20.33,True,1,21075,-1246.96,-6327103.74,26279682.0,19952578.26
2011-12-01,1244.58,-2.38,-0.19,1565.15,-20.48,True,1,21076,-1244.58,-6328348.32,26230768.08,19902419.76
2011-12-02,1244.28,-0.3,-0.02,1565.15,-20.5,True,1,21077,-1244.28,-6329592.6,26225689.56,19896096.96
2011-12-05,1257.08,12.8,1.03,1565.15,-19.68,True,1,21078,-1257.08,-6330849.68,26496732.24,20165882.56
2011-12-06,1258.47,1.39,0.11,1565.15,-19.59,True,1,21079,-1258.47,-6332108.15,26527289.13,20195180.98
2011-12-07,1261.01,2.54,0.2,1565.15,-19.43,True,1,21080,-1261.01,-6333369.16,26582090.8,20248721.64
2011-12-08,1234.35,-26.66,-2.11,1565.15,-21.14,True,1,21081,-1234.35,-6334603.51,26021332.35,19686728.84
2011-12-09,1255.19,20.84,1.69,1565.15,-19.8,True,1,21082,-1255.19,-6335858.7,26461915.58,20126056.88
2011-12-12,1236.47,-18.72,-1.49,1565.15,-21.0,True,1,21083,-1236.47,-6337095.17,26068497.01,19731401.84
2011-12-13,1225.73,-10.74,-0.87,1565.15,-21.69,True,1,21084,-1225.73,-6338320.9,25843291.32,19504970.42
2011-12-14,1211.82,-13.91,-1.14,1565.15,-22.58,True,1,21085,-1211.82,-6339532.72,25551224.7,19211691.98
2011-12-15,1215.75,3.93,0.32,1565.15,-22.32,True,1,21086,-1215.75,-6340748.47,25635304.5,19294556.03
2011-12-16,1219.66,3.91,0.32,1565.15,-22.07,True,1,21087,-1219.66,-6341968.13,25718970.42,19377002.29
2011-12-19,1205.35,-14.31,-1.17,1565.15,-22.99,True,1,21088,-1205.35,-6343173.48,25418420.8,19075247.32
2011-12-20,1241.3,35.95,2.98,1565.15,-20.69,True,1,21089,-1241.3,-6344414.78,26177775.7,19833360.92
2011-12-21,1243.72,2.42,0.2,1565.15,-20.54,True,1,21090,-1243.72,-6345658.5,26230054.8,19884396.3
2011-12-22,1254.0,10.28,0.83,1565.15,-19.88,True,1,21091,-1254.0,-6346912.5,26448114.0,20101201.5
2011-12-23,1265.33,11.33,0.9,1565.15,-19.16,True,1,21092,-1265.33,-6348177.83,26688340.36,20340162.53
2011-12-27,1265.43,0.1,0.01,1565.15,-19.15,True,1,21093,-1265.43,-6349443.26,26691714.99,20342271.73
2011-12-28,1249.64,-15.79,-1.25,1565.15,-20.16,True,1,21094,-1249.64,-6350692.9,26359906.16,20009213.26
2011-12-29,1263.02,13.38,1.07,1565.15,-19.3,True,1,21095,-1263.02,-6351955.92,26643406.9,20291450.98
2011-12-30,1257.6,-5.42,-0.43,1565.15,-19.65,True,1,21096,-1257.6,-6353213.52,26530329.6,20177116.08
2012-01-03,1277.06,19.46,1.55,1565.15,-18.41,True,1,21097,-1277.06,-6354490.58,26942134.82,20587644.24
2012-01-04,1277.3,0.24,0.02,1565.15,-18.39,True,1,21098,-1277.3,-6355767.88,26948475.4,20592707.52
2012-01-05,1281.06,3.76,0.29,1565.15,-18.15,True,1,21099,-1281.06,-6357048.94,27029084.94,20672036.0
2012-01-06,1277.81,-3.25,-0.25,1565.15,-18.36,True,1,21100,-1277.81,-6358326.75,26961791.0,20603464.25
2012-01-09,1280.7,2.89,0.23,1565.15,-18.17,True,1,21101,-1280.7,-6359607.45,27024050.7,20664443.25
2012-01-10,1292.08,11.38,0.89,1565.15,-17.45,True,1,21102,-1292.08,-6360899.53,27265472.16,20904572.63
2012-01-11,1292.48,0.4,0.03,1565.15,-17.42,True,1,21103,-1292.48,-6362192.01,27275205.44,20913013.43
2012-01-12,1295.5,3.02,0.23,1565.15,-17.23,True,1,21104,-1295.5,-6363487.51,27340232.0,20976744.49
2012-01-13,1289.09,-6.41,-0.5,1565.15,-17.64,True,1,21105,-1289.09,-6364776.6,27206244.45,20841467.85
2012-01-17,1293.67,4.58,0.36,1565.15,-17.34,True,1,21106,-1293.67,-6366070.27,27304199.02,20938128.75
2012-01-18,1308.04,14.37,1.11,1565.15,-16.43,True,1,21107,-1308.04,-6367378.31,27608800.28,21241421.97
2012-01-19,1314.5,6.46,0.49,1565.15,-16.01,True,1,21108,-1314.5,-6368692.81,27746466.0,21377773.19
2012-01-20,1315.38,0.88,0.07,1565.15,-15.96,True,1,21109,-1315.38,-6370008.19,27766356.42,21396348.23
2012-01-23,1316.0,0.62,0.05,1565.15,-15.92,True,1,21110,-1316.0,-6371324.19,27780760.0,21409435.81
2012-01-24,1314.65,-1.35,-0.1,1565.15,-16.0,True,1,21111,-1314.65,-6372638.84,27753576.15,21380937.31
2012-01-25,1326.06,11.41,0.87,1565.15,-15.28,True,1,21112,-1326.06,-6373964.9,27995778.72,21621813.82
2012-01-26,1318.43,-7.63,-0.57,1565.15,-15.76,True,1,21113,-1318.43,-6375283.33,27836012.59,21460729.26
2012-01-27,1316.33,-2.1,-0.16,1565.15,-15.9,True,1,21114,-1316.33,-6376599.66,27792991.62,21416391.96
2012-01-30,1313.01,-3.32,-0.25,1565.15,-16.11,True,1,21115,-1313.01,-6377912.67,27724206.15,21346293.48
2012-01-31,1312.41,-0.6,-0.05,1565.15,-16.15,True,1,21116,-1312.41,-6379225.08,27712849.56,21333624.48
2012-02-01,1324.09,11.68,0.89,1565.15,-15.4,True,1,21117,-1324.09,-6380549.17,27960808.53,21580259.36
2012-02-02,1325.54,1.45,0.11,1565.15,-15.31,True,1,21118,-1325.54,-6381874.71,27992753.72,21610879.01
2012-02-03,1344.9,19.36,1.46,1565.15,-14.07,True,1,21119,-1344.9,-6383219.61,28402943.1,22019723.49
2012-02-06,1344.33,-0.57,-0.04,1565.15,-14.11,True,1,21120,-1344.33,-6384563.94,28392249.6,22007685.66
2012-02-07,1347.05,2.72,0.2,1565.15,-13.94,True,1,21121,-1347.05,-6385910.99,28451043.05,22065132.06
2012-02-08,1349.96,2.91,0.22,1565.15,-13.75,True,1,21122,-1349.96,-6387260.95,28513855.12,22126594.17
2012-02-09,1351.95,1.99,0.15,1565.15,-13.62,True,1,21123,-1351.95,-6388612.9,28557239.85,22168626.95
2012-02-10,1342.64,-9.31,-0.69,1565.15,-14.22,True,1,21124,-1342.64,-6389955.54,28361927.36,21971971.82
2012-02-13,1351.77,9.13,0.68,1565.15,-13.63,True,1,21125,-1351.77,-6391307.31,28556141.25,22164833.94
2012-02-14,1350.5,-1.27,-0.09,1565.15,-13.71,True,1,21126,-1350.5,-6392657.81,28530663.0,22138005.19
2012-02-15,1343.23,-7.27,-0.54,1565.15,-14.18,True,1,21127,-1343.23,-6394001.04,28378420.21,21984419.17
2012-02-16,1358.04,14.81,1.1,1565.15,-13.23,True,1,21128,-1358.04,-6395359.08,28692669.12,22297310.04
2012-02-17,1361.23,3.19,0.24,1565.15,-13.03,True,1,21129,-1361.23,-6396720.31,28761428.67,22364708.36
2012-02-21,1362.21,0.98,0.07,1565.15,-12.97,True,1,21130,-1362.21,-6398082.52,28783497.3,22385414.78
2012-02-22,1357.66,-4.55,-0.33,1565.15,-13.26,True,1,21131,-1357.66,-6399440.18,28688713.46,22289273.28
2012-02-23,1363.46,5.8,0.43,1565.15,-12.89,True,1,21132,-1363.46,-6400803.64,28812636.72,22411833.08
2012-02-24,1365.74,2.28,0.17,1565.15,-12.74,True,1,21133,-1365.74,-6402169.38,28862183.42,22460014.04
2012-02-27,1367.59,1.85,0.14,1565.15,-12.62,True,1,21134,-1367.59,-6403536.97,28902647.06,22499110.09
2012-02-28,1372.18,4.59,0.34,1565.15,-12.33,True,1,21135,-1372.18,-6404909.15,29001024.3,22596115.15
2012-02-29,1365.68,-6.5,-0.47,1565.15,-12.74,True,1,21136,-1365.68,-6406274.83,28865012.48,22458737.65
2012-03-01,1374.09,8.41,0.62,1565.15,-12.21,True,1,21137,-1374.09,-6407648.92,29044140.33,22636491.41
2012-03-02,1369.63,-4.46,-0.32,1565.15,-12.49,True,1,21138,-1369.63,-6409018.55,28951238.94,22542220.39
2012-03-05,1364.33,-5.3,-0.39,1565.15,-12.83,True,1,21139,-1364.33,-6410382.88,28840571.87,22430188.99
2012-03-06,1343.36,-20.97,-1.54,1565.15,-14.17,True,1,21140,-1343.36,-6411726.24,28398630.4,21986904.16
2012-03-07,1352.63,9.27,0.69,1565.15,-13.58,True,1,21141,-1352.63,-6413078.87,28595950.83,22182871.96
2012-03-08,1365.91,13.28,0.98,1565.15,-12.73,True,1,21142,-1365.91,-6414444.78,28878069.22,22463624.44
2012-03-09,1370.87,4.96,0.36,1565.15,-12.41,True,1,21143,-1370.87,-6415815.65,28984304.41,22568488.76
2012-03-12,1371.09,0.22,0.02,1565.15,-12.4,True,1,21144,-1371.09,-6417186.74,28990326.96,22573140.22
2012-03-13,1395.95,24.86,1.81,1565.15,-10.81,True,1,21145,-1395.95,-6418582.69,29517362.75,23098780.06
2012-03-14,1394.28,-1.67,-0.12,1565.15,-10.92,True,1,21146,-1394.28,-6419976.97,29483444.88,23063467.91
2012-03-15,1402.6,8.32,0.6,1565.15,-10.39,True,1,21147,-1402.6,-6421379.57,29660782.2,23239402.63
2012-03-16,1404.17,1.57,0.11,1565.15,-10.28,True,1,21148,-1404.17,-6422783.74,29695387.16,23272603.42
2012-03-19,1409.75,5.58,0.4,1565.15,-9.93,True,1,21149,-1409.75,-6424193.49,29814802.75,23390609.26
2012-03-20,1405.52,-4.23,-0.3,1565.15,-10.2,True,1,21150,-1405.52,-6425599.01,29726748.0,23301148.99
2012-03-21,1402.89,-2.63,-0.19,1565.15,-10.37,True,1,21151,-1402.89,-6427001.9,29672526.39,23245524.49
2012-03-22,1392.78,-10.11,-0.72,1565.15,-11.01,True,1,21152,-1392.78,-6428394.68,29460082.56,23031687.88
2012-03-23,1397.11,4.33,0.31,1565.15,-10.74,True,1,21153,-1397.11,-6429791.79,29553067.83,23123276.04
2012-03-26,1416.51,19.4,1.39,1565.15,-9.5,True,1,21154,-1416.51,-6431208.3,29964852.54,23533644.24
2012-03-27,1412.52,-3.99,-0.28,1565.15,-9.75,True,1,21155,-1412.52,-6432620.82,29881860.6,23449239.78
2012-03-28,1405.54,-6.98,-0.49,1565.15,-10.2,True,1,21156,-1405.54,-6434026.36,29735604.24,23301577.88
2012-03-29,1403.28,-2.26,-0.16,1565.15,-10.34,True,1,21157,-1403.28,-6435429.64,29689194.96,23253765.32
2012-03-30,1408.47,5.19,0.37,1565.15,-10.01,True,1,21158,-1408.47,-6436838.11,29800408.26,23363570.15
2012-04-02,1419.04,10.57,0.75,1565.15,-9.34,True,1,21159,-1419.04,-6438257.15,30025467.36,23587210.21
2012-04-03,1413.38,-5.66,-0.4,1565.15,-9.7,True,1,21160,-1413.38,-6439670.53,29907120.8,23467450.27
2012-04-04,1398.96,-14.42,-1.02,1565.15,-10.62,True,1,21161,-1398.96,-6441069.49,29603392.56,23162323.07
2012-04-05,1398.08,-0.88,-0.06,1565.15,-10.67,True,1,21162,-1398.08,-6442467.57,29586168.96,23143701.39
2012-04-09,1382.2,-15.88,-1.14,1565.15,-11.69,True,1,21163,-1382.2,-6443849.77,29251498.6,22807648.83
2012-04-10,1358.59,-23.61,-1.71,1565.15,-13.2,True,1,21164,-1358.59,-6445208.36,28753198.76,22307990.4
2012-04-11,1368.71,10.12,0.74,1565.15,-12.55,True,1,21165,-1368.71,-6446577.07,28968747.15,22522170.08
2012-04-12,1387.57,18.86,1.38,1565.15,-11.35,True,1,21166,-1387.57,-6447964.64,29369306.62,22921341.98
2012-04-13,1370.26,-17.31,-1.25,1565.15,-12.45,True,1,21167,-1370.26,-6449334.9,29004293.42,22554958.52
2012-04-16,1369.57,-0.69,-0.05,1565.15,-12.5,True,1,21168,-1369.57,-6450704.47,28991057.76,22540353.29
2012-04-17,1390.78,21.21,1.55,1565.15,-11.14,True,1,21169,-1390.78,-6452095.25,29441421.82,22989326.57
2012-04-18,1385.14,-5.64,-0.41,1565.15,-11.5,True,1,21170,-1385.14,-6453480.39,29323413.8,22869933.41
2012-04-19,1376.92,-8.22,-0.59,1565.15,-12.03,True,1,21171,-1376.92,-6454857.31,29150773.32,22695916.01
2012-04-20,1378.53,1.61,0.12,1565.15,-11.92,True,1,21172,-1378.53,-6456235.84,29186237.16,22730001.32
2012-04-23,1366.94,-11.59,-0.84,1565.15,-12.66,True,1,21173,-1366.94,-6457602.78,28942220.62,22484617.84
2012-04-24,1371.97,5.03,0.37,1565.15,-12.34,True,1,21174,-1371.97,-6458974.75,29050092.78,22591118.03
2012-04-25,1390.69,18.72,1.36,1565.15,-11.15,True,1,21175,-1390.69,-6460365.44,29447860.75,22987495.31
2012-04-26,1399.98,9.29,0.67,1565.15,-10.55,True,1,21176,-1399.98,-6461765.42,29645976.48,23184211.06
2012-04-27,1403.36,3.38,0.24,1565.15,-10.34,True,1,21177,-1403.36,-6463168.78,29718954.72,23255785.94
2012-04-30,1397.91,-5.45,-0.39,1565.15,-10.68,True,1,21178,-1397.91,-6464566.69,29604937.98,23140371.29
2012-05-01,1405.82,7.91,0.57,1565.15,-10.18,True,1,21179,-1405.82,-6465972.51,29773861.78,23307889.27
2012-05-02,1402.31,-3.51,-0.25,1565.15,-10.4,True,1,21180,-1402.31,-6467374.82,29700925.8,23233550.98
2012-05-03,1391.57,-10.74,-0.77,1565.15,-11.09,True,1,21181,-1391.57,-6468766.39,29474844.17,23006077.78
2012-05-04,1369.1,-22.47,-1.62,1565.15,-12.53,True,1,21182,-1369.1,-6470135.49,29000276.2,22530140.71
2012-05-07,1369.58,0.48,0.04,1565.15,-12.5,True,1,21183,-1369.58,-6471505.07,29011813.14,22540308.07
2012-05-08,1363.72,-5.86,-0.43,1565.15,-12.87,True,1,21184,-1363.72,-6472868.79,28889044.48,22416175.69
2012-05-09,1354.58,-9.14,-0.67,1565.15,-13.45,True,1,21185,-1354.58,-6474223.37,28696777.3,22222553.93
2012-05-10,1357.99,3.41,0.25,1565.15,-13.24,True,1,21186,-1357.99,-6475581.36,28770376.14,22294794.78
2012-05-11,1353.39,-4.6,-0.34,1565.15,-13.53,True,1,21187,-1353.39,-6476934.75,28674273.93,22197339.18
2012-05-14,1338.35,-15.04,-1.11,1565.15,-14.49,True,1,21188,-1338.35,-6478273.1,28356959.8,21878686.7
2012-05-15,1330.66,-7.69,-0.57,1565.15,-14.98,True,1,21189,-1330.66,-6479603.76,28195354.74,21715750.98
2012-05-16,1324.8,-5.86,-0.44,1565.15,-15.36,True,1,21190,-1324.8,-6480928.56,28072512.0,21591583.44
2012-05-17,1304.86,-19.94,-1.5,1565.15,-16.63,True,1,21191,-1304.86,-6482233.42,27651288.26,21169054.84
2012-05-18,1295.22,-9.64,-0.74,1565.15,-17.25,True,1,21192,-1295.22,-6483528.64,27448302.24,20964773.6
2012-05-21,1315.99,20.77,1.6,1565.15,-15.92,True,1,21193,-1315.99,-6484844.63,27889776.07,21404931.44
2012-05-22,1316.63,0.64,0.05,1565.15,-15.88,True,1,21194,-1316.63,-6486161.26,27904656.22,21418494.96
2012-05-23,1318.86,2.23,0.17,1565.15,-15.74,True,1,21195,-1318.86,-6487480.12,27953237.7,21465757.58
2012-05-24,1320.68,1.82,0.14,1565.15,-15.62,True,1,21196,-1320.68,-6488800.8,27993133.28,21504332.48
2012-05-25,1317.82,-2.86,-0.22,1565.15,-15.8,True,1,21197,-1317.82,-6490118.62,27933830.54,21443711.92
2012-05-29,1332.42,14.6,1.11,1565.15,-14.87,True,1,21198,-1332.42,-6491451.04,28244639.16,21753188.12
2012-05-30,1313.32,-19.1,-1.43,1565.15,-16.09,True,1,21199,-1313.32,-6492764.36,27841070.68,21348306.32
2012-05-31,1310.33,-2.99,-0.23,1565.15,-16.28,True,1,21200,-1310.33,-6494074.69,27778996.0,21284921.31
2012-06-01,1278.04,-32.29,-2.46,1565.15,-18.34,True,1,21201,-1278.04,-6495352.73,27095726.04,20600373.31
2012-06-04,1278.18,0.14,0.01,1565.15,-18.34,True,1,21202,-1278.18,-6496630.91,27099972.36,20603341.45
2012-06-05,1285.5,7.32,0.57,1565.15,-17.87,True,1,21203,-1285.5,-6497916.41,27256456.5,20758540.09
2012-06-06,1315.13,29.63,2.31,1565.15,-15.97,True,1,21204,-1315.13,-6499231.54,27886016.52,21386784.98
2012-06-07,1314.99,-0.14,-0.01,1565.15,-15.98,True,1,21205,-1314.99,-6500546.53,27884362.95,21383816.42
2012-06-08,1325.66,10.67,0.81,1565.15,-15.3,True,1,21206,-1325.66,-6501872.19,28111945.96,21610073.77
2012-06-11,1308.93,-16.73,-1.26,1565.15,-16.37,True,1,21207,-1308.93,-6503181.12,27758478.51,21255297.39
2012-06-12,1324.18,15.25,1.16,1565.15,-15.4,True,1,21208,-1324.18,-6504505.3,28083209.44,21578704.14
2012-06-13,1314.88,-9.3,-0.7,1565.15,-15.99,True,1,21209,-1314.88,-6505820.18,27887289.92,21381469.74
2012-06-14,1329.1,14.22,1.08,1565.15,-15.08,True,1,21210,-1329.1,-6507149.28,28190211.0,21683061.72
2012-06-15,1342.84,13.74,1.03,1565.15,-14.2,True,1,21211,-1342.84,-6508492.12,28482979.24,21974487.12
2012-06-18,1344.78,1.94,0.14,1565.15,-14.08,True,1,21212,-1344.78,-6509836.9,28525473.36,22015636.46
2012-06-19,1357.98,13.2,0.98,1565.15,-13.24,True,1,21213,-1357.98,-6511194.88,28806829.74,22295634.86
2012-06-20,1355.69,-2.29,-0.17,1565.15,-13.38,True,1,21214,-1355.69,-6512550.57,28759607.66,22247057.09
2012-06-21,1325.51,-30.18,-2.23,1565.15,-15.31,True,1,21215,-1325.51,-6513876.08,28120694.65,21606818.57
2012-06-22,1335.02,9.51,0.72,1565.15,-14.7,True,1,21216,-1335.02,-6515211.1,28323784.32,21808573.22
2012-06-25,1313.72,-21.3,-1.6,1565.15,-16.06,True,1,21217,-1313.72,-6516524.82,27873197.24,21356672.42
2012-06-26,1319.99,6.27,0.48,1565.15,-15.66,True,1,21218,-1319.99,-6517844.81,28007547.82,21489703.01
2012-06-27,1331.85,11.86,0.9,1565.15,-14.91,True,1,21219,-1331.85,-6519176.66,28260525.15,21741348.49
2012-06-28,1329.04,-2.81,-0.21,1565.15,-15.08,True,1,21220,-1329.04,-6520505.7,28202228.8,21681723.1
2012-06-29,1362.16,33.12,2.49,1565.15,-12.97,True,1,21221,-1362.16,-6521867.86,28906397.36,22384529.5
2012-07-02,1365.51,3.35,0.25,1565.15,-12.76,True,1,21222,-1365.51,-6523233.37,28978853.22,22455619.85
2012-07-03,1374.02,8.51,0.62,1565.15,-12.21,True,1,21223,-1374.02,-6524607.39,29160826.46,22636219.07
2012-07-05,1367.58,-6.44,-0.47,1565.15,-12.62,True,1,21224,-1367.58,-6525974.97,29025517.92,22499542.95
2012-07-06,1354.68,-12.9,-0.94,1565.15,-13.45,True,1,21225,-1354.68,-6527329.65,28753083.0,22225753.35
2012-07-09,1352.46,-2.22,-0.16,1565.15,-13.59,True,1,21226,-1352.46,-6528682.11,28707315.96,22178633.85
2012-07-10,1341.47,-10.99,-0.81,1565.15,-14.29,True,1,21227,-1341.47,-6530023.58,28475383.69,21945360.11
2012-07-11,1341.45,-0.02,-0.0,1565.15,-14.29,True,1,21228,-1341.45,-6531365.03,28476300.6,21944935.57
2012-07-12,1334.76,-6.69,-0.5,1565.15,-14.72,True,1,21229,-1334.76,-6532699.79,28335620.04,21802920.25
2012-07-13,1356.78,22.02,1.65,1565.15,-13.31,True,1,21230,-1356.78,-6534056.57,28804439.4,22270382.83
2012-07-16,1353.64,-3.14,-0.23,1565.15,-13.51,True,1,21231,-1353.64,-6535410.21,28739130.84,22203720.63
2012-07-17,1363.67,10.03,0.74,1565.15,-12.87,True,1,21232,-1363.67,-6536773.88,28953441.44,22416667.56
2012-07-18,1372.78,9.11,0.67,1565.15,-12.29,True,1,21233,-1372.78,-6538146.66,29148237.74,22610091.08
2012-07-19,1376.51,3.73,0.27,1565.15,-12.05,True,1,21234,-1376.51,-6539523.17,29228813.34,22689290.17
2012-07-20,1362.66,-13.85,-1.01,1565.15,-12.94,True,1,21235,-1362.66,-6540885.83,28936085.1,22395199.27
2012-07-23,1350.52,-12.14,-0.89,1565.15,-13.71,True,1,21236,-1350.52,-6542236.35,28679642.72,22137406.37
2012-07-24,1338.31,-12.21,-0.9,1565.15,-14.49,True,1,21237,-1338.31,-6543574.66,28421689.47,21878114.81
2012-07-25,1337.89,-0.42,-0.03,1565.15,-14.52,True,1,21238,-1337.89,-6544912.55,28414107.82,21869195.27
2012-07-26,1360.02,22.13,1.65,1565.15,-13.11,True,1,21239,-1360.02,-6546272.57,28885464.78,22339192.21
2012-07-27,1385.97,25.95,1.91,1565.15,-11.45,True,1,21240,-1385.97,-6547658.54,29438002.8,22890344.26
2012-07-30,1385.3,-0.67,-0.05,1565.15,-11.49,True,1,21241,-1385.3,-6549043.84,29425157.3,22876113.46
2012-07-31,1379.32,-5.98,-0.43,1565.15,-11.87,True,1,21242,-1379.32,-6550423.16,29299515.44,22749092.28
2012-08-01,1375.32,-4.0,-0.29,1565.15,-12.13,True,1,21243,-1375.32,-6551798.48,29215922.76,22664124.28
2012-08-02,1365.0,-10.32,-0.75,1565.15,-12.79,True,1,21244,-1365.0,-6553163.48,28998060.0,22444896.52
2012-08-03,1390.99,25.99,1.9,1565.15,-11.13,True,1,21245,-1390.99,-6554554.47,29551582.55,22997028.08
2012-08-06,1394.23,3.24,0.23,1565.15,-10.92,True,1,21246,-1394.23,-6555948.7,29621810.58,23065861.88
2012-08-07,1401.35,7.12,0.51,1565.15,-10.46,True,1,21247,-1401.35,-6557350.05,29774483.45,23217133.4
2012-08-08,1402.22,0.87,0.06,1565.15,-10.41,True,1,21248,-1402.22,-6558752.27,29794370.56,23235618.29
2012-08-09,1402.8,0.58,0.04,1565.15,-10.37,True,1,21249,-1402.8,-6560155.07,29808097.2,23247942.13
2012-08-10,1405.87,3.07,0.22,1565.15,-10.18,True,1,21250,-1405.87,-6561560.94,29874737.5,23313176.56
2012-08-13,1404.11,-1.76,-0.12,1565.15,-10.29,True,1,21251,-1404.11,-6562965.05,29838741.61,23275776.56
2012-08-14,1403.93,-0.18,-0.01,1565.15,-10.3,True,1,21252,-1403.93,-6564368.98,29836320.36,23271951.38
2012-08-15,1405.53,1.6,0.11,1565.15,-10.2,True,1,21253,-1405.53,-6565774.51,29871729.09,23305954.58
2012-08-16,1415.51,9.98,0.71,1565.15,-9.56,True,1,21254,-1415.51,-6567190.02,30085249.54,23518059.52
2012-08-17,1418.16,2.65,0.19,1565.15,-9.39,True,1,21255,-1418.16,-6568608.18,30142990.8,23574382.62
2012-08-20,1418.13,-0.03,-0.0,1565.15,-9.39,True,1,21256,-1418.13,-6570026.31,30143771.28,23573744.97
2012-08-21,1413.17,-4.96,-0.35,1565.15,-9.71,True,1,21257,-1413.17,-6571439.48,30039754.69,23468315.21
2012-08-22,1413.49,0.32,0.02,1565.15,-9.69,True,1,21258,-1413.49,-6572852.97,30047970.42,23475117.45
2012-08-23,1402.08,-11.41,-0.81,1565.15,-10.42,True,1,21259,-1402.08,-6574255.05,29806818.72,23232563.67
2012-08-24,1411.13,9.05,0.64,1565.15,-9.84,True,1,21260,-1411.13,-6575666.18,30000623.8,23424957.62
2012-08-27,1410.44,-0.69,-0.05,1565.15,-9.88,True,1,21261,-1410.44,-6577076.62,29987364.84,23410288.22
2012-08-28,1409.3,-1.14,-0.08,1565.15,-9.96,True,1,21262,-1409.3,-6578485.92,29964536.6,23386050.68
2012-08-29,1410.49,1.19,0.08,1565.15,-9.88,True,1,21263,-1410.49,-6579896.41,29991248.87,23411352.46
2012-08-30,1399.48,-11.01,-0.78,1565.15,-10.58,True,1,21264,-1399.48,-6581295.89,29758542.72,23177246.83
2012-08-31,1406.58,7.1,0.51,1565.15,-10.13,True,1,21265,-1406.58,-6582702.47,29910923.7,23328221.23
2012-09-04,1404.94,-1.64,-0.12,1565.15,-10.24,True,1,21266,-1404.94,-6584107.41,29877454.04,23293346.63
2012-09-05,1403.44,-1.5,-0.11,1565.15,-10.33,True,1,21267,-1403.44,-6585510.85,29846958.48,23261447.63
2012-09-06,1432.12,28.68,2.04,1565.15,-8.5,True,1,21268,-1432.12,-6586942.97,30458328.16,23871385.19
2012-09-07,1437.92,5.8,0.4,1565.15,-8.13,True,1,21269,-1437.92,-6588380.89,30583120.48,23994739.59
2012-09-10,1429.08,-8.84,-0.62,1565.15,-8.69,True,1,21270,-1429.08,-6589809.97,30396531.6,23806721.63
2012-09-11,1433.56,4.48,0.31,1565.15,-8.41,True,1,21271,-1433.56,-6591243.53,30493254.76,23902011.23
2012-09-12,1436.56,3.0,0.21,1565.15,-8.22,True,1,21272,-1436.56,-6592680.09,30558504.32,23965824.23
2012-09-13,1459.99,23.43,1.63,1565.15,-6.72,True,1,21273,-1459.99,-6594140.08,31058367.27,24464227.19
2012-09-14,1465.77,5.78,0.4,1565.15,-6.35,True,1,21274,-1465.77,-6595605.85,31182790.98,24587185.13
2012-09-17,1461.19,-4.58,-0.31,1565.15,-6.64,True,1,21275,-1461.19,-6597067.04,31086817.25,24489750.21
2012-09-18,1459.32,-1.87,-0.13,1565.15,-6.76,True,1,21276,-1459.32,-6598526.36,31048492.32,24449965.96
2012-09-19,1461.05,1.73,0.12,1565.15,-6.65,True,1,21277,-1461.05,-6599987.41,31086760.85,24486773.44
2012-09-20,1460.26,-0.79,-0.05,1565.15,-6.7,True,1,21278,-1460.26,-6601447.67,31071412.28,24469964.61
2012-09-21,1460.15,-0.11,-0.01,1565.15,-6.71,True,1,21279,-1460.15,-6602907.82,31070531.85,24467624.03
2012-09-24,1456.89,-3.26,-0.22,1565.15,-6.92,True,1,21280,-1456.89,-6604364.71,31002619.2,24398254.49
2012-09-25,1441.59,-15.3,-1.05,1565.15,-7.89,True,1,21281,-1441.59,-6605806.3,30678476.79,24072670.49
2012-09-26,1433.32,-8.27,-0.57,1565.15,-8.42,True,1,21282,-1433.32,-6607239.62,30503916.24,23896676.62
2012-09-27,1447.15,13.83,0.96,1565.15,-7.54,True,1,21283,-1447.15,-6608686.77,30799693.45,24191006.68
2012-09-28,1440.67,-6.48,-0.45,1565.15,-7.95,True,1,21284,-1440.67,-6610127.44,30663220.28,24053092.84
2012-10-01,1444.49,3.82,0.26,1565.15,-7.71,True,1,21285,-1444.49,-6611571.93,30745969.65,24134397.72
2012-10-02,1445.75,1.26,0.09,1565.15,-7.63,True,1,21286,-1445.75,-6613017.68,30774234.5,24161216.82
2012-10-03,1450.99,5.24,0.36,1565.15,-7.29,True,1,21287,-1450.99,-6614468.67,30887224.13,24272755.46
2012-10-04,1461.4,10.41,0.72,1565.15,-6.63,True,1,21288,-1461.4,-6615930.07,31110283.2,24494353.13
2012-10-05,1460.93,-0.47,-0.03,1565.15,-6.66,True,1,21289,-1460.93,-6617391.0,31101738.77,24484347.77
2012-10-08,1455.88,-5.05,-0.35,1565.15,-6.98,True,1,21290,-1455.88,-6618846.88,30995685.2,24376838.32
2012-10-09,1441.48,-14.4,-0.99,1565.15,-7.9,True,1,21291,-1441.48,-6620288.36,30690550.68,24070262.32
2012-10-10,1432.56,-8.92,-0.62,1565.15,-8.47,True,1,21292,-1432.56,-6621720.92,30502067.52,23880346.6
2012-10-11,1432.84,0.28,0.02,1565.15,-8.45,True,1,21293,-1432.84,-6623153.76,30509462.12,23886308.36
2012-10-12,1428.59,-4.25,-0.3,1565.15,-8.72,True,1,21294,-1428.59,-6624582.35,30420395.46,23795813.11
2012-10-15,1440.13,11.54,0.81,1565.15,-7.99,True,1,21295,-1440.13,-6626022.48,30667568.35,24041545.87
2012-10-16,1454.92,14.79,1.03,1565.15,-7.04,True,1,21296,-1454.92,-6627477.4,30983976.32,24356498.92
2012-10-17,1460.91,5.99,0.41,1565.15,-6.66,True,1,21297,-1460.91,-6628938.31,31113000.27,24484061.96
2012-10-18,1457.34,-3.57,-0.24,1565.15,-6.89,True,1,21298,-1457.34,-6630395.65,31038427.32,24408031.67
2012-10-19,1433.19,-24.15,-1.66,1565.15,-8.43,True,1,21299,-1433.19,-6631828.84,30525513.81,23893684.97
2012-10-22,1433.82,0.63,0.04,1565.15,-8.39,True,1,21300,-1433.82,-6633262.66,30540366.0,23907103.34
2012-10-23,1413.11,-20.71,-1.44,1565.15,-9.71,True,1,21301,-1413.11,-6634675.77,30100656.11,23465980.34
2012-10-24,1408.75,-4.36,-0.31,1565.15,-9.99,True,1,21302,-1408.75,-6636084.52,30009192.5,23373107.98
2012-10-25,1412.97,4.22,0.3,1565.15,-9.72,True,1,21303,-1412.97,-6637497.49,30100499.91,23463002.42
2012-10-26,1411.94,-1.03,-0.07,1565.15,-9.79,True,1,21304,-1411.94,-6638909.43,30079969.76,23441060.33
2012-10-31,1412.16,0.22,0.02,1565.15,-9.78,True,1,21305,-1412.16,-6640321.59,30086068.8,23445747.21
2012-11-01,1427.59,15.43,1.09,1565.15,-8.79,True,1,21306,-1427.59,-6641749.18,30416232.54,23774483.36
2012-11-02,1414.2,-13.39,-0.94,1565.15,-9.64,True,1,21307,-1414.2,-6643163.38,30132359.4,23489196.02
2012-11-05,1417.26,3.06,0.22,1565.15,-9.45,True,1,21308,-1417.26,-6644580.64,30198976.08,23554395.44
2012-11-06,1428.39,11.13,0.78,1565.15,-8.74,True,1,21309,-1428.39,-6646009.03,30437562.51,23791553.48
2012-11-07,1394.53,-33.86,-2.37,1565.15,-10.9,True,1,21310,-1394.53,-6647403.56,29717434.3,23070030.74
2012-11-08,1377.51,-17.02,-1.22,1565.15,-11.99,True,1,21311,-1377.51,-6648781.07,29356115.61,22707334.54
2012-11-09,1379.85,2.34,0.17,1565.15,-11.84,True,1,21312,-1379.85,-6650160.92,29407363.2,22757202.28
2012-11-12,1380.03,0.18,0.01,1565.15,-11.83,True,1,21313,-1380.03,-6651540.95,29412579.39,22761038.44
2012-11-13,1374.53,-5.5,-0.4,1565.15,-12.18,True,1,21314,-1374.53,-6652915.48,29296732.42,22643816.94
2012-11-14,1355.49,-19.04,-1.38,1565.15,-13.4,True,1,21315,-1355.49,-6654270.97,28892269.35,22237998.38
2012-11-15,1353.33,-2.16,-0.16,1565.15,-13.53,True,1,21316,-1353.33,-6655624.3,28847582.28,22191957.98
2012-11-16,1359.88,6.55,0.48,1565.15,-13.12,True,1,21317,-1359.88,-6656984.18,28988561.96,22331577.78
2012-11-19,1386.89,27.01,1.99,1565.15,-11.39,True,1,21318,-1386.89,-6658371.07,29565721.02,22907349.95
2012-11-20,1387.81,0.92,0.07,1565.15,-11.33,True,1,21319,-1387.81,-6659758.88,29586721.39,22926962.51
2012-11-21,1391.03,3.22,0.23,1565.15,-11.12,True,1,21320,-1391.03,-6661149.91,29656759.6,22995609.69
2012-11-23,1409.15,18.12,1.3,1565.15,-9.97,True,1,21321,-1409.15,-6662559.06,30044487.15,23381928.09
2012-11-26,1406.29,-2.86,-0.2,1565.15,-10.15,True,1,21322,-1406.29,-6663965.35,29984915.38,23320950.03
2012-11-27,1398.94,-7.35,-0.52,1565.15,-10.62,True,1,21323,-1398.94,-6665364.29,29829597.62,23164233.33
2012-11-28,1409.93,10.99,0.79,1565.15,-9.92,True,1,21324,-1409.93,-6666774.22,30065347.32,23398573.1
2012-11-29,1415.95,6.02,0.43,1565.15,-9.53,True,1,21325,-1415.95,-6668190.17,30195133.75,23526943.58
2012-11-30,1416.18,0.23,0.02,1565.15,-9.52,True,1,21326,-1416.18,-6669606.35,30201454.68,23531848.33
2012-12-03,1409.46,-6.72,-0.48,1565.15,-9.95,True,1,21327,-1409.46,-6671015.81,30059553.42,23388537.61
2012-12-04,1407.05,-2.41,-0.17,1565.15,-10.1,True,1,21328,-1407.05,-6672422.86,30009562.4,23337139.54
2012-12-05,1409.28,2.23,0.16,1565.15,-9.96,True,1,21329,-1409.28,-6673832.14,30058533.12,23384700.98
2012-12-06,1413.94,4.66,0.33,1565.15,-9.66,True,1,21330,-1413.94,-6675246.08,30159340.2,23484094.12
2012-12-07,1418.07,4.13,0.29,1565.15,-9.4,True,1,21331,-1418.07,-6676664.15,30248851.17,23572187.02
2012-12-10,1418.55,0.48,0.03,1565.15,-9.37,True,1,21332,-1418.55,-6678082.7,30260508.6,23582425.9
2012-12-11,1427.84,9.29,0.66,1565.15,-8.77,True,1,21333,-1427.84,-6679510.54,30460110.72,23780600.18
2012-12-12,1428.48,0.64,0.04,1565.15,-8.73,True,1,21334,-1428.48,-6680939.02,30475192.32,23794253.3
2012-12-13,1419.45,-9.03,-0.63,1565.15,-9.31,True,1,21335,-1419.45,-6682358.47,30283965.75,23601607.28
2012-12-14,1413.58,-5.87,-0.41,1565.15,-9.68,True,1,21336,-1413.58,-6683772.05,30160142.88,23476370.83
2012-12-17,1430.36,16.78,1.19,1565.15,-8.61,True,1,21337,-1430.36,-6685202.41,30519591.32,23834388.91
2012-12-18,1446.79,16.43,1.15,1565.15,-7.56,True,1,21338,-1446.79,-6686649.2,30871605.02,24184955.82
2012-12-19,1435.81,-10.98,-0.76,1565.15,-8.26,True,1,21339,-1435.81,-6688085.01,30638749.59,23950664.58
2012-12-20,1443.69,7.88,0.55,1565.15,-7.76,True,1,21340,-1443.69,-6689528.7,30808344.6,24118815.9
2012-12-21,1430.15,-13.54,-0.94,1565.15,-8.62,True,1,21341,-1430.15,-6690958.85,30520831.15,23829872.3
2012-12-24,1426.66,-3.49,-0.24,1565.15,-8.85,True,1,21342,-1426.66,-6692385.51,30447777.72,23755392.21
2012-12-26,1419.83,-6.83,-0.48,1565.15,-9.28,True,1,21343,-1419.83,-6693805.34,30303431.69,23609626.35
2012-12-27,1418.1,-1.73,-0.12,1565.15,-9.4,True,1,21344,-1418.1,-6695223.44,30267926.4,23572702.96
2012-12-28,1402.43,-15.67,-1.1,1565.15,-10.4,True,1,21345,-1402.43,-6696625.87,29934868.35,23238242.48
2012-12-31,1426.19,23.76,1.69,1565.15,-8.88,True,1,21346,-1426.19,-6698052.06,30443451.74,23745399.68
2013-01-02,1462.42,36.23,2.54,1565.15,-6.56,True,1,21347,-1462.42,-6699514.48,31218279.74,24518765.26
2013-01-03,1459.37,-3.05,-0.21,1565.15,-6.76,True,1,21348,-1459.37,-6700973.85,31154630.76,24453656.91
2013-01-04,1466.47,7.1,0.49,1565.15,-6.3,True,1,21349,-1466.47,-6702440.32,31307668.03,24605227.71
2013-01-07,1461.89,-4.58,-0.31,1565.15,-6.6,True,1,21350,-1461.89,-6703902.21,31211351.5,24507449.29
2013-01-08,1457.15,-4.74,-0.32,1565.15,-6.9,True,1,21351,-1457.15,-6705359.36,31111609.65,24406250.29
2013-01-09,1461.02,3.87,0.27,1565.15,-6.65,True,1,21352,-1461.02,-6706820.38,31195699.04,24488878.66
2013-01-10,1472.12,11.1,0.76,1565.15,-5.94,True,1,21353,-1472.12,-6708292.5,31434178.36,24725885.86
2013-01-11,1472.05,-0.07,-0.0,1565.15,-5.95,True,1,21354,-1472.05,-6709764.55,31434155.7,24724391.15
2013-01-14,1470.68,-1.37,-0.09,1565.15,-6.04,True,1,21355,-1470.68,-6711235.23,31406371.4,24695136.17
2013-01-15,1472.34,1.66,0.11,1565.15,-5.93,True,1,21356,-1472.34,-6712707.57,31443293.04,24730585.47
2013-01-16,1472.63,0.29,0.02,1565.15,-5.91,True,1,21357,-1472.63,-6714180.2,31450958.91,24736778.71
2013-01-17,1480.94,8.31,0.56,1565.15,-5.38,True,1,21358,-1480.94,-6715661.14,31629916.52,24914255.38
2013-01-18,1485.98,5.04,0.34,1565.15,-5.06,True,1,21359,-1485.98,-6717147.12,31739046.82,25021899.7
2013-01-22,1492.56,6.58,0.44,1565.15,-4.64,True,1,21360,-1492.56,-6718639.68,31881081.6,25162441.92
2013-01-23,1494.81,2.25,0.15,1565.15,-4.49,True,1,21361,-1494.81,-6720134.49,31930636.41,25210501.92
2013-01-24,1494.82,0.01,0.0,1565.15,-4.49,True,1,21362,-1494.82,-6721629.31,31932344.84,25210715.53
2013-01-25,1502.96,8.14,0.55,1565.15,-3.97,True,1,21363,-1502.96,-6723132.27,32107734.48,25384602.21
2013-01-28,1500.18,-2.78,-0.18,1565.15,-4.15,True,1,21364,-1500.18,-6724632.45,32049845.52,25325213.07
2013-01-29,1507.84,7.66,0.51,1565.15,-3.66,True,1,21365,-1507.84,-6726140.29,32215001.6,25488861.31
2013-01-30,1501.96,-5.88,-0.39,1565.15,-4.04,True,1,21366,-1501.96,-6727642.25,32090877.36,25363235.11
2013-01-31,1498.11,-3.85,-0.26,1565.15,-4.28,True,1,21367,-1498.11,-6729140.36,32010116.37,25280976.01
2013-02-01,1513.17,15.06,1.0,1565.15,-3.32,True,1,21368,-1513.17,-6730653.53,32333416.56,25602763.03
2013-02-04,1495.71,-17.46,-1.15,1565.15,-4.44,True,1,21369,-1495.71,-6732149.24,31961826.99,25229677.75
2013-02-05,1511.29,15.58,1.04,1565.15,-3.44,True,1,21370,-1511.29,-6733660.53,32296267.3,25562606.77
2013-02-06,1512.12,0.83,0.06,1565.15,-3.39,True,1,21371,-1512.12,-6735172.65,32315516.52,25580343.87
2013-02-07,1509.39,-2.73,-0.18,1565.15,-3.56,True,1,21372,-1509.39,-6736682.04,32258683.08,25522001.04
2013-02-08,1517.93,8.54,0.57,1565.15,-3.02,True,1,21373,-1517.93,-6738199.97,32442717.89,25704517.92
2013-02-11,1517.01,-0.92,-0.06,1565.15,-3.08,True,1,21374,-1517.01,-6739716.98,32424571.74,25684854.76
2013-02-12,1519.43,2.42,0.16,1565.15,-2.92,True,1,21375,-1519.43,-6741236.41,32477816.25,25736579.84
2013-02-13,1520.33,0.9,0.06,1565.15,-2.86,True,1,21376,-1520.33,-6742756.74,32498574.08,25755817.34
2013-02-14,1521.38,1.05,0.07,1565.15,-2.8,True,1,21377,-1521.38,-6744278.12,32522540.26,25778262.14
2013-02-15,1519.79,-1.59,-0.1,1565.15,-2.9,True,1,21378,-1519.79,-6745797.91,32490070.62,25744272.71
2013-02-19,1530.94,11.15,0.73,1565.15,-2.19,True,1,21379,-1530.94,-6747328.85,32729966.26,25982637.41
2013-02-20,1511.95,-18.99,-1.24,1565.15,-3.4,True,1,21380,-1511.95,-6748840.8,32325491.0,25576650.2
2013-02-21,1502.42,-9.53,-0.63,1565.15,-4.01,True,1,21381,-1502.42,-6750343.22,32123242.02,25372898.8
2013-02-22,1515.6,13.18,0.88,1565.15,-3.17,True,1,21382,-1515.6,-6751858.82,32406559.2,25654700.38
2013-02-25,1487.85,-27.75,-1.83,1565.15,-4.94,True,1,21383,-1487.85,-6753346.67,31814696.55,25061349.88
2013-02-26,1496.94,9.09,0.61,1565.15,-4.36,True,1,21384,-1496.94,-6754843.61,32010564.96,25255721.35
2013-02-27,1515.99,19.05,1.27,1565.15,-3.14,True,1,21385,-1515.99,-6756359.6,32419446.15,25663086.55
2013-02-28,1514.68,-1.31,-0.09,1565.15,-3.22,True,1,21386,-1514.68,-6757874.28,32392946.48,25635072.2
2013-03-01,1518.2,3.52,0.23,1565.15,-3.0,True,1,21387,-1518.2,-6759392.48,32469743.4,25710350.92
2013-03-04,1525.2,7.0,0.46,1565.15,-2.55,True,1,21388,-1525.2,-6760917.68,32620977.6,25860059.92
2013-03-05,1539.79,14.59,0.96,1565.15,-1.62,True,1,21389,-1539.79,-6762457.47,32934568.31,26172110.84
2013-03-06,1541.46,1.67,0.11,1565.15,-1.51,True,1,21390,-1541.46,-6763998.93,32971829.4,26207830.47
2013-03-07,1544.26,2.8,0.18,1565.15,-1.34,True,1,21391,-1544.26,-6765543.19,33033265.66,26267722.47
2013-03-08,1551.18,6.92,0.45,1565.15,-0.89,True,1,21392,-1551.18,-6767094.37,33182842.56,26415748.19
2013-03-11,1556.22,5.04,0.32,1565.15,-0.57,True,1,21393,-1556.22,-6768650.59,33292214.46,26523563.87
2013-03-12,1552.48,-3.74,-0.24,1565.15,-0.81,True,1,21394,-1552.48,-6770203.07,33213757.12,26443554.05
2013-03-13,1554.52,2.04,0.13,1565.15,-0.68,True,1,21395,-1554.52,-6771757.59,33258955.4,26487197.81
2013-03-14,1563.23,8.71,0.56,1565.15,-0.12,True,1,21396,-1563.23,-6773320.82,33446869.08,26673548.26
2013-03-15,1560.7,-2.53,-0.16,1565.15,-0.28,True,1,21397,-1560.7,-6774881.52,33394297.9,26619416.38
2013-03-18,1552.1,-8.6,-0.55,1565.15,-0.83,True,1,21398,-1552.1,-6776433.62,33211835.8,26435402.18
2013-03-19,1548.34,-3.76,-0.24,1565.15,-1.07,True,1,21399,-1548.34,-6777981.96,33132927.66,26354945.7
2013-03-20,1558.71,10.37,0.67,1565.15,-0.41,True,1,21400,-1558.71,-6779540.67,33356394.0,26576853.33
2013-03-21,1545.8,-12.91,-0.83,1565.15,-1.24,True,1,21401,-1545.8,-6781086.47,33081665.8,26300579.33
2013-03-22,1556.89,11.09,0.72,1565.15,-0.53,True,1,21402,-1556.89,-6782643.36,33320559.78,26537916.42
2013-03-25,1551.69,-5.2,-0.33,1565.15,-0.86,True,1,21403,-1551.69,-6784195.05,33210821.07,26426626.02
2013-03-26,1563.77,12.08,0.78,1565.15,-0.09,True,1,21404,-1563.77,-6785758.82,33470933.08,26685174.26
2013-03-27,1562.85,-0.92,-0.06,1565.15,-0.15,True,1,21405,-1562.85,-6787321.67,33452804.25,26665482.58
2013-03-28,1569.19,6.34,0.41,1569.19,0.0,True,1,21406,-1569.19,-6788890.86,33590081.14,26801190.28
2013-04-01,1562.17,-7.02,-0.45,1569.19,-0.45,True,1,21407,-1562.17,-6790453.03,33441373.19,26650920.16
2013-04-02,1570.25,8.08,0.52,1570.25,0.0,True,1,21408,-1570.25,-6792023.28,33615912.0,26823888.72
2013-04-03,1553.69,-16.56,-1.06,1570.25,-1.06,True,1,21409,-1553.69,-6793576.97,33262949.21,26469372.24
2013-04-04,1559.98,6.29,0.4,1570.25,-0.65,True,1,21410,-1559.98,-6795136.95,33399171.8,26604034.85
2013-04-05,1553.28,-6.7,-0.43,1570.25,-1.08,True,1,21411,-1553.28,-6796690.23,33257278.08,26460587.85
2013-04-08,1563.07,9.79,0.63,1570.25,-0.46,True,1,21412,-1563.07,-6798253.3,33468454.84,26670201.54
2013-04-09,1568.61,5.54,0.35,1570.25,-0.1,True,1,21413,-1568.61,-6799821.91,33588645.93,26788824.02
2013-04-10,1587.73,19.12,1.22,1587.73,0.0,True,1,21414,-1587.73,-6801409.64,33999650.22,27198240.58
2013-04-11,1593.37,5.64,0.36,1593.37,0.0,True,1,21415,-1593.37,-6803003.01,34122018.55,27319015.54
2013-04-12,1588.85,-4.52,-0.28,1593.37,-0.28,True,1,21416,-1588.85,-6804591.86,34026811.6,27222219.74
2013-04-15,1552.36,-36.49,-2.3,1593.37,-2.57,True,1,21417,-1552.36,-6806144.22,33246894.12,26440749.9
2013-04-16,1574.57,22.21,1.43,1593.37,-1.18,True,1,21418,-1574.57,-6807718.79,33724140.26,26916421.47
2013-04-17,1552.01,-22.56,-1.43,1593.37,-2.6,True,1,21419,-1552.01,-6809270.8,33242502.19,26433231.39
2013-04-18,1541.61,-10.4,-0.67,1593.37,-3.25,True,1,21420,-1541.61,-6810812.41,33021286.2,26210473.79
2013-04-19,1555.25,13.64,0.88,1593.37,-2.39,True,1,21421,-1555.25,-6812367.66,33315010.25,26502642.59
2013-04-22,1562.5,7.25,0.47,1593.37,-1.94,True,1,21422,-1562.5,-6813930.16,33471875.0,26657944.84
2013-04-23,1578.78,16.28,1.04,1593.37,-0.92,True,1,21423,-1578.78,-6815508.94,33822203.94,27006695.0
2013-04-24,1578.79,0.01,0.0,1593.37,-0.92,True,1,21424,-1578.79,-6817087.73,33823996.96,27006909.23
2013-04-25,1585.16,6.37,0.4,1593.37,-0.52,True,1,21425,-1585.16,-6818672.89,33962053.0,27143380.11
2013-04-26,1582.24,-2.92,-0.18,1593.37,-0.7,True,1,21426,-1582.24,-6820255.13,33901074.24,27080819.11
2013-04-29,1593.61,11.37,0.72,1593.61,0.0,True,1,21427,-1593.61,-6821848.74,34146281.47,27324432.73
2013-04-30,1597.57,3.96,0.25,1597.57,0.0,True,1,21428,-1597.57,-6823446.31,34232729.96,27409283.65
2013-05-01,1582.7,-14.87,-0.93,1597.57,-0.93,True,1,21429,-1582.7,-6825029.01,33915678.3,27090649.29
2013-05-02,1597.59,14.89,0.94,1597.59,0.0,True,1,21430,-1597.59,-6826626.6,34236353.7,27409727.1
2013-05-03,1614.42,16.83,1.05,1614.42,0.0,True,1,21431,-1614.42,-6828241.02,34598635.02,27770394.0
2013-05-06,1617.5,3.08,0.19,1617.5,0.0,True,1,21432,-1617.5,-6829858.52,34666260.0,27836401.48
2013-05-07,1625.96,8.46,0.52,1625.96,0.0,True,1,21433,-1625.96,-6831484.48,34849200.68,28017716.2
2013-05-08,1632.69,6.73,0.41,1632.69,0.0,True,1,21434,-1632.69,-6833117.17,34995077.46,28161960.29
2013-05-09,1626.67,-6.02,-0.37,1632.69,-0.37,True,1,21435,-1626.67,-6834743.84,34867671.45,28032927.61
2013-05-10,1633.7,7.03,0.43,1633.7,0.0,True,1,21436,-1633.7,-6836377.54,35019993.2,28183615.66
2013-05-13,1633.77,0.07,0.0,1633.77,0.0,True,1,21437,-1633.77,-6838011.31,35023127.49,28185116.18
2013-05-14,1650.34,16.57,1.01,1650.34,0.0,True,1,21438,-1650.34,-6839661.65,35379988.92,28540327.27
2013-05-15,1658.78,8.44,0.51,1658.78,0.0,True,1,21439,-1658.78,-6841320.43,35562584.42,28721263.99
2013-05-16,1650.47,-8.31,-0.5,1658.78,-0.5,True,1,21440,-1650.47,-6842970.9,35386076.8,28543105.9
2013-05-17,1667.47,17.0,1.03,1667.47,0.0,True,1,21441,-1667.47,-6844638.37,35752224.27,28907585.9
2013-05-20,1666.29,-1.18,-0.07,1667.47,-0.07,True,1,21442,-1666.29,-6846304.66,35728590.18,28882285.52
2013-05-21,1669.16,2.87,0.17,1669.16,0.0,True,1,21443,-1669.16,-6847973.82,35791797.88,28943824.06
2013-05-22,1655.35,-13.81,-0.83,1669.16,-0.83,True,1,21444,-1655.35,-6849629.17,35497325.4,28647696.23
2013-05-23,1650.51,-4.84,-0.29,1669.16,-1.12,True,1,21445,-1650.51,-6851279.68,35395186.95,28543907.27
2013-05-24,1649.6,-0.91,-0.06,1669.16,-1.17,True,1,21446,-1649.6,-6852929.28,35377321.6,28524392.32
2013-05-28,1660.06,10.46,0.63,1669.16,-0.55,True,1,21447,-1660.06,-6854589.34,35603306.82,28748717.48
2013-05-29,1648.36,-11.7,-0.7,1669.16,-1.25,True,1,21448,-1648.36,-6856237.7,35354025.28,28497787.58
2013-05-30,1654.41,6.05,0.37,1669.16,-0.88,True,1,21449,-1654.41,-6857892.11,35485440.09,28627547.98
2013-05-31,1630.74,-23.67,-1.43,1669.16,-2.3,True,1,21450,-1630.74,-6859522.85,34979373.0,28119850.15
2013-06-03,1640.42,9.68,0.59,1669.16,-1.72,True,1,21451,-1640.42,-6861163.27,35188649.42,28327486.15
2013-06-04,1631.38,-9.04,-0.55,1669.16,-2.26,True,1,21452,-1631.38,-6862794.65,34996363.76,28133569.11
2013-06-05,1608.9,-22.48,-1.38,1669.16,-3.61,True,1,21453,-1608.9,-6864403.55,34515731.7,27651328.15
2013-06-06,1622.56,13.66,0.85,1669.16,-2.79,True,1,21454,-1622.56,-6866026.11,34810402.24,27944376.13
2013-06-07,1643.38,20.82,1.28,1669.16,-1.54,True,1,21455,-1643.38,-6867669.49,35258717.9,28391048.41
2013-06-10,1642.81,-0.57,-0.04,1669.16,-1.58,True,1,21456,-1642.81,-6869312.3,35248131.36,28378819.06
2013-06-11,1626.13,-16.68,-1.01,1669.16,-2.58,True,1,21457,-1626.13,-6870938.43,34891871.41,28020932.98
2013-06-12,1612.52,-13.61,-0.84,1669.16,-3.39,True,1,21458,-1612.52,-6872550.95,34601454.16,27728903.21
2013-06-13,1636.36,23.84,1.48,1669.16,-1.96,True,1,21459,-1636.36,-6874187.31,35114649.24,28240461.93
2013-06-14,1626.73,-9.63,-0.59,1669.16,-2.54,True,1,21460,-1626.73,-6875814.04,34909625.8,28033811.76
2013-06-17,1639.04,12.31,0.76,1669.16,-1.8,True,1,21461,-1639.04,-6877453.08,35175437.44,28297984.36
2013-06-18,1651.81,12.77,0.78,1669.16,-1.04,True,1,21462,-1651.81,-6879104.89,35451146.22,28572041.33
2013-06-19,1628.93,-22.88,-1.38,1669.16,-2.41,True,1,21463,-1628.93,-6880733.82,34961724.59,28080990.77
2013-06-20,1588.19,-40.74,-2.5,1669.16,-4.85,True,1,21464,-1588.19,-6882322.01,34088910.16,27206588.15
2013-06-21,1592.43,4.24,0.27,1669.16,-4.6,True,1,21465,-1592.43,-6883914.44,34181509.95,27297595.51
2013-06-24,1573.09,-19.34,-1.22,1669.16,-5.76,True,1,21466,-1573.09,-6885487.53,33767949.94,26882462.41
2013-06-25,1588.03,14.94,0.95,1669.16,-4.86,True,1,21467,-1588.03,-6887075.56,34090240.01,27203164.45
2013-06-26,1603.26,15.23,0.96,1669.16,-3.95,True,1,21468,-1603.26,-6888678.82,34418785.68,27530106.86
2013-06-27,1613.2,9.94,0.62,1669.16,-3.35,True,1,21469,-1613.2,-6890292.02,34633790.8,27743498.78
2013-06-28,1606.28,-6.92,-0.43,1669.16,-3.77,True,1,21470,-1606.28,-6891898.3,34486831.6,27594933.3
2013-07-01,1614.96,8.68,0.54,1669.16,-3.25,True,1,21471,-1614.96,-6893513.26,34674806.16,27781292.9
2013-07-02,1614.08,-0.88,-0.05,1669.16,-3.3,True,1,21472,-1614.08,-6895127.34,34657525.76,27762398.42
2013-07-03,1615.41,1.33,0.08,1669.16,-3.22,True,1,21473,-1615.41,-6896742.75,34687698.93,27790956.18
2013-07-05,1631.89,16.48,1.02,1669.16,-2.23,True,1,21474,-1631.89,-6898374.64,35043205.86,28144831.22
2013-07-08,1640.46,8.57,0.52,1669.16,-1.72,True,1,21475,-1640.46,-6900015.1,35228878.5,28328863.4
2013-07-09,1652.32,11.86,0.72,1669.16,-1.01,True,1,21476,-1652.32,-6901667.42,35485224.32,28583556.9
2013-07-10,1652.62,0.3,0.02,1669.16,-0.99,True,1,21477,-1652.62,-6903320.04,35493319.74,28589999.7
2013-07-11,1675.02,22.4,1.36,1675.02,0.0,True,1,21478,-1675.02,-6904995.06,35976079.56,29071084.5
2013-07-12,1680.19,5.17,0.31,1680.19,0.0,True,1,21479,-1680.19,-6906675.25,36088801.01,29182125.76
2013-07-15,1682.5,2.31,0.14,1682.5,0.0,True,1,21480,-1682.5,-6908357.75,36140100.0,29231742.25
2013-07-16,1676.26,-6.24,-0.37,1682.5,-0.37,True,1,21481,-1676.26,-6910034.01,36007741.06,29097707.05
2013-07-17,1680.91,4.65,0.28,1682.5,-0.1,True,1,21482,-1680.91,-6911714.92,36109308.62,29197593.7
2013-07-18,1689.37,8.46,0.5,1689.37,0.0,True,1,21483,-1689.37,-6913404.29,36292735.71,29379331.42
2013-07-19,1692.09,2.72,0.16,1692.09,0.0,True,1,21484,-1692.09,-6915096.38,36352861.56,29437765.18
2013-07-22,1695.53,3.44,0.2,1695.53,0.0,True,1,21485,-1695.53,-6916791.91,36428462.05,29511670.14
2013-07-23,1692.39,-3.14,-0.18,1695.53,-0.18,True,1,21486,-1692.39,-6918484.3,36362691.54,29444207.24
2013-07-24,1685.94,-6.45,-0.38,1695.53,-0.57,True,1,21487,-1685.94,-6920170.24,36225792.78,29305622.54
2013-07-25,1690.25,4.31,0.26,1695.53,-0.31,True,1,21488,-1690.25,-6921860.49,36320092.0,29398231.51
2013-07-26,1691.65,1.4,0.08,1695.53,-0.23,True,1,21489,-1691.65,-6923552.14,36351866.85,29428314.71
2013-07-29,1685.33,-6.32,-0.37,1695.53,-0.6,True,1,21490,-1685.33,-6925237.47,36217741.7,29292504.23
2013-07-30,1685.96,0.63,0.04,1695.53,-0.56,True,1,21491,-1685.96,-6926923.43,36232966.36,29306042.93
2013-07-31,1685.73,-0.23,-0.01,1695.53,-0.58,True,1,21492,-1685.73,-6928609.16,36229709.16,29301100.0
2013-08-01,1706.87,21.14,1.25,1706.87,0.0,True,1,21493,-1706.87,-6930316.03,36685756.91,29755440.88
2013-08-02,1709.67,2.8,0.16,1709.67,0.0,True,1,21494,-1709.67,-6932025.7,36747646.98,29815621.28
2013-08-05,1707.14,-2.53,-0.15,1709.67,-0.15,True,1,21495,-1707.14,-6933732.84,36694974.3,29761241.46
2013-08-06,1697.37,-9.77,-0.57,1709.67,-0.72,True,1,21496,-1697.37,-6935430.21,36486665.52,29551235.31
2013-08-07,1690.91,-6.46,-0.38,1709.67,-1.1,True,1,21497,-1690.91,-6937121.12,36349492.27,29412371.15
2013-08-08,1697.48,6.57,0.39,1709.67,-0.71,True,1,21498,-1697.48,-6938818.6,36492425.04,29553606.44
2013-08-09,1691.42,-6.06,-0.36,1709.67,-1.07,True,1,21499,-1691.42,-6940510.02,36363838.58,29423328.56
2013-08-12,1689.47,-1.95,-0.12,1709.67,-1.18,True,1,21500,-1689.47,-6942199.49,36323605.0,29381405.51
2013-08-13,1694.16,4.69,0.28,1709.67,-0.91,True,1,21501,-1694.16,-6943893.65,36426134.16,29482240.51
2013-08-14,1685.39,-8.77,-0.52,1709.67,-1.42,True,1,21502,-1685.39,-6945579.04,36239255.78,29293676.74
2013-08-15,1661.32,-24.07,-1.43,1709.67,-2.83,True,1,21503,-1661.32,-6947240.36,35723363.96,28776123.6
2013-08-16,1655.83,-5.49,-0.33,1709.67,-3.15,True,1,21504,-1655.83,-6948896.19,35606968.32,28658072.13
2013-08-19,1646.06,-9.77,-0.59,1709.67,-3.72,True,1,21505,-1646.06,-6950542.25,35398520.3,28447978.05
2013-08-20,1652.35,6.29,0.38,1709.67,-3.35,True,1,21506,-1652.35,-6952194.6,35535439.1,28583244.5
2013-08-21,1642.8,-9.55,-0.58,1709.67,-3.91,True,1,21507,-1642.8,-6953837.4,35331699.6,28377862.2
2013-08-22,1656.96,14.16,0.86,1709.67,-3.08,True,1,21508,-1656.96,-6955494.36,35637895.68,28682401.32
2013-08-23,1663.5,6.54,0.4,1709.67,-2.7,True,1,21509,-1663.5,-6957157.86,35780221.5,28823063.64
2013-08-26,1656.78,-6.72,-0.4,1709.67,-3.09,True,1,21510,-1656.78,-6958814.64,35637337.8,28678523.16
2013-08-27,1630.48,-26.3,-1.59,1709.67,-4.63,True,1,21511,-1630.48,-6960445.12,35073255.28,28112810.16
2013-08-28,1634.96,4.48,0.28,1709.67,-4.37,True,1,21512,-1634.96,-6962080.08,35171259.52,28209179.44
2013-08-29,1638.17,3.21,0.2,1709.67,-4.18,True,1,21513,-1638.17,-6963718.25,35241951.21,28278232.96
2013-08-30,1632.97,-5.2,-0.32,1709.67,-4.49,True,1,21514,-1632.97,-6965351.22,35131716.58,28166365.36
2013-09-03,1639.77,6.8,0.42,1709.67,-4.09,True,1,21515,-1639.77,-6966990.99,35279651.55,28312660.56
2013-09-04,1653.08,13.31,0.81,1709.67,-3.31,True,1,21516,-1653.08,-6968644.07,35567669.28,28599025.21
2013-09-05,1655.08,2.0,0.12,1709.67,-3.19,True,1,21517,-1655.08,-6970299.15,35612356.36,28642057.21
2013-09-06,1655.17,0.09,0.0,1709.67,-3.19,True,1,21518,-1655.17,-6971954.32,35615948.06,28643993.74
2013-09-09,1671.71,16.54,1.0,1709.67,-2.22,True,1,21519,-1671.71,-6973626.03,35973527.49,28999901.46
2013-09-10,1683.99,12.28,0.74,1709.67,-1.5,True,1,21520,-1683.99,-6975310.02,36239464.8,29264154.78
2013-09-11,1689.13,5.14,0.3,1709.67,-1.2,True,1,21521,-1689.13,-6976999.15,36351766.73,29374767.58
2013-09-12,1683.42,-5.71,-0.34,1709.67,-1.54,True,1,21522,-1683.42,-6978682.57,36230565.24,29251882.67
2013-09-13,1687.99,4.57,0.27,1709.67,-1.27,True,1,21523,-1687.99,-6980370.56,36330608.77,29350238.21
2013-09-16,1697.6,9.61,0.57,1709.67,-0.71,True,1,21524,-1697.6,-6982068.16,36539142.4,29557074.24
2013-09-17,1704.76,7.16,0.42,1709.67,-0.29,True,1,21525,-1704.76,-6983772.92,36694959.0,29711186.08
2013-09-18,1725.52,20.76,1.22,1725.52,0.0,True,1,21526,-1725.52,-6985498.44,37143543.52,30158045.08
2013-09-19,1722.34,-3.18,-0.18,1725.52,-0.18,True,1,21527,-1722.34,-6987220.78,37076813.18,30089592.4
2013-09-20,1709.91,-12.43,-0.72,1725.52,-0.9,True,1,21528,-1709.91,-6988930.69,36810942.48,29822011.79
2013-09-23,1701.84,-8.07,-0.47,1725.52,-1.37,True,1,21529,-1701.84,-6990632.53,36638913.36,29648280.83
2013-09-24,1697.42,-4.42,-0.26,1725.52,-1.63,True,1,21530,-1697.42,-6992329.95,36545452.6,29553122.65
2013-09-25,1692.77,-4.65,-0.27,1725.52,-1.9,True,1,21531,-1692.77,-6994022.72,36447030.87,29453008.15
2013-09-26,1698.67,5.9,0.35,1725.52,-1.56,True,1,21532,-1698.67,-6995721.39,36575762.44,29580041.05
2013-09-27,1691.75,-6.92,-0.41,1725.52,-1.96,True,1,21533,-1691.75,-6997413.14,36428452.75,29431039.61
2013-09-30,1681.55,-10.2,-0.6,1725.52,-2.55,True,1,21534,-1681.55,-6999094.69,36210497.7,29211403.01
2013-10-01,1695.0,13.45,0.8,1725.52,-1.77,True,1,21535,-1695.0,-7000789.69,36501825.0,29501035.31
2013-10-02,1693.87,-1.13,-0.07,1725.52,-1.83,True,1,21536,-1693.87,-7002483.56,36479184.32,29476700.76
2013-10-03,1678.66,-15.21,-0.9,1725.52,-2.72,True,1,21537,-1678.66,-7004162.22,36153300.42,29149138.2
2013-10-04,1690.5,11.84,0.7,1725.52,-2.03,True,1,21538,-1690.5,-7005852.72,36409989.0,29404136.28
2013-10-07,1676.12,-14.38,-0.85,1725.52,-2.86,True,1,21539,-1676.12,-7007528.84,36101948.68,29094419.84
2013-10-08,1655.45,-20.67,-1.23,1725.52,-4.06,True,1,21540,-1655.45,-7009184.29,35658393.0,28649208.71
2013-10-09,1656.4,0.95,0.06,1725.52,-4.01,True,1,21541,-1656.4,-7010840.69,35680512.4,28669671.71
2013-10-10,1692.56,36.16,2.18,1725.52,-1.91,True,1,21542,-1692.56,-7012533.25,36461127.52,29448594.27
2013-10-11,1703.2,10.64,0.63,1725.52,-1.29,True,1,21543,-1703.2,-7014236.45,36692037.6,29677801.15
2013-10-14,1710.14,6.94,0.41,1725.52,-0.89,True,1,21544,-1710.14,-7015946.59,36843256.16,29827309.57
2013-10-15,1698.06,-12.08,-0.71,1725.52,-1.59,True,1,21545,-1698.06,-7017644.65,36584702.7,29567058.05
2013-10-16,1721.54,23.48,1.38,1725.52,-0.23,True,1,21546,-1721.54,-7019366.19,37092300.84,30072934.65
2013-10-17,1733.15,11.61,0.67,1733.15,0.0,True,1,21547,-1733.15,-7021099.34,37344183.05,30323083.71
2013-10-18,1744.5,11.35,0.66,1744.5,0.0,True,1,21548,-1744.5,-7022843.84,37590486.0,30567642.16
2013-10-21,1744.66,0.16,0.01,1744.66,0.0,True,1,21549,-1744.66,-7024588.5,37595678.34,30571089.84
2013-10-22,1754.67,10.01,0.57,1754.67,0.0,True,1,21550,-1754.67,-7026343.17,37813138.5,30786795.33
2013-10-23,1746.38,-8.29,-0.47,1754.67,-0.47,True,1,21551,-1746.38,-7028089.55,37636235.38,30608145.83
2013-10-24,1752.07,5.69,0.33,1754.67,-0.15,True,1,21552,-1752.07,-7029841.62,37760612.64,30730771.02
2013-10-25,1759.77,7.7,0.44,1759.77,0.0,True,1,21553,-1759.77,-7031601.39,37928322.81,30896721.42
2013-10-28,1762.11,2.34,0.13,1762.11,0.0,True,1,21554,-1762.11,-7033363.5,37980518.94,30947155.44
2013-10-29,1771.95,9.84,0.56,1771.95,0.0,True,1,21555,-1771.95,-7035135.45,38194382.25,31159246.8
2013-10-30,1763.31,-8.64,-0.49,1771.95,-0.49,True,1,21556,-1763.31,-7036898.76,38009910.36,30973011.6
2013-10-31,1756.54,-6.77,-0.38,1771.95,-0.87,True,1,21557,-1756.54,-7038655.3,37865732.78,30827077.48
2013-11-01,1761.64,5.1,0.29,1771.95,-0.58,True,1,21558,-1761.64,-7040416.94,37977435.12,30937018.18
2013-11-04,1767.93,6.29,0.36,1771.95,-0.23,True,1,21559,-1767.93,-7042184.87,38114802.87,31072618.0
2013-11-05,1762.97,-4.96,-0.28,1771.95,-0.51,True,1,21560,-1762.97,-7043947.84,38009633.2,30965685.36
2013-11-06,1770.49,7.52,0.43,1771.95,-0.08,True,1,21561,-1770.49,-7045718.33,38173534.89,31127816.56
2013-11-07,1747.15,-23.34,-1.32,1771.95,-1.4,True,1,21562,-1747.15,-7047465.48,37672048.3,30624582.82
2013-11-08,1770.61,23.46,1.34,1771.95,-0.08,True,1,21563,-1770.61,-7049236.09,38179663.43,31130427.34
2013-11-11,1771.89,1.28,0.07,1771.95,-0.0,True,1,21564,-1771.89,-7051007.98,38209035.96,31158027.98
2013-11-12,1767.69,-4.2,-0.24,1771.95,-0.24,True,1,21565,-1767.69,-7052775.67,38120234.85,31067459.18
2013-11-13,1782.0,14.31,0.81,1782.0,0.0,True,1,21566,-1782.0,-7054557.67,38430612.0,31376054.33
2013-11-14,1790.62,8.62,0.48,1790.62,0.0,True,1,21567,-1790.62,-7056348.29,38618301.54,31561953.25
2013-11-15,1798.18,7.56,0.42,1798.18,0.0,True,1,21568,-1798.18,-7058146.47,38783146.24,31724999.77
2013-11-18,1791.53,-6.65,-0.37,1798.18,-0.37,True,1,21569,-1791.53,-7059938.0,38641510.57,31581572.57
2013-11-19,1787.87,-3.66,-0.2,1798.18,-0.57,True,1,21570,-1787.87,-7061725.87,38564355.9,31502630.03
2013-11-20,1781.37,-6.5,-0.36,1798.18,-0.94,True,1,21571,-1781.37,-7063507.24,38425932.27,31362425.03
2013-11-21,1795.85,14.48,0.81,1798.18,-0.13,True,1,21572,-1795.85,-7065303.09,38740076.2,31674773.11
2013-11-22,1804.76,8.91,0.5,1804.76,0.0,True,1,21573,-1804.76,-7067107.85,38934087.48,31866979.63
2013-11-25,1802.48,-2.28,-0.13,1804.76,-0.13,True,1,21574,-1802.48,-7068910.33,38886703.52,31817793.19
2013-11-26,1802.75,0.27,0.02,1804.76,-0.11,True,1,21575,-1802.75,-7070713.08,38894331.25,31823618.17
2013-11-27,1807.23,4.48,0.25,1807.23,0.0,True,1,21576,-1807.23,-7072520.31,38992794.48,31920274.17
2013-11-29,1805.81,-1.42,-0.08,1807.23,-0.08,True,1,21577,-1805.81,-7074326.12,38963962.37,31889636.25
2013-12-02,1800.9,-4.91,-0.27,1807.23,-0.35,True,1,21578,-1800.9,-7076127.02,38859820.2,31783693.18
2013-12-03,1795.15,-5.75,-0.32,1807.23,-0.67,True,1,21579,-1795.15,-7077922.17,38737541.85,31659619.68
2013-12-04,1792.81,-2.34,-0.13,1807.23,-0.8,True,1,21580,-1792.81,-7079714.98,38688839.8,31609124.82
2013-12-05,1785.03,-7.78,-0.43,1807.23,-1.23,True,1,21581,-1785.03,-7081500.01,38522732.43,31441232.42
2013-12-06,1805.09,20.06,1.12,1807.23,-0.12,True,1,21582,-1805.09,-7083305.1,38957452.38,31874147.28
2013-12-09,1808.37,3.28,0.18,1808.37,0.0,True,1,21583,-1808.37,-7085113.47,39030049.71,31944936.24
2013-12-10,1802.62,-5.75,-0.32,1808.37,-0.32,True,1,21584,-1802.62,-7086916.09,38907750.08,31820833.99
2013-12-11,1782.22,-20.4,-1.13,1808.37,-1.45,True,1,21585,-1782.22,-7088698.31,38469218.7,31380520.39
2013-12-12,1775.5,-6.72,-0.38,1808.37,-1.82,True,1,21586,-1775.5,-7090473.81,38325943.0,31235469.19
2013-12-13,1775.32,-0.18,-0.01,1808.37,-1.83,True,1,21587,-1775.32,-7092249.13,38323832.84,31231583.71
2013-12-16,1786.54,11.22,0.63,1808.37,-1.21,True,1,21588,-1786.54,-7094035.67,38567825.52,31473789.85
2013-12-17,1781.0,-5.54,-0.31,1808.37,-1.51,True,1,21589,-1781.0,-7095816.67,38450009.0,31354192.33
2013-12-18,1810.65,29.65,1.66,1810.65,0.0,True,1,21590,-1810.65,-7097627.32,39091933.5,31994306.18
2013-12-19,1809.6,-1.05,-0.06,1810.65,-0.06,True,1,21591,-1809.6,-7099436.92,39071073.6,31971636.68
2013-12-20,1818.32,8.72,0.48,1818.32,0.0,True,1,21592,-1818.32,-7101255.24,39261165.44,32159910.2
2013-12-23,1827.99,9.67,0.53,1827.99,0.0,True,1,21593,-1827.99,-7103083.23,39471788.07,32368704.84
2013-12-24,1833.32,5.33,0.29,1833.32,0.0,True,1,21594,-1833.32,-7104916.55,39588712.08,32483795.53
2013-12-26,1842.02,8.7,0.48,1842.02,0.0,True,1,21595,-1842.02,-7106758.57,39778421.9,32671663.33
2013-12-27,1841.4,-0.62,-0.03,1842.02,-0.03,True,1,21596,-1841.4,-7108599.97,39766874.4,32658274.43
2013-12-30,1841.07,-0.33,-0.02,1842.02,-0.05,True,1,21597,-1841.07,-7110441.04,39761588.79,32651147.75
2013-12-31,1848.36,7.29,0.4,1848.36,0.0,True,1,21598,-1848.36,-7112289.4,39920879.28,32808589.88
2014-01-02,1831.98,-16.38,-0.89,1848.36,-0.89,True,1,21599,-1831.98,-7114121.38,39568936.02,32454814.64
2014-01-03,1831.37,-0.61,-0.03,1848.36,-0.92,True,1,21600,-1831.37,-7115952.75,39557592.0,32441639.25
2014-01-06,1826.77,-4.6,-0.25,1848.36,-1.17,True,1,21601,-1826.77,-7117779.52,39460058.77,32342279.25
2014-01-07,1837.88,11.11,0.61,1848.36,-0.57,True,1,21602,-1837.88,-7119617.4,39701883.76,32582266.36
2014-01-08,1837.49,-0.39,-0.02,1848.36,-0.59,True,1,21603,-1837.49,-7121454.89,39695296.47,32573841.58
2014-01-09,1838.13,0.64,0.04,1848.36,-0.55,True,1,21604,-1838.13,-7123293.02,39710960.52,32587667.5
2014-01-10,1842.37,4.24,0.23,1848.36,-0.32,True,1,21605,-1842.37,-7125135.39,39804403.85,32679268.46
2014-01-13,1819.2,-23.17,-1.26,1848.36,-1.58,True,1,21606,-1819.2,-7126954.59,39305635.2,32178680.61
2014-01-14,1838.88,19.68,1.08,1848.36,-0.51,True,1,21607,-1838.88,-7128793.47,39732680.16,32603886.69
2014-01-15,1848.38,9.5,0.52,1848.38,0.0,True,1,21608,-1848.38,-7130641.85,39939795.04,32809153.19
2014-01-16,1845.89,-2.49,-0.14,1848.38,-0.14,True,1,21609,-1845.89,-7132487.74,39887837.01,32755349.27
2014-01-17,1838.7,-7.19,-0.39,1848.38,-0.52,True,1,21610,-1838.7,-7134326.44,39734307.0,32599980.56
2014-01-21,1843.8,5.1,0.28,1848.38,-0.25,True,1,21611,-1843.8,-7136170.24,39846361.8,32710191.56
2014-01-22,1844.86,1.06,0.06,1848.38,-0.19,True,1,21612,-1844.86,-7138015.1,39871114.32,32733099.22
2014-01-23,1828.46,-16.4,-0.89,1848.38,-1.08,True,1,21613,-1828.46,-7139843.56,39518505.98,32378662.42
2014-01-24,1790.29,-38.17,-2.09,1848.38,-3.14,True,1,21614,-1790.29,-7141633.85,38695328.06,31553694.21
2014-01-27,1781.56,-8.73,-0.49,1848.38,-3.62,True,1,21615,-1781.56,-7143415.41,38508419.4,31365003.99
2014-01-28,1792.5,10.94,0.61,1848.38,-3.02,True,1,21616,-1792.5,-7145207.91,38746680.0,31601472.09
2014-01-29,1774.2,-18.3,-1.02,1848.38,-4.01,True,1,21617,-1774.2,-7146982.11,38352881.4,31205899.29
2014-01-30,1794.19,19.99,1.13,1848.38,-2.93,True,1,21618,-1794.19,-7148776.3,38786799.42,31638023.12
2014-01-31,1782.59,-11.6,-0.65,1848.38,-3.56,True,1,21619,-1782.59,-7150558.89,38537813.21,31387254.32
2014-02-03,1741.89,-40.7,-2.28,1848.38,-5.76,True,1,21620,-1741.89,-7152300.78,37659661.8,30507361.02
2014-02-04,1755.2,13.31,0.76,1848.38,-5.04,True,1,21621,-1755.2,-7154055.98,37949179.2,30795123.22
2014-02-05,1751.64,-3.56,-0.2,1848.38,-5.23,True,1,21622,-1751.64,-7155807.62,37873960.08,30718152.46
2014-02-06,1773.43,21.79,1.24,1848.38,-4.06,True,1,21623,-1773.43,-7157581.05,38346876.89,31189295.84
2014-02-07,1797.02,23.59,1.33,1848.38,-2.78,True,1,21624,-1797.02,-7159378.07,38858760.48,31699382.41
2014-02-10,1799.84,2.82,0.16,1848.38,-2.63,True,1,21625,-1799.84,-7161177.91,38921540.0,31760362.09
2014-02-11,1819.75,19.91,1.11,1848.38,-1.55,True,1,21626,-1819.75,-7162997.66,39353913.5,32190915.84
2014-02-12,1819.26,-0.49,-0.03,1848.38,-1.58,True,1,21627,-1819.26,-7164816.92,39345136.02,32180319.1
2014-02-13,1829.83,10.57,0.58,1848.38,-1.0,True,1,21628,-1829.83,-7166646.75,39575563.24,32408916.49
2014-02-14,1838.63,8.8,0.48,1848.38,-0.53,True,1,21629,-1838.63,-7168485.38,39767728.27,32599242.89
2014-02-18,1840.76,2.13,0.12,1848.38,-0.41,True,1,21630,-1840.76,-7170326.14,39815638.8,32645312.66
2014-02-19,1828.75,-12.01,-0.65,1848.38,-1.06,True,1,21631,-1828.75,-7172154.89,39557691.25,32385536.36
2014-02-20,1839.78,11.03,0.6,1848.38,-0.46,True,1,21632,-1839.78,-7173994.67,39798120.96,32624126.29
2014-02-21,1836.25,-3.53,-0.19,1848.38,-0.66,True,1,21633,-1836.25,-7175830.92,39723596.25,32547765.33
2014-02-24,1847.61,11.36,0.62,1848.38,-0.04,True,1,21634,-1847.61,-7177678.53,39971194.74,32793516.21
2014-02-25,1845.12,-2.49,-0.14,1848.38,-0.18,True,1,21635,-1845.12,-7179523.65,39919171.2,32739647.55
2014-02-26,1845.16,0.04,0.0,1848.38,-0.17,True,1,21636,-1845.16,-7181368.81,39921881.76,32740512.95
2014-02-27,1854.29,9.13,0.5,1854.29,0.0,True,1,21637,-1854.29,-7183223.1,40121272.73,32938049.63
2014-02-28,1859.45,5.16,0.28,1859.45,0.0,True,1,21638,-1859.45,-7185082.55,40234779.1,33049696.55
2014-03-03,1845.73,-13.72,-0.74,1859.45,-0.74,True,1,21639,-1845.73,-7186928.28,39939751.47,32752823.19
2014-03-04,1873.91,28.18,1.53,1873.91,0.0,True,1,21640,-1873.91,-7188802.19,40551412.4,33362610.21
2014-03-05,1873.81,-0.1,-0.0,1873.91,-0.0,True,1,21641,-1873.81,-7190676.0,40551122.21,33360446.21
2014-03-06,1877.03,3.22,0.17,1877.03,0.0,True,1,21642,-1877.03,-7192553.03,40622683.26,33430130.23
2014-03-07,1878.04,1.01,0.05,1878.04,0.0,True,1,21643,-1878.04,-7194431.07,40646419.72,33451988.65
2014-03-10,1877.17,-0.87,-0.05,1878.04,-0.05,True,1,21644,-1877.17,-7196308.24,40629467.48,33433159.24
2014-03-11,1867.63,-9.54,-0.51,1878.04,-0.55,True,1,21645,-1867.63,-7198175.87,40424851.35,33226675.48
2014-03-12,1868.2,0.57,0.03,1878.04,-0.52,True,1,21646,-1868.2,-7200044.07,40439057.2,33239013.13
2014-03-13,1846.34,-21.86,-1.17,1878.04,-1.69,True,1,21647,-1846.34,-7201890.41,39967721.98,32765831.57
2014-03-14,1841.13,-5.21,-0.28,1878.04,-1.96,True,1,21648,-1841.13,-7203731.54,39856782.24,32653050.7
2014-03-17,1858.83,17.7,0.96,1878.04,-1.02,True,1,21649,-1858.83,-7205590.37,40241810.67,33036220.3
2014-03-18,1872.25,13.42,0.72,1878.04,-0.31,True,1,21650,-1872.25,-7207462.62,40534212.5,33326749.88
2014-03-19,1860.77,-11.48,-0.61,1878.04,-0.92,True,1,21651,-1860.77,-7209323.39,40287531.27,33078207.88
2014-03-20,1872.01,11.24,0.6,1878.04,-0.32,True,1,21652,-1872.01,-7211195.4,40532760.52,33321565.12
2014-03-21,1866.52,-5.49,-0.29,1878.04,-0.61,True,1,21653,-1866.52,-7213061.92,40415757.56,33202695.64
2014-03-24,1857.44,-9.08,-0.49,1878.04,-1.1,True,1,21654,-1857.44,-7214919.36,40221005.76,33006086.4
2014-03-25,1865.62,8.18,0.44,1878.04,-0.66,True,1,21655,-1865.62,-7216784.98,40400001.1,33183216.12
2014-03-26,1852.56,-13.06,-0.7,1878.04,-1.36,True,1,21656,-1852.56,-7218637.54,40119039.36,32900401.82
2014-03-27,1849.04,-3.52,-0.19,1878.04,-1.54,True,1,21657,-1849.04,-7220486.58,40044659.28,32824172.7
2014-03-28,1857.62,8.58,0.46,1878.04,-1.09,True,1,21658,-1857.62,-7222344.2,40232333.96,33009989.76
2014-03-31,1872.34,14.72,0.79,1878.04,-0.3,True,1,21659,-1872.34,-7224216.54,40553012.06,33328795.52
2014-04-01,1885.52,13.18,0.7,1885.52,0.0,True,1,21660,-1885.52,-7226102.06,40840363.2,33614261.14
2014-04-02,1890.9,5.38,0.28,1890.9,0.0,True,1,21661,-1890.9,-7227992.96,40958784.9,33730791.94
2014-04-03,1888.77,-2.13,-0.11,1890.9,-0.11,True,1,21662,-1888.77,-7229881.73,40914535.74,33684654.01
2014-04-04,1865.09,-23.68,-1.25,1890.9,-1.36,True,1,21663,-1865.09,-7231746.82,40403444.67,33171697.85
2014-04-07,1845.04,-20.05,-1.08,1890.9,-2.42,True,1,21664,-1845.04,-7233591.86,39970946.56,32737354.7
2014-04-08,1851.96,6.92,0.38,1890.9,-2.06,True,1,21665,-1851.96,-7235443.82,40122713.4,32887269.58
2014-04-09,1872.18,20.22,1.09,1890.9,-0.99,True,1,21666,-1872.18,-7237316.0,40562651.88,33325335.88
2014-04-10,1833.08,-39.1,-2.09,1890.9,-3.06,True,1,21667,-1833.08,-7239149.08,39717344.36,32478195.28
2014-04-11,1815.69,-17.39,-0.95,1890.9,-3.98,True,1,21668,-1815.69,-7240964.77,39342370.92,32101406.15
2014-04-14,1830.61,14.92,0.82,1890.9,-3.19,True,1,21669,-1830.61,-7242795.38,39667488.09,32424692.71
2014-04-15,1842.98,12.37,0.68,1890.9,-2.53,True,1,21670,-1842.98,-7244638.36,39937376.6,32692738.24
2014-04-16,1862.31,19.33,1.05,1890.9,-1.51,True,1,21671,-1862.31,-7246500.67,40358120.01,33111619.34
2014-04-17,1864.85,2.54,0.14,1890.9,-1.38,True,1,21672,-1864.85,-7248365.52,40415029.2,33166663.68
2014-04-21,1871.89,7.04,0.38,1890.9,-1.0,True,1,21673,-1871.89,-7250237.41,40569471.97,33319234.56
2014-04-22,1879.55,7.66,0.41,1890.9,-0.6,True,1,21674,-1879.55,-7252116.96,40737366.7,33485249.74
2014-04-23,1875.39,-4.16,-0.22,1890.9,-0.82,True,1,21675,-1875.39,-7253992.35,40649078.25,33395085.9
2014-04-24,1878.61,3.22,0.17,1890.9,-0.65,True,1,21676,-1878.61,-7255870.96,40720750.36,33464879.4
2014-04-25,1863.4,-15.21,-0.81,1890.9,-1.45,True,1,21677,-1863.4,-7257734.36,40392921.8,33135187.44
2014-04-28,1869.43,6.03,0.32,1890.9,-1.14,True,1,21678,-1869.43,-7259603.79,40525503.54,33265899.75
2014-04-29,1878.33,8.9,0.48,1890.9,-0.66,True,1,21679,-1878.33,-7261482.12,40720316.07,33458833.95
2014-04-30,1883.95,5.62,0.3,1890.9,-0.37,True,1,21680,-1883.95,-7263366.07,40844036.0,33580669.93
2014-05-01,1883.68,-0.27,-0.01,1890.9,-0.38,True,1,21681,-1883.68,-7265249.75,40840066.08,33574816.33
2014-05-02,1881.14,-2.54,-0.14,1890.9,-0.52,True,1,21682,-1881.14,-7267130.89,40786877.48,33519746.59
2014-05-05,1884.66,3.52,0.19,1890.9,-0.33,True,1,21683,-1884.66,-7269015.55,40865082.78,33596067.23
2014-05-06,1867.72,-16.94,-0.9,1890.9,-1.23,True,1,21684,-1867.72,-7270883.27,40499640.48,33228757.21
2014-05-07,1878.21,10.49,0.56,1890.9,-0.67,True,1,21685,-1878.21,-7272761.48,40728983.85,33456222.37
2014-05-08,1875.63,-2.58,-0.14,1890.9,-0.81,True,1,21686,-1875.63,-7274637.11,40674912.18,33400275.07
2014-05-09,1878.48,2.85,0.15,1890.9,-0.66,True,1,21687,-1878.48,-7276515.59,40738595.76,33462080.17
2014-05-12,1896.65,18.17,0.97,1896.65,0.0,True,1,21688,-1896.65,-7278412.24,41134545.2,33856132.96
2014-05-13,1897.45,0.8,0.04,1897.45,0.0,True,1,21689,-1897.45,-7280309.69,41153793.05,33873483.36
2014-05-14,1888.53,-8.92,-0.47,1897.45,-0.47,True,1,21690,-1888.53,-7282198.22,40962215.7,33680017.48
2014-05-15,1870.85,-17.68,-0.94,1897.45,-1.4,True,1,21691,-1870.85,-7284069.07,40580607.35,33296538.28
2014-05-16,1877.86,7.01,0.38,1897.45,-1.03,True,1,21692,-1877.86,-7285946.93,40734539.12,33448592.19
2014-05-19,1885.08,7.22,0.38,1897.45,-0.65,True,1,21693,-1885.08,-7287832.01,40893040.44,33605208.43
2014-05-20,1872.83,-12.25,-0.65,1897.45,-1.3,True,1,21694,-1872.83,-7289704.84,40629174.02,33339469.18
2014-05-21,1888.03,15.2,0.81,1897.45,-0.5,True,1,21695,-1888.03,-7291592.87,40960810.85,33669217.98
2014-05-22,1892.49,4.46,0.24,1897.45,-0.26,True,1,21696,-1892.49,-7293485.36,41059463.04,33765977.68
2014-05-23,1900.53,8.04,0.42,1900.53,0.0,True,1,21697,-1900.53,-7295385.89,41235799.41,33940413.52
2014-05-27,1911.91,11.38,0.6,1911.91,0.0,True,1,21698,-1911.91,-7297297.8,41484623.18,34187325.38
2014-05-28,1909.78,-2.13,-0.11,1911.91,-0.11,True,1,21699,-1909.78,-7299207.58,41440316.22,34141108.64
2014-05-29,1920.03,10.25,0.54,1920.03,0.0,True,1,21700,-1920.03,-7301127.61,41664651.0,34363523.39
2014-05-30,1923.57,3.54,0.18,1923.57,0.0,True,1,21701,-1923.57,-7303051.18,41743392.57,34440341.39
2014-06-02,1924.97,1.4,0.07,1924.97,0.0,True,1,21702,-1924.97,-7304976.15,41775698.94,34470722.79
2014-06-03,1924.24,-0.73,-0.04,1924.97,-0.04,True,1,21703,-1924.24,-7306900.39,41761780.72,34454880.33
2014-06-04,1927.88,3.64,0.19,1927.88,0.0,True,1,21704,-1927.88,-7308828.27,41842707.52,34533879.25
2014-06-05,1940.46,12.58,0.65,1940.46,0.0,True,1,21705,-1940.46,-7310768.73,42117684.3,34806915.57
2014-06-06,1949.44,8.98,0.46,1949.44,0.0,True,1,21706,-1949.44,-7312718.17,42314544.64,35001826.47
2014-06-09,1951.27,1.83,0.09,1951.27,0.0,True,1,21707,-1951.27,-7314669.44,42356217.89,35041548.45
2014-06-10,1950.79,-0.48,-0.02,1951.27,-0.02,True,1,21708,-1950.79,-7316620.23,42347749.32,35031129.09
2014-06-11,1943.89,-6.9,-0.35,1951.27,-0.38,True,1,21709,-1943.89,-7318564.12,42199908.01,34881343.89
2014-06-12,1930.11,-13.78,-0.71,1951.27,-1.08,True,1,21710,-1930.11,-7320494.23,41902688.1,34582193.87
2014-06-13,1936.16,6.05,0.31,1951.27,-0.77,True,1,21711,-1936.16,-7322430.39,42035969.76,34713539.37
2014-06-16,1937.78,1.62,0.08,1951.27,-0.69,True,1,21712,-1937.78,-7324368.17,42073079.36,34748711.19
2014-06-17,1941.99,4.21,0.22,1951.27,-0.48,True,1,21713,-1941.99,-7326310.16,42166428.87,34840118.71
2014-06-18,1956.98,14.99,0.77,1956.98,0.0,True,1,21714,-1956.98,-7328267.14,42493863.72,35165596.58
2014-06-19,1959.48,2.5,0.13,1959.48,0.0,True,1,21715,-1959.48,-7330226.62,42550108.2,35219881.58
2014-06-20,1962.87,3.39,0.17,1962.87,0.0,True,1,21716,-1962.87,-7332189.49,42625684.92,35293495.43
2014-06-23,1962.61,-0.26,-0.01,1962.87,-0.01,True,1,21717,-1962.61,-7334152.1,42622001.37,35287849.27
2014-06-24,1949.98,-12.63,-0.64,1962.87,-0.66,True,1,21718,-1949.98,-7336102.08,42349665.64,35013563.56
2014-06-25,1959.53,9.55,0.49,1962.87,-0.17,True,1,21719,-1959.53,-7338061.61,42559032.07,35220970.46
2014-06-26,1957.22,-2.31,-0.12,1962.87,-0.29,True,1,21720,-1957.22,-7340018.83,42510818.4,35170799.57
2014-06-27,1960.96,3.74,0.19,1962.87,-0.1,True,1,21721,-1960.96,-7341979.79,42594012.16,35252032.37
2014-06-30,1960.23,-0.73,-0.04,1962.87,-0.13,True,1,21722,-1960.23,-7343940.02,42580116.06,35236176.04
2014-07-01,1973.32,13.09,0.67,1973.32,0.0,True,1,21723,-1973.32,-7345913.34,42866430.36,35520517.02
2014-07-02,1974.62,1.3,0.07,1974.62,0.0,True,1,21724,-1974.62,-7347887.96,42896644.88,35548756.92
2014-07-03,1985.44,10.82,0.55,1985.44,0.0,True,1,21725,-1985.44,-7349873.4,43133684.0,35783810.6
2014-07-07,1977.65,-7.79,-0.39,1985.44,-0.39,True,1,21726,-1977.65,-7351851.05,42966423.9,35614572.85
2014-07-08,1963.71,-13.94,-0.7,1985.44,-1.09,True,1,21727,-1963.71,-7353814.76,42665527.17,35311712.41
2014-07-09,1972.83,9.12,0.46,1985.44,-0.64,True,1,21728,-1972.83,-7355787.59,42865650.24,35509862.65
2014-07-10,1964.68,-8.15,-0.41,1985.44,-1.05,True,1,21729,-1964.68,-7357752.27,42690531.72,35332779.45
2014-07-11,1967.57,2.89,0.15,1985.44,-0.9,True,1,21730,-1967.57,-7359719.84,42755296.1,35395576.26
2014-07-14,1977.1,9.53,0.48,1985.44,-0.42,True,1,21731,-1977.1,-7361696.94,42964360.1,35602663.16
2014-07-15,1973.28,-3.82,-0.19,1985.44,-0.61,True,1,21732,-1973.28,-7363670.22,42883320.96,35519650.74
2014-07-16,1981.57,8.29,0.42,1985.44,-0.2,True,1,21733,-1981.57,-7365651.79,43065460.81,35699809.02
2014-07-17,1958.12,-23.45,-1.18,1985.44,-1.38,True,1,21734,-1958.12,-7367609.91,42557780.08,35190170.17
2014-07-18,1978.22,20.1,1.03,1985.44,-0.36,True,1,21735,-1978.22,-7369588.13,42996611.7,35627023.57
2014-07-21,1973.63,-4.59,-0.23,1985.44,-0.6,True,1,21736,-1973.63,-7371561.76,42898821.68,35527259.92
2014-07-22,1983.53,9.9,0.5,1985.44,-0.1,True,1,21737,-1983.53,-7373545.29,43115991.61,35742446.32
2014-07-23,1987.01,3.48,0.18,1987.01,0.0,True,1,21738,-1987.01,-7375532.3,43193623.38,35818091.08
2014-07-24,1987.98,0.97,0.05,1987.98,0.0,True,1,21739,-1987.98,-7377520.28,43216697.22,35839176.94
2014-07-25,1978.34,-9.64,-0.48,1987.98,-0.48,True,1,21740,-1978.34,-7379498.62,43009111.6,35629612.98
2014-07-28,1978.91,0.57,0.03,1987.98,-0.46,True,1,21741,-1978.91,-7381477.53,43023482.31,35642004.78
2014-07-29,1969.95,-8.96,-0.45,1987.98,-0.91,True,1,21742,-1969.95,-7383447.48,42830652.9,35447205.42
2014-07-30,1970.07,0.12,0.01,1987.98,-0.9,True,1,21743,-1970.07,-7385417.55,42835232.01,35449814.46
2014-07-31,1930.67,-39.4,-2.0,1987.98,-2.88,True,1,21744,-1930.67,-7387348.22,41980488.48,34593140.26
2014-08-01,1925.15,-5.52,-0.29,1987.98,-3.16,True,1,21745,-1925.15,-7389273.37,41862386.75,34473113.38
2014-08-04,1938.99,13.84,0.72,1987.98,-2.46,True,1,21746,-1938.99,-7391212.36,42165276.54,34774064.18
2014-08-05,1920.21,-18.78,-0.97,1987.98,-3.41,True,1,21747,-1920.21,-7393132.57,41758806.87,34365674.3
2014-08-06,1920.24,0.03,0.0,1987.98,-3.41,True,1,21748,-1920.24,-7395052.81,41761379.52,34366326.71
2014-08-07,1909.57,-10.67,-0.56,1987.98,-3.94,True,1,21749,-1909.57,-7396962.38,41531237.93,34134275.55
2014-08-08,1931.59,22.02,1.15,1987.98,-2.84,True,1,21750,-1931.59,-7398893.97,42012082.5,34613188.53
2014-08-11,1936.92,5.33,0.28,1987.98,-2.57,True,1,21751,-1936.92,-7400830.89,42129946.92,34729116.03
2014-08-12,1933.75,-3.17,-0.16,1987.98,-2.73,True,1,21752,-1933.75,-7402764.64,42062930.0,34660165.36
2014-08-13,1946.72,12.97,0.67,1987.98,-2.08,True,1,21753,-1946.72,-7404711.36,42347000.16,34942288.8
2014-08-14,1955.18,8.46,0.44,1987.98,-1.65,True,1,21754,-1955.18,-7406666.54,42532985.72,35126319.18
2014-08-15,1955.06,-0.12,-0.01,1987.98,-1.66,True,1,21755,-1955.06,-7408621.6,42532330.3,35123708.7
2014-08-18,1971.74,16.68,0.85,1987.98,-0.82,True,1,21756,-1971.74,-7410593.34,42897175.44,35486582.1
2014-08-19,1981.6,9.86,0.5,1987.98,-0.32,True,1,21757,-1981.6,-7412574.94,43113671.2,35701096.26
2014-08-20,1986.51,4.91,0.25,1987.98,-0.07,True,1,21758,-1986.51,-7414561.45,43222484.58,35807923.13
2014-08-21,1992.37,5.86,0.3,1992.37,0.0,True,1,21759,-1992.37,-7416553.82,43351978.83,35935425.01
2014-08-22,1988.4,-3.97,-0.2,1992.37,-0.2,True,1,21760,-1988.4,-7418542.22,43267584.0,35849041.78
2014-08-25,1997.92,9.52,0.48,1997.92,0.0,True,1,21761,-1997.92,-7420540.14,43476737.12,36056196.98
2014-08-26,2000.02,2.1,0.1,2000.02,0.0,True,1,21762,-2000.02,-7422540.16,43524435.24,36101895.08
2014-08-27,2000.12,0.1,0.0,2000.12,0.0,True,1,21763,-2000.12,-7424540.28,43528611.56,36104071.28
2014-08-28,1996.74,-3.38,-0.17,2000.12,-0.17,True,1,21764,-1996.74,-7426537.02,43457049.36,36030512.34
2014-08-29,2003.37,6.63,0.33,2003.37,0.0,True,1,21765,-2003.37,-7428540.39,43603348.05,36174807.66
2014-09-02,2002.28,-1.09,-0.05,2003.37,-0.05,True,1,21766,-2002.28,-7430542.67,43581626.48,36151083.81
2014-09-03,2000.72,-1.56,-0.08,2003.37,-0.13,True,1,21767,-2000.72,-7432543.39,43549672.24,36117128.85
2014-09-04,1997.65,-3.07,-0.15,2003.37,-0.29,True,1,21768,-1997.65,-7434541.04,43484845.2,36050304.16
2014-09-05,2007.71,10.06,0.5,2007.71,0.0,True,1,21769,-2007.71,-7436548.75,43705838.99,36269290.24
2014-09-08,2001.54,-6.17,-0.31,2007.71,-0.31,True,1,21770,-2001.54,-7438550.29,43573525.8,36134975.51
2014-09-09,1988.44,-13.1,-0.66,2007.71,-0.96,True,1,21771,-1988.44,-7440538.73,43290327.24,35849788.51
2014-09-10,1995.69,7.25,0.36,2007.71,-0.6,True,1,21772,-1995.69,-7442534.42,43450162.68,36007628.26
2014-09-11,1997.45,1.76,0.09,2007.71,-0.51,True,1,21773,-1997.45,-7444531.87,43490478.85,36045946.98
2014-09-12,1985.54,-11.91,-0.6,2007.71,-1.1,True,1,21774,-1985.54,-7446517.41,43233147.96,35786630.55
2014-09-15,1984.13,-1.41,-0.07,2007.71,-1.17,True,1,21775,-1984.13,-7448501.54,43204430.75,35755929.21
2014-09-16,1998.98,14.85,0.75,2007.71,-0.44,True,1,21776,-1998.98,-7450500.52,43529788.48,36079287.96
2014-09-17,2001.57,2.59,0.13,2007.71,-0.31,True,1,21777,-2001.57,-7452502.09,43588189.89,36135687.8
2014-09-18,2011.36,9.79,0.49,2011.36,0.0,True,1,21778,-2011.36,-7454513.45,43803398.08,36348884.63
2014-09-19,2010.4,-0.96,-0.05,2011.36,-0.05,True,1,21779,-2010.4,-7456523.85,43784501.6,36327977.75
2014-09-22,1994.29,-16.11,-0.8,2011.36,-0.85,True,1,21780,-1994.29,-7458518.14,43435636.2,35977118.06
2014-09-23,1982.77,-11.52,-0.58,2011.36,-1.42,True,1,21781,-1982.77,-7460500.91,43186713.37,35726212.46
2014-09-24,1998.3,15.53,0.78,2011.36,-0.65,True,1,21782,-1998.3,-7462499.21,43526970.6,36064471.39
2014-09-25,1965.99,-32.31,-1.62,2011.36,-2.26,True,1,21783,-1965.99,-7464465.2,42825160.17,35360694.97
2014-09-26,1982.85,16.86,0.86,2011.36,-1.42,True,1,21784,-1982.85,-7466448.05,43194404.4,35727956.35
2014-09-29,1977.8,-5.05,-0.26,2011.36,-1.67,True,1,21785,-1977.8,-7468425.85,43086373.0,35617947.15
2014-09-30,1972.29,-5.51,-0.28,2011.36,-1.94,True,1,21786,-1972.29,-7470398.14,42968309.94,35497911.8
2014-10-01,1946.16,-26.13,-1.32,2011.36,-3.24,True,1,21787,-1946.16,-7472344.3,42400987.92,34928643.62
2014-10-02,1946.17,0.01,0.0,2011.36,-3.24,True,1,21788,-1946.17,-7474290.47,42403151.96,34928861.49
2014-10-03,1967.9,21.73,1.12,2011.36,-2.16,True,1,21789,-1967.9,-7476258.37,42878573.1,35402314.73
2014-10-06,1964.82,-3.08,-0.16,2011.36,-2.31,True,1,21790,-1964.82,-7478223.19,42813427.8,35335204.61
2014-10-07,1935.1,-29.72,-1.51,2011.36,-3.79,True,1,21791,-1935.1,-7480158.29,42167764.1,34687605.81
2014-10-08,1968.89,33.79,1.75,2011.36,-2.11,True,1,21792,-1968.89,-7482127.18,42906050.88,35423923.7
2014-10-09,1928.21,-40.68,-2.07,2011.36,-4.13,True,1,21793,-1928.21,-7484055.39,42021480.53,34537425.14
2014-10-10,1906.13,-22.08,-1.14,2011.36,-5.23,True,1,21794,-1906.13,-7485961.52,41542197.22,34056235.7
2014-10-13,1874.74,-31.39,-1.65,2011.36,-6.79,True,1,21795,-1874.74,-7487836.26,40859958.3,33372122.04
2014-10-14,1877.7,2.96,0.16,2011.36,-6.64,True,1,21796,-1877.7,-7489713.96,40926349.2,33436635.24
2014-10-15,1862.49,-15.21,-0.81,2011.36,-7.4,True,1,21797,-1862.49,-7491576.45,40596694.53,33105118.08
2014-10-16,1862.76,0.27,0.01,2011.36,-7.39,True,1,21798,-1862.76,-7493439.21,40604442.48,33111003.27
2014-10-17,1886.76,24.0,1.29,2011.36,-6.2,True,1,21799,-1886.76,-7495325.97,41129481.24,33634155.27
2014-10-20,1904.01,17.25,0.91,2011.36,-5.34,True,1,21800,-1904.01,-7497229.98,41507418.0,34010188.02
2014-10-21,1941.28,37.27,1.96,2011.36,-3.48,True,1,21801,-1941.28,-7499171.26,42321845.28,34822674.02
2014-10-22,1927.11,-14.17,-0.73,2011.36,-4.19,True,1,21802,-1927.11,-7501098.37,42014852.22,34513753.85
2014-10-23,1950.82,23.71,1.23,2011.36,-3.01,True,1,21803,-1950.82,-7503049.19,42533728.46,35030679.27
2014-10-24,1964.58,13.76,0.7,2011.36,-2.33,True,1,21804,-1964.58,-7505013.77,42835702.32,35330688.55
2014-10-27,1961.63,-2.95,-0.15,2011.36,-2.47,True,1,21805,-1961.63,-7506975.4,42773342.15,35266366.75
2014-10-28,1985.05,23.42,1.19,2011.36,-1.31,True,1,21806,-1985.05,-7508960.45,43286000.3,35777039.85
2014-10-29,1982.3,-2.75,-0.14,2011.36,-1.44,True,1,21807,-1982.3,-7510942.75,43228016.1,35717073.35
2014-10-30,1994.65,12.35,0.62,2011.36,-0.83,True,1,21808,-1994.65,-7512937.4,43499327.2,35986389.8
2014-10-31,2018.05,23.4,1.17,2018.05,0.0,True,1,21809,-2018.05,-7514955.45,44011652.45,36496697.0
2014-11-03,2017.81,-0.24,-0.01,2018.05,-0.01,True,1,21810,-2017.81,-7516973.26,44008436.1,36491462.84
2014-11-04,2012.1,-5.71,-0.28,2018.05,-0.3,True,1,21811,-2012.1,-7518985.36,43885913.1,36366927.74
2014-11-05,2023.57,11.47,0.57,2023.57,0.0,True,1,21812,-2023.57,-7521008.93,44138108.84,36617099.91
2014-11-06,2031.21,7.64,0.38,2031.21,0.0,True,1,21813,-2031.21,-7523040.14,44306783.73,36783743.59
2014-11-07,2031.92,0.71,0.04,2031.92,0.0,True,1,21814,-2031.92,-7525072.06,44324302.88,36799230.82
2014-11-10,2038.26,6.34,0.31,2038.26,0.0,True,1,21815,-2038.26,-7527110.32,44464641.9,36937531.58
2014-11-11,2039.68,1.42,0.07,2039.68,0.0,True,1,21816,-2039.68,-7529150.0,44497658.88,36968508.88
2014-11-12,2038.25,-1.43,-0.07,2039.68,-0.07,True,1,21817,-2038.25,-7531188.25,44468500.25,36937312.0
2014-11-13,2039.33,1.08,0.05,2039.68,-0.02,True,1,21818,-2039.33,-7533227.58,44494101.94,36960874.36
2014-11-14,2039.82,0.49,0.02,2039.82,0.0,True,1,21819,-2039.82,-7535267.4,44506832.58,36971565.18
2014-11-17,2041.32,1.5,0.07,2041.32,0.0,True,1,21820,-2041.32,-7537308.72,44541602.4,37004293.68
2014-11-18,2051.8,10.48,0.51,2051.8,0.0,True,1,21821,-2051.8,-7539360.52,44772327.8,37232967.28
2014-11-19,2048.72,-3.08,-0.15,2051.8,-0.15,True,1,21822,-2048.72,-7541409.24,44707167.84,37165758.6
2014-11-20,2052.75,4.03,0.2,2052.75,0.0,True,1,21823,-2052.75,-7543461.99,44797163.25,37253701.26
2014-11-21,2063.5,10.75,0.52,2063.5,0.0,True,1,21824,-2063.5,-7545525.49,45033824.0,37488298.51
2014-11-24,2069.41,5.91,0.29,2069.41,0.0,True,1,21825,-2069.41,-7547594.9,45164873.25,37617278.35
2014-11-25,2067.03,-2.38,-0.12,2069.41,-0.12,True,1,21826,-2067.03,-7549661.93,45114996.78,37565334.85
2014-11-26,2072.83,5.8,0.28,2072.83,0.0,True,1,21827,-2072.83,-7551734.76,45243660.41,37691925.65
2014-11-28,2067.56,-5.27,-0.25,2072.83,-0.25,True,1,21828,-2067.56,-7553802.32,45130699.68,37576897.36
2014-12-01,2053.44,-14.12,-0.68,2072.83,-0.94,True,1,21829,-2053.44,-7555855.76,44824541.76,37268686.0
2014-12-02,2066.55,13.11,0.64,2072.83,-0.3,True,1,21830,-2066.55,-7557922.31,45112786.5,37554864.19
2014-12-03,2074.33,7.78,0.38,2074.33,0.0,True,1,21831,-2074.33,-7559996.64,45284698.23,37724701.59
2014-12-04,2071.92,-2.41,-0.12,2074.33,-0.12,True,1,21832,-2071.92,-7562068.56,45234157.44,37672088.88
2014-12-05,2075.37,3.45,0.17,2075.37,0.0,True,1,21833,-2075.37,-7564143.93,45311553.21,37747409.28
2014-12-08,2060.31,-15.06,-0.73,2075.37,-0.73,True,1,21834,-2060.31,-7566204.24,44984808.54,37418604.3
2014-12-09,2059.82,-0.49,-0.02,2075.37,-0.75,True,1,21835,-2059.82,-7568264.06,44976169.7,37407905.64
2014-12-10,2026.14,-33.68,-1.64,2075.37,-2.37,True,1,21836,-2026.14,-7570290.2,44242793.04,36672502.84
2014-12-11,2035.33,9.19,0.45,2075.37,-1.93,True,1,21837,-2035.33,-7572325.53,44445501.21,36873175.68
2014-12-12,2002.33,-33.0,-1.62,2075.37,-3.52,True,1,21838,-2002.33,-7574327.86,43726882.54,36152554.68
2014-12-15,1989.63,-12.7,-0.63,2075.37,-4.13,True,1,21839,-1989.63,-7576317.49,43451529.57,35875212.08
2014-12-16,1972.74,-16.89,-0.85,2075.37,-4.94,True,1,21840,-1972.74,-7578290.23,43084641.6,35506351.37
2014-12-17,2012.89,40.15,2.04,2075.37,-3.01,True,1,21841,-2012.89,-7580303.12,43963530.49,36383227.37
2014-12-18,2061.23,48.34,2.4,2075.37,-0.68,True,1,21842,-2061.23,-7582364.35,45021385.66,37439021.31
2014-12-19,2070.65,9.42,0.46,2075.37,-0.23,True,1,21843,-2070.65,-7584435.0,45229207.95,37644772.95
2014-12-22,2078.54,7.89,0.38,2078.54,0.0,True,1,21844,-2078.54,-7586513.54,45403627.76,37817114.22
2014-12-23,2082.17,3.63,0.18,2082.17,0.0,True,1,21845,-2082.17,-7588595.71,45485003.65,37896407.94
2014-12-24,2081.88,-0.29,-0.01,2082.17,-0.01,True,1,21846,-2081.88,-7590677.59,45480750.48,37890072.89
2014-12-26,2088.77,6.89,0.33,2088.77,0.0,True,1,21847,-2088.77,-7592766.36,45633358.19,38040591.83
2014-12-29,2090.57,1.8,0.09,2090.57,0.0,True,1,21848,-2090.57,-7594856.93,45674773.36,38079916.43
2014-12-30,2080.35,-10.22,-0.49,2090.57,-0.49,True,1,21849,-2080.35,-7596937.28,45453567.15,37856629.87
2014-12-31,2058.9,-21.45,-1.03,2090.57,-1.52,True,1,21850,-2058.9,-7598996.18,44986965.0,37387968.82
2015-01-02,2058.2,-0.7,-0.03,2090.57,-1.55,True,1,21851,-2058.2,-7601054.38,44973728.2,37372673.82
2015-01-05,2020.58,-37.62,-1.83,2090.57,-3.35,True,1,21852,-2020.58,-7603074.96,44153714.16,36550639.2
2015-01-06,2002.61,-17.97,-0.89,2090.57,-4.21,True,1,21853,-2002.61,-7605077.57,43763036.33,36157958.76
2015-01-07,2025.9,23.29,1.16,2090.57,-3.09,True,1,21854,-2025.9,-7607103.47,44274018.6,36666915.13
2015-01-08,2062.14,36.24,1.79,2090.57,-1.36,True,1,21855,-2062.14,-7609165.61,45068069.7,37458904.09
2015-01-09,2044.81,-17.33,-0.84,2090.57,-2.19,True,1,21856,-2044.81,-7611210.42,44691367.36,37080156.94
2015-01-12,2028.26,-16.55,-0.81,2090.57,-2.98,True,1,21857,-2028.26,-7613238.68,44331678.82,36718440.14
2015-01-13,2023.03,-5.23,-0.26,2090.57,-3.23,True,1,21858,-2023.03,-7615261.71,44219389.74,36604128.03
2015-01-14,2011.27,-11.76,-0.58,2090.57,-3.79,True,1,21859,-2011.27,-7617272.98,43964350.93,36347077.95
2015-01-15,1992.67,-18.6,-0.92,2090.57,-4.68,True,1,21860,-1992.67,-7619265.65,43559766.2,35940500.55
2015-01-16,2019.42,26.75,1.34,2090.57,-3.4,True,1,21861,-2019.42,-7621285.07,44146540.62,36525255.55
2015-01-20,2022.55,3.13,0.16,2090.57,-3.25,True,1,21862,-2022.55,-7623307.62,44216988.1,36593680.48
2015-01-21,2032.12,9.57,0.47,2090.57,-2.8,True,1,21863,-2032.12,-7625339.74,44428239.56,36802899.82
2015-01-22,2063.15,31.03,1.53,2090.57,-1.31,True,1,21864,-2063.15,-7627402.89,45108711.6,37481308.71
2015-01-23,2051.82,-11.33,-0.55,2090.57,-1.85,True,1,21865,-2051.82,-7629454.71,44863044.3,37233589.59
2015-01-26,2057.09,5.27,0.26,2090.57,-1.6,True,1,21866,-2057.09,-7631511.8,44980329.94,37348818.14
2015-01-27,2029.55,-27.54,-1.34,2090.57,-2.92,True,1,21867,-2029.55,-7633541.35,44380169.85,36746628.5
2015-01-28,2002.16,-27.39,-1.35,2090.57,-4.23,True,1,21868,-2002.16,-7635543.51,43783234.88,36147691.37
2015-01-29,2021.25,19.09,0.95,2090.57,-3.32,True,1,21869,-2021.25,-7637564.76,44202716.25,36565151.49
2015-01-30,1994.99,-26.26,-1.3,2090.57,-4.57,True,1,21870,-1994.99,-7639559.75,43630431.3,35990871.55
2015-02-02,2020.85,25.86,1.3,2090.57,-3.34,True,1,21871,-2020.85,-7641580.6,44198010.35,36556429.75
2015-02-03,2050.03,29.18,1.44,2090.57,-1.94,True,1,21872,-2050.03,-7643630.63,44838256.16,37194625.53
2015-02-04,2041.51,-8.52,-0.42,2090.57,-2.35,True,1,21873,-2041.51,-7645672.14,44653948.23,37008276.09
2015-02-05,2062.52,21.01,1.03,2090.57,-1.34,True,1,21874,-2062.52,-7647734.66,45115562.48,37467827.82
2015-02-06,2055.47,-7.05,-0.34,2090.57,-1.68,True,1,21875,-2055.47,-7649790.13,44963406.25,37313616.12
2015-02-09,2046.74,-8.73,-0.42,2090.57,-2.1,True,1,21876,-2046.74,-7651836.87,44774484.24,37122647.37
2015-02-10,2068.59,21.85,1.07,2090.57,-1.05,True,1,21877,-2068.59,-7653905.46,45254543.43,37600637.97
2015-02-11,2068.53,-0.06,-0.0,2090.57,-1.05,True,1,21878,-2068.53,-7655973.99,45255299.34,37599325.35
2015-02-12,2088.48,19.95,0.96,2090.57,-0.1,True,1,21879,-2088.48,-7658062.47,45693853.92,38035791.45
2015-02-13,2096.99,8.51,0.41,2096.99,0.0,True,1,21880,-2096.99,-7660159.46,45882141.2,38221981.74
2015-02-17,2100.34,3.35,0.16,2100.34,0.0,True,1,21881,-2100.34,-7662259.8,45957539.54,38295279.74
2015-02-18,2099.68,-0.66,-0.03,2100.34,-0.03,True,1,21882,-2099.68,-7664359.48,45945197.76,38280838.28
2015-02-19,2097.45,-2.23,-0.11,2100.34,-0.14,True,1,21883,-2097.45,-7666456.93,45898498.35,38232041.42
2015-02-20,2110.3,12.85,0.61,2110.3,0.0,True,1,21884,-2110.3,-7668567.23,46181805.2,38513237.97
2015-02-23,2109.66,-0.64,-0.03,2110.3,-0.03,True,1,21885,-2109.66,-7670676.89,46169909.1,38499232.21
2015-02-24,2115.48,5.82,0.28,2115.48,0.0,True,1,21886,-2115.48,-7672792.37,46299395.28,38626602.91
2015-02-25,2113.86,-1.62,-0.08,2115.48,-0.08,True,1,21887,-2113.86,-7674906.23,46266053.82,38591147.59
2015-02-26,2110.74,-3.12,-0.15,2115.48,-0.22,True,1,21888,-2110.74,-7677016.97,46199877.12,38522860.15
2015-02-27,2104.5,-6.24,-0.3,2115.48,-0.52,True,1,21889,-2104.5,-7679121.47,46065400.5,38386279.03
2015-03-02,2117.39,12.89,0.61,2117.39,0.0,True,1,21890,-2117.39,-7681238.86,46349667.1,38668428.24
2015-03-03,2107.78,-9.61,-0.45,2117.39,-0.45,True,1,21891,-2107.78,-7683346.64,46141411.98,38458065.34
2015-03-04,2098.53,-9.25,-0.44,2117.39,-0.89,True,1,21892,-2098.53,-7685445.17,45941018.76,38255573.59
2015-03-05,2101.04,2.51,0.12,2117.39,-0.77,True,1,21893,-2101.04,-7687546.21,45998068.72,38310522.51
2015-03-06,2071.26,-29.78,-1.42,2117.39,-2.18,True,1,21894,-2071.26,-7689617.47,45348166.44,37658548.97
2015-03-09,2079.43,8.17,0.39,2117.39,-1.79,True,1,21895,-2079.43,-7691696.9,45529119.85,37837422.95
2015-03-10,2044.16,-35.27,-1.7,2117.39,-3.46,True,1,21896,-2044.16,-7693741.06,44758927.36,37065186.3
2015-03-11,2040.24,-3.92,-0.19,2117.39,-3.64,True,1,21897,-2040.24,-7695781.3,44675135.28,36979353.98
2015-03-12,2065.95,25.71,1.26,2117.39,-2.43,True,1,21898,-2065.95,-7697847.25,45240173.1,37542325.85
2015-03-13,2053.4,-12.55,-0.61,2117.39,-3.02,True,1,21899,-2053.4,-7699900.65,44967406.6,37267505.95
2015-03-16,2081.19,27.79,1.35,2117.39,-1.71,True,1,21900,-2081.19,-7701981.84,45578061.0,37876079.16
2015-03-17,2074.28,-6.91,-0.33,2117.39,-2.04,True,1,21901,-2074.28,-7704056.12,45428806.28,37724750.16
2015-03-18,2099.5,25.22,1.22,2117.39,-0.84,True,1,21902,-2099.5,-7706155.62,45983249.0,38277093.38
2015-03-19,2089.27,-10.23,-0.49,2117.39,-1.33,True,1,21903,-2089.27,-7708244.89,45761280.81,38053035.92
2015-03-20,2108.1,18.83,0.9,2117.39,-0.44,True,1,21904,-2108.1,-7710352.99,46175822.4,38465469.41
2015-03-23,2104.42,-3.68,-0.18,2117.39,-0.61,True,1,21905,-2104.42,-7712457.41,46097320.1,38384862.69
2015-03-24,2091.5,-12.92,-0.61,2117.39,-1.22,True,1,21906,-2091.5,-7714548.91,45816399.0,38101850.09
2015-03-25,2061.05,-30.45,-1.46,2117.39,-2.66,True,1,21907,-2061.05,-7716609.96,45151422.35,37434812.39
2015-03-26,2056.15,-4.9,-0.24,2117.39,-2.89,True,1,21908,-2056.15,-7718666.11,45046134.2,37327468.09
2015-03-27,2061.02,4.87,0.24,2117.39,-2.66,True,1,21909,-2061.02,-7720727.13,45154887.18,37434160.05
2015-03-30,2086.24,25.22,1.22,2117.39,-1.47,True,1,21910,-2086.24,-7722813.37,45709518.4,37986705.03
2015-03-31,2067.89,-18.35,-0.88,2117.39,-2.34,True,1,21911,-2067.89,-7724881.26,45309537.79,37584656.53
2015-04-01,2059.69,-8.2,-0.4,2117.39,-2.72,True,1,21912,-2059.69,-7726940.95,45131927.28,37404986.33
2015-04-02,2066.96,7.27,0.35,2117.39,-2.38,True,1,21913,-2066.96,-7729007.91,45293294.48,37564286.57
2015-04-06,2080.62,13.66,0.66,2117.39,-1.74,True,1,21914,-2080.62,-7731088.53,45594706.68,37863618.15
2015-04-07,2076.33,-4.29,-0.21,2117.39,-1.94,True,1,21915,-2076.33,-7733164.86,45502771.95,37769607.09
2015-04-08,2081.9,5.57,0.27,2117.39,-1.68,True,1,21916,-2081.9,-7735246.76,45626920.4,37891673.64
2015-04-09,2091.18,9.28,0.45,2117.39,-1.24,True,1,21917,-2091.18,-7737337.94,45832392.06,38095054.12
2015-04-10,2102.06,10.88,0.52,2117.39,-0.72,True,1,21918,-2102.06,-7739440.0,46072951.08,38333511.08
2015-04-13,2092.43,-9.63,-0.46,2117.39,-1.18,True,1,21919,-2092.43,-7741532.43,45863973.17,38122440.74
2015-04-14,2095.84,3.41,0.16,2117.39,-1.02,True,1,21920,-2095.84,-7743628.27,45940812.8,38197184.53
2015-04-15,2106.63,10.79,0.52,2117.39,-0.51,True,1,21921,-2106.63,-7745734.9,46179436.23,38433701.33
2015-04-16,2104.99,-1.64,-0.08,2117.39,-0.59,True,1,21922,-2104.99,-7747839.89,46145590.78,38397750.89
2015-04-17,2081.18,-23.81,-1.13,2117.39,-1.71,True,1,21923,-2081.18,-7749921.07,45625709.14,37875788.07
2015-04-20,2100.4,19.22,0.92,2117.39,-0.8,True,1,21924,-2100.4,-7752021.47,46049169.6,38297148.13
2015-04-21,2097.29,-3.11,-0.15,2117.39,-0.95,True,1,21925,-2097.29,-7754118.76,45983083.25,38228964.49
2015-04-22,2107.96,10.67,0.51,2117.39,-0.44,True,1,21926,-2107.96,-7756226.72,46219130.96,38462904.24
2015-04-23,2112.93,4.97,0.24,2117.39,-0.21,True,1,21927,-2112.93,-7758339.65,46330216.11,38571876.46
2015-04-24,2117.69,4.76,0.22,2117.69,0.0,True,1,21928,-2117.69,-7760457.34,46436706.32,38676248.98
2015-04-27,2108.92,-8.77,-0.41,2117.69,-0.41,True,1,21929,-2108.92,-7762566.26,46246506.68,38483940.42
2015-04-28,2114.76,5.84,0.28,2117.69,-0.14,True,1,21930,-2114.76,-7764681.02,46376686.8,38612005.78
2015-04-29,2106.85,-7.91,-0.37,2117.69,-0.51,True,1,21931,-2106.85,-7766787.87,46205327.35,38438539.48
2015-04-30,2085.51,-21.34,-1.01,2117.69,-1.52,True,1,21932,-2085.51,-7768873.38,45739405.32,37970531.94
2015-05-01,2108.29,22.78,1.09,2117.69,-0.44,True,1,21933,-2108.29,-7770981.67,46241124.57,38470142.9
2015-05-04,2114.49,6.2,0.29,2117.69,-0.15,True,1,21934,-2114.49,-7773096.16,46379223.66,38606127.5
2015-05-05,2089.46,-25.03,-1.18,2117.69,-1.33,True,1,21935,-2089.46,-7775185.62,45832305.1,38057119.48
2015-05-06,2080.15,-9.31,-0.45,2117.69,-1.77,True,1,21936,-2080.15,-7777265.77,45630170.4,37852904.63
2015-05-07,2088.0,7.85,0.38,2117.69,-1.4,True,1,21937,-2088.0,-7779353.77,45804456.0,38025102.23
2015-05-08,2116.1,28.1,1.35,2117.69,-0.08,True,1,21938,-2116.1,-7781469.87,46423001.8,38641531.93
2015-05-11,2105.33,-10.77,-0.51,2117.69,-0.58,True,1,21939,-2105.33,-7783575.2,46188834.87,38405259.67
2015-05-12,2099.12,-6.21,-0.3,2117.69,-0.88,True,1,21940,-2099.12,-7785674.32,46054692.8,38269018.48
2015-05-13,2098.48,-0.64,-0.03,2117.69,-0.91,True,1,21941,-2098.48,-7787772.8,46042749.68,38254976.88
2015-05-14,2121.1,22.62,1.08,2121.1,0.0,True,1,21942,-2121.1,-7789893.9,46541176.2,38751282.3
2015-05-15,2122.73,1.63,0.08,2122.73,0.0,True,1,21943,-2122.73,-7792016.63,46579064.39,38787047.76
2015-05-18,2129.2,6.47,0.3,2129.2,0.0,True,1,21944,-2129.2,-7794145.83,46723164.8,38929018.97
2015-05-19,2127.83,-1.37,-0.06,2129.2,-0.06,True,1,21945,-2127.83,-7796273.66,46695229.35,38898955.69
2015-05-20,2125.85,-1.98,-0.09,2129.2,-0.16,True,1,21946,-2125.85,-7798399.51,46653904.1,38855504.59
2015-05-21,2130.82,4.97,0.23,2130.82,0.0,True,1,21947,-2130.82,-7800530.33,46765106.54,38964576.21
2015-05-22,2126.06,-4.76,-0.22,2130.82,-0.22,True,1,21948,-2126.06,-7802656.39,46662764.88,38860108.49
2015-05-26,2104.2,-21.86,-1.03,2130.82,-1.25,True,1,21949,-2104.2,-7804760.59,46185085.8,38380325.21
2015-05-27,2123.48,19.28,0.92,2130.82,-0.34,True,1,21950,-2123.48,-7806884.07,46610386.0,38803501.93
2015-05-28,2120.79,-2.69,-0.13,2130.82,-0.47,True,1,21951,-2120.79,-7809004.86,46553461.29,38744456.43
2015-05-29,2107.39,-13.4,-0.63,2130.82,-1.1,True,1,21952,-2107.39,-7811112.25,46261425.28,38450313.03
2015-06-01,2111.73,4.34,0.21,2130.82,-0.9,True,1,21953,-2111.73,-7813223.98,46358808.69,38545584.71
2015-06-02,2109.6,-2.13,-0.1,2130.82,-1.0,True,1,21954,-2109.6,-7815333.58,46314158.4,38498824.82
2015-06-03,2114.07,4.47,0.21,2130.82,-0.79,True,1,21955,-2114.07,-7817447.65,46414406.85,38596959.2
2015-06-04,2095.84,-18.23,-0.86,2130.82,-1.64,True,1,21956,-2095.84,-7819543.49,46016263.04,38196719.55
2015-06-05,2092.83,-3.01,-0.14,2130.82,-1.78,True,1,21957,-2092.83,-7821636.32,45952268.31,38130631.99
2015-06-08,2079.28,-13.55,-0.65,2130.82,-2.42,True,1,21958,-2079.28,-7823715.6,45656830.24,37833114.64
2015-06-09,2080.15,0.87,0.04,2130.82,-2.38,True,1,21959,-2080.15,-7825795.75,45678013.85,37852218.1
2015-06-10,2105.2,25.05,1.2,2130.82,-1.2,True,1,21960,-2105.2,-7827900.95,46230192.0,38402291.05
2015-06-11,2108.86,3.66,0.17,2130.82,-1.03,True,1,21961,-2108.86,-7830009.81,46312674.46,38482664.65
2015-06-12,2094.11,-14.75,-0.7,2130.82,-1.72,True,1,21962,-2094.11,-7832103.92,45990843.82,38158739.9
2015-06-15,2084.43,-9.68,-0.46,2130.82,-2.18,True,1,21963,-2084.43,-7834188.35,45780336.09,37946147.74
2015-06-16,2096.29,11.86,0.57,2130.82,-1.62,True,1,21964,-2096.29,-7836284.64,46042913.56,38206628.92
2015-06-17,2100.44,4.15,0.2,2130.82,-1.43,True,1,21965,-2100.44,-7838385.08,46136164.6,38297779.52
2015-06-18,2121.24,20.8,0.99,2130.82,-0.45,True,1,21966,-2121.24,-7840506.32,46595157.84,38754651.52
2015-06-19,2109.99,-11.25,-0.53,2130.82,-0.98,True,1,21967,-2109.99,-7842616.31,46350150.33,38507534.02
2015-06-22,2122.85,12.86,0.61,2130.82,-0.37,True,1,21968,-2122.85,-7844739.16,46634768.8,38790029.64
2015-06-23,2124.2,1.35,0.06,2130.82,-0.31,True,1,21969,-2124.2,-7846863.36,46666549.8,38819686.44
2015-06-24,2108.58,-15.62,-0.74,2130.82,-1.04,True,1,21970,-2108.58,-7848971.94,46325502.6,38476530.66
2015-06-25,2102.31,-6.27,-0.3,2130.82,-1.34,True,1,21971,-2102.31,-7851074.25,46189853.01,38338778.76
2015-06-26,2101.49,-0.82,-0.04,2130.82,-1.38,True,1,21972,-2101.49,-7853175.74,46173938.28,38320762.54
2015-06-29,2057.64,-43.85,-2.09,2130.82,-3.43,True,1,21973,-2057.64,-7855233.38,45212523.72,37357290.34
2015-06-30,2063.11,5.47,0.27,2130.82,-3.18,True,1,21974,-2063.11,-7857296.49,45334779.14,37477482.65
2015-07-01,2077.42,14.31,0.69,2130.82,-2.51,True,1,21975,-2077.42,-7859373.91,45651304.5,37791930.59
2015-07-02,2076.78,-0.64,-0.03,2130.82,-2.54,True,1,21976,-2076.78,-7861450.69,45639317.28,37777866.59
2015-07-06,2068.76,-8.02,-0.39,2130.82,-2.91,True,1,21977,-2068.76,-7863519.45,45465138.52,37601619.07
2015-07-07,2081.34,12.58,0.61,2130.82,-2.32,True,1,21978,-2081.34,-7865600.79,45743690.52,37878089.73
2015-07-08,2046.68,-34.66,-1.66,2130.82,-3.95,True,1,21979,-2046.68,-7867647.47,44983979.72,37116332.25
2015-07-09,2051.31,4.63,0.23,2130.82,-3.73,True,1,21980,-2051.31,-7869698.78,45087793.8,37218095.02
2015-07-10,2076.62,25.31,1.23,2130.82,-2.54,True,1,21981,-2076.62,-7871775.4,45646184.22,37774408.82
2015-07-13,2099.6,22.98,1.11,2130.82,-1.46,True,1,21982,-2099.6,-7873875.0,46153407.2,38279532.2
2015-07-14,2108.95,9.35,0.44,2130.82,-1.03,True,1,21983,-2108.95,-7875983.95,46361047.85,38485063.9
2015-07-15,2107.4,-1.55,-0.07,2130.82,-1.1,True,1,21984,-2107.4,-7878091.35,46329081.6,38450990.25
2015-07-16,2124.29,16.89,0.8,2130.82,-0.31,True,1,21985,-2124.29,-7880215.64,46702515.65,38822300.01
2015-07-17,2126.64,2.35,0.11,2130.82,-0.2,True,1,21986,-2126.64,-7882342.28,46756307.04,38873964.76
2015-07-20,2128.28,1.64,0.08,2130.82,-0.12,True,1,21987,-2128.28,-7884470.56,46794492.36,38910021.8
2015-07-21,2119.21,-9.07,-0.43,2130.82,-0.55,True,1,21988,-2119.21,-7886589.77,46597189.48,38710599.71
2015-07-22,2114.15,-5.06,-0.24,2130.82,-0.78,True,1,21989,-2114.15,-7888703.92,46488044.35,38599340.43
2015-07-23,2102.15,-12.0,-0.57,2130.82,-1.34,True,1,21990,-2102.15,-7890806.07,46226278.5,38335472.43
2015-07-24,2079.65,-22.5,-1.07,2130.82,-2.4,True,1,21991,-2079.65,-7892885.72,45733583.15,37840697.43
2015-07-27,2067.64,-12.01,-0.58,2130.82,-2.96,True,1,21992,-2067.64,-7894953.36,45471538.88,37576585.52
2015-07-28,2093.25,25.61,1.24,2130.82,-1.76,True,1,21993,-2093.25,-7897046.61,46036847.25,38139800.64
2015-07-29,2108.57,15.32,0.73,2130.82,-1.04,True,1,21994,-2108.57,-7899155.18,46375888.58,38476733.4
2015-07-30,2108.63,0.06,0.0,2130.82,-1.04,True,1,21995,-2108.63,-7901263.81,46379316.85,38478053.04
2015-07-31,2103.84,-4.79,-0.23,2130.82,-1.27,True,1,21996,-2103.84,-7903367.65,46276064.64,38372696.99
2015-08-03,2098.04,-5.8,-0.28,2130.82,-1.54,True,1,21997,-2098.04,-7905465.69,46150585.88,38245120.19
2015-08-04,2093.32,-4.72,-0.22,2130.82,-1.76,True,1,21998,-2093.32,-7907559.01,46048853.36,38141294.35
2015-08-05,2099.84,6.52,0.31,2130.82,-1.45,True,1,21999,-2099.84,-7909658.85,46194380.16,38284721.31
2015-08-06,2083.56,-16.28,-0.78,2130.82,-2.22,True,1,22000,-2083.56,-7911742.41,45838320.0,37926577.59
2015-08-07,2077.57,-5.99,-0.29,2130.82,-2.5,True,1,22001,-2077.57,-7913819.98,45708617.57,37794797.59
2015-08-10,2104.18,26.61,1.28,2130.82,-1.25,True,1,22002,-2104.18,-7915924.16,46296168.36,38380244.2
2015-08-11,2084.07,-20.11,-0.96,2130.82,-2.19,True,1,22003,-2084.07,-7918008.23,45855792.21,37937783.98
2015-08-12,2086.05,1.98,0.1,2130.82,-2.1,True,1,22004,-2086.05,-7920094.28,45901444.2,37981349.92
2015-08-13,2083.39,-2.66,-0.13,2130.82,-2.23,True,1,22005,-2083.39,-7922177.67,45844996.95,37922819.28
2015-08-14,2091.54,8.15,0.39,2130.82,-1.84,True,1,22006,-2091.54,-7924269.21,46026429.24,38102160.03
2015-08-17,2102.44,10.9,0.52,2130.82,-1.33,True,1,22007,-2102.44,-7926371.65,46268397.08,38342025.43
2015-08-18,2096.92,-5.52,-0.26,2130.82,-1.59,True,1,22008,-2096.92,-7928468.57,46149015.36,38220546.79
2015-08-19,2079.61,-17.31,-0.82,2130.82,-2.4,True,1,22009,-2079.61,-7930548.18,45770136.49,37839588.31
2015-08-20,2035.73,-43.88,-2.11,2130.82,-4.46,True,1,22010,-2035.73,-7932583.91,44806417.3,36873833.39
2015-08-21,1970.89,-64.84,-3.18,2130.82,-7.51,True,1,22011,-1970.89,-7934554.8,43381259.79,35446704.99
2015-08-24,1893.21,-77.68,-3.94,2130.82,-11.15,True,1,22012,-1893.21,-7936448.01,41673338.52,33736890.51
2015-08-25,1867.61,-25.6,-1.35,2130.82,-12.35,True,1,22013,-1867.61,-7938315.62,41111698.93,33173383.31
2015-08-26,1940.51,72.9,3.9,2130.82,-8.93,True,1,22014,-1940.51,-7940256.13,42718387.14,34778131.01
2015-08-27,1987.66,47.15,2.43,2130.82,-6.72,True,1,22015,-1987.66,-7942243.79,43758334.9,35816091.11
2015-08-28,1988.87,1.21,0.06,2130.82,-6.66,True,1,22016,-1988.87,-7944232.66,43786961.92,35842729.26
2015-08-31,1972.18,-16.69,-0.84,2130.82,-7.44,True,1,22017,-1972.18,-7946204.84,43421487.06,35475282.22
2015-09-01,1913.85,-58.33,-2.96,2130.82,-10.18,True,1,22018,-1913.85,-7948118.69,42139149.3,34191030.61
2015-09-02,1948.86,35.01,1.83,2130.82,-8.54,True,1,22019,-1948.86,-7950067.55,42911948.34,34961880.79
2015-09-03,1951.13,2.27,0.12,2130.82,-8.43,True,1,22020,-1951.13,-7952018.68,42963882.6,35011863.92
2015-09-04,1921.22,-29.91,-1.53,2130.82,-9.84,True,1,22021,-1921.22,-7953939.9,42307185.62,34353245.72
2015-09-08,1969.41,48.19,2.51,2130.82,-7.58,True,1,22022,-1969.41,-7955909.31,43370347.02,35414437.71
2015-09-09,1942.04,-27.37,-1.39,2130.82,-8.86,True,1,22023,-1942.04,-7957851.35,42769546.92,34811695.57
2015-09-10,1952.29,10.25,0.53,2130.82,-8.38,True,1,22024,-1952.29,-7959803.64,42997234.96,35037431.32
2015-09-11,1961.05,8.76,0.45,2130.82,-7.97,True,1,22025,-1961.05,-7961764.69,43192126.25,35230361.56
2015-09-14,1953.03,-8.02,-0.41,2130.82,-8.34,True,1,22026,-1953.03,-7963717.72,43017438.78,35053721.06
2015-09-15,1978.09,25.06,1.28,2130.82,-7.17,True,1,22027,-1978.09,-7965695.81,43571388.43,35605692.62
2015-09-16,1995.31,17.22,0.87,2130.82,-6.36,True,1,22028,-1995.31,-7967691.12,43952688.68,35984997.56
2015-09-17,1990.2,-5.11,-0.26,2130.82,-6.6,True,1,22029,-1990.2,-7969681.32,43842115.8,35872434.48
2015-09-18,1958.03,-32.17,-1.62,2130.82,-8.11,True,1,22030,-1958.03,-7971639.35,43135400.9,35163761.55
2015-09-21,1966.97,8.94,0.46,2130.82,-7.69,True,1,22031,-1966.97,-7973606.32,43334316.07,35360709.75
2015-09-22,1942.74,-24.23,-1.23,2130.82,-8.83,True,1,22032,-1942.74,-7975549.06,42802447.68,34826898.62
2015-09-23,1938.76,-3.98,-0.2,2130.82,-9.01,True,1,22033,-1938.76,-7977487.82,42716699.08,34739211.26
2015-09-24,1932.24,-6.52,-0.34,2130.82,-9.32,True,1,22034,-1932.24,-7979420.06,42574976.16,34595556.1
2015-09-25,1931.34,-0.9,-0.05,2130.82,-9.36,True,1,22035,-1931.34,-7981351.4,42557076.9,34575725.5
2015-09-28,1881.77,-49.57,-2.57,2130.82,-11.69,True,1,22036,-1881.77,-7983233.17,41466683.72,33483450.55
2015-09-29,1884.09,2.32,0.12,2130.82,-11.58,True,1,22037,-1884.09,-7985117.26,41519691.33,33534574.07
2015-09-30,1920.03,35.94,1.91,2130.82,-9.89,True,1,22038,-1920.03,-7987037.29,42313621.14,34326583.85
2015-10-01,1923.82,3.79,0.2,2130.82,-9.72,True,1,22039,-1923.82,-7988961.11,42399068.98,34410107.87
2015-10-02,1951.36,27.54,1.43,2130.82,-8.42,True,1,22040,-1951.36,-7990912.47,43007974.4,35017061.93
2015-10-05,1987.05,35.69,1.83,2130.82,-6.75,True,1,22041,-1987.05,-7992899.52,43796569.05,35803669.53
2015-10-06,1979.92,-7.13,-0.36,2130.82,-7.08,True,1,22042,-1979.92,-7994879.44,43641396.64,35646517.2
2015-10-07,1995.83,15.91,0.8,2130.82,-6.34,True,1,22043,-1995.83,-7996875.27,43994080.69,35997205.42
2015-10-08,2013.43,17.6,0.88,2130.82,-5.51,True,1,22044,-2013.43,-7998888.7,44384050.92,36385162.22
2015-10-09,2014.89,1.46,0.07,2130.82,-5.44,True,1,22045,-2014.89,-8000903.59,44418250.05,36417346.46
2015-10-12,2017.46,2.57,0.13,2130.82,-5.32,True,1,22046,-2017.46,-8002921.05,44476923.16,36474002.11
2015-10-13,2003.69,-13.77,-0.68,2130.82,-5.97,True,1,22047,-2003.69,-8004924.74,44175353.43,36170428.69
2015-10-14,1994.24,-9.45,-0.47,2130.82,-6.41,True,1,22048,-1994.24,-8006918.98,43969003.52,35962084.54
2015-10-15,2023.86,29.62,1.48,2130.82,-5.02,True,1,22049,-2023.86,-8008942.84,44624089.14,36615146.3
2015-10-16,2033.11,9.25,0.46,2130.82,-4.59,True,1,22050,-2033.11,-8010975.95,44830075.5,36819099.55
2015-10-19,2033.66,0.55,0.03,2130.82,-4.56,True,1,22051,-2033.66,-8013009.61,44844236.66,36831227.05
2015-10-20,2030.77,-2.89,-0.14,2130.82,-4.7,True,1,22052,-2030.77,-8015040.38,44782540.04,36767499.66
2015-10-21,2018.94,-11.83,-0.58,2130.82,-5.25,True,1,22053,-2018.94,-8017059.32,44523683.82,36506624.5
2015-10-22,2052.51,33.57,1.66,2130.82,-3.68,True,1,22054,-2052.51,-8019111.83,45266055.54,37246943.71
2015-10-23,2075.15,22.64,1.1,2130.82,-2.61,True,1,22055,-2075.15,-8021186.98,45767433.25,37746246.27
2015-10-26,2071.18,-3.97,-0.19,2130.82,-2.8,True,1,22056,-2071.18,-8023258.16,45681946.08,37658687.92
2015-10-27,2065.89,-5.29,-0.26,2130.82,-3.05,True,1,22057,-2065.89,-8025324.05,45567335.73,37542011.68
2015-10-28,2090.35,24.46,1.18,2130.82,-1.9,True,1,22058,-2090.35,-8027414.4,46108940.3,38081525.9
2015-10-29,2089.41,-0.94,-0.04,2130.82,-1.94,True,1,22059,-2089.41,-8029503.81,46090295.19,38060791.38
2015-10-30,2079.36,-10.05,-0.48,2130.82,-2.42,True,1,22060,-2079.36,-8031583.17,45870681.6,37839098.43
2015-11-02,2104.05,24.69,1.19,2130.82,-1.26,True,1,22061,-2104.05,-8033687.22,46417447.05,38383759.83
2015-11-03,2109.79,5.74,0.27,2130.82,-0.99,True,1,22062,-2109.79,-8035797.01,46546186.98,38510389.97
2015-11-04,2102.31,-7.48,-0.36,2130.82,-1.34,True,1,22063,-2102.31,-8037899.32,46383265.53,38345366.21
2015-11-05,2099.93,-2.38,-0.11,2130.82,-1.45,True,1,22064,-2099.93,-8039999.25,46332855.52,38292856.27
2015-11-06,2099.2,-0.73,-0.04,2130.82,-1.48,True,1,22065,-2099.2,-8042098.45,46318848.0,38276749.55
2015-11-09,2078.58,-20.62,-0.98,2130.82,-2.45,True,1,22066,-2078.58,-8044177.03,45865946.28,37821769.25
2015-11-10,2081.72,3.14,0.15,2130.82,-2.3,True,1,22067,-2081.72,-8046258.75,45937315.24,37891056.49
2015-11-11,2075.0,-6.72,-0.32,2130.82,-2.62,True,1,22068,-2075.0,-8048333.75,45791100.0,37742766.25
2015-11-12,2045.97,-29.03,-1.4,2130.82,-3.98,True,1,22069,-2045.97,-8050379.72,45152511.93,37102132.21
2015-11-13,2023.04,-22.93,-1.12,2130.82,-5.06,True,1,22070,-2023.04,-8052402.76,44648492.8,36596090.04
2015-11-16,2053.19,30.15,1.49,2130.82,-3.64,True,1,22071,-2053.19,-8054455.95,45315956.49,37261500.54
2015-11-17,2050.44,-2.75,-0.13,2130.82,-3.77,True,1,22072,-2050.44,-8056506.39,45257311.68,37200805.29
2015-11-18,2083.58,33.14,1.62,2130.82,-2.22,True,1,22073,-2083.58,-8058589.97,45990861.34,37932271.37
2015-11-19,2081.24,-2.34,-0.11,2130.82,-2.33,True,1,22074,-2081.24,-8060671.21,45941291.76,37880620.55
2015-11-20,2089.17,7.93,0.38,2130.82,-1.96,True,1,22075,-2089.17,-8062760.38,46118427.75,38055667.37
2015-11-23,2086.59,-2.58,-0.12,2130.82,-2.08,True,1,22076,-2086.59,-8064846.97,46063560.84,37998713.87
2015-11-24,2089.14,2.55,0.12,2130.82,-1.96,True,1,22077,-2089.14,-8066936.11,46121943.78,38055007.67
2015-11-25,2088.87,-0.27,-0.01,2130.82,-1.97,True,1,22078,-2088.87,-8069024.98,46118071.86,38049046.88
2015-11-27,2090.11,1.24,0.06,2130.82,-1.91,True,1,22079,-2090.11,-8071115.09,46147538.69,38076423.6
2015-11-30,2080.41,-9.7,-0.46,2130.82,-2.37,True,1,22080,-2080.41,-8073195.5,45935452.8,37862257.3
2015-12-01,2102.63,22.22,1.07,2130.82,-1.32,True,1,22081,-2102.63,-8075298.13,46428173.03,38352874.9
2015-12-02,2079.51,-23.12,-1.1,2130.82,-2.41,True,1,22082,-2079.51,-8077377.64,45919739.82,37842362.18
2015-12-03,2049.62,-29.89,-1.44,2130.82,-3.81,True,1,22083,-2049.62,-8079427.26,45261758.46,37182331.2
2015-12-04,2091.69,42.07,2.05,2130.82,-1.84,True,1,22084,-2091.69,-8081518.95,46192881.96,38111363.01
2015-12-07,2077.07,-14.62,-0.7,2130.82,-2.52,True,1,22085,-2077.07,-8083596.02,45872090.95,37788494.93
2015-12-08,2063.59,-13.48,-0.65,2130.82,-3.16,True,1,22086,-2063.59,-8085659.61,45576448.74,37490789.13
2015-12-09,2047.62,-15.97,-0.77,2130.82,-3.9,True,1,22087,-2047.62,-8087707.23,45225782.94,37138075.71
2015-12-10,2052.23,4.61,0.22,2130.82,-3.69,True,1,22088,-2052.23,-8089759.46,45329656.24,37239896.78
2015-12-11,2012.37,-39.86,-1.94,2130.82,-5.56,True,1,22089,-2012.37,-8091771.83,44451240.93,36359469.1
2015-12-14,2021.94,9.57,0.48,2130.82,-5.11,True,1,22090,-2021.94,-8093793.77,44664654.6,36570860.83
2015-12-15,2043.41,21.47,1.06,2130.82,-4.1,True,1,22091,-2043.41,-8095837.18,45140970.31,37045133.13
2015-12-16,2073.07,29.66,1.45,2130.82,-2.71,True,1,22092,-2073.07,-8097910.25,45798262.44,37700352.19
2015-12-17,2041.89,-31.18,-1.5,2130.82,-4.17,True,1,22093,-2041.89,-8099952.14,45111475.77,37011523.63
2015-12-18,2005.55,-36.34,-1.78,2130.82,-5.88,True,1,22094,-2005.55,-8101957.69,44310621.7,36208664.01
2015-12-21,2021.15,15.6,0.78,2130.82,-5.15,True,1,22095,-2021.15,-8103978.84,44657309.25,36553330.41
2015-12-22,2038.97,17.82,0.88,2130.82,-4.31,True,1,22096,-2038.97,-8106017.81,45053081.12,36947063.31
2015-12-23,2064.29,25.32,1.24,2130.82,-3.12,True,1,22097,-2064.29,-8108082.1,45614616.13,37506534.03
2015-12-24,2060.99,-3.3,-0.16,2130.82,-3.28,True,1,22098,-2060.99,-8110143.09,45543757.02,37433613.93
2015-12-28,2056.5,-4.49,-0.22,2130.82,-3.49,True,1,22099,-2056.5,-8112199.59,45446593.5,37334393.91
2015-12-29,2078.36,21.86,1.06,2130.82,-2.46,True,1,22100,-2078.36,-8114277.95,45931756.0,37817478.05
2015-12-30,2063.36,-15.0,-0.72,2130.82,-3.17,True,1,22101,-2063.36,-8116341.31,45602319.36,37485978.05
2015-12-31,2043.94,-19.42,-0.94,2130.82,-4.08,True,1,22102,-2043.94,-8118385.25,45175161.88,37056776.63
2016-01-04,2012.66,-31.28,-1.53,2130.82,-5.54,True,1,22103,-2012.66,-8120397.91,44485823.98,36365426.07
2016-01-05,2016.71,4.05,0.2,2130.82,-5.36,True,1,22104,-2016.71,-8122414.62,44577357.84,36454943.22
2016-01-06,1990.26,-26.45,-1.31,2130.82,-6.6,True,1,22105,-1990.26,-8124404.88,43994697.3,35870292.42
2016-01-07,1943.09,-47.17,-2.37,2130.82,-8.81,True,1,22106,-1943.09,-8126347.97,42953947.54,34827599.57
2016-01-08,1922.03,-21.06,-1.08,2130.82,-9.8,True,1,22107,-1922.03,-8128270.0,42490317.21,34362047.21
2016-01-11,1923.67,1.64,0.08,2130.82,-9.72,True,1,22108,-1923.67,-8130193.67,42528496.36,34398302.69
2016-01-12,1938.68,15.01,0.78,2130.82,-9.02,True,1,22109,-1938.68,-8132132.35,42862276.12,34730143.77
2016-01-13,1890.28,-48.4,-2.5,2130.82,-11.29,True,1,22110,-1890.28,-8134022.63,41794090.8,33660068.17
2016-01-14,1921.84,31.56,1.67,2130.82,-9.81,True,1,22111,-1921.84,-8135944.47,42493804.24,34357859.77
2016-01-15,1880.33,-41.51,-2.16,2130.82,-11.76,True,1,22112,-1880.33,-8137824.8,41577856.96,33440032.16
2016-01-19,1881.33,1.0,0.05,2130.82,-11.71,True,1,22113,-1881.33,-8139706.13,41601850.29,33462144.16
2016-01-20,1859.33,-22.0,-1.17,2130.82,-12.74,True,1,22114,-1859.33,-8141565.46,41117223.62,32975658.16
2016-01-21,1868.99,9.66,0.52,2130.82,-12.29,True,1,22115,-1868.99,-8143434.45,41332713.85,33189279.4
2016-01-22,1906.9,37.91,2.03,2130.82,-10.51,True,1,22116,-1906.9,-8145341.35,42173000.4,34027659.05
2016-01-25,1877.08,-29.82,-1.56,2130.82,-11.91,True,1,22117,-1877.08,-8147218.43,41515378.36,33368159.93
2016-01-26,1903.63,26.55,1.41,2130.82,-10.66,True,1,22118,-1903.63,-8149122.06,42104488.34,33955366.28
2016-01-27,1882.95,-20.68,-1.09,2130.82,-11.63,True,1,22119,-1882.95,-8151005.01,41648971.05,33497966.04
2016-01-28,1893.36,10.41,0.55,2130.82,-11.14,True,1,22120,-1893.36,-8152898.37,41881123.2,33728224.83
2016-01-29,1940.24,46.88,2.48,2130.82,-8.94,True,1,22121,-1940.24,-8154838.61,42920049.04,34765210.43
2016-02-01,1939.38,-0.86,-0.04,2130.82,-8.98,True,1,22122,-1939.38,-8156777.99,42902964.36,34746186.37
2016-02-02,1903.03,-36.35,-1.87,2130.82,-10.69,True,1,22123,-1903.03,-8158681.02,42100732.69,33942051.67
2016-02-03,1912.53,9.5,0.5,2130.82,-10.24,True,1,22124,-1912.53,-8160593.55,42312813.72,34152220.17
2016-02-04,1915.45,2.92,0.15,2130.82,-10.11,True,1,22125,-1915.45,-8162509.0,42379331.25,34216822.25
2016-02-05,1880.05,-35.4,-1.85,2130.82,-11.77,True,1,22126,-1880.05,-8164389.05,41597986.3,33433597.25
2016-02-08,1853.44,-26.61,-1.42,2130.82,-13.02,True,1,22127,-1853.44,-8166242.49,41011066.88,32844824.39
2016-02-09,1852.21,-1.23,-0.07,2130.82,-13.08,True,1,22128,-1852.21,-8168094.7,40985702.88,32817608.18
2016-02-10,1851.86,-0.35,-0.02,2130.82,-13.09,True,1,22129,-1851.86,-8169946.56,40979809.94,32809863.38
2016-02-11,1829.08,-22.78,-1.23,2130.82,-14.16,True,1,22130,-1829.08,-8171775.64,40477540.4,32305764.76
2016-02-12,1864.78,35.7,1.95,2130.82,-12.48,True,1,22131,-1864.78,-8173640.42,41269446.18,33095805.76
2016-02-16,1895.58,30.8,1.65,2130.82,-11.04,True,1,22132,-1895.58,-8175536.0,41952976.56,33777440.56
2016-02-17,1926.82,31.24,1.65,2130.82,-9.57,True,1,22133,-1926.82,-8177462.82,42646307.06,34468844.24
2016-02-18,1917.83,-8.99,-0.47,2130.82,-10.0,True,1,22134,-1917.83,-8179380.65,42449249.22,34269868.57
2016-02-19,1917.78,-0.05,-0.0,2130.82,-10.0,True,1,22135,-1917.78,-8181298.43,42450060.3,34268761.87
2016-02-22,1945.5,27.72,1.44,2130.82,-8.7,True,1,22136,-1945.5,-8183243.93,43065588.0,34882344.07
2016-02-23,1921.27,-24.23,-1.25,2130.82,-9.83,True,1,22137,-1921.27,-8185165.2,42531153.99,34345988.79
2016-02-24,1929.8,8.53,0.44,2130.82,-9.43,True,1,22138,-1929.8,-8187095.0,42721912.4,34534817.4
2016-02-25,1951.7,21.9,1.14,2130.82,-8.41,True,1,22139,-1951.7,-8189046.7,43208686.3,35019639.6
2016-02-26,1948.05,-3.65,-0.19,2130.82,-8.58,True,1,22140,-1948.05,-8190994.75,43129827.0,34938832.25
2016-02-29,1932.23,-15.82,-0.81,2130.82,-9.32,True,1,22141,-1932.23,-8192926.98,42781504.43,34588577.45
2016-03-01,1978.35,46.12,2.39,2130.82,-7.16,True,1,22142,-1978.35,-8194905.33,43804625.7,35609720.37
2016-03-02,1986.45,8.1,0.41,2130.82,-6.78,True,1,22143,-1986.45,-8196891.78,43985962.35,35789070.57
2016-03-03,1993.4,6.95,0.35,2130.82,-6.45,True,1,22144,-1993.4,-8198885.18,44141849.6,35942964.42
2016-03-04,1999.99,6.59,0.33,2130.82,-6.14,True,1,22145,-1999.99,-8200885.17,44289778.55,36088893.38
2016-03-07,2001.76,1.77,0.09,2130.82,-6.06,True,1,22146,-2001.76,-8202886.93,44330976.96,36128090.03
2016-03-08,1979.26,-22.5,-1.12,2130.82,-7.11,True,1,22147,-1979.26,-8204866.19,43834671.22,35629805.03
2016-03-09,1989.26,10.0,0.5,2130.82,-6.64,True,1,22148,-1989.26,-8206855.45,44058130.48,35851275.03
2016-03-10,1989.57,0.31,0.02,2130.82,-6.63,True,1,22149,-1989.57,-8208845.02,44066985.93,35858140.91
2016-03-11,2022.19,32.62,1.64,2130.82,-5.1,True,1,22150,-2022.19,-8210867.21,44791508.5,36580641.29
2016-03-14,2019.64,-2.55,-0.13,2130.82,-5.22,True,1,22151,-2019.64,-8212886.85,44737045.64,36524158.79
2016-03-15,2015.93,-3.71,-0.18,2130.82,-5.39,True,1,22152,-2015.93,-8214902.78,44656881.36,36441978.58
2016-03-16,2027.22,11.29,0.56,2130.82,-4.86,True,1,22153,-2027.22,-8216930.0,44909004.66,36692074.66
2016-03-17,2040.59,13.37,0.66,2130.82,-4.24,True,1,22154,-2040.59,-8218970.59,45207230.86,36988260.27
2016-03-18,2049.58,8.99,0.44,2130.82,-3.81,True,1,22155,-2049.58,-8221020.17,45408444.9,37187424.73
2016-03-21,2051.6,2.02,0.1,2130.82,-3.72,True,1,22156,-2051.6,-8223071.77,45455249.6,37232177.83
2016-03-22,2049.8,-1.8,-0.09,2130.82,-3.8,True,1,22157,-2049.8,-8225121.57,45417418.6,37192297.03
2016-03-23,2036.71,-13.09,-0.64,2130.82,-4.42,True,1,22158,-2036.71,-8227158.28,45129420.18,36902261.9
2016-03-24,2035.94,-0.77,-0.04,2130.82,-4.45,True,1,22159,-2035.94,-8229194.22,45114394.46,36885200.24
2016-03-28,2037.05,1.11,0.06,2130.82,-4.4,True,1,22160,-2037.05,-8231231.27,45141028.0,36909796.73
2016-03-29,2055.01,17.96,0.88,2130.82,-3.56,True,1,22161,-2055.01,-8233286.28,45541076.61,37307790.33
2016-03-30,2063.95,8.94,0.44,2130.82,-3.14,True,1,22162,-2063.95,-8235350.23,45741259.9,37505909.67
2016-03-31,2059.74,-4.21,-0.2,2130.82,-3.34,True,1,22163,-2059.74,-8237409.97,45650017.62,37412607.65
2016-04-01,2072.78,13.04,0.63,2130.82,-2.72,True,1,22164,-2072.78,-8239482.75,45941095.92,37701613.17
2016-04-04,2066.13,-6.65,-0.32,2130.82,-3.04,True,1,22165,-2066.13,-8241548.88,45795771.45,37554222.57
2016-04-05,2045.17,-20.96,-1.01,2130.82,-4.02,True,1,22166,-2045.17,-8243594.05,45333238.22,37089644.17
2016-04-06,2066.66,21.49,1.05,2130.82,-3.01,True,1,22167,-2066.66,-8245660.71,45811652.22,37565991.51
2016-04-07,2041.91,-24.75,-1.2,2130.82,-4.17,True,1,22168,-2041.91,-8247702.62,45265060.88,37017358.26
2016-04-08,2047.6,5.69,0.28,2130.82,-3.91,True,1,22169,-2047.6,-8249750.22,45393244.4,37143494.18
2016-04-11,2041.99,-5.61,-0.27,2130.82,-4.17,True,1,22170,-2041.99,-8251792.21,45270918.3,37019126.09
2016-04-12,2061.72,19.73,0.97,2130.82,-3.24,True,1,22171,-2061.72,-8253853.93,45710394.12,37456540.19
2016-04-13,2082.42,20.7,1.0,2130.82,-2.27,True,1,22172,-2082.42,-8255936.35,46171416.24,37915479.89
2016-04-14,2082.78,0.36,0.02,2130.82,-2.26,True,1,22173,-2082.78,-8258019.13,46181480.94,37923461.81
2016-04-15,2080.73,-2.05,-0.1,2130.82,-2.35,True,1,22174,-2080.73,-8260099.86,46138107.02,37878007.16
2016-04-18,2094.34,13.61,0.65,2130.82,-1.71,True,1,22175,-2094.34,-8262194.2,46441989.5,38179795.3
2016-04-19,2100.8,6.46,0.31,2130.82,-1.41,True,1,22176,-2100.8,-8264295.0,46587340.8,38323045.8
2016-04-20,2102.4,1.6,0.08,2130.82,-1.33,True,1,22177,-2102.4,-8266397.4,46624924.8,38358527.4
2016-04-21,2091.48,-10.92,-0.52,2130.82,-1.85,True,1,22178,-2091.48,-8268488.88,46384843.44,38116354.56
2016-04-22,2091.58,0.1,0.0,2130.82,-1.84,True,1,22179,-2091.58,-8270580.46,46389152.82,38118572.36
2016-04-25,2087.79,-3.79,-0.18,2130.82,-2.02,True,1,22180,-2087.79,-8272668.25,46307182.2,38034513.95
2016-04-26,2091.7,3.91,0.19,2130.82,-1.84,True,1,22181,-2091.7,-8274759.95,46395997.7,38121237.75
2016-04-27,2095.15,3.45,0.16,2130.82,-1.67,True,1,22182,-2095.15,-8276855.1,46474617.3,38197762.2
2016-04-28,2075.81,-19.34,-0.92,2130.82,-2.58,True,1,22183,-2075.81,-8278930.91,46047693.23,37768762.32
2016-04-29,2065.3,-10.51,-0.51,2130.82,-3.08,True,1,22184,-2065.3,-8280996.21,45816615.2,37535618.99
2016-05-02,2081.43,16.13,0.78,2130.82,-2.32,True,1,22185,-2081.43,-8283077.64,46176524.55,37893446.91
2016-05-03,2063.37,-18.06,-0.87,2130.82,-3.16,True,1,22186,-2063.37,-8285141.01,45777926.82,37492785.81
2016-05-04,2051.12,-12.25,-0.59,2130.82,-3.74,True,1,22187,-2051.12,-8287192.13,45508199.44,37221007.31
2016-05-05,2050.63,-0.49,-0.02,2130.82,-3.76,True,1,22188,-2050.63,-8289242.76,45499378.44,37210135.68
2016-05-06,2057.14,6.51,0.32,2130.82,-3.46,True,1,22189,-2057.14,-8291299.9,45645879.46,37354579.56
2016-05-09,2058.69,1.55,0.08,2130.82,-3.38,True,1,22190,-2058.69,-8293358.59,45682331.1,37388972.51
2016-05-10,2084.39,25.7,1.25,2130.82,-2.18,True,1,22191,-2084.39,-8295442.98,46254698.49,37959255.51
2016-05-11,2064.46,-19.93,-0.96,2130.82,-3.11,True,1,22192,-2064.46,-8297507.44,45814496.32,37516988.88
2016-05-12,2064.11,-0.35,-0.02,2130.82,-3.13,True,1,22193,-2064.11,-8299571.55,45808793.23,37509221.68
2016-05-13,2046.61,-17.5,-0.85,2130.82,-3.95,True,1,22194,-2046.61,-8301618.16,45422462.34,37120844.18
2016-05-16,2066.66,20.05,0.98,2130.82,-3.01,True,1,22195,-2066.66,-8303684.82,45869518.7,37565833.88
2016-05-17,2047.21,-19.45,-0.94,2130.82,-3.92,True,1,22196,-2047.21,-8305732.03,45439873.16,37134141.13
2016-05-18,2047.63,0.42,0.02,2130.82,-3.9,True,1,22197,-2047.63,-8307779.66,45451243.11,37143463.45
2016-05-19,2040.04,-7.59,-0.37,2130.82,-4.26,True,1,22198,-2040.04,-8309819.7,45284807.92,36974988.22
2016-05-20,2052.32,12.28,0.6,2130.82,-3.68,True,1,22199,-2052.32,-8311872.02,45559451.68,37247579.66
2016-05-23,2048.04,-4.28,-0.21,2130.82,-3.88,True,1,22200,-2048.04,-8313920.06,45466488.0,37152567.94
2016-05-24,2076.06,28.02,1.37,2130.82,-2.57,True,1,22201,-2076.06,-8315996.12,46090608.06,37774611.94
2016-05-25,2090.54,14.48,0.7,2130.82,-1.89,True,1,22202,-2090.54,-8318086.66,46414169.08,38096082.42
2016-05-26,2090.1,-0.44,-0.02,2130.82,-1.91,True,1,22203,-2090.1,-8320176.76,46406490.3,38086313.54
2016-05-27,2099.06,8.96,0.43,2130.82,-1.49,True,1,22204,-2099.06,-8322275.82,46607528.24,38285252.42
2016-05-31,2096.95,-2.11,-0.1,2130.82,-1.59,True,1,22205,-2096.95,-8324372.77,46562774.75,38238401.98
2016-06-01,2099.33,2.38,0.11,2130.82,-1.48,True,1,22206,-2099.33,-8326472.1,46617721.98,38291249.88
2016-06-02,2105.26,5.93,0.28,2130.82,-1.2,True,1,22207,-2105.26,-8328577.36,46751508.82,38422931.46
2016-06-03,2099.13,-6.13,-0.29,2130.82,-1.49,True,1,22208,-2099.13,-8330676.49,46617479.04,38286802.55
2016-06-06,2109.41,10.28,0.49,2130.82,-1.0,True,1,22209,-2109.41,-8332785.9,46847886.69,38515100.79
2016-06-07,2112.13,2.72,0.13,2130.82,-0.88,True,1,22210,-2112.13,-8334898.03,46910407.3,38575509.27
2016-06-08,2119.12,6.99,0.33,2130.82,-0.55,True,1,22211,-2119.12,-8337017.15,47067774.32,38730757.17
2016-06-09,2115.48,-3.64,-0.17,2130.82,-0.72,True,1,22212,-2115.48,-8339132.63,46989041.76,38649909.13
2016-06-10,2096.07,-19.41,-0.92,2130.82,-1.63,True,1,22213,-2096.07,-8341228.7,46560002.91,38218774.21
2016-06-13,2079.06,-17.01,-0.81,2130.82,-2.43,True,1,22214,-2079.06,-8343307.76,46184238.84,37840931.08
2016-06-14,2075.32,-3.74,-0.18,2130.82,-2.6,True,1,22215,-2075.32,-8345383.08,46103233.8,37757850.72
2016-06-15,2071.5,-3.82,-0.18,2130.82,-2.78,True,1,22216,-2071.5,-8347454.58,46020444.0,37672989.42
2016-06-16,2077.99,6.49,0.31,2130.82,-2.48,True,1,22217,-2077.99,-8349532.57,46166703.83,37817171.26
2016-06-17,2071.22,-6.77,-0.33,2130.82,-2.8,True,1,22218,-2071.22,-8351603.79,46018365.96,37666762.17
2016-06-20,2083.25,12.03,0.58,2130.82,-2.23,True,1,22219,-2083.25,-8353687.04,46287731.75,37934044.71
2016-06-21,2088.9,5.65,0.27,2130.82,-1.97,True,1,22220,-2088.9,-8355775.94,46415358.0,38059582.06
2016-06-22,2085.45,-3.45,-0.16,2130.82,-2.13,True,1,22221,-2085.45,-8357861.39,46340784.45,37982923.06
2016-06-23,2113.32,27.87,1.34,2130.82,-0.82,True,1,22222,-2113.32,-8359974.71,46962197.04,38602222.33
2016-06-24,2037.41,-75.91,-3.59,2130.82,-4.38,True,1,22223,-2037.41,-8362012.12,45277362.43,36915350.31
2016-06-27,2000.54,-36.87,-1.81,2130.82,-6.11,True,1,22224,-2000.54,-8364012.66,44460000.96,36095988.3
2016-06-28,2036.09,35.55,1.78,2130.82,-4.45,True,1,22225,-2036.09,-8366048.75,45252100.25,36886051.5
2016-06-29,2070.77,34.68,1.7,2130.82,-2.82,True,1,22226,-2070.77,-8368119.52,46024934.02,37656814.5
2016-06-30,2098.86,28.09,1.36,2130.82,-1.5,True,1,22227,-2098.86,-8370218.38,46651361.22,38281142.84
2016-07-01,2102.95,4.09,0.2,2130.82,-1.31,True,1,22228,-2102.95,-8372321.33,46744372.6,38372051.27
2016-07-05,2088.55,-14.4,-0.68,2130.82,-1.98,True,1,22229,-2088.55,-8374409.88,46426377.95,38051968.07
2016-07-06,2099.73,11.18,0.54,2130.82,-1.46,True,1,22230,-2099.73,-8376509.61,46676997.9,38300488.29
2016-07-07,2097.9,-1.83,-0.09,2130.82,-1.54,True,1,22231,-2097.9,-8378607.51,46638414.9,38259807.39
2016-07-08,2129.9,32.0,1.52,2130.82,-0.04,True,1,22232,-2129.9,-8380737.41,47351936.8,38971199.39
2016-07-11,2137.16,7.26,0.34,2137.16,0.0,True,1,22233,-2137.16,-8382874.57,47515478.28,39132603.71
2016-07-12,2152.14,14.98,0.7,2152.14,0.0,True,1,22234,-2152.14,-8385026.71,47850680.76,39465654.05
2016-07-13,2152.43,0.29,0.01,2152.43,0.0,True,1,22235,-2152.43,-8387179.14,47859281.05,39472101.91
2016-07-14,2163.75,11.32,0.53,2163.75,0.0,True,1,22236,-2163.75,-8389342.89,48113145.0,39723802.11
2016-07-15,2161.74,-2.01,-0.09,2163.75,-0.09,True,1,22237,-2161.74,-8391504.63,48070612.38,39679107.75
2016-07-18,2166.89,5.15,0.24,2166.89,0.0,True,1,22238,-2166.89,-8393671.52,48187299.82,39793628.3
2016-07-19,2163.78,-3.11,-0.14,2166.89,-0.14,True,1,22239,-2163.78,-8395835.3,48120303.42,39724468.12
2016-07-20,2173.02,9.24,0.43,2173.02,0.0,True,1,22240,-2173.02,-8398008.32,48327964.8,39929956.48
2016-07-21,2165.17,-7.85,-0.36,2173.02,-0.36,True,1,22241,-2165.17,-8400173.49,48155545.97,39755372.48
2016-07-22,2175.03,9.86,0.46,2175.03,0.0,True,1,22242,-2175.03,-8402348.52,48377017.26,39974668.74
2016-07-25,2168.48,-6.55,-0.3,2175.03,-0.3,True,1,22243,-2168.48,-8404517.0,48233500.64,39828983.64
2016-07-26,2169.18,0.7,0.03,2175.03,-0.27,True,1,22244,-2169.18,-8406686.18,48251239.92,39844553.74
2016-07-27,2166.58,-2.6,-0.12,2175.03,-0.39,True,1,22245,-2166.58,-8408852.76,48195572.1,39786719.34
2016-07-28,2170.06,3.48,0.16,2175.03,-0.23,True,1,22246,-2170.06,-8411022.82,48275154.76,39864131.94
2016-07-29,2173.6,3.54,0.16,2175.03,-0.07,True,1,22247,-2173.6,-8413196.42,48356079.2,39942882.78
2016-08-01,2170.84,-2.76,-0.13,2175.03,-0.19,True,1,22248,-2170.84,-8415367.26,48296848.32,39881481.06
2016-08-02,2157.03,-13.81,-0.64,2175.03,-0.83,True,1,22249,-2157.03,-8417524.29,47991760.47,39574236.18
2016-08-03,2163.79,6.76,0.31,2175.03,-0.52,True,1,22250,-2163.79,-8419688.08,48144327.5,39724639.42
2016-08-04,2164.25,0.46,0.02,2175.03,-0.5,True,1,22251,-2164.25,-8421852.33,48156726.75,39734874.42
2016-08-05,2182.87,18.62,0.86,2182.87,0.0,True,1,22252,-2182.87,-8424035.2,48573223.24,40149188.04
2016-08-08,2180.89,-1.98,-0.09,2182.87,-0.09,True,1,22253,-2180.89,-8426216.09,48531345.17,40105129.08
2016-08-09,2181.74,0.85,0.04,2182.87,-0.05,True,1,22254,-2181.74,-8428397.83,48552441.96,40124044.13
2016-08-10,2175.49,-6.25,-0.29,2182.87,-0.34,True,1,22255,-2175.49,-8430573.32,48415529.95,39984956.63
2016-08-11,2185.79,10.3,0.47,2185.79,0.0,True,1,22256,-2185.79,-8432759.11,48646942.24,40214183.13
2016-08-12,2184.05,-1.74,-0.08,2185.79,-0.08,True,1,22257,-2184.05,-8434943.16,48610400.85,40175457.69
2016-08-15,2190.15,6.1,0.28,2190.15,0.0,True,1,22258,-2190.15,-8437133.31,48748358.7,40311225.39
2016-08-16,2178.15,-12.0,-0.55,2190.15,-0.55,True,1,22259,-2178.15,-8439311.46,48483440.85,40044129.39
2016-08-17,2182.22,4.07,0.19,2190.15,-0.36,True,1,22260,-2182.22,-8441493.68,48576217.2,40134723.52
2016-08-18,2187.02,4.8,0.22,2190.15,-0.14,True,1,22261,-2187.02,-8443680.7,48685252.22,40241571.52
2016-08-19,2183.87,-3.15,-0.14,2190.15,-0.29,True,1,22262,-2183.87,-8445864.57,48617313.94,40171449.37
2016-08-22,2182.64,-1.23,-0.06,2190.15,-0.34,True,1,22263,-2182.64,-8448047.21,48592114.32,40144067.11
2016-08-23,2186.9,4.26,0.2,2190.15,-0.15,True,1,22264,-2186.9,-8450234.11,48689141.6,40238907.49
2016-08-24,2175.44,-11.46,-0.52,2190.15,-0.67,True,1,22265,-2175.44,-8452409.55,48436171.6,39983762.05
2016-08-25,2172.47,-2.97,-0.14,2190.15,-0.81,True,1,22266,-2172.47,-8454582.02,48372217.02,39917635.0
2016-08-26,2169.04,-3.43,-0.16,2190.15,-0.96,True,1,22267,-2169.04,-8456751.06,48298013.68,39841262.62
2016-08-29,2180.38,11.34,0.52,2190.15,-0.45,True,1,22268,-2180.38,-8458931.44,48552701.84,40093770.4
2016-08-30,2176.12,-4.26,-0.2,2190.15,-0.64,True,1,22269,-2176.12,-8461107.56,48460016.28,39998908.72
2016-08-31,2170.95,-5.17,-0.24,2190.15,-0.88,True,1,22270,-2170.95,-8463278.51,48347056.5,39883777.99
2016-09-01,2170.86,-0.09,-0.0,2190.15,-0.88,True,1,22271,-2170.86,-8465449.37,48347223.06,39881773.69
2016-09-02,2179.98,9.12,0.42,2190.15,-0.46,True,1,22272,-2179.98,-8467629.35,48552514.56,40084885.21
2016-09-06,2186.48,6.5,0.3,2190.15,-0.17,True,1,22273,-2186.48,-8469815.83,48699469.04,40229653.21
2016-09-07,2186.16,-0.32,-0.02,2190.15,-0.18,True,1,22274,-2186.16,-8472001.99,48694527.84,40222525.85
2016-09-08,2181.3,-4.86,-0.22,2190.15,-0.4,True,1,22275,-2181.3,-8474183.29,48588457.5,40114274.21
2016-09-09,2127.81,-53.49,-2.45,2190.15,-2.85,True,1,22276,-2127.81,-8476311.1,47399095.56,38922784.46
2016-09-12,2159.04,31.23,1.47,2190.15,-1.42,True,1,22277,-2159.04,-8478470.14,48096934.08,39618463.94
2016-09-13,2127.02,-32.02,-1.48,2190.15,-2.88,True,1,22278,-2127.02,-8480597.16,47385751.56,38905154.4
2016-09-14,2125.77,-1.25,-0.06,2190.15,-2.94,True,1,22279,-2125.77,-8482722.93,47360029.83,38877306.9
2016-09-15,2147.26,21.49,1.01,2190.15,-1.96,True,1,22280,-2147.26,-8484870.19,47840952.8,39356082.61
2016-09-16,2139.16,-8.1,-0.38,2190.15,-2.33,True,1,22281,-2139.16,-8487009.35,47662623.96,39175614.61
2016-09-19,2139.12,-0.04,-0.0,2190.15,-2.33,True,1,22282,-2139.12,-8489148.47,47663871.84,39174723.37
2016-09-20,2139.76,0.64,0.03,2190.15,-2.3,True,1,22283,-2139.76,-8491288.23,47680272.08,39188983.85
2016-09-21,2163.12,23.36,1.09,2190.15,-1.23,True,1,22284,-2163.12,-8493451.35,48202966.08,39709514.73
2016-09-22,2177.18,14.06,0.65,2190.15,-0.59,True,1,22285,-2177.18,-8495628.53,48518456.3,40022827.77
2016-09-23,2164.69,-12.49,-0.57,2190.15,-1.16,True,1,22286,-2164.69,-8497793.22,48242281.34,39744488.12
2016-09-26,2146.1,-18.59,-0.86,2190.15,-2.01,True,1,22287,-2146.1,-8499939.32,47830130.7,39330191.38
2016-09-27,2159.93,13.83,0.64,2190.15,-1.38,True,1,22288,-2159.93,-8502099.25,48140519.84,39638420.59
2016-09-28,2171.37,11.44,0.53,2190.15,-0.86,True,1,22289,-2171.37,-8504270.62,48397665.93,39893395.31
2016-09-29,2151.13,-20.24,-0.93,2190.15,-1.78,True,1,22290,-2151.13,-8506421.75,47948687.7,39442265.95
2016-09-30,2168.27,17.14,0.8,2190.15,-1.0,True,1,22291,-2168.27,-8508590.02,48332906.57,39824316.55
2016-10-03,2161.2,-7.07,-0.33,2190.15,-1.32,True,1,22292,-2161.2,-8510751.22,48177470.4,39666719.18
2016-10-04,2150.49,-10.71,-0.5,2190.15,-1.81,True,1,22293,-2150.49,-8512901.71,47940873.57,39427971.86
2016-10-05,2159.73,9.24,0.43,2190.15,-1.39,True,1,22294,-2159.73,-8515061.44,48149020.62,39633959.18
2016-10-06,2160.77,1.04,0.05,2190.15,-1.34,True,1,22295,-2160.77,-8517222.21,48174367.15,39657144.94
2016-10-07,2153.74,-7.03,-0.32,2190.15,-1.66,True,1,22296,-2153.74,-8519375.95,48019787.04,39500411.09
2016-10-10,2163.66,9.92,0.46,2190.15,-1.21,True,1,22297,-2163.66,-8521539.61,48243127.02,39721587.41
2016-10-11,2136.73,-26.93,-1.25,2190.15,-2.44,True,1,22298,-2136.73,-8523676.34,47644805.54,39121129.2
2016-10-12,2139.18,2.45,0.12,2190.15,-2.33,True,1,22299,-2139.18,-8525815.52,47701574.82,39175759.3
2016-10-13,2132.55,-6.63,-0.31,2190.15,-2.63,True,1,22300,-2132.55,-8527948.07,47555865.0,39027916.93
2016-10-14,2132.98,0.43,0.02,2190.15,-2.61,True,1,22301,-2132.98,-8530081.05,47567586.98,39037505.93
2016-10-17,2126.5,-6.48,-0.3,2190.15,-2.91,True,1,22302,-2126.5,-8532207.55,47425203.0,38892995.45
2016-10-18,2139.6,13.1,0.62,2190.15,-2.31,True,1,22303,-2139.6,-8534347.15,47719498.8,39185151.65
2016-10-19,2144.29,4.69,0.22,2190.15,-2.09,True,1,22304,-2144.29,-8536491.44,47826244.16,39289752.72
2016-10-20,2141.34,-2.95,-0.14,2190.15,-2.23,True,1,22305,-2141.34,-8538632.78,47762588.7,39223955.92
2016-10-21,2141.16,-0.18,-0.01,2190.15,-2.24,True,1,22306,-2141.16,-8540773.94,47760714.96,39219941.02
2016-10-24,2151.33,10.17,0.48,2190.15,-1.77,True,1,22307,-2151.33,-8542925.27,47989718.31,39446793.04
2016-10-25,2143.16,-8.17,-0.38,2190.15,-2.15,True,1,22308,-2143.16,-8545068.43,47809613.28,39264544.85
2016-10-26,2139.43,-3.73,-0.17,2190.15,-2.32,True,1,22309,-2139.43,-8547207.86,47728543.87,39181336.01
2016-10-27,2133.04,-6.39,-0.3,2190.15,-2.61,True,1,22310,-2133.04,-8549340.9,47588122.4,39038781.5
2016-10-28,2126.41,-6.63,-0.31,2190.15,-2.91,True,1,22311,-2126.41,-8551467.31,47442333.51,38890866.2
2016-10-31,2126.15,-0.26,-0.01,2190.15,-2.92,True,1,22312,-2126.15,-8553593.46,47438658.8,38885065.34
2016-11-01,2111.72,-14.43,-0.68,2190.15,-3.58,True,1,22313,-2111.72,-8555705.18,47118808.36,38563103.18
2016-11-02,2097.94,-13.78,-0.65,2190.15,-4.21,True,1,22314,-2097.94,-8557803.12,46813433.16,38255630.04
2016-11-03,2088.66,-9.28,-0.44,2190.15,-4.63,True,1,22315,-2088.66,-8559891.78,46608447.9,38048556.12
2016-11-04,2085.18,-3.48,-0.17,2190.15,-4.79,True,1,22316,-2085.18,-8561976.96,46532876.88,37970899.92
2016-11-07,2131.52,46.34,2.22,2190.15,-2.68,True,1,22317,-2131.52,-8564108.48,47569131.84,39005023.36
2016-11-08,2139.56,8.04,0.38,2190.15,-2.31,True,1,22318,-2139.56,-8566248.04,47750700.08,39184452.04
2016-11-09,2163.26,23.7,1.11,2190.15,-1.23,True,1,22319,-2163.26,-8568411.3,48281799.94,39713388.64
2016-11-10,2167.48,4.22,0.2,2190.15,-1.03,True,1,22320,-2167.48,-8570578.78,48378153.6,39807574.82
2016-11-11,2164.45,-3.03,-0.14,2190.15,-1.17,True,1,22321,-2164.45,-8572743.23,48312688.45,39739945.22
2016-11-14,2164.2,-0.25,-0.01,2190.15,-1.18,True,1,22322,-2164.2,-8574907.43,48309272.4,39734364.97
2016-11-15,2180.39,16.19,0.75,2190.15,-0.45,True,1,22323,-2180.39,-8577087.82,48672845.97,40095758.15
2016-11-16,2176.94,-3.45,-0.16,2190.15,-0.6,True,1,22324,-2176.94,-8579264.76,48598008.56,40018743.8
2016-11-17,2187.12,10.18,0.47,2190.15,-0.14,True,1,22325,-2187.12,-8581451.88,48827454.0,40246002.12
2016-11-18,2181.9,-5.22,-0.24,2190.15,-0.38,True,1,22326,-2181.9,-8583633.78,48713099.4,40129465.62
2016-11-21,2198.18,16.28,0.75,2198.18,0.0,True,1,22327,-2198.18,-8585831.96,49078764.86,40492932.9
2016-11-22,2202.94,4.76,0.22,2202.94,0.0,True,1,22328,-2202.94,-8588034.9,49187244.32,40599209.42
2016-11-23,2204.72,1.78,0.08,2204.72,0.0,True,1,22329,-2204.72,-8590239.62,49229192.88,40638953.26
2016-11-25,2213.35,8.63,0.39,2213.35,0.0,True,1,22330,-2213.35,-8592452.97,49424105.5,40831652.53
2016-11-28,2201.72,-11.63,-0.52,2213.35,-0.52,True,1,22331,-2201.72,-8594654.69,49166609.32,40571954.63
2016-11-29,2204.66,2.94,0.13,2213.35,-0.39,True,1,22332,-2204.66,-8596859.35,49234467.12,40637607.77
2016-11-30,2198.81,-5.85,-0.26,2213.35,-0.66,True,1,22333,-2198.81,-8599058.16,49106023.73,40506965.57
2016-12-01,2191.08,-7.73,-0.35,2213.35,-1.01,True,1,22334,-2191.08,-8601249.24,48935580.72,40334331.48
2016-12-02,2191.95,0.87,0.04,2213.35,-0.97,True,1,22335,-2191.95,-8603441.19,48957203.25,40353762.06
2016-12-05,2204.71,12.76,0.58,2213.35,-0.39,True,1,22336,-2204.71,-8605645.9,49244402.56,40638756.66
2016-12-06,2212.23,7.52,0.34,2213.35,-0.05,True,1,22337,-2212.23,-8607858.13,49414581.51,40806723.38
2016-12-07,2241.35,29.12,1.32,2241.35,0.0,True,1,22338,-2241.35,-8610099.48,50067276.3,41457176.82
2016-12-08,2246.19,4.84,0.22,2246.19,0.0,True,1,22339,-2246.19,-8612345.67,50177638.41,41565292.74
2016-12-09,2259.53,13.34,0.59,2259.53,0.0,True,1,22340,-2259.53,-8614605.2,50477900.2,41863295.0
2016-12-12,2256.96,-2.57,-0.11,2259.53,-0.11,True,1,22341,-2256.96,-8616862.16,50422743.36,41805881.2
2016-12-13,2271.72,14.76,0.65,2271.72,0.0,True,1,22342,-2271.72,-8619133.88,50754768.24,42135634.36
2016-12-14,2253.28,-18.44,-0.81,2271.72,-0.81,True,1,22343,-2253.28,-8621387.16,50345035.04,41723647.88
2016-12-15,2262.03,8.75,0.39,2271.72,-0.43,True,1,22344,-2262.03,-8623649.19,50542798.32,41919149.13
2016-12-16,2258.07,-3.96,-0.18,2271.72,-0.6,True,1,22345,-2258.07,-8625907.26,50456574.15,41830666.89
2016-12-19,2262.53,4.46,0.2,2271.72,-0.4,True,1,22346,-2262.53,-8628169.79,50558495.38,41930325.59
2016-12-20,2270.76,8.23,0.36,2271.72,-0.04,True,1,22347,-2270.76,-8630440.55,50744673.72,42114233.17
2016-12-21,2265.18,-5.58,-0.25,2271.72,-0.29,True,1,22348,-2265.18,-8632705.73,50622242.64,41989536.91
2016-12-22,2260.96,-4.22,-0.19,2271.72,-0.47,True,1,22349,-2260.96,-8634966.69,50530195.04,41895228.35
2016-12-23,2263.79,2.83,0.12,2271.72,-0.35,True,1,22350,-2263.79,-8637230.48,50595706.5,41958476.02
2016-12-27,2268.88,5.09,0.22,2271.72,-0.12,True,1,22351,-2268.88,-8639499.36,50711736.88,42072237.52
2016-12-28,2249.92,-18.96,-0.84,2271.72,-0.96,True,1,22352,-2249.92,-8641749.28,50290211.84,41648462.56
2016-12-29,2249.26,-0.66,-0.03,2271.72,-0.99,True,1,22353,-2249.26,-8643998.54,50277708.78,41633710.24
2016-12-30,2238.83,-10.43,-0.46,2271.72,-1.45,True,1,22354,-2238.83,-8646237.37,50046805.82,41400568.45
2017-01-03,2257.83,19.0,0.85,2271.72,-0.61,True,1,22355,-2257.83,-8648495.2,50473789.65,41825294.45
2017-01-04,2270.75,12.92,0.57,2271.72,-0.04,True,1,22356,-2270.75,-8650765.95,50764887.0,42114121.05
2017-01-05,2269.0,-1.75,-0.08,2271.72,-0.12,True,1,22357,-2269.0,-8653034.95,50728033.0,42074998.05
2017-01-06,2276.98,7.98,0.35,2276.98,0.0,True,1,22358,-2276.98,-8655311.93,50908718.84,42253406.91
2017-01-09,2268.9,-8.08,-0.36,2276.98,-0.36,True,1,22359,-2268.9,-8657580.83,50730335.1,42072754.27
2017-01-10,2268.9,0.0,0.0,2276.98,-0.36,True,1,22360,-2268.9,-8659849.73,50732604.0,42072754.27
2017-01-11,2275.32,6.42,0.28,2276.98,-0.07,True,1,22361,-2275.32,-8662125.05,50878430.52,42216305.47
2017-01-12,2270.44,-4.88,-0.21,2276.98,-0.29,True,1,22362,-2270.44,-8664395.49,50771579.28,42107183.79
2017-01-13,2274.64,4.2,0.18,2276.98,-0.1,True,1,22363,-2274.64,-8666670.13,50867774.32,42201104.19
2017-01-17,2267.89,-6.75,-0.3,2276.98,-0.4,True,1,22364,-2267.89,-8668938.02,50719091.96,42050153.94
2017-01-18,2271.89,4.0,0.18,2276.98,-0.22,True,1,22365,-2271.89,-8671209.91,50810819.85,42139609.94
2017-01-19,2263.69,-8.2,-0.36,2276.98,-0.58,True,1,22366,-2263.69,-8673473.6,50629690.54,41956216.94
2017-01-20,2271.31,7.62,0.34,2276.98,-0.25,True,1,22367,-2271.31,-8675744.91,50802390.77,42126645.86
2017-01-23,2265.2,-6.11,-0.27,2276.98,-0.52,True,1,22368,-2265.2,-8678010.11,50667993.6,41989983.49
2017-01-24,2280.07,14.87,0.66,2280.07,0.0,True,1,22369,-2280.07,-8680290.18,51002885.83,42322595.65
2017-01-25,2298.37,18.3,0.8,2298.37,0.0,True,1,22370,-2298.37,-8682588.55,51414536.9,42731948.35
2017-01-26,2296.68,-1.69,-0.07,2298.37,-0.07,True,1,22371,-2296.68,-8684885.23,51379028.28,42694143.05
2017-01-27,2294.69,-1.99,-0.09,2298.37,-0.16,True,1,22372,-2294.69,-8687179.92,51336804.68,42649624.76
2017-01-30,2280.9,-13.79,-0.6,2298.37,-0.76,True,1,22373,-2280.9,-8689460.82,51030575.7,42341114.88
2017-01-31,2278.87,-2.03,-0.09,2298.37,-0.85,True,1,22374,-2278.87,-8691739.69,50987437.38,42295697.69
2017-02-01,2279.55,0.68,0.03,2298.37,-0.82,True,1,22375,-2279.55,-8694019.24,51004931.25,42310912.01
2017-02-02,2280.85,1.3,0.06,2298.37,-0.76,True,1,22376,-2280.85,-8696300.09,51036299.6,42339999.51
2017-02-03,2297.42,16.57,0.73,2298.37,-0.04,True,1,22377,-2297.42,-8698597.51,51409367.34,42710769.83
2017-02-06,2292.56,-4.86,-0.21,2298.37,-0.25,True,1,22378,-2292.56,-8700890.07,51302907.68,42602017.61
2017-02-07,2293.08,0.52,0.02,2298.37,-0.23,True,1,22379,-2293.08,-8703183.15,51316837.32,42613654.17
2017-02-08,2294.67,1.59,0.07,2298.37,-0.16,True,1,22380,-2294.67,-8705477.82,51354714.6,42649236.78
2017-02-09,2307.87,13.2,0.57,2307.87,0.0,True,1,22381,-2307.87,-8707785.69,51652438.47,42944652.78
2017-02-10,2316.1,8.23,0.36,2316.1,0.0,True,1,22382,-2316.1,-8710101.79,51838950.2,43128848.41
2017-02-13,2328.25,12.15,0.52,2328.25,0.0,True,1,22383,-2328.25,-8712430.04,52113219.75,43400789.71
2017-02-14,2337.58,9.33,0.4,2337.58,0.0,True,1,22384,-2337.58,-8714767.62,52324390.72,43609623.1
2017-02-15,2349.25,11.67,0.5,2349.25,0.0,True,1,22385,-2349.25,-8717116.87,52587961.25,43870844.38
2017-02-16,2347.22,-2.03,-0.09,2349.25,-0.09,True,1,22386,-2347.22,-8719464.09,52544866.92,43825402.83
2017-02-17,2351.16,3.94,0.17,2351.16,0.0,True,1,22387,-2351.16,-8721815.25,52635418.92,43913603.67
2017-02-21,2365.38,14.22,0.6,2365.38,0.0,True,1,22388,-2365.38,-8724180.63,52956127.44,44231946.81
2017-02-22,2362.82,-2.56,-0.11,2365.38,-0.11,True,1,22389,-2362.82,-8726543.45,52901176.98,44174633.53
2017-02-23,2363.81,0.99,0.04,2365.38,-0.07,True,1,22390,-2363.81,-8728907.26,52925705.9,44196798.64
2017-02-24,2367.34,3.53,0.15,2367.34,0.0,True,1,22391,-2367.34,-8731274.6,53007109.94,44275835.34
2017-02-27,2369.75,2.41,0.1,2369.75,0.0,True,1,22392,-2369.75,-8733644.35,53063442.0,44329797.65
2017-02-28,2363.64,-6.11,-0.26,2369.75,-0.26,True,1,22393,-2363.64,-8736007.99,52928990.52,44192982.53
2017-03-01,2395.96,32.32,1.37,2395.96,0.0,True,1,22394,-2395.96,-8738403.95,53655128.24,44916724.29
2017-03-02,2381.92,-14.04,-0.59,2395.96,-0.59,True,1,22395,-2381.92,-8740785.87,53343098.4,44602312.53
2017-03-03,2383.12,1.2,0.05,2395.96,-0.54,True,1,22396,-2383.12,-8743168.99,53372355.52,44629186.53
2017-03-06,2375.31,-7.81,-0.33,2395.96,-0.86,True,1,22397,-2375.31,-8745544.3,53199818.07,44454273.77
2017-03-07,2368.39,-6.92,-0.29,2395.96,-1.15,True,1,22398,-2368.39,-8747912.69,53047199.22,44299286.53
2017-03-08,2362.98,-5.41,-0.23,2395.96,-1.38,True,1,22399,-2362.98,-8750275.67,52928389.02,44178113.35
2017-03-09,2364.87,1.89,0.08,2395.96,-1.3,True,1,22400,-2364.87,-8752640.54,52973088.0,44220447.46
2017-03-10,2372.6,7.73,0.33,2395.96,-0.98,True,1,22401,-2372.6,-8755013.14,53148612.6,44393599.46
2017-03-13,2373.47,0.87,0.04,2395.96,-0.94,True,1,22402,-2373.47,-8757386.61,53170474.94,44413088.33
2017-03-14,2365.45,-8.02,-0.34,2395.96,-1.27,True,1,22403,-2365.45,-8759752.06,52993176.35,44233424.29
2017-03-15,2385.26,19.81,0.84,2395.96,-0.45,True,1,22404,-2385.26,-8762137.32,53439365.04,44677227.72
2017-03-16,2381.38,-3.88,-0.16,2395.96,-0.61,True,1,22405,-2381.38,-8764518.7,53354818.9,44590300.2
2017-03-17,2378.25,-3.13,-0.13,2395.96,-0.74,True,1,22406,-2378.25,-8766896.95,53287069.5,44520172.55
2017-03-20,2373.47,-4.78,-0.2,2395.96,-0.94,True,1,22407,-2373.47,-8769270.42,53182342.29,44413071.87
2017-03-21,2344.02,-29.45,-1.24,2395.96,-2.17,True,1,22408,-2344.02,-8771614.44,52524800.16,43753185.72
2017-03-22,2348.45,4.43,0.19,2395.96,-1.98,True,1,22409,-2348.45,-8773962.89,52626416.05,43852453.16
2017-03-23,2345.96,-2.49,-0.11,2395.96,-2.09,True,1,22410,-2345.96,-8776308.85,52572963.6,43796654.75
2017-03-24,2343.98,-1.98,-0.08,2395.96,-2.17,True,1,22411,-2343.98,-8778652.83,52530935.78,43752282.95
2017-03-27,2341.59,-2.39,-0.1,2395.96,-2.27,True,1,22412,-2341.59,-8780994.42,52479715.08,43698720.66
2017-03-28,2358.57,16.98,0.72,2395.96,-1.56,True,1,22413,-2358.57,-8783352.99,52862629.41,44079276.42
2017-03-29,2361.13,2.56,0.11,2395.96,-1.45,True,1,22414,-2361.13,-8785714.12,52922367.82,44136653.7
2017-03-30,2368.06,6.93,0.29,2395.96,-1.16,True,1,22415,-2368.06,-8788082.18,53080064.9,44291982.72
2017-03-31,2362.72,-5.34,-0.23,2395.96,-1.39,True,1,22416,-2362.72,-8790444.9,52962731.52,44172286.62
2017-04-03,2358.84,-3.88,-0.16,2395.96,-1.55,True,1,22417,-2358.84,-8792803.74,52878116.28,44085312.54
2017-04-04,2360.16,1.32,0.06,2395.96,-1.49,True,1,22418,-2360.16,-8795163.9,52910066.88,44114902.98
2017-04-05,2352.95,-7.21,-0.3,2395.96,-1.8,True,1,22419,-2352.95,-8797516.85,52750786.05,43953269.2
2017-04-06,2357.49,4.54,0.19,2395.96,-1.61,True,1,22420,-2357.49,-8799874.34,52854925.8,44055051.46
2017-04-07,2355.54,-1.95,-0.08,2395.96,-1.69,True,1,22421,-2355.54,-8802229.88,52813562.34,44011332.46
2017-04-10,2357.16,1.62,0.07,2395.96,-1.62,True,1,22422,-2357.16,-8804587.04,52852241.52,44047654.48
2017-04-11,2353.78,-3.38,-0.14,2395.96,-1.76,True,1,22423,-2353.78,-8806940.82,52778808.94,43971868.12
2017-04-12,2344.93,-8.85,-0.38,2395.96,-2.13,True,1,22424,-2344.93,-8809285.75,52582710.32,43773424.57
2017-04-13,2328.95,-15.98,-0.68,2395.96,-2.8,True,1,22425,-2328.95,-8811614.7,52226703.75,43415089.05
2017-04-17,2349.01,20.06,0.86,2395.96,-1.96,True,1,22426,-2349.01,-8813963.71,52678898.26,43864934.55
2017-04-18,2342.19,-6.82,-0.29,2395.96,-2.24,True,1,22427,-2342.19,-8816305.9,52528295.13,43711989.23
2017-04-19,2338.17,-4.02,-0.17,2395.96,-2.41,True,1,22428,-2338.17,-8818644.07,52440476.76,43621832.69
2017-04-20,2355.84,17.67,0.76,2395.96,-1.67,True,1,22429,-2355.84,-8820999.91,52839135.36,44018135.45
2017-04-21,2348.69,-7.15,-0.3,2395.96,-1.97,True,1,22430,-2348.69,-8823348.6,52681116.7,43857768.1
2017-04-24,2374.15,25.46,1.08,2395.96,-0.91,True,1,22431,-2374.15,-8825722.75,53254558.65,44428835.9
2017-04-25,2388.61,14.46,0.61,2395.96,-0.31,True,1,22432,-2388.61,-8828111.36,53581299.52,44753188.16
2017-04-26,2387.45,-1.16,-0.05,2395.96,-0.36,True,1,22433,-2387.45,-8830498.81,53557665.85,44727167.04
2017-04-27,2388.77,1.32,0.06,2395.96,-0.3,True,1,22434,-2388.77,-8832887.58,53589666.18,44756778.6
2017-04-28,2384.2,-4.57,-0.19,2395.96,-0.49,True,1,22435,-2384.2,-8835271.78,53489527.0,44654255.22
2017-05-01,2388.33,4.13,0.17,2395.96,-0.32,True,1,22436,-2388.33,-8837660.11,53584571.88,44746911.77
2017-05-02,2391.17,2.84,0.12,2395.96,-0.2,True,1,22437,-2391.17,-8840051.28,53650681.29,44810630.01
2017-05-03,2388.13,-3.04,-0.13,2395.96,-0.33,True,1,22438,-2388.13,-8842439.41,53584860.94,44742421.53
2017-05-04,2389.52,1.39,0.06,2395.96,-0.27,True,1,22439,-2389.52,-8844828.93,53618439.28,44773610.35
2017-05-05,2399.29,9.77,0.41,2399.29,0.0,True,1,22440,-2399.29,-8847228.22,53840067.6,44992839.38
2017-05-08,2399.38,0.09,0.0,2399.38,0.0,True,1,22441,-2399.38,-8849627.6,53844486.58,44994858.98
2017-05-09,2396.92,-2.46,-0.1,2399.38,-0.1,True,1,22442,-2396.92,-8852024.52,53791678.64,44939654.12
2017-05-10,2399.63,2.71,0.11,2399.63,0.0,True,1,22443,-2399.63,-8854424.15,53854896.09,45000471.94
2017-05-11,2394.44,-5.19,-0.22,2399.63,-0.22,True,1,22444,-2394.44,-8856818.59,53740811.36,44883992.77
2017-05-12,2390.9,-3.54,-0.15,2399.63,-0.36,True,1,22445,-2390.9,-8859209.49,53663750.5,44804541.01
2017-05-15,2402.32,11.42,0.48,2402.32,0.0,True,1,22446,-2402.32,-8861611.81,53922474.72,45060862.91
2017-05-16,2400.67,-1.65,-0.07,2402.32,-0.07,True,1,22447,-2400.67,-8864012.48,53887839.49,45023827.01
2017-05-17,2357.03,-43.64,-1.82,2402.32,-1.88,True,1,22448,-2357.03,-8866369.51,52910609.44,44044239.93
2017-05-18,2365.72,8.69,0.37,2402.32,-1.52,True,1,22449,-2365.72,-8868735.23,53108048.28,44239313.05
2017-05-19,2381.73,16.01,0.68,2402.32,-0.86,True,1,22450,-2381.73,-8871116.96,53469838.5,44598721.54
2017-05-22,2394.02,12.29,0.52,2402.32,-0.35,True,1,22451,-2394.02,-8873510.98,53748143.02,44874632.04
2017-05-23,2398.42,4.4,0.18,2402.32,-0.16,True,1,22452,-2398.42,-8875909.4,53849325.84,44973416.44
2017-05-24,2404.39,5.97,0.25,2404.39,0.0,True,1,22453,-2404.39,-8878313.79,53985768.67,45107454.88
2017-05-25,2415.07,10.68,0.44,2415.07,0.0,True,1,22454,-2415.07,-8880728.86,54227981.78,45347252.92
2017-05-26,2415.82,0.75,0.03,2415.82,0.0,True,1,22455,-2415.82,-8883144.68,54247238.1,45364093.42
2017-05-30,2412.91,-2.91,-0.12,2415.82,-0.12,True,1,22456,-2412.91,-8885557.59,54184306.96,45298749.37
2017-05-31,2411.8,-1.11,-0.05,2415.82,-0.17,True,1,22457,-2411.8,-8887969.39,54161792.6,45273823.21
2017-06-01,2430.06,18.26,0.76,2430.06,0.0,True,1,22458,-2430.06,-8890399.45,54574287.48,45683888.03
2017-06-02,2439.07,9.01,0.37,2439.07,0.0,True,1,22459,-2439.07,-8892838.52,54779073.13,45886234.61
2017-06-05,2436.1,-2.97,-0.12,2439.07,-0.12,True,1,22460,-2436.1,-8895274.62,54714806.0,45819531.38
2017-06-06,2429.33,-6.77,-0.28,2439.07,-0.4,True,1,22461,-2429.33,-8897703.95,54565181.13,45667477.18
2017-06-07,2433.14,3.81,0.16,2439.07,-0.24,True,1,22462,-2433.14,-8900137.09,54653190.68,45753053.59
2017-06-08,2433.79,0.65,0.03,2439.07,-0.22,True,1,22463,-2433.79,-8902570.88,54670224.77,45767653.89
2017-06-09,2431.77,-2.02,-0.08,2439.07,-0.3,True,1,22464,-2431.77,-8905002.65,54627281.28,45722278.63
2017-06-12,2429.39,-2.38,-0.1,2439.07,-0.4,True,1,22465,-2429.39,-8907432.04,54576246.35,45668814.31
2017-06-13,2440.35,10.96,0.45,2440.35,0.0,True,1,22466,-2440.35,-8909872.39,54824903.1,45915030.71
2017-06-14,2437.92,-2.43,-0.1,2440.35,-0.1,True,1,22467,-2437.92,-8912310.31,54772748.64,45860438.33
2017-06-15,2432.46,-5.46,-0.22,2440.35,-0.32,True,1,22468,-2432.46,-8914742.77,54652511.28,45737768.51
2017-06-16,2433.15,0.69,0.03,2440.35,-0.3,True,1,22469,-2433.15,-8917175.92,54670447.35,45753271.43
2017-06-19,2453.46,20.31,0.84,2453.46,0.0,True,1,22470,-2453.46,-8919629.38,55129246.2,46209616.82
2017-06-20,2437.03,-16.43,-0.67,2453.46,-0.67,True,1,22471,-2437.03,-8922066.41,54762501.13,45840434.72
2017-06-21,2435.61,-1.42,-0.06,2453.46,-0.73,True,1,22472,-2435.61,-8924502.02,54733027.92,45808525.9
2017-06-22,2434.5,-1.11,-0.05,2453.46,-0.77,True,1,22473,-2434.5,-8926936.52,54710518.5,45783581.98
2017-06-23,2438.3,3.8,0.16,2453.46,-0.62,True,1,22474,-2438.3,-8929374.82,54798354.2,45868979.38
2017-06-26,2439.07,0.77,0.03,2453.46,-0.59,True,1,22475,-2439.07,-8931813.89,54818098.25,45886284.36
2017-06-27,2419.38,-19.69,-0.81,2453.46,-1.39,True,1,22476,-2419.38,-8934233.27,54377984.88,45443751.61
2017-06-28,2440.69,21.31,0.88,2453.46,-0.52,True,1,22477,-2440.69,-8936673.96,54859389.13,45922715.17
2017-06-29,2419.7,-20.99,-0.86,2453.46,-1.38,True,1,22478,-2419.7,-8939093.66,54390016.6,45450922.94
2017-06-30,2423.41,3.71,0.15,2453.46,-1.23,True,1,22479,-2423.41,-8941517.07,54475833.39,45534316.32
2017-07-03,2429.01,5.6,0.23,2453.46,-1.0,True,1,22480,-2429.01,-8943946.08,54604144.8,45660198.72
2017-07-05,2432.54,3.53,0.14,2453.46,-0.85,True,1,22481,-2432.54,-8946378.62,54685931.74,45739553.12
2017-07-06,2409.75,-22.79,-0.94,2453.46,-1.78,True,1,22482,-2409.75,-8948788.37,54175999.5,45227211.13
2017-07-07,2425.18,15.43,0.64,2453.46,-1.15,True,1,22483,-2425.18,-8951213.55,54525321.94,45574108.39
2017-07-10,2427.43,2.25,0.09,2453.46,-1.06,True,1,22484,-2427.43,-8953640.98,54578336.12,45624695.14
2017-07-11,2425.53,-1.9,-0.08,2453.46,-1.14,True,1,22485,-2425.53,-8956066.51,54538042.05,45581975.54
2017-07-12,2443.25,17.72,0.73,2453.46,-0.42,True,1,22486,-2443.25,-8958509.76,54938919.5,45980409.74
2017-07-13,2447.83,4.58,0.19,2453.46,-0.23,True,1,22487,-2447.83,-8960957.59,55044353.21,46083395.62
2017-07-14,2459.27,11.44,0.47,2459.27,0.0,True,1,22488,-2459.27,-8963416.86,55304063.76,46340646.9
2017-07-17,2459.14,-0.13,-0.0,2459.27,-0.0,True,1,22489,-2459.14,-8965876.0,55303599.46,46337723.46
2017-07-18,2460.61,1.47,0.06,2460.61,0.0,True,1,22490,-2460.61,-8968336.61,55339118.9,46370782.29
2017-07-19,2473.83,13.22,0.54,2473.83,0.0,True,1,22491,-2473.83,-8970810.44,55638910.53,46668100.09
2017-07-20,2473.45,-0.38,-0.02,2473.83,-0.02,True,1,22492,-2473.45,-8973283.89,55632837.4,46659553.51
2017-07-21,2472.54,-0.91,-0.04,2473.83,-0.05,True,1,22493,-2472.54,-8975756.43,55614842.22,46639085.79
2017-07-24,2469.91,-2.63,-0.11,2473.83,-0.16,True,1,22494,-2469.91,-8978226.34,55558155.54,46579929.2
2017-07-25,2477.13,7.22,0.29,2477.13,0.0,True,1,22495,-2477.13,-8980703.47,55723039.35,46742335.88
2017-07-26,2477.83,0.7,0.03,2477.83,0.0,True,1,22496,-2477.83,-8983181.3,55741263.68,46758082.38
2017-07-27,2475.42,-2.41,-0.1,2477.83,-0.1,True,1,22497,-2475.42,-8985656.72,55689523.74,46703867.02
2017-07-28,2472.1,-3.32,-0.13,2477.83,-0.23,True,1,22498,-2472.1,-8988128.82,55617305.8,46629176.98
2017-07-31,2470.3,-1.8,-0.07,2477.83,-0.3,True,1,22499,-2470.3,-8990599.12,55579279.7,46588680.58
2017-08-01,2476.35,6.05,0.24,2477.83,-0.06,True,1,22500,-2476.35,-8993075.47,55717875.0,46724799.53
2017-08-02,2477.57,1.22,0.05,2477.83,-0.01,True,1,22501,-2477.57,-8995553.04,55747802.57,46752249.53
2017-08-03,2472.16,-5.41,-0.22,2477.83,-0.23,True,1,22502,-2472.16,-8998025.2,55628544.32,46630519.12
2017-08-04,2476.83,4.67,0.19,2477.83,-0.04,True,1,22503,-2476.83,-9000502.03,55736105.49,46735603.46
2017-08-07,2480.91,4.08,0.16,2480.91,0.0,True,1,22504,-2480.91,-9002982.94,55830398.64,46827415.7
2017-08-08,2474.92,-5.99,-0.24,2480.91,-0.24,True,1,22505,-2474.92,-9005457.86,55698074.6,46692616.74
2017-08-09,2474.02,-0.9,-0.04,2480.91,-0.28,True,1,22506,-2474.02,-9007931.88,55680294.12,46672362.24
2017-08-10,2438.21,-35.81,-1.45,2480.91,-1.72,True,1,22507,-2438.21,-9010370.09,54876792.47,45866422.38
2017-08-11,2441.32,3.11,0.13,2480.91,-1.6,True,1,22508,-2441.32,-9012811.41,54949230.56,45936419.15
2017-08-14,2465.84,24.52,1.0,2480.91,-0.61,True,1,22509,-2465.84,-9015277.25,55503592.56,46488315.31
2017-08-15,2464.61,-1.23,-0.05,2480.91,-0.66,True,1,22510,-2464.61,-9017741.86,55478371.1,46460629.24
2017-08-16,2468.11,3.5,0.14,2480.91,-0.52,True,1,22511,-2468.11,-9020209.97,55559624.21,46539414.24
2017-08-17,2430.01,-38.1,-1.54,2480.91,-2.05,True,1,22512,-2430.01,-9022639.98,54704385.12,45681745.14
2017-08-18,2425.55,-4.46,-0.18,2480.91,-2.23,True,1,22513,-2425.55,-9025065.53,54606407.15,45581341.62
2017-08-21,2428.37,2.82,0.12,2480.91,-2.12,True,1,22514,-2428.37,-9027493.9,54672322.18,45644828.28
2017-08-22,2452.51,24.14,0.99,2480.91,-1.14,True,1,22515,-2452.51,-9029946.41,55218262.65,46188316.24
2017-08-23,2444.04,-8.47,-0.34,2480.91,-1.49,True,1,22516,-2444.04,-9032390.45,55030004.64,45997614.19
2017-08-24,2438.97,-5.07,-0.21,2480.91,-1.69,True,1,22517,-2438.97,-9034829.42,54918287.49,45883458.07
2017-08-25,2443.05,4.08,0.17,2480.91,-1.53,True,1,22518,-2443.05,-9037272.47,55012599.9,45975327.43
2017-08-28,2444.24,1.19,0.05,2480.91,-1.48,True,1,22519,-2444.24,-9039716.71,55041840.56,46002123.85
2017-08-29,2446.3,2.06,0.08,2480.91,-1.4,True,1,22520,-2446.3,-9042163.01,55090676.0,46048512.99
2017-08-30,2457.59,11.29,0.46,2480.91,-0.94,True,1,22521,-2457.59,-9044620.6,55347384.39,46302763.79
2017-08-31,2471.65,14.06,0.57,2480.91,-0.37,True,1,22522,-2471.65,-9047092.25,55666501.3,46619409.05
2017-09-01,2476.55,4.9,0.2,2480.91,-0.18,True,1,22523,-2476.55,-9049568.8,55779335.65,46729766.85
2017-09-05,2457.85,-18.7,-0.76,2480.91,-0.93,True,1,22524,-2457.85,-9052026.65,55360613.4,46308586.75
2017-09-06,2465.54,7.69,0.31,2480.91,-0.62,True,1,22525,-2465.54,-9054492.19,55536288.5,46481796.31
2017-09-07,2465.1,-0.44,-0.02,2480.91,-0.64,True,1,22526,-2465.1,-9056957.29,55528842.6,46471885.31
2017-09-08,2461.43,-3.67,-0.15,2480.91,-0.78,True,1,22527,-2461.43,-9059418.72,55448633.61,46389214.89
2017-09-11,2488.11,26.68,1.08,2488.11,0.0,True,1,22528,-2488.11,-9061906.83,56052142.08,46990235.25
2017-09-12,2496.48,8.37,0.34,2496.48,0.0,True,1,22529,-2496.48,-9064403.31,56243197.92,47178794.61
2017-09-13,2498.37,1.89,0.08,2498.37,0.0,True,1,22530,-2498.37,-9066901.68,56288276.1,47221374.42
2017-09-14,2495.62,-2.75,-0.11,2498.37,-0.11,True,1,22531,-2495.62,-9069397.3,56228814.22,47159416.92
2017-09-15,2500.23,4.61,0.18,2500.23,0.0,True,1,22532,-2500.23,-9071897.53,56335182.36,47263284.83
2017-09-18,2503.87,3.64,0.15,2503.87,0.0,True,1,22533,-2503.87,-9074401.4,56419702.71,47345301.31
2017-09-19,2506.65,2.78,0.11,2506.65,0.0,True,1,22534,-2506.65,-9076908.05,56484851.1,47407943.05
2017-09-20,2508.24,1.59,0.06,2508.24,0.0,True,1,22535,-2508.24,-9079416.29,56523188.4,47443772.11
2017-09-21,2500.6,-7.64,-0.3,2508.24,-0.3,True,1,22536,-2500.6,-9081916.89,56353521.6,47271604.71
2017-09-22,2502.22,1.62,0.06,2508.24,-0.24,True,1,22537,-2502.22,-9084419.11,56392532.14,47308113.03
2017-09-25,2496.66,-5.56,-0.22,2508.24,-0.46,True,1,22538,-2496.66,-9086915.77,56269723.08,47182807.31
2017-09-26,2496.84,0.18,0.01,2508.24,-0.45,True,1,22539,-2496.84,-9089412.61,56276276.76,47186864.15
2017-09-27,2507.04,10.2,0.41,2508.24,-0.05,True,1,22540,-2507.04,-9091919.65,56508681.6,47416761.95
2017-09-28,2510.06,3.02,0.12,2510.06,0.0,True,1,22541,-2510.06,-9094429.71,56579262.46,47484832.75
2017-09-29,2519.36,9.3,0.37,2519.36,0.0,True,1,22542,-2519.36,-9096949.07,56791413.12,47694464.05
2017-10-02,2529.12,9.76,0.39,2529.12,0.0,True,1,22543,-2529.12,-9099478.19,57013952.16,47914473.97
2017-10-03,2534.58,5.46,0.22,2534.58,0.0,True,1,22544,-2534.58,-9102012.77,57139571.52,48037558.75
2017-10-04,2537.74,3.16,0.12,2537.74,0.0,True,1,22545,-2537.74,-9104550.51,57213348.3,48108797.79
2017-10-05,2552.07,14.33,0.56,2552.07,0.0,True,1,22546,-2552.07,-9107102.58,57538970.22,48431867.64
2017-10-06,2549.33,-2.74,-0.11,2552.07,-0.11,True,1,22547,-2549.33,-9109651.91,57479743.51,48370091.6
2017-10-09,2544.73,-4.6,-0.18,2552.07,-0.29,True,1,22548,-2544.73,-9112196.64,57378572.04,48266375.4
2017-10-10,2550.64,5.91,0.23,2552.07,-0.06,True,1,22549,-2550.64,-9114747.28,57514381.36,48399634.08
2017-10-11,2555.24,4.6,0.18,2555.24,0.0,True,1,22550,-2555.24,-9117302.52,57620662.0,48503359.48
2017-10-12,2550.93,-4.31,-0.17,2555.24,-0.17,True,1,22551,-2550.93,-9119853.45,57526022.43,48406168.98
2017-10-13,2553.17,2.24,0.09,2555.24,-0.08,True,1,22552,-2553.17,-9122406.62,57579089.84,48456683.22
2017-10-16,2557.64,4.47,0.18,2557.64,0.0,True,1,22553,-2557.64,-9124964.26,57682454.92,48557490.66
2017-10-17,2559.36,1.72,0.07,2559.36,0.0,True,1,22554,-2559.36,-9127523.62,57723805.44,48596281.82
2017-10-18,2561.26,1.9,0.07,2561.26,0.0,True,1,22555,-2561.26,-9130084.88,57769219.3,48639134.42
2017-10-19,2562.1,0.84,0.03,2562.1,0.0,True,1,22556,-2562.1,-9132646.98,57790727.6,48658080.62
2017-10-20,2575.21,13.11,0.51,2575.21,0.0,True,1,22557,-2575.21,-9135222.19,58089011.97,48953789.78
2017-10-23,2564.98,-10.23,-0.4,2575.21,-0.4,True,1,22558,-2564.98,-9137787.17,57860818.84,48723031.67
2017-10-24,2569.13,4.15,0.16,2575.21,-0.24,True,1,22559,-2569.13,-9140356.3,57957003.67,48816647.37
2017-10-25,2557.15,-11.98,-0.47,2575.21,-0.7,True,1,22560,-2557.15,-9142913.45,57689304.0,48546390.55
2017-10-26,2560.4,3.25,0.13,2575.21,-0.57,True,1,22561,-2560.4,-9145473.85,57765184.4,48619710.55
2017-10-27,2581.07,20.67,0.81,2581.07,0.0,True,1,22562,-2581.07,-9148054.92,58234101.34,49086046.42
2017-10-30,2572.83,-8.24,-0.32,2581.07,-0.32,True,1,22563,-2572.83,-9150627.75,58050763.29,48900135.54
2017-10-31,2575.26,2.43,0.09,2581.07,-0.22,True,1,22564,-2575.26,-9153203.01,58108166.64,48954963.63
2017-11-01,2579.36,4.1,0.16,2581.07,-0.07,True,1,22565,-2579.36,-9155782.37,58203258.4,49047476.03
2017-11-02,2579.85,0.49,0.02,2581.07,-0.05,True,1,22566,-2579.85,-9158362.22,58216895.1,49058532.88
2017-11-03,2587.84,7.99,0.31,2587.84,0.0,True,1,22567,-2587.84,-9160950.06,58399785.28,49238835.22
2017-11-06,2591.13,3.29,0.13,2591.13,0.0,True,1,22568,-2591.13,-9163541.19,58476621.84,49313080.65
2017-11-07,2590.64,-0.49,-0.02,2591.13,-0.02,True,1,22569,-2590.64,-9166131.83,58468154.16,49302022.33
2017-11-08,2594.38,3.74,0.14,2594.38,0.0,True,1,22570,-2594.38,-9168726.21,58555156.6,49386430.39
2017-11-09,2584.62,-9.76,-0.38,2594.38,-0.38,True,1,22571,-2584.62,-9171310.83,58337458.02,49166147.19
2017-11-10,2582.3,-2.32,-0.09,2594.38,-0.47,True,1,22572,-2582.3,-9173893.13,58287675.6,49113782.47
2017-11-13,2584.84,2.54,0.1,2594.38,-0.37,True,1,22573,-2584.84,-9176477.97,58347593.32,49171115.35
2017-11-14,2578.87,-5.97,-0.23,2594.38,-0.6,True,1,22574,-2578.87,-9179056.84,58215411.38,49036354.54
2017-11-15,2564.62,-14.25,-0.55,2594.38,-1.15,True,1,22575,-2564.62,-9181621.46,57896296.5,48714675.04
2017-11-16,2585.64,21.02,0.82,2594.38,-0.34,True,1,22576,-2585.64,-9184207.1,58373408.64,49189201.54
2017-11-17,2578.85,-6.79,-0.26,2594.38,-0.6,True,1,22577,-2578.85,-9186785.95,58222696.45,49035910.5
2017-11-20,2582.14,3.29,0.13,2594.38,-0.47,True,1,22578,-2582.14,-9189368.09,58299556.92,49110188.83
2017-11-21,2599.03,16.89,0.65,2599.03,0.0,True,1,22579,-2599.03,-9191967.12,58683498.37,49491531.25
2017-11-22,2597.08,-1.95,-0.08,2599.03,-0.08,True,1,22580,-2597.08,-9194564.2,58642066.4,49447502.2
2017-11-24,2602.42,5.34,0.21,2602.42,0.0,True,1,22581,-2602.42,-9197166.62,58765246.02,49568079.4
2017-11-27,2601.42,-1.0,-0.04,2602.42,-0.04,True,1,22582,-2601.42,-9199768.04,58745266.44,49545498.4
2017-11-28,2627.04,25.62,0.98,2627.04,0.0,True,1,22583,-2627.04,-9202395.08,59326444.32,50124049.24
2017-11-29,2626.07,-0.97,-0.04,2627.04,-0.04,True,1,22584,-2626.07,-9205021.15,59307164.88,50102143.73
2017-11-30,2647.58,21.51,0.82,2647.58,0.0,True,1,22585,-2647.58,-9207668.73,59795594.3,50587925.57
2017-12-01,2642.22,-5.36,-0.2,2647.58,-0.2,True,1,22586,-2642.22,-9210310.95,59677180.92,50466869.97
2017-12-04,2639.44,-2.78,-0.1,2647.58,-0.31,True,1,22587,-2639.44,-9212950.39,59617031.28,50404080.89
2017-12-05,2629.57,-9.87,-0.37,2647.58,-0.68,True,1,22588,-2629.57,-9215579.96,59396727.16,50181147.2
2017-12-06,2629.27,-0.3,-0.01,2647.58,-0.69,True,1,22589,-2629.27,-9218209.23,59392580.03,50174370.8
2017-12-07,2636.98,7.71,0.29,2647.58,-0.4,True,1,22590,-2636.98,-9220846.21,59569378.2,50348531.99
2017-12-08,2651.5,14.52,0.55,2651.5,0.0,True,1,22591,-2651.5,-9223497.71,59900036.5,50676538.79
2017-12-11,2659.99,8.49,0.32,2659.99,0.0,True,1,22592,-2659.99,-9226157.7,60094494.08,50868336.38
2017-12-12,2664.11,4.12,0.16,2664.11,0.0,True,1,22593,-2664.11,-9228821.81,60190237.23,50961415.42
2017-12-13,2662.85,-1.26,-0.05,2664.11,-0.05,True,1,22594,-2662.85,-9231484.66,60164432.9,50932948.24
2017-12-14,2652.01,-10.84,-0.41,2664.11,-0.45,True,1,22595,-2652.01,-9234136.67,59922165.95,50688029.28
2017-12-15,2675.81,23.8,0.9,2675.81,0.0,True,1,22596,-2675.81,-9236812.48,60462602.76,51225790.28
2017-12-18,2690.16,14.35,0.54,2690.16,0.0,True,1,22597,-2690.16,-9239502.64,60789545.52,51550042.88
2017-12-19,2681.47,-8.69,-0.32,2690.16,-0.32,True,1,22598,-2681.47,-9242184.11,60595859.06,51353674.95
2017-12-20,2679.25,-2.22,-0.08,2690.16,-0.41,True,1,22599,-2679.25,-9244863.36,60548370.75,51303507.39
2017-12-21,2684.57,5.32,0.2,2690.16,-0.21,True,1,22600,-2684.57,-9247547.93,60671282.0,51423734.07
2017-12-22,2683.34,-1.23,-0.05,2690.16,-0.25,True,1,22601,-2683.34,-9250231.27,60646167.34,51395936.07
2017-12-26,2680.5,-2.84,-0.11,2690.16,-0.36,True,1,22602,-2680.5,-9252911.77,60584661.0,51331749.23
2017-12-27,2682.62,2.12,0.08,2690.16,-0.28,True,1,22603,-2682.62,-9255594.39,60635259.86,51379665.47
2017-12-28,2687.54,4.92,0.18,2690.16,-0.1,True,1,22604,-2687.54,-9258281.93,60749154.16,51490872.23
2017-12-29,2673.61,-13.93,-0.52,2690.16,-0.62,True,1,22605,-2673.61,-9260955.54,60436954.05,51175998.51
2018-01-02,2695.81,22.2,0.83,2695.81,0.0,True,1,22606,-2695.81,-9263651.35,60941480.86,51677829.51
2018-01-03,2713.06,17.25,0.64,2713.06,0.0,True,1,22607,-2713.06,-9266364.41,61334147.42,52067783.01
2018-01-04,2723.99,10.93,0.4,2723.99,0.0,True,1,22608,-2723.99,-9269088.4,61583965.92,52314877.52
2018-01-05,2743.15,19.16,0.7,2743.15,0.0,True,1,22609,-2743.15,-9271831.55,62019878.35,52748046.8
2018-01-08,2747.71,4.56,0.17,2747.71,0.0,True,1,22610,-2747.71,-9274579.26,62125723.1,52851143.84
2018-01-09,2751.29,3.58,0.13,2751.29,0.0,True,1,22611,-2751.29,-9277330.55,62209418.19,52932087.64
2018-01-10,2748.23,-3.06,-0.11,2751.29,-0.11,True,1,22612,-2748.23,-9280078.78,62142976.76,52862897.98
2018-01-11,2767.56,19.33,0.7,2767.56,0.0,True,1,22613,-2767.56,-9282846.34,62582834.28,53299987.94
2018-01-12,2786.24,18.68,0.68,2786.24,0.0,True,1,22614,-2786.24,-9285632.58,63008031.36,53722398.78
2018-01-16,2776.42,-9.82,-0.35,2786.24,-0.35,True,1,22615,-2776.42,-9288409.0,62788738.3,53500329.3
2018-01-17,2802.56,26.14,0.94,2802.56,0.0,True,1,22616,-2802.56,-9291211.56,63382696.96,54091485.4
2018-01-18,2798.03,-4.53,-0.16,2802.56,-0.16,True,1,22617,-2798.03,-9294009.59,63283044.51,53989034.92
2018-01-19,2810.3,12.27,0.44,2810.3,0.0,True,1,22618,-2810.3,-9296819.89,63563365.4,54266545.51
2018-01-22,2832.97,22.67,0.81,2832.97,0.0,True,1,22619,-2832.97,-9299652.86,64078948.43,54779295.57
2018-01-23,2839.13,6.16,0.22,2839.13,0.0,True,1,22620,-2839.13,-9302491.99,64221120.6,54918628.61
2018-01-24,2837.54,-1.59,-0.06,2839.13,-0.06,True,1,22621,-2837.54,-9305329.53,64187992.34,54882662.81
2018-01-25,2839.25,1.71,0.06,2839.25,0.0,True,1,22622,-2839.25,-9308168.78,64229513.5,54921344.72
2018-01-26,2872.87,33.62,1.18,2872.87,0.0,True,1,22623,-2872.87,-9311041.65,64992938.01,55681896.36
2018-01-29,2853.53,-19.34,-0.67,2872.87,-0.67,True,1,22624,-2853.53,-9313895.18,64558262.72,55244367.54
2018-01-30,2822.43,-31.1,-1.09,2872.87,-1.76,True,1,22625,-2822.43,-9316717.61,63857478.75,54540761.14
2018-01-31,2823.81,1.38,0.05,2872.87,-1.71,True,1,22626,-2823.81,-9319541.42,63891525.06,54571983.64
2018-02-01,2821.98,-1.83,-0.06,2872.87,-1.77,True,1,22627,-2821.98,-9322363.4,63852941.46,54530578.06
2018-02-02,2762.13,-59.85,-2.12,2872.87,-3.86,True,1,22628,-2762.13,-9325125.53,62501477.64,53176352.11
2018-02-05,2648.94,-113.19,-4.1,2872.87,-7.8,True,1,22629,-2648.94,-9327774.47,59942863.26,50615088.79
2018-02-06,2695.14,46.2,1.74,2872.87,-6.19,True,1,22630,-2695.14,-9330469.61,60991018.2,51660548.59
2018-02-07,2681.66,-13.48,-0.5,2872.87,-6.66,True,1,22631,-2681.66,-9333151.27,60688647.46,51355496.19
2018-02-08,2581.0,-100.66,-3.75,2872.87,-10.16,True,1,22632,-2581.0,-9335732.27,58413192.0,49077459.73
2018-02-09,2619.55,38.55,1.49,2872.87,-8.82,True,1,22633,-2619.55,-9338351.82,59288275.15,49949923.33
2018-02-12,2656.0,36.45,1.39,2872.87,-7.55,True,1,22634,-2656.0,-9341007.82,60115904.0,50774896.18
2018-02-13,2662.94,6.94,0.26,2872.87,-7.31,True,1,22635,-2662.94,-9343670.76,60275646.9,50931976.14
2018-02-14,2698.63,35.69,1.34,2872.87,-6.06,True,1,22636,-2698.63,-9346369.39,61086188.68,51739819.29
2018-02-15,2731.2,32.57,1.21,2872.87,-4.93,True,1,22637,-2731.2,-9349100.59,61826174.4,52477073.81
2018-02-16,2732.22,1.02,0.04,2872.87,-4.9,True,1,22638,-2732.22,-9351832.81,61851996.36,52500163.55
2018-02-20,2716.26,-15.96,-0.58,2872.87,-5.45,True,1,22639,-2716.26,-9354549.07,61493410.14,52138861.07
2018-02-21,2701.33,-14.93,-0.55,2872.87,-5.97,True,1,22640,-2701.33,-9357250.4,61158111.2,51800860.8
2018-02-22,2703.96,2.63,0.1,2872.87,-5.88,True,1,22641,-2703.96,-9359954.36,61220358.36,51860404.0
2018-02-23,2747.3,43.34,1.6,2872.87,-4.37,True,1,22642,-2747.3,-9362701.66,62204366.6,52841664.94
2018-02-26,2779.6,32.3,1.18,2872.87,-3.25,True,1,22643,-2779.6,-9365481.26,62938482.8,53573001.54
2018-02-27,2744.28,-35.32,-1.27,2872.87,-4.48,True,1,22644,-2744.28,-9368225.54,62141476.32,52773250.78
2018-02-28,2713.83,-30.45,-1.11,2872.87,-5.54,True,1,22645,-2713.83,-9370939.37,61454680.35,52083740.98
2018-03-01,2677.67,-36.16,-1.33,2872.87,-6.8,True,1,22646,-2677.67,-9373617.04,60638514.82,51264897.78
2018-03-02,2691.25,13.58,0.51,2872.87,-6.32,True,1,22647,-2691.25,-9376308.29,60948738.75,51572430.46
2018-03-05,2720.94,29.69,1.1,2872.87,-5.29,True,1,22648,-2720.94,-9379029.23,61623849.12,52244819.89
2018-03-06,2728.12,7.18,0.26,2872.87,-5.04,True,1,22649,-2728.12,-9381757.35,61789189.88,52407432.53
2018-03-07,2726.8,-1.32,-0.05,2872.87,-5.08,True,1,22650,-2726.8,-9384484.15,61762020.0,52377535.85
2018-03-08,2738.97,12.17,0.45,2872.87,-4.66,True,1,22651,-2738.97,-9387223.12,62040409.47,52653186.35
2018-03-09,2786.57,47.6,1.74,2872.87,-3.0,True,1,22652,-2786.57,-9390009.69,63121383.64,53731373.95
2018-03-12,2783.02,-3.55,-0.13,2872.87,-3.13,True,1,22653,-2783.02,-9392792.71,63043752.06,53650959.35
2018-03-13,2765.31,-17.71,-0.64,2872.87,-3.74,True,1,22654,-2765.31,-9395558.02,62645332.74,53249774.72
2018-03-14,2749.48,-15.83,-0.57,2872.87,-4.3,True,1,22655,-2749.48,-9398307.5,62289469.4,52891161.9
2018-03-15,2747.33,-2.15,-0.08,2872.87,-4.37,True,1,22656,-2747.33,-9401054.83,62243508.48,52842453.65
2018-03-16,2752.01,4.68,0.17,2872.87,-4.21,True,1,22657,-2752.01,-9403806.84,62352290.57,52948483.73
2018-03-19,2712.92,-39.09,-1.42,2872.87,-5.57,True,1,22658,-2712.92,-9406519.76,61469341.36,52062821.6
2018-03-20,2716.94,4.02,0.15,2872.87,-5.43,True,1,22659,-2716.94,-9409236.7,61563143.46,52153906.76
2018-03-21,2711.93,-5.01,-0.18,2872.87,-5.6,True,1,22660,-2711.93,-9411948.63,61452333.8,52040385.17
2018-03-22,2643.69,-68.24,-2.52,2872.87,-7.98,True,1,22661,-2643.69,-9414592.32,59908659.09,50494066.77
2018-03-23,2588.26,-55.43,-2.1,2872.87,-9.91,True,1,22662,-2588.26,-9417180.58,58655148.12,49237967.54
2018-03-26,2658.55,70.29,2.72,2872.87,-7.46,True,1,22663,-2658.55,-9419839.13,60250718.65,50830879.52
2018-03-27,2612.62,-45.93,-1.73,2872.87,-9.06,True,1,22664,-2612.62,-9422451.75,59212419.68,49789967.93
2018-03-28,2605.0,-7.62,-0.29,2872.87,-9.32,True,1,22665,-2605.0,-9425056.75,59042325.0,49617268.25
2018-03-29,2640.87,35.87,1.38,2872.87,-8.08,True,1,22666,-2640.87,-9427697.62,59857959.42,50430261.8
2018-04-02,2581.88,-58.99,-2.23,2872.87,-10.13,True,1,22667,-2581.88,-9430279.5,58523473.96,49093194.46
2018-04-03,2614.45,32.57,1.26,2872.87,-8.99,True,1,22668,-2614.45,-9432893.95,59264352.6,49831458.65
2018-04-04,2644.69,30.24,1.16,2872.87,-7.94,True,1,22669,-2644.69,-9435538.64,59952477.61,50516938.97
2018-04-05,2662.84,18.15,0.69,2872.87,-7.31,True,1,22670,-2662.84,-9438201.48,60366582.8,50928381.32
2018-04-06,2604.47,-58.37,-2.19,2872.87,-9.34,True,1,22671,-2604.47,-9440805.95,59045939.37,49605133.42
2018-04-09,2613.16,8.69,0.33,2872.87,-9.04,True,1,22672,-2613.16,-9443419.11,59245563.52,49802144.41
2018-04-10,2656.87,43.71,1.67,2872.87,-7.52,True,1,22673,-2656.87,-9446075.98,60239213.51,50793137.53
2018-04-11,2642.19,-14.68,-0.55,2872.87,-8.03,True,1,22674,-2642.19,-9448718.17,59909016.06,50460297.89
2018-04-12,2663.99,21.8,0.82,2872.87,-7.27,True,1,22675,-2663.99,-9451382.16,60405973.25,50954591.09
2018-04-13,2656.3,-7.69,-0.29,2872.87,-7.54,True,1,22676,-2656.3,-9454038.46,60234258.8,50780220.34
2018-04-16,2677.84,21.54,0.81,2872.87,-6.79,True,1,22677,-2677.84,-9456716.3,60725377.68,51268661.38
2018-04-17,2706.39,28.55,1.07,2872.87,-5.8,True,1,22678,-2706.39,-9459422.69,61375512.42,51916089.73
2018-04-18,2708.64,2.25,0.08,2872.87,-5.72,True,1,22679,-2708.64,-9462131.33,61429246.56,51967115.23
2018-04-19,2693.13,-15.51,-0.57,2872.87,-6.26,True,1,22680,-2693.13,-9464824.46,61080188.4,51615363.94
2018-04-20,2670.14,-22.99,-0.85,2872.87,-7.06,True,1,22681,-2670.14,-9467494.6,60561445.34,51093950.74
2018-04-23,2670.29,0.15,0.01,2872.87,-7.05,True,1,22682,-2670.29,-9470164.89,60567517.78,51097352.89
2018-04-24,2634.56,-35.73,-1.34,2872.87,-8.3,True,1,22683,-2634.56,-9472799.45,59759724.48,50286925.03
2018-04-25,2639.4,4.84,0.18,2872.87,-8.13,True,1,22684,-2639.4,-9475438.85,59872149.6,50396710.75
2018-04-26,2666.94,27.54,1.04,2872.87,-7.17,True,1,22685,-2666.94,-9478105.79,60499533.9,51021428.11
2018-04-27,2669.91,2.97,0.11,2872.87,-7.06,True,1,22686,-2669.91,-9480775.7,60569578.26,51088802.56
2018-04-30,2648.05,-21.86,-0.82,2872.87,-7.83,True,1,22687,-2648.05,-9483423.75,60076310.35,50592886.6
2018-05-01,2654.8,6.75,0.26,2872.87,-7.59,True,1,22688,-2654.8,-9486078.55,60232102.4,50746023.85
2018-05-02,2635.67,-19.13,-0.72,2872.87,-8.26,True,1,22689,-2635.67,-9488714.22,59800716.63,50312002.41
2018-05-03,2629.73,-5.94,-0.22,2872.87,-8.46,True,1,22690,-2629.73,-9491343.95,59668573.7,50177229.75
2018-05-04,2663.42,33.69,1.28,2872.87,-7.29,True,1,22691,-2663.42,-9494007.37,60435663.22,50941655.85
2018-05-07,2672.63,9.21,0.35,2872.87,-6.97,True,1,22692,-2672.63,-9496680.0,60647319.96,51150639.96
2018-05-08,2671.92,-0.71,-0.03,2872.87,-7.0,True,1,22693,-2671.92,-9499351.92,60633880.56,51134528.64
2018-05-09,2697.79,25.87,0.97,2872.87,-6.09,True,1,22694,-2697.79,-9502049.71,61223646.26,51721596.55
2018-05-10,2723.07,25.28,0.94,2872.87,-5.21,True,1,22695,-2723.07,-9504772.78,61800073.65,52295300.87
2018-05-11,2727.72,4.65,0.17,2872.87,-5.05,True,1,22696,-2727.72,-9507500.5,61908333.12,52400832.62
2018-05-14,2730.13,2.41,0.09,2872.87,-4.97,True,1,22697,-2730.13,-9510230.63,61965760.61,52455529.98
2018-05-15,2711.45,-18.68,-0.68,2872.87,-5.62,True,1,22698,-2711.45,-9512942.08,61544492.1,52031550.02
2018-05-16,2722.46,11.01,0.41,2872.87,-5.24,True,1,22699,-2722.46,-9515664.54,61797119.54,52281455.0
2018-05-17,2720.13,-2.33,-0.09,2872.87,-5.32,True,1,22700,-2720.13,-9518384.67,61746951.0,52228566.33
2018-05-18,2712.97,-7.16,-0.26,2872.87,-5.57,True,1,22701,-2712.97,-9521097.64,61587131.97,52066034.33
2018-05-21,2733.01,20.04,0.74,2872.87,-4.87,True,1,22702,-2733.01,-9523830.65,62044793.02,52520962.37
2018-05-22,2724.44,-8.57,-0.31,2872.87,-5.17,True,1,22703,-2724.44,-9526555.09,61852961.32,52326406.23
2018-05-23,2733.29,8.85,0.32,2872.87,-4.86,True,1,22704,-2733.29,-9529288.38,62056616.16,52527327.78
2018-05-24,2727.76,-5.53,-0.2,2872.87,-5.05,True,1,22705,-2727.76,-9532016.14,61933790.8,52401774.66
2018-05-25,2721.33,-6.43,-0.24,2872.87,-5.28,True,1,22706,-2721.33,-9534737.47,61790518.98,52255781.51
2018-05-29,2689.86,-31.47,-1.16,2872.87,-6.37,True,1,22707,-2689.86,-9537427.33,61078651.02,51541223.69
2018-05-30,2724.01,34.15,1.27,2872.87,-5.18,True,1,22708,-2724.01,-9540151.34,61856819.08,52316667.74
2018-05-31,2705.27,-18.74,-0.69,2872.87,-5.83,True,1,22709,-2705.27,-9542856.61,61433976.43,51891119.82
2018-06-01,2734.62,29.35,1.08,2872.87,-4.81,True,1,22710,-2734.62,-9545591.23,62103220.2,52557628.97
2018-06-04,2746.87,12.25,0.45,2872.87,-4.39,True,1,22711,-2746.87,-9548338.1,62384164.57,52835826.47
2018-06-05,2748.8,1.93,0.07,2872.87,-4.32,True,1,22712,-2748.8,-9551086.9,62430745.6,52879658.7
2018-06-06,2772.35,23.55,0.86,2872.87,-3.5,True,1,22713,-2772.35,-9553859.25,62968385.55,53414526.3
2018-06-07,2770.37,-1.98,-0.07,2872.87,-3.57,True,1,22714,-2770.37,-9556629.62,62926184.18,53369554.56
2018-06-08,2779.03,8.66,0.31,2872.87,-3.27,True,1,22715,-2779.03,-9559408.65,63125666.45,53566257.8
2018-06-11,2782.0,2.97,0.11,2872.87,-3.16,True,1,22716,-2782.0,-9562190.65,63195912.0,53633721.35
2018-06-12,2786.85,4.85,0.17,2872.87,-2.99,True,1,22717,-2786.85,-9564977.5,63308871.45,53743893.95
2018-06-13,2775.63,-11.22,-0.4,2872.87,-3.38,True,1,22718,-2775.63,-9567753.13,63056762.34,53489009.21
2018-06-14,2782.49,6.86,0.25,2872.87,-3.15,True,1,22719,-2782.49,-9570535.62,63215390.31,53644854.69
2018-06-15,2779.66,-2.83,-0.1,2872.87,-3.24,True,1,22720,-2779.66,-9573315.28,63153875.2,53580559.92
2018-06-18,2773.75,-5.91,-0.21,2872.87,-3.45,True,1,22721,-2773.75,-9576089.03,63022373.75,53446284.72
2018-06-19,2762.59,-11.16,-0.4,2872.87,-3.84,True,1,22722,-2762.59,-9578851.62,62771569.98,53192718.36
2018-06-20,2767.32,4.73,0.17,2872.87,-3.67,True,1,22723,-2767.32,-9581618.94,62881812.36,53300193.42
2018-06-21,2749.76,-17.56,-0.64,2872.87,-4.28,True,1,22724,-2749.76,-9584368.7,62485546.24,52901177.54
2018-06-22,2754.88,5.12,0.19,2872.87,-4.11,True,1,22725,-2754.88,-9587123.58,62604648.0,53017524.42
2018-06-25,2717.07,-37.81,-1.37,2872.87,-5.42,True,1,22726,-2717.07,-9589840.65,61748132.82,52158292.17
2018-06-26,2723.06,5.99,0.22,2872.87,-5.22,True,1,22727,-2723.06,-9592563.71,61886984.62,52294420.91
2018-06-27,2699.63,-23.43,-0.86,2872.87,-6.03,True,1,22728,-2699.63,-9595263.34,61357190.64,51761927.3
2018-06-28,2716.31,16.68,0.62,2872.87,-5.45,True,1,22729,-2716.31,-9597979.65,61739009.99,52141030.34
2018-06-29,2718.37,2.06,0.08,2872.87,-5.38,True,1,22730,-2718.37,-9600698.02,61788550.1,52187852.08
2018-07-02,2726.71,8.34,0.31,2872.87,-5.09,True,1,22731,-2726.71,-9603424.73,61980845.01,52377420.28
2018-07-03,2713.22,-13.49,-0.5,2872.87,-5.56,True,1,22732,-2713.22,-9606137.95,61676917.04,52070779.09
2018-07-05,2736.61,23.39,0.86,2872.87,-4.74,True,1,22733,-2736.61,-9608874.56,62211355.13,52602480.57
2018-07-06,2759.82,23.21,0.85,2872.87,-3.94,True,1,22734,-2759.82,-9611634.38,62741747.88,53130113.5
2018-07-09,2784.17,24.35,0.88,2872.87,-3.09,True,1,22735,-2784.17,-9614418.55,63298104.95,53683686.4
2018-07-10,2793.84,9.67,0.35,2872.87,-2.75,True,1,22736,-2793.84,-9617212.39,63520746.24,53903533.85
2018-07-11,2774.02,-19.82,-0.71,2872.87,-3.44,True,1,22737,-2774.02,-9619986.41,63072892.74,53452906.33
2018-07-12,2798.29,24.27,0.88,2872.87,-2.6,True,1,22738,-2798.29,-9622784.7,63627518.02,54004733.32
2018-07-13,2801.31,3.02,0.11,2872.87,-2.49,True,1,22739,-2801.31,-9625586.01,63698988.09,54073402.08
2018-07-16,2798.43,-2.88,-0.1,2872.87,-2.59,True,1,22740,-2798.43,-9628384.44,63636298.2,54007913.76
2018-07-17,2809.55,11.12,0.4,2872.87,-2.2,True,1,22741,-2809.55,-9631193.99,63891976.55,54260782.56
2018-07-18,2815.62,6.07,0.22,2872.87,-1.99,True,1,22742,-2815.62,-9634009.61,64032830.04,54398820.43
2018-07-19,2804.49,-11.13,-0.4,2872.87,-2.38,True,1,22743,-2804.49,-9636814.1,63782516.07,54145701.97
2018-07-20,2801.83,-2.66,-0.1,2872.87,-2.47,True,1,22744,-2801.83,-9639615.93,63724821.52,54085205.59
2018-07-23,2806.98,5.15,0.18,2872.87,-2.29,True,1,22745,-2806.98,-9642422.91,63844760.1,54202337.19
2018-07-24,2820.4,13.42,0.48,2872.87,-1.83,True,1,22746,-2820.4,-9645243.31,64152818.4,54507575.09
2018-07-25,2846.07,25.67,0.91,2872.87,-0.93,True,1,22747,-2846.07,-9648089.38,64739554.29,55091464.91
2018-07-26,2837.44,-8.63,-0.3,2872.87,-1.23,True,1,22748,-2837.44,-9650926.82,64546085.12,54895158.3
2018-07-27,2818.82,-18.62,-0.66,2872.87,-1.88,True,1,22749,-2818.82,-9653745.64,64125336.18,54471590.54
2018-07-30,2802.6,-16.22,-0.57,2872.87,-2.45,True,1,22750,-2802.6,-9656548.24,63759150.0,54102601.76
2018-07-31,2816.29,13.69,0.49,2872.87,-1.97,True,1,22751,-2816.29,-9659364.53,64073413.79,54414049.26
2018-08-01,2813.36,-2.93,-0.1,2872.87,-2.07,True,1,22752,-2813.36,-9662177.89,64009566.72,54347388.83
2018-08-02,2827.22,13.86,0.49,2872.87,-1.59,True,1,22753,-2827.22,-9665005.11,64327736.66,54662731.55
2018-08-03,2840.35,13.13,0.46,2872.87,-1.13,True,1,22754,-2840.35,-9667845.46,64629323.9,54961478.44
2018-08-06,2850.4,10.05,0.35,2872.87,-0.78,True,1,22755,-2850.4,-9670695.86,64860852.0,55190156.14
2018-08-07,2858.45,8.05,0.28,2872.87,-0.5,True,1,22756,-2858.45,-9673554.31,65046888.2,55373333.89
2018-08-08,2857.7,-0.75,-0.03,2872.87,-0.53,True,1,22757,-2857.7,-9676412.01,65032678.9,55356266.89
2018-08-09,2853.58,-4.12,-0.14,2872.87,-0.67,True,1,22758,-2853.58,-9679265.59,64941773.64,55262508.05
2018-08-10,2833.28,-20.3,-0.71,2872.87,-1.38,True,1,22759,-2833.28,-9682098.87,64482619.52,54800520.65
2018-08-13,2821.93,-11.35,-0.4,2872.87,-1.77,True,1,22760,-2821.93,-9684920.8,64227126.8,54542206.0
2018-08-14,2839.96,18.03,0.64,2872.87,-1.15,True,1,22761,-2839.96,-9687760.76,64640329.56,54952568.8
2018-08-15,2818.37,-21.59,-0.76,2872.87,-1.9,True,1,22762,-2818.37,-9690579.13,64151737.94,54461158.81
2018-08-16,2840.69,22.32,0.79,2872.87,-1.12,True,1,22763,-2840.69,-9693419.82,64662626.47,54969206.65
2018-08-17,2850.13,9.44,0.33,2872.87,-0.79,True,1,22764,-2850.13,-9696269.95,64880359.32,55184089.37
2018-08-20,2857.05,6.92,0.24,2872.87,-0.55,True,1,22765,-2857.05,-9699127.0,65040743.25,55341616.25
2018-08-21,2862.96,5.91,0.21,2872.87,-0.34,True,1,22766,-2862.96,-9701989.96,65178147.36,55476157.4
2018-08-22,2861.82,-1.14,-0.04,2872.87,-0.38,True,1,22767,-2861.82,-9704851.78,65155055.94,55450204.16
2018-08-23,2856.98,-4.84,-0.17,2872.87,-0.55,True,1,22768,-2856.98,-9707708.76,65047720.64,55340011.88
2018-08-24,2874.69,17.71,0.62,2874.69,0.0,True,1,22769,-2874.69,-9710583.45,65453816.61,55743233.16
2018-08-27,2896.74,22.05,0.77,2896.74,0.0,True,1,22770,-2896.74,-9713480.19,65958769.8,56245289.61
2018-08-28,2897.52,0.78,0.03,2897.52,0.0,True,1,22771,-2897.52,-9716377.71,65979427.92,56263050.21
2018-08-29,2914.04,16.52,0.57,2914.04,0.0,True,1,22772,-2914.04,-9719291.75,66358518.88,56639227.13
2018-08-30,2901.13,-12.91,-0.44,2914.04,-0.44,True,1,22773,-2901.13,-9722192.88,66067433.49,56345240.61
2018-08-31,2901.52,0.39,0.01,2914.04,-0.43,True,1,22774,-2901.52,-9725094.4,66079216.48,56354122.08
2018-09-04,2896.72,-4.8,-0.16,2914.04,-0.59,True,1,22775,-2896.72,-9727991.12,65972798.0,56244806.88
2018-09-05,2888.6,-8.12,-0.28,2914.04,-0.87,True,1,22776,-2888.6,-9730879.72,65790753.6,56059873.88
2018-09-06,2878.05,-10.55,-0.36,2914.04,-1.24,True,1,22777,-2878.05,-9733757.77,65553344.85,55819587.08
2018-09-07,2871.68,-6.37,-0.22,2914.04,-1.45,True,1,22778,-2871.68,-9736629.45,65411127.04,55674497.59
2018-09-10,2877.13,5.45,0.19,2914.04,-1.27,True,1,22779,-2877.13,-9739506.58,65538144.27,55798637.69
2018-09-11,2887.89,10.76,0.37,2914.04,-0.9,True,1,22780,-2887.89,-9742394.47,65786134.2,56043739.73
2018-09-12,2888.92,1.03,0.04,2914.04,-0.86,True,1,22781,-2888.92,-9745283.39,65812486.52,56067203.13
2018-09-13,2904.18,15.26,0.53,2914.04,-0.34,True,1,22782,-2904.18,-9748187.57,66163028.76,56414841.19
2018-09-14,2904.98,0.8,0.03,2914.04,-0.31,True,1,22783,-2904.98,-9751092.55,66184159.34,56433066.79
2018-09-17,2888.8,-16.18,-0.56,2914.04,-0.87,True,1,22784,-2888.8,-9753981.35,65818419.2,56064437.85
2018-09-18,2904.31,15.51,0.54,2914.04,-0.33,True,1,22785,-2904.31,-9756885.66,66174703.35,56417817.69
2018-09-19,2907.95,3.64,0.12,2914.04,-0.21,True,1,22786,-2907.95,-9759793.61,66260548.7,56500755.09
2018-09-20,2930.75,22.8,0.78,2930.75,0.0,True,1,22787,-2930.75,-9762724.36,66783000.25,57020275.89
2018-09-21,2929.67,-1.08,-0.04,2930.75,-0.04,True,1,22788,-2929.67,-9765654.03,66761319.96,56995665.93
2018-09-24,2919.37,-10.3,-0.35,2930.75,-0.39,True,1,22789,-2919.37,-9768573.4,66529522.93,56760949.53
2018-09-25,2915.56,-3.81,-0.13,2930.75,-0.52,True,1,22790,-2915.56,-9771488.96,66445612.4,56674123.44
2018-09-26,2905.97,-9.59,-0.33,2930.75,-0.85,True,1,22791,-2905.97,-9774394.93,66229962.27,56455567.34
2018-09-27,2914.0,8.03,0.28,2930.75,-0.57,True,1,22792,-2914.0,-9777308.93,66415888.0,56638579.07
2018-09-28,2913.98,-0.02,-0.0,2930.75,-0.57,True,1,22793,-2913.98,-9780222.91,66418346.14,56638123.23
2018-10-01,2924.59,10.61,0.36,2930.75,-0.21,True,1,22794,-2924.59,-9783147.5,66663104.46,56879956.96
2018-10-02,2923.43,-1.16,-0.04,2930.75,-0.25,True,1,22795,-2923.43,-9786070.93,66639586.85,56853515.92
2018-10-03,2925.51,2.08,0.07,2930.75,-0.18,True,1,22796,-2925.51,-9788996.44,66689925.96,56900929.52
2018-10-04,2901.61,-23.9,-0.82,2930.75,-0.99,True,1,22797,-2901.61,-9791898.05,66148003.17,56356105.12
2018-10-05,2885.57,-16.04,-0.55,2930.75,-1.54,True,1,22798,-2885.57,-9794783.62,65785224.86,55990441.24
2018-10-08,2884.43,-1.14,-0.04,2930.75,-1.58,True,1,22799,-2884.43,-9797668.05,65762119.57,55964451.52
2018-10-09,2880.34,-4.09,-0.14,2930.75,-1.72,True,1,22800,-2880.34,-9800548.39,65671752.0,55871203.61
2018-10-10,2785.68,-94.66,-3.29,2930.75,-4.95,True,1,22801,-2785.68,-9803334.07,63516289.68,53712955.61
2018-10-11,2728.37,-57.31,-2.06,2930.75,-6.9,True,1,22802,-2728.37,-9806062.44,62212292.74,52406230.3
2018-10-12,2767.13,38.76,1.42,2930.75,-5.58,True,1,22803,-2767.13,-9808829.57,63098865.39,53290035.82
2018-10-15,2750.79,-16.34,-0.59,2930.75,-6.14,True,1,22804,-2750.79,-9811580.36,62729015.16,52917434.8
2018-10-16,2809.92,59.13,2.15,2930.75,-4.12,True,1,22805,-2809.92,-9814390.28,64080225.6,54265835.32
2018-10-17,2809.21,-0.71,-0.02,2930.75,-4.15,True,1,22806,-2809.21,-9817199.49,64066843.26,54249643.77
2018-10-18,2768.78,-40.43,-1.44,2930.75,-5.53,True,1,22807,-2768.78,-9819968.27,63147565.46,53327597.19
2018-10-19,2767.78,-1.0,-0.04,2930.75,-5.56,True,1,22808,-2767.78,-9822736.05,63127526.24,53304790.19
2018-10-22,2755.88,-11.9,-0.43,2930.75,-5.97,True,1,22809,-2755.88,-9825491.93,62858866.92,53033374.99
2018-10-23,2740.69,-15.19,-0.55,2930.75,-6.48,True,1,22810,-2740.69,-9828232.62,62515138.9,52686906.28
2018-10-24,2656.1,-84.59,-3.09,2930.75,-9.37,True,1,22811,-2656.1,-9830888.72,60588297.1,50757408.38
2018-10-25,2705.57,49.47,1.86,2930.75,-7.68,True,1,22812,-2705.57,-9833594.29,61719462.84,51885868.55
2018-10-26,2658.69,-46.88,-1.73,2930.75,-9.28,True,1,22813,-2658.69,-9836252.98,60652694.97,50816441.99
2018-10-29,2641.25,-17.44,-0.66,2930.75,-9.88,True,1,22814,-2641.25,-9838894.23,60257477.5,50418583.27
2018-10-30,2682.63,41.38,1.57,2930.75,-8.47,True,1,22815,-2682.63,-9841576.86,61204203.45,51362626.59
2018-10-31,2711.74,29.11,1.08,2930.75,-7.47,True,1,22816,-2711.74,-9844288.6,61871059.84,52026771.24
2018-11-01,2740.37,28.63,1.06,2930.75,-6.5,True,1,22817,-2740.37,-9847028.97,62527022.29,52679993.32
2018-11-02,2723.06,-17.31,-0.63,2930.75,-7.09,True,1,22818,-2723.06,-9849752.03,62134783.08,52285031.05
2018-11-05,2738.31,15.25,0.56,2930.75,-6.57,True,1,22819,-2738.31,-9852490.34,62485495.89,52633005.55
2018-11-06,2755.45,17.14,0.63,2930.75,-5.98,True,1,22820,-2755.45,-9855245.79,62879369.0,53024123.21
2018-11-07,2813.89,58.44,2.12,2930.75,-3.99,True,1,22821,-2813.89,-9858059.68,64215783.69,54357724.01
2018-11-08,2806.83,-7.06,-0.25,2930.75,-4.23,True,1,22822,-2806.83,-9860866.51,64057474.26,54196607.75
2018-11-09,2781.01,-25.82,-0.92,2930.75,-5.11,True,1,22823,-2781.01,-9863647.52,63470991.23,53607343.71
2018-11-12,2726.22,-54.79,-1.97,2930.75,-6.98,True,1,22824,-2726.22,-9866373.74,62223245.28,52356871.54
2018-11-13,2722.18,-4.04,-0.15,2930.75,-7.12,True,1,22825,-2722.18,-9869095.92,62133758.5,52264662.58
2018-11-14,2701.58,-20.6,-0.76,2930.75,-7.82,True,1,22826,-2701.58,-9871797.5,61666265.08,51794467.58
2018-11-15,2730.2,28.62,1.06,2930.75,-6.84,True,1,22827,-2730.2,-9874527.7,62322275.4,52447747.7
2018-11-16,2736.27,6.07,0.22,2930.75,-6.64,True,1,22828,-2736.27,-9877263.97,62463571.56,52586307.59
2018-11-19,2690.73,-45.54,-1.66,2930.75,-8.19,True,1,22829,-2690.73,-9879954.7,61426675.17,51546720.47
2018-11-20,2641.89,-48.84,-1.82,2930.75,-9.86,True,1,22830,-2641.89,-9882596.59,60314348.7,50431752.11
2018-11-21,2649.93,8.04,0.3,2930.75,-9.58,True,1,22831,-2649.93,-9885246.52,60500551.83,50615305.31
2018-11-23,2632.56,-17.37,-0.66,2930.75,-10.18,True,1,22832,-2632.56,-9887879.08,60106609.92,50218730.84
2018-11-26,2673.45,40.89,1.55,2930.75,-8.78,True,1,22833,-2673.45,-9890552.53,61042883.85,51152331.32
2018-11-27,2682.17,8.72,0.33,2930.75,-8.48,True,1,22834,-2682.17,-9893234.7,61244669.78,51351435.08
2018-11-28,2743.79,61.62,2.3,2930.75,-6.38,True,1,22835,-2743.79,-9895978.49,62654444.65,52758466.16
2018-11-29,2737.8,-5.99,-0.22,2930.75,-6.58,True,1,22836,-2737.8,-9898716.29,62520400.8,52621684.51
2018-11-30,2760.17,22.37,0.82,2930.75,-5.82,True,1,22837,-2760.17,-9901476.46,63034002.29,53132525.83
2018-12-03,2790.37,30.2,1.09,2930.75,-4.79,True,1,22838,-2790.37,-9904266.83,63726470.06,53822203.23
2018-12-04,2700.06,-90.31,-3.24,2930.75,-7.87,True,1,22839,-2700.06,-9906966.89,61666670.34,51759703.45
2018-12-06,2695.95,-4.11,-0.15,2930.75,-8.01,True,1,22840,-2695.95,-9909662.84,61575498.0,51665835.16
2018-12-07,2633.08,-62.87,-2.33,2930.75,-10.16,True,1,22841,-2633.08,-9912295.92,60142180.28,50229884.36
2018-12-10,2637.72,4.64,0.18,2930.75,-10.0,True,1,22842,-2637.72,-9914933.64,60250800.24,50335866.6
2018-12-11,2636.78,-0.94,-0.04,2930.75,-10.03,True,1,22843,-2636.78,-9917570.42,60231965.54,50314395.12
2018-12-12,2651.07,14.29,0.54,2930.75,-9.54,True,1,22844,-2651.07,-9920221.49,60561043.08,50640821.59
2018-12-13,2650.54,-0.53,-0.02,2930.75,-9.56,True,1,22845,-2650.54,-9922872.03,60551586.3,50628714.27
2018-12-14,2599.95,-50.59,-1.91,2930.75,-11.29,True,1,22846,-2599.95,-9925471.98,59398457.7,49472985.72
2018-12-17,2545.94,-54.01,-2.08,2930.75,-13.13,True,1,22847,-2545.94,-9928017.92,58167091.18,48239073.26
2018-12-18,2546.16,0.22,0.01,2930.75,-13.12,True,1,22848,-2546.16,-9930564.08,58174663.68,48244099.6
2018-12-19,2506.96,-39.2,-1.54,2930.75,-14.46,True,1,22849,-2506.96,-9933071.04,57281529.04,47348458.0
2018-12-20,2467.42,-39.54,-1.58,2930.75,-15.81,True,1,22850,-2467.42,-9935538.46,56380547.0,46445008.54
2018-12-21,2416.62,-50.8,-2.06,2930.75,-17.54,True,1,22851,-2416.62,-9937955.08,55222183.62,45284228.54
2018-12-24,2351.1,-65.52,-2.71,2930.75,-19.78,True,1,22852,-2351.1,-9940306.18,53727337.2,43787031.02
2018-12-26,2467.7,116.6,4.96,2930.75,-15.8,True,1,22853,-2467.7,-9942773.88,56394348.1,46451574.22
2018-12-27,2488.83,21.13,0.86,2930.75,-15.08,True,1,22854,-2488.83,-9945262.71,56879720.82,46934458.11
2018-12-28,2485.74,-3.09,-0.12,2930.75,-15.18,True,1,22855,-2485.74,-9947748.45,56811587.7,46863839.25
2018-12-31,2506.85,21.11,0.85,2930.75,-14.46,True,1,22856,-2506.85,-9950255.3,57296563.6,47346308.3
2019-01-02,2510.03,3.18,0.13,2930.75,-14.36,True,1,22857,-2510.03,-9952765.33,57371755.71,47418990.38
2019-01-03,2447.89,-62.14,-2.48,2930.75,-16.48,True,1,22858,-2447.89,-9955213.22,55953869.62,45998656.4
2019-01-04,2531.94,84.05,3.43,2930.75,-13.61,True,1,22859,-2531.94,-9957745.16,57877616.46,47919871.3
2019-01-07,2549.69,17.75,0.7,2930.75,-13.0,True,1,22860,-2549.69,-9960294.85,58285913.4,48325618.55
2019-01-08,2574.41,24.72,0.97,2930.75,-12.16,True,1,22861,-2574.41,-9962869.26,58853587.01,48890717.75
2019-01-09,2584.96,10.55,0.41,2930.75,-11.8,True,1,22862,-2584.96,-9965454.22,59097355.52,49131901.3
2019-01-10,2596.64,11.68,0.45,2930.75,-11.4,True,1,22863,-2596.64,-9968050.86,59366980.32,49398929.46
2019-01-11,2596.26,-0.38,-0.02,2930.75,-11.41,True,1,22864,-2596.26,-9970647.12,59360888.64,49390241.52
2019-01-14,2582.61,-13.65,-0.53,2930.75,-11.88,True,1,22865,-2582.61,-9973229.73,59051377.65,49078147.92
2019-01-15,2610.3,27.69,1.07,2930.75,-10.93,True,1,22866,-2610.3,-9975840.03,59687119.8,49711279.77
2019-01-16,2616.1,5.8,0.22,2930.75,-10.74,True,1,22867,-2616.1,-9978456.13,59822358.7,49843902.57
2019-01-17,2635.96,19.86,0.76,2930.75,-10.06,True,1,22868,-2635.96,-9981092.09,60279133.28,50298041.19
2019-01-18,2670.71,34.75,1.32,2930.75,-8.87,True,1,22869,-2670.71,-9983762.8,61076466.99,51092704.19
2019-01-22,2632.9,-37.81,-1.42,2930.75,-10.16,True,1,22870,-2632.9,-9986395.7,60214423.0,50228027.3
2019-01-23,2638.7,5.8,0.22,2930.75,-9.96,True,1,22871,-2638.7,-9989034.4,60349707.7,50360673.3
2019-01-24,2642.33,3.63,0.14,2930.75,-9.84,True,1,22872,-2642.33,-9991676.73,60435371.76,50443695.03
2019-01-25,2664.76,22.43,0.85,2930.75,-9.08,True,1,22873,-2664.76,-9994341.49,60951055.48,50956713.99
2019-01-28,2643.85,-20.91,-0.78,2930.75,-9.79,True,1,22874,-2643.85,-9996985.34,60475424.9,50478439.56
2019-01-29,2640.0,-3.85,-0.15,2930.75,-9.92,True,1,22875,-2640.0,-9999625.34,60390000.0,50390374.66
2019-01-30,2681.05,41.05,1.56,2930.75,-8.52,True,1,22876,-2681.05,-10002306.39,61331699.8,51329393.41
2019-01-31,2704.1,23.05,0.86,2930.75,-7.73,True,1,22877,-2704.1,-10005010.49,61861695.7,51856685.21
2019-02-01,2706.53,2.43,0.09,2930.75,-7.65,True,1,22878,-2706.53,-10007717.02,61919993.34,51912276.32
2019-02-04,2724.87,18.34,0.68,2930.75,-7.02,True,1,22879,-2724.87,-10010441.89,62342300.73,52331858.84
2019-02-05,2737.7,12.83,0.47,2930.75,-6.59,True,1,22880,-2737.7,-10013179.59,62638576.0,52625396.41
2019-02-06,2731.61,-6.09,-0.22,2930.75,-6.8,True,1,22881,-2731.61,-10015911.2,62501968.41,52486057.21
2019-02-07,2706.05,-25.56,-0.94,2930.75,-7.67,True,1,22882,-2706.05,-10018617.25,61919836.1,51901218.85
2019-02-08,2707.88,1.83,0.07,2930.75,-7.6,True,1,22883,-2707.88,-10021325.13,61964418.04,51943092.91
2019-02-11,2709.8,1.92,0.07,2930.75,-7.54,True,1,22884,-2709.8,-10024034.93,62011063.2,51987028.27
2019-02-12,2744.73,34.93,1.29,2930.75,-6.35,True,1,22885,-2744.73,-10026779.66,62813146.05,52786366.39
2019-02-13,2753.03,8.3,0.3,2930.75,-6.06,True,1,22886,-2753.03,-10029532.69,63005844.58,52976311.89
2019-02-14,2745.73,-7.3,-0.26,2930.75,-6.31,True,1,22887,-2745.73,-10032278.42,62841522.51,52809244.09
2019-02-15,2775.6,29.87,1.09,2930.75,-5.29,True,1,22888,-2775.6,-10035054.02,63527932.8,53492878.78
2019-02-19,2779.76,4.16,0.15,2930.75,-5.15,True,1,22889,-2779.76,-10037833.78,63625926.64,53588092.86
2019-02-20,2784.7,4.94,0.18,2930.75,-4.98,True,1,22890,-2784.7,-10040618.48,63741783.0,53701164.52
2019-02-21,2774.88,-9.82,-0.35,2930.75,-5.32,True,1,22891,-2774.88,-10043393.36,63519778.08,53476384.72
2019-02-22,2792.67,17.79,0.64,2930.75,-4.71,True,1,22892,-2792.67,-10046186.03,63929801.64,53883615.61
2019-02-25,2796.11,3.44,0.12,2930.75,-4.59,True,1,22893,-2796.11,-10048982.14,64011346.23,53962364.09
2019-02-26,2793.9,-2.21,-0.08,2930.75,-4.67,True,1,22894,-2793.9,-10051776.04,63963546.6,53911770.56
2019-02-27,2792.38,-1.52,-0.05,2930.75,-4.72,True,1,22895,-2792.38,-10054568.42,63931540.1,53876971.68
2019-02-28,2784.49,-7.89,-0.28,2930.75,-4.99,True,1,22896,-2784.49,-10057352.91,63753683.04,53696330.13
2019-03-01,2803.69,19.2,0.69,2930.75,-4.34,True,1,22897,-2803.69,-10060156.6,64196089.93,54135933.33
2019-03-04,2792.81,-10.88,-0.39,2930.75,-4.71,True,1,22898,-2792.81,-10062949.41,63949763.38,53886813.97
2019-03-05,2789.65,-3.16,-0.11,2930.75,-4.81,True,1,22899,-2789.65,-10065739.06,63880195.35,53814456.29
2019-03-06,2771.45,-18.2,-0.65,2930.75,-5.44,True,1,22900,-2771.45,-10068510.51,63466205.0,53397694.49
2019-03-07,2748.93,-22.52,-0.81,2930.75,-6.2,True,1,22901,-2748.93,-10071259.44,62953245.93,52881986.49
2019-03-08,2743.07,-5.86,-0.21,2930.75,-6.4,True,1,22902,-2743.07,-10074002.51,62821789.14,52747786.63
2019-03-11,2783.3,40.23,1.47,2930.75,-5.03,True,1,22903,-2783.3,-10076785.81,63745919.9,53669134.09
2019-03-12,2791.52,8.22,0.3,2930.75,-4.75,True,1,22904,-2791.52,-10079577.33,63936974.08,53857396.75
2019-03-13,2810.92,19.4,0.7,2930.75,-4.09,True,1,22905,-2810.92,-10082388.25,64384122.6,54301734.35
2019-03-14,2808.48,-2.44,-0.09,2930.75,-4.17,True,1,22906,-2808.48,-10085196.73,64331042.88,54245846.15
2019-03-15,2822.48,14.0,0.5,2930.75,-3.69,True,1,22907,-2822.48,-10088019.21,64654549.36,54566530.15
2019-03-18,2832.94,10.46,0.37,2930.75,-3.34,True,1,22908,-2832.94,-10090852.15,64896989.52,54806137.37
2019-03-19,2832.57,-0.37,-0.01,2930.75,-3.35,True,1,22909,-2832.57,-10093684.72,64891346.13,54797661.41
2019-03-20,2824.23,-8.34,-0.29,2930.75,-3.64,True,1,22910,-2824.23,-10096508.95,64703109.3,54606600.35
2019-03-21,2854.88,30.65,1.08,2930.75,-2.59,True,1,22911,-2854.88,-10099363.83,65408155.68,55308791.85
2019-03-22,2800.71,-54.17,-1.9,2930.75,-4.44,True,1,22912,-2800.71,-10102164.54,64169867.52,54067702.98
2019-03-25,2798.36,-2.35,-0.08,2930.75,-4.52,True,1,22913,-2798.36,-10104962.9,64118822.68,54013859.78
2019-03-26,2818.46,20.1,0.72,2930.75,-3.83,True,1,22914,-2818.46,-10107781.36,64582192.44,54474411.08
2019-03-27,2805.37,-13.09,-0.46,2930.75,-4.28,True,1,22915,-2805.37,-10110586.73,64285053.55,54174466.82
2019-03-28,2815.44,10.07,0.36,2930.75,-3.93,True,1,22916,-2815.44,-10113402.17,64518623.04,54405220.87
2019-03-29,2834.4,18.96,0.67,2930.75,-3.29,True,1,22917,-2834.4,-10116236.57,64955944.8,54839708.23
2019-04-01,2867.19,32.79,1.16,2930.75,-2.17,True,1,22918,-2867.19,-10119103.76,65710260.42,55591156.66
2019-04-02,2867.24,0.05,0.0,2930.75,-2.17,True,1,22919,-2867.24,-10121971.0,65714273.56,55592302.56
2019-04-03,2873.4,6.16,0.22,2930.75,-1.96,True,1,22920,-2873.4,-10124844.4,65858328.0,55733483.6
2019-04-04,2879.39,5.99,0.21,2930.75,-1.75,True,1,22921,-2879.39,-10127723.79,65998498.19,55870774.4
2019-04-05,2892.74,13.35,0.46,2930.75,-1.3,True,1,22922,-2892.74,-10130616.53,66307386.28,56176769.75
2019-04-08,2895.77,3.03,0.1,2930.75,-1.19,True,1,22923,-2895.77,-10133512.3,66379735.71,56246223.41
2019-04-09,2878.2,-17.57,-0.61,2930.75,-1.79,True,1,22924,-2878.2,-10136390.5,65979856.8,55843466.3
2019-04-10,2888.21,10.01,0.35,2930.75,-1.45,True,1,22925,-2888.21,-10139278.71,66212214.25,56072935.54
2019-04-11,2888.32,0.11,0.0,2930.75,-1.45,True,1,22926,-2888.32,-10142167.03,66217624.32,56075457.29
2019-04-12,2907.41,19.09,0.66,2930.75,-0.8,True,1,22927,-2907.41,-10145074.44,66658189.07,56513114.63
2019-04-15,2905.58,-1.83,-0.06,2930.75,-0.86,True,1,22928,-2905.58,-10147980.02,66619138.24,56471158.22
2019-04-16,2907.06,1.48,0.05,2930.75,-0.81,True,1,22929,-2907.06,-10150887.08,66655978.74,56505091.66
2019-04-17,2900.45,-6.61,-0.23,2930.75,-1.03,True,1,22930,-2900.45,-10153787.53,66507318.5,56353530.97
2019-04-18,2905.03,4.58,0.16,2930.75,-0.88,True,1,22931,-2905.03,-10156692.56,66615242.93,56458550.37
2019-04-22,2907.97,2.94,0.1,2930.75,-0.78,True,1,22932,-2907.97,-10159600.53,66685568.04,56525967.51
2019-04-23,2933.68,25.71,0.88,2933.68,0.0,True,1,22933,-2933.68,-10162534.21,67278083.44,57115549.23
2019-04-24,2927.25,-6.43,-0.22,2933.68,-0.22,True,1,22934,-2927.25,-10165461.46,67133551.5,56968090.04
2019-04-25,2926.17,-1.08,-0.04,2933.68,-0.26,True,1,22935,-2926.17,-10168387.63,67111708.95,56943321.32
2019-04-26,2939.88,13.71,0.47,2939.88,0.0,True,1,22936,-2939.88,-10171327.51,67429087.68,57257760.17
2019-04-29,2943.03,3.15,0.11,2943.03,0.0,True,1,22937,-2943.03,-10174270.54,67504279.11,57330008.57
2019-04-30,2945.83,2.8,0.1,2945.83,0.0,True,1,22938,-2945.83,-10177216.37,67571448.54,57394232.17
2019-05-01,2923.73,-22.1,-0.75,2945.83,-0.75,True,1,22939,-2923.73,-10180140.1,67067442.47,56887302.37
2019-05-02,2917.52,-6.21,-0.21,2945.83,-0.96,True,1,22940,-2917.52,-10183057.62,66927908.8,56744851.18
2019-05-03,2945.64,28.12,0.96,2945.83,-0.01,True,1,22941,-2945.64,-10186003.26,67575927.24,57389923.98
2019-05-06,2932.47,-13.17,-0.45,2945.83,-0.45,True,1,22942,-2932.47,-10188935.73,67276726.74,57087791.01
2019-05-07,2884.05,-48.42,-1.65,2945.83,-2.1,True,1,22943,-2884.05,-10191819.78,66168759.15,55976939.37
2019-05-08,2879.42,-4.63,-0.16,2945.83,-2.25,True,1,22944,-2879.42,-10194699.2,66065412.48,55870713.28
2019-05-09,2870.72,-8.7,-0.3,2945.83,-2.55,True,1,22945,-2870.72,-10197569.92,65868670.4,55671100.48
2019-05-10,2881.4,10.68,0.37,2945.83,-2.19,True,1,22946,-2881.4,-10200451.32,66116604.4,55916153.08
2019-05-13,2811.87,-69.53,-2.41,2945.83,-4.55,True,1,22947,-2811.87,-10203263.19,64523980.89,54320717.7
2019-05-14,2834.41,22.54,0.8,2945.83,-3.78,True,1,22948,-2834.41,-10206097.6,65044040.68,54837943.08
2019-05-15,2850.96,16.55,0.58,2945.83,-3.22,True,1,22949,-2850.96,-10208948.56,65426681.04,55217732.48
2019-05-16,2876.32,25.36,0.89,2945.83,-2.36,True,1,22950,-2876.32,-10211824.88,66011544.0,55799719.12
2019-05-17,2859.53,-16.79,-0.58,2945.83,-2.93,True,1,22951,-2859.53,-10214684.41,65629073.03,55414388.62
2019-05-20,2840.23,-19.3,-0.68,2945.83,-3.58,True,1,22952,-2840.23,-10217524.64,65188958.96,54971434.32
2019-05-21,2864.36,24.13,0.85,2945.83,-2.77,True,1,22953,-2864.36,-10220389.0,65745655.08,55525266.08
2019-05-22,2856.27,-8.09,-0.28,2945.83,-3.04,True,1,22954,-2856.27,-10223245.27,65562821.58,55339576.31
2019-05-23,2822.24,-34.03,-1.19,2945.83,-4.2,True,1,22955,-2822.24,-10226067.51,64784519.2,54558451.69
2019-05-24,2826.06,3.82,0.14,2945.83,-4.07,True,1,22956,-2826.06,-10228893.57,64875033.36,54646139.79
2019-05-28,2802.39,-23.67,-0.84,2945.83,-4.87,True,1,22957,-2802.39,-10231695.96,64334467.23,54102771.27
2019-05-29,2783.02,-19.37,-0.69,2945.83,-5.53,True,1,22958,-2783.02,-10234478.98,63892573.16,53658094.18
2019-05-30,2788.86,5.84,0.21,2945.83,-5.33,True,1,22959,-2788.86,-10237267.84,64029436.74,53792168.9
2019-05-31,2752.06,-36.8,-1.32,2945.83,-6.58,True,1,22960,-2752.06,-10240019.9,63187297.6,52947277.7
2019-06-03,2744.45,-7.61,-0.28,2945.83,-6.84,True,1,22961,-2744.45,-10242764.35,63015316.45,52772552.1
2019-06-04,2803.27,58.82,2.14,2945.83,-4.84,True,1,22962,-2803.27,-10245567.62,64368685.74,54123118.12
2019-06-05,2826.15,22.88,0.82,2945.83,-4.06,True,1,22963,-2826.15,-10248393.77,64896882.45,54648488.68
2019-06-06,2843.49,17.34,0.61,2945.83,-3.47,True,1,22964,-2843.49,-10251237.26,65297904.36,55046667.1
2019-06-07,2873.34,29.85,1.05,2945.83,-2.46,True,1,22965,-2873.34,-10254110.6,65986253.1,55732142.5
2019-06-10,2886.73,13.39,0.47,2945.83,-2.01,True,1,22966,-2886.73,-10256997.33,66296641.18,56039643.85
2019-06-11,2885.72,-1.01,-0.04,2945.83,-2.04,True,1,22967,-2885.72,-10259883.05,66276331.24,56016448.19
2019-06-12,2879.84,-5.88,-0.2,2945.83,-2.24,True,1,22968,-2879.84,-10262762.89,66144165.12,55881402.23
2019-06-13,2891.64,11.8,0.41,2945.83,-1.84,True,1,22969,-2891.64,-10265654.53,66418079.16,56152424.63
2019-06-14,2886.98,-4.66,-0.16,2945.83,-2.0,True,1,22970,-2886.98,-10268541.51,66313930.6,56045389.09
2019-06-17,2889.67,2.69,0.09,2945.83,-1.91,True,1,22971,-2889.67,-10271431.18,66378609.57,56107178.39
2019-06-18,2917.75,28.08,0.97,2945.83,-0.95,True,1,22972,-2917.75,-10274348.93,67026553.0,56752204.07
2019-06-19,2926.46,8.71,0.3,2945.83,-0.66,True,1,22973,-2926.46,-10277275.39,67229565.58,56952290.19
2019-06-20,2954.18,27.72,0.95,2954.18,0.0,True,1,22974,-2954.18,-10280229.57,67869331.32,57589101.75
2019-06-21,2950.46,-3.72,-0.13,2954.18,-0.13,True,1,22975,-2950.46,-10283180.03,67786818.5,57503638.47
2019-06-24,2945.35,-5.11,-0.17,2954.18,-0.3,True,1,22976,-2945.35,-10286125.38,67672361.6,57386236.22
2019-06-25,2917.38,-27.97,-0.95,2954.18,-1.25,True,1,22977,-2917.38,-10289042.76,67032640.26,56743597.5
2019-06-26,2913.78,-3.6,-0.12,2954.18,-1.37,True,1,22978,-2913.78,-10291956.54,66952836.84,56660880.3
2019-06-27,2924.92,11.14,0.38,2954.18,-0.99,True,1,22979,-2924.92,-10294881.46,67211736.68,56916855.22
2019-06-28,2941.76,16.84,0.58,2954.18,-0.42,True,1,22980,-2941.76,-10297823.22,67601644.8,57303821.58
2019-07-01,2964.33,22.57,0.77,2964.33,0.0,True,1,22981,-2964.33,-10300787.55,68123267.73,57822480.18
2019-07-02,2973.01,8.68,0.29,2973.01,0.0,True,1,22982,-2973.01,-10303760.56,68325715.82,58021955.26
2019-07-03,2995.82,22.81,0.77,2995.82,0.0,True,1,22983,-2995.82,-10306756.38,68852931.06,58546174.68
2019-07-05,2990.41,-5.41,-0.18,2995.82,-0.18,True,1,22984,-2990.41,-10309746.79,68731583.44,58421836.65
2019-07-08,2975.95,-14.46,-0.48,2995.82,-0.66,True,1,22985,-2975.95,-10312722.74,68402210.75,58089488.01
2019-07-09,2979.63,3.68,0.12,2995.82,-0.54,True,1,22986,-2979.63,-10315702.37,68489775.18,58174072.81
2019-07-10,2993.07,13.44,0.45,2995.82,-0.09,True,1,22987,-2993.07,-10318695.44,68801700.09,58483004.65
2019-07-11,2999.91,6.84,0.23,2999.91,0.0,True,1,22988,-2999.91,-10321695.35,68961931.08,58640235.73
2019-07-12,3013.77,13.86,0.46,3013.77,0.0,True,1,22989,-3013.77,-10324709.12,69283558.53,58958849.41
2019-07-15,3014.3,0.53,0.02,3014.3,0.0,True,1,22990,-3014.3,-10327723.42,69298757.0,58971033.58
2019-07-16,3004.04,-10.26,-0.34,3014.3,-0.34,True,1,22991,-3004.04,-10330727.46,69065883.64,58735156.18
2019-07-17,2984.42,-19.62,-0.65,3014.3,-0.99,True,1,22992,-2984.42,-10333711.88,68617784.64,58284072.76
2019-07-18,2995.11,10.69,0.36,3014.3,-0.64,True,1,22993,-2995.11,-10336706.99,68866564.23,58529857.24
2019-07-19,2976.61,-18.5,-0.62,3014.3,-1.25,True,1,22994,-2976.61,-10339683.6,68444170.34,58104486.74
2019-07-22,2985.03,8.42,0.28,3014.3,-0.97,True,1,22995,-2985.03,-10342668.63,68640764.85,58298096.22
2019-07-23,3005.47,20.44,0.68,3014.3,-0.29,True,1,22996,-3005.47,-10345674.1,69113788.12,58768114.02
2019-07-24,3019.56,14.09,0.47,3019.56,0.0,True,1,22997,-3019.56,-10348693.66,69440821.32,59092127.66
2019-07-25,3003.67,-15.89,-0.53,3019.56,-0.53,True,1,22998,-3003.67,-10351697.33,69078402.66,58726705.33
2019-07-26,3025.86,22.19,0.74,3025.86,0.0,True,1,22999,-3025.86,-10354723.19,69591754.14,59237030.95
2019-07-29,3020.97,-4.89,-0.16,3025.86,-0.16,True,1,23000,-3020.97,-10357744.16,69482310.0,59124565.84
2019-07-30,3013.18,-7.79,-0.26,3025.86,-0.42,True,1,23001,-3013.18,-10360757.34,69306153.18,58945395.84
2019-07-31,2980.38,-32.8,-1.09,3025.86,-1.5,True,1,23002,-2980.38,-10363737.72,68554700.76,58190963.04
2019-08-01,2953.56,-26.82,-0.9,3025.86,-2.39,True,1,23003,-2953.56,-10366691.28,67940740.68,57574049.4
2019-08-02,2932.05,-21.51,-0.73,3025.86,-3.1,True,1,23004,-2932.05,-10369623.33,67448878.2,57079254.87
2019-08-05,2844.74,-87.31,-2.98,3025.86,-5.99,True,1,23005,-2844.74,-10372468.07,65443243.7,55070775.63
2019-08-06,2881.77,37.03,1.3,3025.86,-4.76,True,1,23006,-2881.77,-10375349.84,66298000.62,55922650.78
2019-08-07,2883.98,2.21,0.08,3025.86,-4.69,True,1,23007,-2883.98,-10378233.82,66351727.86,55973494.04
2019-08-08,2938.09,54.11,1.88,3025.86,-2.9,True,1,23008,-2938.09,-10381171.91,67599574.72,57218402.81
2019-08-09,2918.65,-19.44,-0.66,3025.86,-3.54,True,1,23009,-2918.65,-10384090.56,67155217.85,56771127.29
2019-08-12,2882.7,-35.95,-1.23,3025.86,-4.73,True,1,23010,-2882.7,-10386973.26,66330927.0,55943953.74
2019-08-13,2926.32,43.62,1.51,3025.86,-3.29,True,1,23011,-2926.32,-10389899.58,67337549.52,56947649.94
2019-08-14,2840.6,-85.72,-2.93,3025.86,-6.12,True,1,23012,-2840.6,-10392740.18,65367887.2,54975147.02
2019-08-15,2847.6,7.0,0.25,3025.86,-5.89,True,1,23013,-2847.6,-10395587.78,65531818.8,55136231.02
2019-08-16,2888.68,41.08,1.44,3025.86,-4.53,True,1,23014,-2888.68,-10398476.46,66480081.52,56081605.06
2019-08-19,2923.65,34.97,1.21,3025.86,-3.38,True,1,23015,-2923.65,-10401400.11,67287804.75,56886404.64
2019-08-20,2900.51,-23.14,-0.79,3025.86,-4.14,True,1,23016,-2900.51,-10404300.62,66758138.16,56353837.54
2019-08-21,2924.43,23.92,0.82,3025.86,-3.35,True,1,23017,-2924.43,-10407225.05,67311605.31,56904380.26
2019-08-22,2922.95,-1.48,-0.05,3025.86,-3.4,True,1,23018,-2922.95,-10410148.0,67280463.1,56870315.1
2019-08-23,2847.11,-75.84,-2.6,3025.86,-5.91,True,1,23019,-2847.11,-10412995.11,65537625.09,55124629.98
2019-08-26,2878.38,31.27,1.1,3025.86,-4.87,True,1,23020,-2878.38,-10415873.49,66260307.6,55844434.11
2019-08-27,2869.16,-9.22,-0.32,3025.86,-5.18,True,1,23021,-2869.16,-10418742.65,66050932.36,55632189.71
2019-08-28,2887.94,18.78,0.66,3025.86,-4.56,True,1,23022,-2887.94,-10421630.59,66486154.68,56064524.09
2019-08-29,2924.58,36.64,1.27,3025.86,-3.35,True,1,23023,-2924.58,-10424555.17,67332605.34,56908050.17
2019-08-30,2926.46,1.88,0.06,3025.86,-3.28,True,1,23024,-2926.46,-10427481.63,67378815.04,56951333.41
2019-09-03,2906.27,-20.19,-0.69,3025.86,-3.95,True,1,23025,-2906.27,-10430387.9,66916866.75,56486478.85
2019-09-04,2937.78,31.51,1.08,3025.86,-2.91,True,1,23026,-2937.78,-10433325.68,67645322.28,57211996.6
2019-09-05,2976.0,38.22,1.3,3025.86,-1.65,True,1,23027,-2976.0,-10436301.68,68528352.0,58092050.32
2019-09-06,2978.71,2.71,0.09,3025.86,-1.56,True,1,23028,-2978.71,-10439280.39,68593733.88,58154453.49
2019-09-09,2978.43,-0.28,-0.01,3025.86,-1.57,True,1,23029,-2978.43,-10442258.82,68590264.47,58148005.65
2019-09-10,2979.39,0.96,0.03,3025.86,-1.54,True,1,23030,-2979.39,-10445238.21,68615351.7,58170113.49
2019-09-11,3000.93,21.54,0.72,3025.86,-0.82,True,1,23031,-3000.93,-10448239.14,69114418.83,58666179.69
2019-09-12,3009.57,8.64,0.29,3025.86,-0.54,True,1,23032,-3009.57,-10451248.71,69316416.24,58865167.53
2019-09-13,3007.39,-2.18,-0.07,3025.86,-0.61,True,1,23033,-3007.39,-10454256.1,69269213.87,58814957.77
2019-09-16,2997.96,-9.43,-0.31,3025.86,-0.92,True,1,23034,-2997.96,-10457254.06,69055010.64,58597756.58
2019-09-17,3005.7,7.74,0.26,3025.86,-0.67,True,1,23035,-3005.7,-10460259.76,69236299.5,58776039.74
2019-09-18,3006.73,1.03,0.03,3025.86,-0.63,True,1,23036,-3006.73,-10463266.49,69263032.28,58799765.79
2019-09-19,3006.79,0.06,0.0,3025.86,-0.63,True,1,23037,-3006.79,-10466273.28,69267421.23,58801147.95
2019-09-20,2992.07,-14.72,-0.49,3025.86,-1.12,True,1,23038,-2992.07,-10469265.35,68931308.66,58462043.31
2019-09-23,2991.78,-0.29,-0.01,3025.86,-1.13,True,1,23039,-2991.78,-10472257.13,68927619.42,58455362.29
2019-09-24,2966.6,-25.18,-0.84,3025.86,-1.96,True,1,23040,-2966.6,-10475223.73,68350464.0,57875240.27
2019-09-25,2984.87,18.27,0.62,3025.86,-1.36,True,1,23041,-2984.87,-10478208.6,68774389.67,58296181.07
2019-09-26,2977.62,-7.25,-0.24,3025.86,-1.59,True,1,23042,-2977.62,-10481186.22,68610320.04,58129133.82
2019-09-27,2961.79,-15.83,-0.53,3025.86,-2.12,True,1,23043,-2961.79,-10484148.01,68248526.97,57764378.96
2019-09-30,2976.74,14.95,0.5,3025.86,-1.62,True,1,23044,-2976.74,-10487124.75,68595996.56,58108871.81
2019-10-01,2940.25,-36.49,-1.23,3025.86,-2.83,True,1,23045,-2940.25,-10490065.0,67758061.25,57267996.25
2019-10-02,2887.61,-52.64,-1.79,3025.86,-4.57,True,1,23046,-2887.61,-10492952.61,66547860.06,56054907.45
2019-10-03,2910.63,23.02,0.8,3025.86,-3.81,True,1,23047,-2910.63,-10495863.24,67081289.61,56585426.37
2019-10-04,2952.01,41.38,1.42,3025.86,-2.44,True,1,23048,-2952.01,-10498815.25,68037926.48,57539111.23
2019-10-07,2938.79,-13.22,-0.45,3025.86,-2.88,True,1,23049,-2938.79,-10501754.04,67736170.71,57234416.67
2019-10-08,2893.06,-45.73,-1.56,3025.86,-4.39,True,1,23050,-2893.06,-10504647.1,66685033.0,56180385.9
2019-10-09,2919.4,26.34,0.91,3025.86,-3.52,True,1,23051,-2919.4,-10507566.5,67295089.4,56787522.9
2019-10-10,2938.13,18.73,0.64,3025.86,-2.9,True,1,23052,-2938.13,-10510504.63,67729772.76,57219268.13
2019-10-11,2970.27,32.14,1.09,3025.86,-1.84,True,1,23053,-2970.27,-10513474.9,68473634.31,57960159.41
2019-10-14,2966.15,-4.12,-0.14,3025.86,-1.97,True,1,23054,-2966.15,-10516441.05,68381622.1,57865181.05
2019-10-15,2995.68,29.53,1.0,3025.86,-1.0,True,1,23055,-2995.68,-10519436.73,69065402.4,58545965.67
2019-10-16,2989.69,-5.99,-0.2,3025.86,-1.2,True,1,23056,-2989.69,-10522426.42,68930292.64,58407866.22
2019-10-17,2997.95,8.26,0.28,3025.86,-0.92,True,1,23057,-2997.95,-10525424.37,69123733.15,58598308.78
2019-10-18,2986.2,-11.75,-0.39,3025.86,-1.31,True,1,23058,-2986.2,-10528410.57,68855799.6,58327389.03
2019-10-21,3006.72,20.52,0.69,3025.86,-0.63,True,1,23059,-3006.72,-10531417.29,69331956.48,58800539.19
2019-10-22,2995.99,-10.73,-0.36,3025.86,-0.99,True,1,23060,-2995.99,-10534413.28,69087529.4,58553116.12
2019-10-23,3004.52,8.53,0.28,3025.86,-0.7,True,1,23061,-3004.52,-10537417.8,69287235.72,58749817.92
2019-10-24,3010.29,5.77,0.19,3025.86,-0.52,True,1,23062,-3010.29,-10540428.09,69423307.98,58882879.89
2019-10-25,3022.55,12.26,0.41,3025.86,-0.11,True,1,23063,-3022.55,-10543450.64,69709070.65,59165620.01
2019-10-28,3039.42,16.87,0.56,3039.42,0.0,True,1,23064,-3039.42,-10546490.06,70101182.88,59554692.82
2019-10-29,3036.89,-2.53,-0.08,3039.42,-0.08,True,1,23065,-3036.89,-10549526.95,70045867.85,59496340.9
2019-10-30,3046.77,9.88,0.32,3046.77,0.0,True,1,23066,-3046.77,-10552573.72,70276796.82,59724223.1
2019-10-31,3037.56,-9.21,-0.3,3046.77,-0.3,True,1,23067,-3037.56,-10555611.28,70067396.52,59511785.24
2019-11-01,3066.91,29.35,0.97,3066.91,0.0,True,1,23068,-3066.91,-10558678.19,70747479.88,60188801.69
2019-11-04,3078.27,11.36,0.37,3078.27,0.0,True,1,23069,-3078.27,-10561756.46,71012610.63,60450854.17
2019-11-05,3074.62,-3.65,-0.12,3078.27,-0.12,True,1,23070,-3074.62,-10564831.08,70931483.4,60366652.32
2019-11-06,3076.78,2.16,0.07,3078.27,-0.05,True,1,23071,-3076.78,-10567907.86,70984391.38,60416483.52
2019-11-07,3085.18,8.4,0.27,3085.18,0.0,True,1,23072,-3085.18,-10570993.04,71181272.96,60610279.92
2019-11-08,3093.08,7.9,0.26,3093.08,0.0,True,1,23073,-3093.08,-10574086.12,71366634.84,60792548.72
2019-11-11,3087.01,-6.07,-0.2,3093.08,-0.2,True,1,23074,-3087.01,-10577173.13,71229668.74,60652495.61
2019-11-12,3091.84,4.83,0.16,3093.08,-0.04,True,1,23075,-3091.84,-10580264.97,71344208.0,60763943.03
2019-11-13,3094.04,2.2,0.07,3094.04,0.0,True,1,23076,-3094.04,-10583359.01,71398067.04,60814708.03
2019-11-14,3096.63,2.59,0.08,3096.63,0.0,True,1,23077,-3096.63,-10586455.64,71460930.51,60874474.87
2019-11-15,3120.46,23.83,0.77,3120.46,0.0,True,1,23078,-3120.46,-10589576.1,72013975.88,61424399.78
2019-11-18,3122.03,1.57,0.05,3122.03,0.0,True,1,23079,-3122.03,-10592698.13,72053330.37,61460632.24
2019-11-19,3120.18,-1.85,-0.06,3122.03,-0.06,True,1,23080,-3120.18,-10595818.31,72013754.4,61417936.09
2019-11-20,3108.46,-11.72,-0.38,3122.03,-0.44,True,1,23081,-3108.46,-10598926.77,71746365.26,61147438.49
2019-11-21,3103.54,-4.92,-0.16,3122.03,-0.59,True,1,23082,-3103.54,-10602030.31,71635910.28,61033879.97
2019-11-22,3110.29,6.75,0.22,3122.03,-0.38,True,1,23083,-3110.29,-10605140.6,71794824.07,61189683.47
2019-11-25,3133.64,23.35,0.75,3133.64,0.0,True,1,23084,-3133.64,-10608274.24,72336945.76,61728671.52
2019-11-26,3140.52,6.88,0.22,3140.52,0.0,True,1,23085,-3140.52,-10611414.76,72498904.2,61887489.44
2019-11-27,3153.63,13.11,0.42,3153.63,0.0,True,1,23086,-3153.63,-10614568.39,72804702.18,62190133.79
2019-11-29,3140.98,-12.65,-0.4,3153.63,-0.4,True,1,23087,-3140.98,-10617709.37,72515805.26,61898095.89
2019-12-02,3113.87,-27.11,-0.86,3153.63,-1.26,True,1,23088,-3113.87,-10620823.24,71893030.56,61272207.32
2019-12-03,3093.2,-20.67,-0.66,3153.63,-1.92,True,1,23089,-3093.2,-10623916.44,71418894.8,60794978.36
2019-12-04,3112.76,19.56,0.63,3153.63,-1.3,True,1,23090,-3112.76,-10627029.2,71873628.4,61246599.2
2019-12-05,3117.43,4.67,0.15,3153.63,-1.15,True,1,23091,-3117.43,-10630146.63,71984576.13,61354429.5
2019-12-06,3145.91,28.48,0.91,3153.63,-0.24,True,1,23092,-3145.91,-10633292.54,72645353.72,62012061.18
2019-12-09,3135.96,-9.95,-0.32,3153.63,-0.56,True,1,23093,-3135.96,-10636428.5,72418724.28,61782295.78
2019-12-10,3132.52,-3.44,-0.11,3153.63,-0.67,True,1,23094,-3132.52,-10639561.02,72342416.88,61702855.86
2019-12-11,3141.63,9.11,0.29,3153.63,-0.38,True,1,23095,-3141.63,-10642702.65,72555944.85,61913242.2
2019-12-12,3168.57,26.94,0.86,3168.57,0.0,True,1,23096,-3168.57,-10645871.22,73181292.72,62535421.5
2019-12-13,3168.8,0.23,0.01,3168.8,0.0,True,1,23097,-3168.8,-10649040.02,73189773.6,62540733.58
2019-12-16,3191.45,22.65,0.72,3191.45,0.0,True,1,23098,-3191.45,-10652231.47,73716112.1,63063880.63
2019-12-17,3192.52,1.07,0.03,3192.52,0.0,True,1,23099,-3192.52,-10655423.99,73744019.48,63088595.49
2019-12-18,3191.14,-1.38,-0.04,3192.52,-0.04,True,1,23100,-3191.14,-10658615.13,73715334.0,63056718.87
2019-12-19,3205.37,14.23,0.45,3205.37,0.0,True,1,23101,-3205.37,-10661820.5,74047252.37,63385431.87
2019-12-20,3221.22,15.85,0.49,3221.22,0.0,True,1,23102,-3221.22,-10665041.72,74416624.44,63751582.72
2019-12-23,3224.01,2.79,0.09,3224.01,0.0,True,1,23103,-3224.01,-10668265.73,74484303.03,63816037.3
2019-12-24,3223.38,-0.63,-0.02,3224.01,-0.02,True,1,23104,-3223.38,-10671489.11,74472971.52,63801482.41
2019-12-26,3239.91,16.53,0.51,3239.91,0.0,True,1,23105,-3239.91,-10674729.02,74858120.55,64183391.53
2019-12-27,3240.02,0.11,0.0,3240.02,0.0,True,1,23106,-3240.02,-10677969.04,74863902.12,64185933.08
2019-12-30,3221.29,-18.73,-0.58,3240.02,-0.58,True,1,23107,-3221.29,-10681190.33,74434348.03,63753157.7
2019-12-31,3230.78,9.49,0.3,3240.02,-0.28,True,1,23108,-3230.78,-10684421.11,74656864.24,63972443.13
2020-01-02,3257.85,27.07,0.84,3257.85,0.0,True,1,23109,-3257.85,-10687678.96,75285655.65,64597976.69
2020-01-03,3234.85,-23.0,-0.71,3257.85,-0.71,True,1,23110,-3234.85,-10690913.81,74757383.5,64066469.69
2020-01-06,3246.28,11.43,0.35,3257.85,-0.36,True,1,23111,-3246.28,-10694160.09,75024777.08,64330616.99
2020-01-07,3237.18,-9.1,-0.28,3257.85,-0.63,True,1,23112,-3237.18,-10697397.27,74817704.16,64120306.89
2020-01-08,3253.05,15.87,0.49,3257.85,-0.15,True,1,23113,-3253.05,-10700650.32,75187744.65,64487094.33
2020-01-09,3274.7,21.65,0.67,3274.7,0.0,True,1,23114,-3274.7,-10703925.02,75691415.8,64987490.78
2020-01-10,3265.35,-9.35,-0.29,3274.7,-0.29,True,1,23115,-3265.35,-10707190.37,75478565.25,64771374.88
2020-01-13,3288.13,22.78,0.7,3288.13,0.0,True,1,23116,-3288.13,-10710478.5,76008413.08,65297934.58
2020-01-14,3283.15,-4.98,-0.15,3288.13,-0.15,True,1,23117,-3283.15,-10713761.65,75896578.55,65182816.9
2020-01-15,3289.29,6.14,0.19,3289.29,0.0,True,1,23118,-3289.29,-10717050.94,76041806.22,65324755.28
2020-01-16,3316.81,27.52,0.84,3316.81,0.0,True,1,23119,-3316.81,-10720367.75,76681330.39,65960962.64
2020-01-17,3329.62,12.81,0.39,3329.62,0.0,True,1,23120,-3329.62,-10723697.37,76980814.4,66257117.03
2020-01-21,3320.79,-8.83,-0.26,3329.62,-0.26,True,1,23121,-3320.79,-10727018.16,76779985.59,66052967.43
2020-01-22,3321.75,0.96,0.03,3329.62,-0.24,True,1,23122,-3321.75,-10730339.91,76805503.5,66075163.59
2020-01-23,3325.54,3.79,0.11,3329.62,-0.12,True,1,23123,-3325.54,-10733665.45,76896461.42,66162795.97
2020-01-24,3295.47,-30.07,-0.9,3329.62,-1.03,True,1,23124,-3295.47,-10736960.92,76204448.28,65467487.36
2020-01-27,3243.63,-51.84,-1.57,3329.62,-2.58,True,1,23125,-3243.63,-10740204.55,75008943.75,64268739.2
2020-01-28,3276.24,32.61,1.0,3329.62,-1.6,True,1,23126,-3276.24,-10743480.79,75766326.24,65022845.45
2020-01-29,3273.4,-2.84,-0.09,3329.62,-1.69,True,1,23127,-3273.4,-10746754.19,75703921.8,64957167.61
2020-01-30,3283.66,10.26,0.31,3329.62,-1.38,True,1,23128,-3283.66,-10750037.85,75944488.48,65194450.63
2020-01-31,3225.52,-58.14,-1.77,3329.62,-3.13,True,1,23129,-3225.52,-10753263.37,74603052.08,63849788.71
2020-02-03,3248.92,23.4,0.72,3329.62,-2.42,True,1,23130,-3248.92,-10756512.29,75147519.6,64391007.31
2020-02-04,3297.59,48.67,1.5,3329.62,-0.96,True,1,23131,-3297.59,-10759809.88,76276554.29,65516744.41
2020-02-05,3334.69,37.1,1.12,3334.69,0.0,True,1,23132,-3334.69,-10763144.57,77138049.08,66374904.51
2020-02-06,3345.78,11.09,0.33,3345.78,0.0,True,1,23133,-3345.78,-10766490.35,77397928.74,66631438.39
2020-02-07,3327.71,-18.07,-0.54,3345.78,-0.54,True,1,23134,-3327.71,-10769818.06,76983243.14,66213425.08
2020-02-10,3352.09,24.38,0.73,3352.09,0.0,True,1,23135,-3352.09,-10773170.15,77550602.15,66777432.0
2020-02-11,3357.75,5.66,0.17,3357.75,0.0,True,1,23136,-3357.75,-10776527.9,77684904.0,66908376.1
2020-02-12,3379.45,21.7,0.65,3379.45,0.0,True,1,23137,-3379.45,-10779907.35,78190334.65,67410427.3
2020-02-13,3373.94,-5.51,-0.16,3379.45,-0.16,True,1,23138,-3373.94,-10783281.29,78066223.72,67282942.43
2020-02-14,3380.16,6.22,0.18,3380.16,0.0,True,1,23139,-3380.16,-10786661.45,78213522.24,67426860.79
2020-02-18,3370.29,-9.87,-0.29,3380.16,-0.29,True,1,23140,-3370.29,-10790031.74,77988510.6,67198478.86
2020-02-19,3386.15,15.86,0.47,3386.15,0.0,True,1,23141,-3386.15,-10793417.89,78358897.15,67565479.26
2020-02-20,3373.23,-12.92,-0.38,3386.15,-0.38,True,1,23142,-3373.23,-10796791.12,78063288.66,67266497.54
2020-02-21,3337.75,-35.48,-1.05,3386.15,-1.43,True,1,23143,-3337.75,-10800128.87,77245548.25,66445419.38
2020-02-24,3225.89,-111.86,-3.35,3386.15,-4.73,True,1,23144,-3225.89,-10803354.76,74659998.16,63856643.4
2020-02-25,3128.21,-97.68,-3.03,3386.15,-7.62,True,1,23145,-3128.21,-10806482.97,72402420.45,61595937.48
2020-02-26,3116.39,-11.82,-0.38,3386.15,-7.97,True,1,23146,-3116.39,-10809599.36,72131962.94,61322363.58
2020-02-27,2978.76,-137.63,-4.42,3386.15,-12.03,True,1,23147,-2978.76,-10812578.12,68949357.72,58136779.6
2020-02-28,2954.22,-24.54,-0.82,3386.15,-12.76,True,1,23148,-2954.22,-10815532.34,68384284.56,57568752.22
2020-03-02,3090.23,136.01,4.6,3386.15,-8.74,True,1,23149,-3090.23,-10818622.57,71535734.27,60717111.7
2020-03-03,3003.37,-86.86,-2.81,3386.15,-11.3,True,1,23150,-3003.37,-10821625.94,69528015.5,58706389.56
2020-03-04,3130.12,126.75,4.22,3386.15,-7.56,True,1,23151,-3130.12,-10824756.06,72465408.12,61640652.06
2020-03-05,3023.94,-106.18,-3.39,3386.15,-10.7,True,1,23152,-3023.94,-10827780.0,70010258.88,59182478.88
2020-03-06,2972.37,-51.57,-1.7,3386.15,-12.22,True,1,23153,-2972.37,-10830752.37,68819282.61,57988530.24
2020-03-09,2746.56,-225.81,-7.6,3386.15,-18.89,True,1,23154,-2746.56,-10833498.93,63593850.24,52760351.31
2020-03-10,2882.23,135.67,4.94,3386.15,-14.88,True,1,23155,-2882.23,-10836381.16,66738035.65,55901654.49
2020-03-11,2741.38,-140.85,-4.89,3386.15,-19.04,True,1,23156,-2741.38,-10839122.54,63479395.28,52640272.74
2020-03-12,2480.64,-260.74,-9.51,3386.15,-26.74,True,1,23157,-2480.64,-10841603.18,57444180.48,46602577.3
2020-03-13,2711.02,230.38,9.29,3386.15,-19.94,True,1,23158,-2711.02,-10844314.2,62781801.16,51937486.96
2020-03-16,2386.13,-324.89,-11.98,3386.15,-29.53,True,1,23159,-2386.13,-10846700.33,55260384.67,44413684.34
2020-03-17,2529.19,143.06,6.0,3386.15,-25.31,True,1,23160,-2529.19,-10849229.52,58576040.4,47726810.88
2020-03-18,2398.1,-131.09,-5.18,3386.15,-29.18,True,1,23161,-2398.1,-10851627.62,55542394.1,44690766.48
2020-03-19,2409.39,11.29,0.47,3386.15,-28.85,True,1,23162,-2409.39,-10854037.01,55806291.18,44952254.17
2020-03-20,2304.92,-104.47,-4.34,3386.15,-31.93,True,1,23163,-2304.92,-10856341.93,53388861.96,42532520.03
2020-03-23,2237.4,-67.52,-2.93,3386.15,-33.92,True,1,23164,-2237.4,-10858579.33,51827133.6,40968554.27
2020-03-24,2447.33,209.93,9.38,3386.15,-27.72,True,1,23165,-2447.33,-10861026.66,56692399.45,45831372.79
2020-03-25,2475.56,28.23,1.15,3386.15,-26.89,True,1,23166,-2475.56,-10863502.22,57348822.96,46485320.74
2020-03-26,2630.07,154.51,6.24,3386.15,-22.33,True,1,23167,-2630.07,-10866132.29,60930831.69,50064699.4
2020-03-27,2541.47,-88.6,-3.37,3386.15,-24.94,True,1,23168,-2541.47,-10868673.76,58880776.96,48012103.2
2020-03-30,2626.65,85.18,3.35,3386.15,-22.43,True,1,23169,-2626.65,-10871300.41,60856853.85,49985553.44
2020-03-31,2584.59,-42.06,-1.6,3386.15,-23.67,True,1,23170,-2584.59,-10873885.0,59884950.3,49011065.3
2020-04-01,2470.5,-114.09,-4.41,3386.15,-27.04,True,1,23171,-2470.5,-10876355.5,57243955.5,46367600.0
2020-04-02,2526.9,56.4,2.28,3386.15,-25.38,True,1,23172,-2526.9,-10878882.4,58553326.8,47674444.4
2020-04-03,2488.65,-38.25,-1.51,3386.15,-26.5,True,1,23173,-2488.65,-10881371.05,57669486.45,46788115.4
2020-04-06,2663.68,175.03,7.03,3386.15,-21.34,True,1,23174,-2663.68,-10884034.73,61728120.32,50844085.59
2020-04-07,2659.41,-4.27,-0.16,3386.15,-21.46,True,1,23175,-2659.41,-10886694.14,61631826.75,50745132.61
2020-04-08,2749.98,90.57,3.41,3386.15,-18.79,True,1,23176,-2749.98,-10889444.12,63733536.48,52844092.36
2020-04-09,2789.82,39.84,1.45,3386.15,-17.61,True,1,23177,-2789.82,-10892233.94,64659658.14,53767424.2
2020-04-13,2761.63,-28.19,-1.01,3386.15,-18.44,True,1,23178,-2761.63,-10894995.57,64009060.14,53114064.57
2020-04-14,2846.06,84.43,3.06,3386.15,-15.95,True,1,23179,-2846.06,-10897841.63,65968824.74,55070983.11
2020-04-15,2783.36,-62.7,-2.2,3386.15,-17.8,True,1,23180,-2783.36,-10900624.99,64518284.8,53617659.81
2020-04-16,2799.55,16.19,0.58,3386.15,-17.32,True,1,23181,-2799.55,-10903424.54,64896368.55,53992944.01
2020-04-17,2874.56,75.01,2.68,3386.15,-15.11,True,1,23182,-2874.56,-10906299.1,66638049.92,55731750.82
2020-04-20,2823.16,-51.4,-1.79,3386.15,-16.63,True,1,23183,-2823.16,-10909122.26,65449318.28,54540196.02
2020-04-21,2736.56,-86.6,-3.07,3386.15,-19.18,True,1,23184,-2736.56,-10911858.82,63444407.04,52532548.22
2020-04-22,2799.31,62.75,2.29,3386.15,-17.33,True,1,23185,-2799.31,-10914658.13,64902002.35,53987344.22
2020-04-23,2797.8,-1.51,-0.05,3386.15,-17.38,True,1,23186,-2797.8,-10917455.93,64869790.8,53952334.87
2020-04-24,2836.74,38.94,1.39,3386.15,-16.23,True,1,23187,-2836.74,-10920292.67,65775490.38,54855197.71
2020-04-27,2878.48,41.74,1.47,3386.15,-14.99,True,1,23188,-2878.48,-10923171.15,66746194.24,55823023.09
2020-04-28,2863.39,-15.09,-0.52,3386.15,-15.44,True,1,23189,-2863.39,-10926034.54,66399150.71,55473116.17
2020-04-29,2939.51,76.12,2.66,3386.15,-13.19,True,1,23190,-2939.51,-10928974.05,68167236.9,57238262.85
2020-04-30,2912.43,-27.08,-0.92,3386.15,-13.99,True,1,23191,-2912.43,-10931886.48,67542164.13,56610277.65
2020-05-01,2830.71,-81.72,-2.81,3386.15,-16.4,True,1,23192,-2830.71,-10934717.19,65649826.32,54715109.13
