,date,close,daily change,daily change pct,high to date,off from high,buy,shares bought,shares owned,cash spend,cash balance,market value,current gain
6747,1955-01-03,36.75,0.77,2.14,36.75,0.0,True,1,1,-36.75,-36.75,36.75,0.0
6748,1955-01-04,36.42,-0.33,-0.9,36.75,-0.9,True,1,2,-36.42,-73.17,72.84,-0.33
6749,1955-01-05,35.52,-0.9,-2.47,36.75,-3.35,True,1,3,-35.52,-108.69,106.56,-2.13
6750,1955-01-06,35.04,-0.48,-1.35,36.75,-4.65,True,1,4,-35.04,-143.73,140.16,-3.57
6751,1955-01-07,35.33,0.29,0.83,36.75,-3.86,True,1,5,-35.33,-179.06,176.65,-2.41
6752,1955-01-10,35.79,0.46,1.3,36.75,-2.61,True,1,6,-35.79,-214.85,214.74,-0.11
6753,1955-01-11,35.68,-0.11,-0.31,36.75,-2.91,True,1,7,-35.68,-250.53,249.76,-0.77
6754,1955-01-12,35.58,-0.1,-0.28,36.75,-3.18,True,1,8,-35.58,-286.11,284.64,-1.47
6755,1955-01-13,35.43,-0.15,-0.42,36.75,-3.59,True,1,9,-35.43,-321.54,318.87,-2.67
6756,1955-01-14,35.28,-0.15,-0.42,36.75,-4.0,True,1,10,-35.28,-356.82,352.8,-4.02
6757,1955-01-17,34.58,-0.7,-1.98,36.75,-5.9,True,1,11,-34.58,-391.4,380.38,-11.02
6758,1955-01-18,34.8,0.22,0.64,36.75,-5.31,True,1,12,-34.8,-426.2,417.6,-8.6
6759,1955-01-19,34.96,0.16,0.46,36.75,-4.87,True,1,13,-34.96,-461.16,454.48,-6.68
6760,1955-01-20,35.13,0.17,0.49,36.75,-4.41,True,1,14,-35.13,-496.29,491.82,-4.47
6761,1955-01-21,35.44,0.31,0.88,36.75,-3.56,True,1,15,-35.44,-531.73,531.6,-0.13
6762,1955-01-24,35.52,0.08,0.23,36.75,-3.35,True,1,16,-35.52,-567.25,568.32,1.07
6763,1955-01-25,35.51,-0.01,-0.03,36.75,-3.37,True,1,17,-35.51,-602.76,603.67,0.91
6764,1955-01-26,35.95,0.44,1.24,36.75,-2.18,True,1,18,-35.95,-638.71,647.1,8.39
6765,1955-01-27,35.99,0.04,0.11,36.75,-2.07,True,1,19,-35.99,-674.7,683.81,9.11
6766,1955-01-28,36.19,0.2,0.56,36.75,-1.52,True,1,20,-36.19,-710.89,723.8,12.91
6767,1955-01-31,36.63,0.44,1.22,36.75,-0.33,True,1,21,-36.63,-747.52,769.23,21.71
6768,1955-02-01,36.72,0.09,0.25,36.75,-0.08,True,1,22,-36.72,-784.24,807.84,23.6
6769,1955-02-02,36.61,-0.11,-0.3,36.75,-0.38,True,1,23,-36.61,-820.85,842.03,21.18
6770,1955-02-03,36.44,-0.17,-0.46,36.75,-0.84,True,1,24,-36.44,-857.29,874.56,17.27
6771,1955-02-04,36.96,0.52,1.43,36.96,0.0,True,1,25,-36.96,-894.25,924.0,29.75
6772,1955-02-07,36.96,0.0,0.0,36.96,0.0,True,1,26,-36.96,-931.21,960.96,29.75
6773,1955-02-08,36.46,-0.5,-1.35,36.96,-1.35,True,1,27,-36.46,-967.67,984.42,16.75
6774,1955-02-09,36.75,0.29,0.8,36.96,-0.57,True,1,28,-36.75,-1004.42,1029.0,24.58
6775,1955-02-10,37.08,0.33,0.9,37.08,0.0,True,1,29,-37.08,-1041.5,1075.32,33.82
6776,1955-02-11,37.15,0.07,0.19,37.15,0.0,True,1,30,-37.15,-1078.65,1114.5,35.85
6777,1955-02-14,36.89,-0.26,-0.7,37.15,-0.7,True,1,31,-36.89,-1115.54,1143.59,28.05
6778,1955-02-15,36.89,0.0,0.0,37.15,-0.7,True,1,32,-36.89,-1152.43,1180.48,28.05
6779,1955-02-16,36.77,-0.12,-0.32,37.15,-1.02,True,1,33,-36.77,-1189.2,1213.41,24.21
6780,1955-02-17,36.84,0.07,0.19,37.15,-0.83,True,1,34,-36.84,-1226.04,1252.56,26.52
6781,1955-02-18,36.89,0.05,0.14,37.15,-0.7,True,1,35,-36.89,-1262.93,1291.15,28.22
6782,1955-02-21,36.85,-0.04,-0.11,37.15,-0.81,True,1,36,-36.85,-1299.78,1326.6,26.82
6783,1955-02-23,36.82,-0.03,-0.08,37.15,-0.89,True,1,37,-36.82,-1336.6,1362.34,25.74
6784,1955-02-24,36.62,-0.2,-0.54,37.15,-1.43,True,1,38,-36.62,-1373.22,1391.56,18.34
6785,1955-02-25,36.57,-0.05,-0.14,37.15,-1.56,True,1,39,-36.57,-1409.79,1426.23,16.44
6786,1955-02-28,36.76,0.19,0.52,37.15,-1.05,True,1,40,-36.76,-1446.55,1470.4,23.85
6787,1955-03-01,36.83,0.07,0.19,37.15,-0.86,True,1,41,-36.83,-1483.38,1510.03,26.65
6788,1955-03-02,37.15,0.32,0.87,37.15,0.0,True,1,42,-37.15,-1520.53,1560.3,39.77
6789,1955-03-03,37.29,0.14,0.38,37.29,0.0,True,1,43,-37.29,-1557.82,1603.47,45.65
6790,1955-03-04,37.52,0.23,0.62,37.52,0.0,True,1,44,-37.52,-1595.34,1650.88,55.54
6791,1955-03-07,37.28,-0.24,-0.64,37.52,-0.64,True,1,45,-37.28,-1632.62,1677.6,44.98
6792,1955-03-08,36.58,-0.7,-1.88,37.52,-2.5,True,1,46,-36.58,-1669.2,1682.68,13.48
6793,1955-03-09,36.22,-0.36,-0.98,37.52,-3.46,True,1,47,-36.22,-1705.42,1702.34,-3.08
6794,1955-03-10,36.45,0.23,0.64,37.52,-2.85,True,1,48,-36.45,-1741.87,1749.6,7.73
6795,1955-03-11,35.82,-0.63,-1.73,37.52,-4.53,True,1,49,-35.82,-1777.69,1755.18,-22.51
6796,1955-03-14,34.96,-0.86,-2.4,37.52,-6.82,True,1,50,-34.96,-1812.65,1748.0,-64.65
6797,1955-03-15,35.71,0.75,2.14,37.52,-4.82,True,1,51,-35.71,-1848.36,1821.21,-27.15
6798,1955-03-16,35.98,0.27,0.76,37.52,-4.1,True,1,52,-35.98,-1884.34,1870.96,-13.38
6799,1955-03-17,36.12,0.14,0.39,37.52,-3.73,True,1,53,-36.12,-1920.46,1914.36,-6.1
6800,1955-03-18,36.18,0.06,0.17,37.52,-3.57,True,1,54,-36.18,-1956.64,1953.72,-2.92
6801,1955-03-21,35.95,-0.23,-0.64,37.52,-4.18,True,1,55,-35.95,-1992.59,1977.25,-15.34
6802,1955-03-22,36.17,0.22,0.61,37.52,-3.6,True,1,56,-36.17,-2028.76,2025.52,-3.24
6803,1955-03-23,36.64,0.47,1.3,37.52,-2.35,True,1,57,-36.64,-2065.4,2088.48,23.08
6804,1955-03-24,36.93,0.29,0.79,37.52,-1.57,True,1,58,-36.93,-2102.33,2141.94,39.61
6805,1955-03-25,36.96,0.03,0.08,37.52,-1.49,True,1,59,-36.96,-2139.29,2180.64,41.35
6806,1955-03-28,36.83,-0.13,-0.35,37.52,-1.84,True,1,60,-36.83,-2176.12,2209.8,33.68
6807,1955-03-29,36.85,0.02,0.05,37.52,-1.79,True,1,61,-36.85,-2212.97,2247.85,34.88
6808,1955-03-30,36.52,-0.33,-0.9,37.52,-2.66,True,1,62,-36.52,-2249.49,2264.24,14.75
6809,1955-03-31,36.58,0.06,0.16,37.52,-2.5,True,1,63,-36.58,-2286.07,2304.54,18.47
6810,1955-04-01,36.95,0.37,1.01,37.52,-1.52,True,1,64,-36.95,-2323.02,2364.8,41.78
6811,1955-04-04,36.83,-0.12,-0.32,37.52,-1.84,True,1,65,-36.83,-2359.85,2393.95,34.1
6812,1955-04-05,36.98,0.15,0.41,37.52,-1.44,True,1,66,-36.98,-2396.83,2440.68,43.85
6813,1955-04-06,37.17,0.19,0.51,37.52,-0.93,True,1,67,-37.17,-2434.0,2490.39,56.39
6814,1955-04-07,37.34,0.17,0.46,37.52,-0.48,True,1,68,-37.34,-2471.34,2539.12,67.78
6815,1955-04-11,37.44,0.1,0.27,37.52,-0.21,True,1,69,-37.44,-2508.78,2583.36,74.58
6816,1955-04-12,37.66,0.22,0.59,37.66,0.0,True,1,70,-37.66,-2546.44,2636.2,89.76
6817,1955-04-13,37.71,0.05,0.13,37.71,0.0,True,1,71,-37.71,-2584.15,2677.41,93.26
6818,1955-04-14,37.79,0.08,0.21,37.79,0.0,True,1,72,-37.79,-2621.94,2720.88,98.94
6819,1955-04-15,37.96,0.17,0.45,37.96,0.0,True,1,73,-37.96,-2659.9,2771.08,111.18
6820,1955-04-18,38.27,0.31,0.82,38.27,0.0,True,1,74,-38.27,-2698.17,2831.98,133.81
6821,1955-04-19,38.22,-0.05,-0.13,38.27,-0.13,True,1,75,-38.22,-2736.39,2866.5,130.11
6822,1955-04-20,38.28,0.06,0.16,38.28,0.0,True,1,76,-38.28,-2774.67,2909.28,134.61
6823,1955-04-21,38.32,0.04,0.1,38.32,0.0,True,1,77,-38.32,-2812.99,2950.64,137.65
6824,1955-04-22,38.01,-0.31,-0.81,38.32,-0.81,True,1,78,-38.01,-2851.0,2964.78,113.78
6825,1955-04-25,38.11,0.1,0.26,38.32,-0.55,True,1,79,-38.11,-2889.11,3010.69,121.58
6826,1955-04-26,38.31,0.2,0.52,38.32,-0.03,True,1,80,-38.31,-2927.42,3064.8,137.38
6827,1955-04-27,38.11,-0.2,-0.52,38.32,-0.55,True,1,81,-38.11,-2965.53,3086.91,121.38
6828,1955-04-28,37.68,-0.43,-1.13,38.32,-1.67,True,1,82,-37.68,-3003.21,3089.76,86.55
6829,1955-04-29,37.96,0.28,0.74,38.32,-0.94,True,1,83,-37.96,-3041.17,3150.68,109.51
6830,1955-05-02,38.04,0.08,0.21,38.32,-0.73,True,1,84,-38.04,-3079.21,3195.36,116.15
6831,1955-05-03,37.7,-0.34,-0.89,38.32,-1.62,True,1,85,-37.7,-3116.91,3204.5,87.59
6832,1955-05-04,37.64,-0.06,-0.16,38.32,-1.78,True,1,86,-37.64,-3154.55,3237.04,82.49
6833,1955-05-05,37.82,0.18,0.48,38.32,-1.3,True,1,87,-37.82,-3192.37,3290.34,97.97
6834,1955-05-06,37.89,0.07,0.18,38.32,-1.12,True,1,88,-37.89,-3230.26,3334.32,104.06
6835,1955-05-09,37.93,0.04,0.11,38.32,-1.02,True,1,89,-37.93,-3268.19,3375.77,107.58
6836,1955-05-10,37.85,-0.08,-0.21,38.32,-1.23,True,1,90,-37.85,-3306.04,3406.5,100.46
6837,1955-05-11,37.42,-0.43,-1.14,38.32,-2.35,True,1,91,-37.42,-3343.46,3405.22,61.76
6838,1955-05-12,37.2,-0.22,-0.59,38.32,-2.92,True,1,92,-37.2,-3380.66,3422.4,41.74
6839,1955-05-13,37.44,0.24,0.64,38.32,-2.3,True,1,93,-37.44,-3418.1,3481.92,63.82
6840,1955-05-16,37.02,-0.42,-1.12,38.32,-3.39,True,1,94,-37.02,-3455.12,3479.88,24.76
6841,1955-05-17,36.97,-0.05,-0.14,38.32,-3.52,True,1,95,-36.97,-3492.09,3512.15,20.06
6842,1955-05-18,37.28,0.31,0.84,38.32,-2.71,True,1,96,-37.28,-3529.37,3578.88,49.51
6843,1955-05-19,37.49,0.21,0.56,38.32,-2.17,True,1,97,-37.49,-3566.86,3636.53,69.67
6844,1955-05-20,37.74,0.25,0.67,38.32,-1.51,True,1,98,-37.74,-3604.6,3698.52,93.92
6845,1955-05-23,37.48,-0.26,-0.69,38.32,-2.19,True,1,99,-37.48,-3642.08,3710.52,68.44
6846,1955-05-24,37.46,-0.02,-0.05,38.32,-2.24,True,1,100,-37.46,-3679.54,3746.0,66.46
6847,1955-05-25,37.6,0.14,0.37,38.32,-1.88,True,1,101,-37.6,-3717.14,3797.6,80.46
6848,1955-05-26,37.85,0.25,0.66,38.32,-1.23,True,1,102,-37.85,-3754.99,3860.7,105.71
6849,1955-05-27,37.93,0.08,0.21,38.32,-1.02,True,1,103,-37.93,-3792.92,3906.79,113.87
6850,1955-05-31,37.91,-0.02,-0.05,38.32,-1.07,True,1,104,-37.91,-3830.83,3942.64,111.81
6851,1955-06-01,37.96,0.05,0.13,38.32,-0.94,True,1,105,-37.96,-3868.79,3985.8,117.01
6852,1955-06-02,38.01,0.05,0.13,38.32,-0.81,True,1,106,-38.01,-3906.8,4029.06,122.26
6853,1955-06-03,38.37,0.36,0.95,38.37,0.0,True,1,107,-38.37,-3945.17,4105.59,160.42
6854,1955-06-06,39.69,1.32,3.44,39.69,0.0,True,1,108,-39.69,-3984.86,4286.52,301.66
6855,1955-06-07,39.96,0.27,0.68,39.96,0.0,True,1,109,-39.96,-4024.82,4355.64,330.82
6856,1955-06-08,39.22,-0.74,-1.85,39.96,-1.85,True,1,110,-39.22,-4064.04,4314.2,250.16
6857,1955-06-09,39.01,-0.21,-0.54,39.96,-2.38,True,1,111,-39.01,-4103.05,4330.11,227.06
6858,1955-06-10,39.25,0.24,0.62,39.96,-1.78,True,1,112,-39.25,-4142.3,4396.0,253.7
6859,1955-06-13,39.62,0.37,0.94,39.96,-0.85,True,1,113,-39.62,-4181.92,4477.06,295.14
6860,1955-06-14,39.67,0.05,0.13,39.96,-0.73,True,1,114,-39.67,-4221.59,4522.38,300.79
6861,1955-06-15,39.89,0.22,0.56,39.96,-0.18,True,1,115,-39.89,-4261.48,4587.35,325.87
6862,1955-06-16,39.96,0.07,0.18,39.96,0.0,True,1,116,-39.96,-4301.44,4635.36,333.92
6863,1955-06-17,40.1,0.14,0.35,40.1,0.0,True,1,117,-40.1,-4341.54,4691.7,350.16
6864,1955-06-20,40.14,0.04,0.1,40.14,0.0,True,1,118,-40.14,-4381.68,4736.52,354.84
6865,1955-06-21,40.51,0.37,0.92,40.51,0.0,True,1,119,-40.51,-4422.19,4820.69,398.5
6866,1955-06-22,40.6,0.09,0.22,40.6,0.0,True,1,120,-40.6,-4462.79,4872.0,409.21
6867,1955-06-23,40.75,0.15,0.37,40.75,0.0,True,1,121,-40.75,-4503.54,4930.75,427.21
6868,1955-06-24,40.96,0.21,0.52,40.96,0.0,True,1,122,-40.96,-4544.5,4997.12,452.62
6869,1955-06-27,40.99,0.03,0.07,40.99,0.0,True,1,123,-40.99,-4585.49,5041.77,456.28
6870,1955-06-28,40.77,-0.22,-0.54,40.99,-0.54,True,1,124,-40.77,-4626.26,5055.48,429.22
6871,1955-06-29,40.79,0.02,0.05,40.99,-0.49,True,1,125,-40.79,-4667.05,5098.75,431.7
6872,1955-06-30,41.03,0.24,0.59,41.03,0.0,True,1,126,-41.03,-4708.08,5169.78,461.7
6873,1955-07-01,41.19,0.16,0.39,41.19,0.0,True,1,127,-41.19,-4749.27,5231.13,481.86
6874,1955-07-05,41.69,0.5,1.21,41.69,0.0,True,1,128,-41.69,-4790.96,5336.32,545.36
6875,1955-07-06,43.18,1.49,3.57,43.18,0.0,True,1,129,-43.18,-4834.14,5570.22,736.08
6876,1955-07-07,42.58,-0.6,-1.39,43.18,-1.39,True,1,130,-42.58,-4876.72,5535.4,658.68
6877,1955-07-08,42.64,0.06,0.14,43.18,-1.25,True,1,131,-42.64,-4919.36,5585.84,666.48
6878,1955-07-11,42.75,0.11,0.26,43.18,-1.0,True,1,132,-42.75,-4962.11,5643.0,680.89
6879,1955-07-12,42.75,0.0,0.0,43.18,-1.0,True,1,133,-42.75,-5004.86,5685.75,680.89
6880,1955-07-13,42.24,-0.51,-1.19,43.18,-2.18,True,1,134,-42.24,-5047.1,5660.16,613.06
6881,1955-07-14,42.25,0.01,0.02,43.18,-2.15,True,1,135,-42.25,-5089.35,5703.75,614.4
6882,1955-07-15,42.4,0.15,0.36,43.18,-1.81,True,1,136,-42.4,-5131.75,5766.4,634.65
6883,1955-07-18,42.36,-0.04,-0.09,43.18,-1.9,True,1,137,-42.36,-5174.11,5803.32,629.21
6884,1955-07-19,42.1,-0.26,-0.61,43.18,-2.5,True,1,138,-42.1,-5216.21,5809.8,593.59
6885,1955-07-20,42.23,0.13,0.31,43.18,-2.2,True,1,139,-42.23,-5258.44,5869.97,611.53
6886,1955-07-21,42.64,0.41,0.97,43.18,-1.25,True,1,140,-42.64,-5301.08,5969.6,668.52
6887,1955-07-22,43.0,0.36,0.84,43.18,-0.42,True,1,141,-43.0,-5344.08,6063.0,718.92
6888,1955-07-25,43.48,0.48,1.12,43.48,0.0,True,1,142,-43.48,-5387.56,6174.16,786.6
6889,1955-07-26,43.58,0.1,0.23,43.58,0.0,True,1,143,-43.58,-5431.14,6231.94,800.8
6890,1955-07-27,43.76,0.18,0.41,43.76,0.0,True,1,144,-43.76,-5474.9,6301.44,826.54
6891,1955-07-28,43.5,-0.26,-0.59,43.76,-0.59,True,1,145,-43.5,-5518.4,6307.5,789.1
6892,1955-07-29,43.52,0.02,0.05,43.76,-0.55,True,1,146,-43.52,-5561.92,6353.92,792.0
6893,1955-08-01,42.93,-0.59,-1.36,43.76,-1.9,True,1,147,-42.93,-5604.85,6310.71,705.86
6894,1955-08-02,43.03,0.1,0.23,43.76,-1.67,True,1,148,-43.03,-5647.88,6368.44,720.56
6895,1955-08-03,43.09,0.06,0.14,43.76,-1.53,True,1,149,-43.09,-5690.97,6420.41,729.44
6896,1955-08-04,42.36,-0.73,-1.69,43.76,-3.2,True,1,150,-42.36,-5733.33,6354.0,620.67
6897,1955-08-05,42.56,0.2,0.47,43.76,-2.74,True,1,151,-42.56,-5775.89,6426.56,650.67
6898,1955-08-08,42.31,-0.25,-0.59,43.76,-3.31,True,1,152,-42.31,-5818.2,6431.12,612.92
6899,1955-08-09,41.75,-0.56,-1.32,43.76,-4.59,True,1,153,-41.75,-5859.95,6387.75,527.8
6900,1955-08-10,41.74,-0.01,-0.02,43.76,-4.62,True,1,154,-41.74,-5901.69,6427.96,526.27
6901,1955-08-11,42.13,0.39,0.93,43.76,-3.72,True,1,155,-42.13,-5943.82,6530.15,586.33
6902,1955-08-12,42.21,0.08,0.19,43.76,-3.54,True,1,156,-42.21,-5986.03,6584.76,598.73
6903,1955-08-15,42.17,-0.04,-0.1,43.76,-3.63,True,1,157,-42.17,-6028.2,6620.69,592.49
6904,1955-08-16,41.86,-0.31,-0.74,43.76,-4.34,True,1,158,-41.86,-6070.06,6613.88,543.82
6905,1955-08-17,41.9,0.04,0.1,43.76,-4.25,True,1,159,-41.9,-6111.96,6662.1,550.14
6906,1955-08-18,41.84,-0.06,-0.14,43.76,-4.39,True,1,160,-41.84,-6153.8,6694.4,540.6
6907,1955-08-19,42.02,0.18,0.43,43.76,-3.98,True,1,161,-42.02,-6195.82,6765.22,569.4
6908,1955-08-22,41.98,-0.04,-0.1,43.76,-4.07,True,1,162,-41.98,-6237.8,6800.76,562.96
6909,1955-08-23,42.55,0.57,1.36,43.76,-2.76,True,1,163,-42.55,-6280.35,6935.65,655.3
6910,1955-08-24,42.61,0.06,0.14,43.76,-2.63,True,1,164,-42.61,-6322.96,6988.04,665.08
6911,1955-08-25,42.8,0.19,0.45,43.76,-2.19,True,1,165,-42.8,-6365.76,7062.0,696.24
6912,1955-08-26,42.99,0.19,0.44,43.76,-1.76,True,1,166,-42.99,-6408.75,7136.34,727.59
6913,1955-08-29,42.96,-0.03,-0.07,43.76,-1.83,True,1,167,-42.96,-6451.71,7174.32,722.61
6914,1955-08-30,42.92,-0.04,-0.09,43.76,-1.92,True,1,168,-42.92,-6494.63,7210.56,715.93
6915,1955-08-31,43.18,0.26,0.61,43.76,-1.32,True,1,169,-43.18,-6537.81,7297.42,759.61
6916,1955-09-01,43.37,0.19,0.44,43.76,-0.89,True,1,170,-43.37,-6581.18,7372.9,791.72
6917,1955-09-02,43.6,0.23,0.53,43.76,-0.37,True,1,171,-43.6,-6624.78,7455.6,830.82
6918,1955-09-06,43.86,0.26,0.6,43.86,0.0,True,1,172,-43.86,-6668.64,7543.92,875.28
6919,1955-09-07,43.85,-0.01,-0.02,43.86,-0.02,True,1,173,-43.85,-6712.49,7586.05,873.56
6920,1955-09-08,43.88,0.03,0.07,43.88,0.0,True,1,174,-43.88,-6756.37,7635.12,878.75
6921,1955-09-09,43.89,0.01,0.02,43.89,0.0,True,1,175,-43.89,-6800.26,7680.75,880.49
6922,1955-09-12,44.19,0.3,0.68,44.19,0.0,True,1,176,-44.19,-6844.45,7777.44,932.99
6923,1955-09-13,44.8,0.61,1.38,44.8,0.0,True,1,177,-44.8,-6889.25,7929.6,1040.35
6924,1955-09-14,44.99,0.19,0.42,44.99,0.0,True,1,178,-44.99,-6934.24,8008.22,1073.98
6925,1955-09-15,44.75,-0.24,-0.53,44.99,-0.53,True,1,179,-44.75,-6978.99,8010.25,1031.26
6926,1955-09-16,45.09,0.34,0.76,45.09,0.0,True,1,180,-45.09,-7024.08,8116.2,1092.12
6927,1955-09-19,45.16,0.07,0.16,45.16,0.0,True,1,181,-45.16,-7069.24,8173.96,1104.72
6928,1955-09-20,45.13,-0.03,-0.07,45.16,-0.07,True,1,182,-45.13,-7114.37,8213.66,1099.29
6929,1955-09-21,45.39,0.26,0.58,45.39,0.0,True,1,183,-45.39,-7159.76,8306.37,1146.61
6930,1955-09-22,45.39,0.0,0.0,45.39,0.0,True,1,184,-45.39,-7205.15,8351.76,1146.61
6931,1955-09-23,45.63,0.24,0.53,45.63,0.0,True,1,185,-45.63,-7250.78,8441.55,1190.77
6932,1955-09-26,42.61,-3.02,-6.62,45.63,-6.62,True,1,186,-42.61,-7293.39,7925.46,632.07
6933,1955-09-27,43.58,0.97,2.28,45.63,-4.49,True,1,187,-43.58,-7336.97,8149.46,812.49
6934,1955-09-28,44.31,0.73,1.68,45.63,-2.89,True,1,188,-44.31,-7381.28,8330.28,949.0
6935,1955-09-29,44.03,-0.28,-0.63,45.63,-3.51,True,1,189,-44.03,-7425.31,8321.67,896.36
6936,1955-09-30,43.67,-0.36,-0.82,45.63,-4.3,True,1,190,-43.67,-7468.98,8297.3,828.32
6937,1955-10-03,42.49,-1.18,-2.7,45.63,-6.88,True,1,191,-42.49,-7511.47,8115.59,604.12
6938,1955-10-04,42.82,0.33,0.78,45.63,-6.16,True,1,192,-42.82,-7554.29,8221.44,667.15
6939,1955-10-05,42.99,0.17,0.4,45.63,-5.79,True,1,193,-42.99,-7597.28,8297.07,699.79
6940,1955-10-06,42.7,-0.29,-0.68,45.63,-6.42,True,1,194,-42.7,-7639.98,8283.8,643.82
6941,1955-10-07,42.38,-0.32,-0.75,45.63,-7.12,True,1,195,-42.38,-7682.36,8264.1,581.74
6942,1955-10-10,41.15,-1.23,-2.9,45.63,-9.82,True,1,196,-41.15,-7723.51,8065.4,341.89
6943,1955-10-11,40.8,-0.35,-0.85,45.63,-10.58,True,1,197,-40.8,-7764.31,8037.6,273.29
6944,1955-10-12,41.52,0.72,1.76,45.63,-9.01,True,1,198,-41.52,-7805.83,8220.96,415.13
6945,1955-10-13,41.39,-0.13,-0.31,45.63,-9.29,True,1,199,-41.39,-7847.22,8236.61,389.39
6946,1955-10-14,41.22,-0.17,-0.41,45.63,-9.66,True,1,200,-41.22,-7888.44,8244.0,355.56
6947,1955-10-17,41.35,0.13,0.32,45.63,-9.38,True,1,201,-41.35,-7929.79,8311.35,381.56
6948,1955-10-18,41.65,0.3,0.73,45.63,-8.72,True,1,202,-41.65,-7971.44,8413.3,441.86
6949,1955-10-19,42.07,0.42,1.01,45.63,-7.8,True,1,203,-42.07,-8013.51,8540.21,526.7
6950,1955-10-20,42.59,0.52,1.24,45.63,-6.66,True,1,204,-42.59,-8056.1,8688.36,632.26
6951,1955-10-21,42.59,0.0,0.0,45.63,-6.66,True,1,205,-42.59,-8098.69,8730.95,632.26
6952,1955-10-24,42.91,0.32,0.75,45.63,-5.96,True,1,206,-42.91,-8141.6,8839.46,697.86
6953,1955-10-25,42.63,-0.28,-0.65,45.63,-6.58,True,1,207,-42.63,-8184.23,8824.41,640.18
6954,1955-10-26,42.29,-0.34,-0.8,45.63,-7.32,True,1,208,-42.29,-8226.52,8796.32,569.8
6955,1955-10-27,42.34,0.05,0.12,45.63,-7.21,True,1,209,-42.34,-8268.86,8849.06,580.2
6956,1955-10-28,42.37,0.03,0.07,45.63,-7.14,True,1,210,-42.37,-8311.23,8897.7,586.47
6957,1955-10-31,42.34,-0.03,-0.07,45.63,-7.21,True,1,211,-42.34,-8353.57,8933.74,580.17
6958,1955-11-01,42.28,-0.06,-0.14,45.63,-7.34,True,1,212,-42.28,-8395.85,8963.36,567.51
6959,1955-11-02,42.35,0.07,0.17,45.63,-7.19,True,1,213,-42.35,-8438.2,9020.55,582.35
6960,1955-11-03,43.24,0.89,2.1,45.63,-5.24,True,1,214,-43.24,-8481.44,9253.36,771.92
6961,1955-11-04,43.96,0.72,1.66,45.63,-3.66,True,1,215,-43.96,-8525.4,9451.4,926.0
6962,1955-11-07,44.15,0.19,0.43,45.63,-3.24,True,1,216,-44.15,-8569.55,9536.4,966.85
6963,1955-11-09,44.61,0.46,1.04,45.63,-2.24,True,1,217,-44.61,-8614.16,9680.37,1066.21
6964,1955-11-10,44.72,0.11,0.25,45.63,-1.99,True,1,218,-44.72,-8658.88,9748.96,1090.08
6965,1955-11-11,45.24,0.52,1.16,45.63,-0.86,True,1,219,-45.24,-8704.12,9907.56,1203.44
6966,1955-11-14,46.41,1.17,2.59,46.41,0.0,True,1,220,-46.41,-8750.53,10210.2,1459.67
6967,1955-11-15,46.21,-0.2,-0.43,46.41,-0.43,True,1,221,-46.21,-8796.74,10212.41,1415.67
6968,1955-11-16,45.91,-0.3,-0.65,46.41,-1.08,True,1,222,-45.91,-8842.65,10192.02,1349.37
6969,1955-11-17,45.59,-0.32,-0.7,46.41,-1.77,True,1,223,-45.59,-8888.24,10166.57,1278.33
6970,1955-11-18,45.54,-0.05,-0.11,46.41,-1.88,True,1,224,-45.54,-8933.78,10200.96,1267.18
6971,1955-11-21,45.22,-0.32,-0.7,46.41,-2.56,True,1,225,-45.22,-8979.0,10174.5,1195.5
6972,1955-11-22,45.66,0.44,0.97,46.41,-1.62,True,1,226,-45.66,-9024.66,10319.16,1294.5
6973,1955-11-23,45.72,0.06,0.13,46.41,-1.49,True,1,227,-45.72,-9070.38,10378.44,1308.06
6974,1955-11-25,45.68,-0.04,-0.09,46.41,-1.57,True,1,228,-45.68,-9116.06,10415.04,1298.98
6975,1955-11-28,45.38,-0.3,-0.66,46.41,-2.22,True,1,229,-45.38,-9161.44,10392.02,1230.58
6976,1955-11-29,45.56,0.18,0.4,46.41,-1.83,True,1,230,-45.56,-9207.0,10478.8,1271.8
6977,1955-11-30,45.51,-0.05,-0.11,46.41,-1.94,True,1,231,-45.51,-9252.51,10512.81,1260.3
6978,1955-12-01,45.35,-0.16,-0.35,46.41,-2.28,True,1,232,-45.35,-9297.86,10521.2,1223.34
6979,1955-12-02,45.44,0.09,0.2,46.41,-2.09,True,1,233,-45.44,-9343.3,10587.52,1244.22
6980,1955-12-05,45.7,0.26,0.57,46.41,-1.53,True,1,234,-45.7,-9389.0,10693.8,1304.8
6981,1955-12-06,45.7,0.0,0.0,46.41,-1.53,True,1,235,-45.7,-9434.7,10739.5,1304.8
6982,1955-12-07,45.55,-0.15,-0.33,46.41,-1.85,True,1,236,-45.55,-9480.25,10749.8,1269.55
6983,1955-12-08,45.82,0.27,0.59,46.41,-1.27,True,1,237,-45.82,-9526.07,10859.34,1333.27
6984,1955-12-09,45.89,0.07,0.15,46.41,-1.12,True,1,238,-45.89,-9571.96,10921.82,1349.86
6985,1955-12-12,45.42,-0.47,-1.02,46.41,-2.13,True,1,239,-45.42,-9617.38,10855.38,1238.0
6986,1955-12-13,45.45,0.03,0.07,46.41,-2.07,True,1,240,-45.45,-9662.83,10908.0,1245.17
6987,1955-12-14,45.07,-0.38,-0.84,46.41,-2.89,True,1,241,-45.07,-9707.9,10861.87,1153.97
6988,1955-12-15,45.06,-0.01,-0.02,46.41,-2.91,True,1,242,-45.06,-9752.96,10904.52,1151.56
6989,1955-12-16,45.13,0.07,0.16,46.41,-2.76,True,1,243,-45.13,-9798.09,10966.59,1168.5
6990,1955-12-19,45.02,-0.11,-0.24,46.41,-3.0,True,1,244,-45.02,-9843.11,10984.88,1141.77
6991,1955-12-20,44.95,-0.07,-0.16,46.41,-3.15,True,1,245,-44.95,-9888.06,11012.75,1124.69
6992,1955-12-21,45.84,0.89,1.98,46.41,-1.23,True,1,246,-45.84,-9933.9,11276.64,1342.74
6993,1955-12-22,45.41,-0.43,-0.94,46.41,-2.15,True,1,247,-45.41,-9979.31,11216.27,1236.96
6994,1955-12-23,45.5,0.09,0.2,46.41,-1.96,True,1,248,-45.5,-10024.81,11284.0,1259.19
6995,1955-12-27,45.22,-0.28,-0.62,46.41,-2.56,True,1,249,-45.22,-10070.03,11259.78,1189.75
6996,1955-12-28,45.05,-0.17,-0.38,46.41,-2.93,True,1,250,-45.05,-10115.08,11262.5,1147.42
6997,1955-12-29,45.15,0.1,0.22,46.41,-2.72,True,1,251,-45.15,-10160.23,11332.65,1172.42
6998,1955-12-30,45.48,0.33,0.73,46.41,-2.0,True,1,252,-45.48,-10205.71,11460.96,1255.25
6999,1956-01-03,45.16,-0.32,-0.7,46.41,-2.69,True,1,253,-45.16,-10250.87,11425.48,1174.61
7000,1956-01-04,45.0,-0.16,-0.35,46.41,-3.04,True,1,254,-45.0,-10295.87,11430.0,1134.13
7001,1956-01-05,44.95,-0.05,-0.11,46.41,-3.15,True,1,255,-44.95,-10340.82,11462.25,1121.43
7002,1956-01-06,45.14,0.19,0.42,46.41,-2.74,True,1,256,-45.14,-10385.96,11555.84,1169.88
7003,1956-01-09,44.51,-0.63,-1.4,46.41,-4.09,True,1,257,-44.51,-10430.47,11439.07,1008.6
7004,1956-01-10,44.16,-0.35,-0.79,46.41,-4.85,True,1,258,-44.16,-10474.63,11393.28,918.65
7005,1956-01-11,44.38,0.22,0.5,46.41,-4.37,True,1,259,-44.38,-10519.01,11494.42,975.41
7006,1956-01-12,44.75,0.37,0.83,46.41,-3.58,True,1,260,-44.75,-10563.76,11635.0,1071.24
7007,1956-01-13,44.67,-0.08,-0.18,46.41,-3.75,True,1,261,-44.67,-10608.43,11658.87,1050.44
7008,1956-01-16,44.14,-0.53,-1.19,46.41,-4.89,True,1,262,-44.14,-10652.57,11564.68,912.11
7009,1956-01-17,44.47,0.33,0.75,46.41,-4.18,True,1,263,-44.47,-10697.04,11695.61,998.57
7010,1956-01-18,44.17,-0.3,-0.68,46.41,-4.83,True,1,264,-44.17,-10741.21,11660.88,919.67
7011,1956-01-19,43.72,-0.45,-1.02,46.41,-5.8,True,1,265,-43.72,-10784.93,11585.8,800.87
7012,1956-01-20,43.22,-0.5,-1.14,46.41,-6.87,True,1,266,-43.22,-10828.15,11496.52,668.37
7013,1956-01-23,43.11,-0.11,-0.26,46.41,-7.11,True,1,267,-43.11,-10871.26,11510.37,639.11
7014,1956-01-24,43.65,0.54,1.25,46.41,-5.95,True,1,268,-43.65,-10914.91,11698.2,783.29
7015,1956-01-25,43.72,0.07,0.16,46.41,-5.8,True,1,269,-43.72,-10958.63,11760.68,802.05
7016,1956-01-26,43.46,-0.26,-0.6,46.41,-6.36,True,1,270,-43.46,-11002.09,11734.2,732.11
7017,1956-01-27,43.35,-0.11,-0.25,46.41,-6.59,True,1,271,-43.35,-11045.44,11747.85,702.41
7018,1956-01-30,43.5,0.15,0.35,46.41,-6.27,True,1,272,-43.5,-11088.94,11832.0,743.06
7019,1956-01-31,43.82,0.32,0.74,46.41,-5.58,True,1,273,-43.82,-11132.76,11962.86,830.1
7020,1956-02-01,44.03,0.21,0.48,46.41,-5.13,True,1,274,-44.03,-11176.79,12064.22,887.43
7021,1956-02-02,44.22,0.19,0.43,46.41,-4.72,True,1,275,-44.22,-11221.01,12160.5,939.49
7022,1956-02-03,44.78,0.56,1.27,46.41,-3.51,True,1,276,-44.78,-11265.79,12359.28,1093.49
7023,1956-02-06,44.81,0.03,0.07,46.41,-3.45,True,1,277,-44.81,-11310.6,12412.37,1101.77
7024,1956-02-07,44.6,-0.21,-0.47,46.41,-3.9,True,1,278,-44.6,-11355.2,12398.8,1043.6
7025,1956-02-08,44.16,-0.44,-0.99,46.41,-4.85,True,1,279,-44.16,-11399.36,12320.64,921.28
7026,1956-02-09,43.66,-0.5,-1.13,46.41,-5.92,True,1,280,-43.66,-11443.02,12224.8,781.78
7027,1956-02-10,43.64,-0.02,-0.05,46.41,-5.97,True,1,281,-43.64,-11486.66,12262.84,776.18
7028,1956-02-13,43.58,-0.06,-0.14,46.41,-6.1,True,1,282,-43.58,-11530.24,12289.56,759.32
7029,1956-02-14,43.42,-0.16,-0.37,46.41,-6.44,True,1,283,-43.42,-11573.66,12287.86,714.2
7030,1956-02-15,44.04,0.62,1.43,46.41,-5.11,True,1,284,-44.04,-11617.7,12507.36,889.66
7031,1956-02-16,43.82,-0.22,-0.5,46.41,-5.58,True,1,285,-43.82,-11661.52,12488.7,827.18
7032,1956-02-17,44.52,0.7,1.6,46.41,-4.07,True,1,286,-44.52,-11706.04,12732.72,1026.68
7033,1956-02-20,44.45,-0.07,-0.16,46.41,-4.22,True,1,287,-44.45,-11750.49,12757.15,1006.66
7034,1956-02-21,44.56,0.11,0.25,46.41,-3.99,True,1,288,-44.56,-11795.05,12833.28,1038.23
7035,1956-02-23,44.95,0.39,0.88,46.41,-3.15,True,1,289,-44.95,-11840.0,12990.55,1150.55
7036,1956-02-24,45.32,0.37,0.82,46.41,-2.35,True,1,290,-45.32,-11885.32,13142.8,1257.48
7037,1956-02-27,45.27,-0.05,-0.11,46.41,-2.46,True,1,291,-45.27,-11930.59,13173.57,1242.98
7038,1956-02-28,45.43,0.16,0.35,46.41,-2.11,True,1,292,-45.43,-11976.02,13265.56,1289.54
7039,1956-02-29,45.34,-0.09,-0.2,46.41,-2.31,True,1,293,-45.34,-12021.36,13284.62,1263.26
7040,1956-03-01,45.54,0.2,0.44,46.41,-1.88,True,1,294,-45.54,-12066.9,13388.76,1321.86
7041,1956-03-02,45.81,0.27,0.59,46.41,-1.29,True,1,295,-45.81,-12112.71,13513.95,1401.24
7042,1956-03-05,46.06,0.25,0.55,46.41,-0.75,True,1,296,-46.06,-12158.77,13633.76,1474.99
7043,1956-03-06,46.04,-0.02,-0.04,46.41,-0.8,True,1,297,-46.04,-12204.81,13673.88,1469.07
7044,1956-03-07,46.01,-0.03,-0.06,46.41,-0.86,True,1,298,-46.01,-12250.82,13710.98,1460.16
7045,1956-03-08,46.12,0.11,0.24,46.41,-0.62,True,1,299,-46.12,-12296.94,13789.88,1492.94
7046,1956-03-09,46.7,0.58,1.26,46.7,0.0,True,1,300,-46.7,-12343.64,14010.0,1666.36
7047,1956-03-12,47.13,0.43,0.92,47.13,0.0,True,1,301,-47.13,-12390.77,14186.13,1795.36
7048,1956-03-13,47.06,-0.07,-0.15,47.13,-0.15,True,1,302,-47.06,-12437.83,14212.12,1774.29
7049,1956-03-14,47.53,0.47,1.0,47.53,0.0,True,1,303,-47.53,-12485.36,14401.59,1916.23
7050,1956-03-15,47.99,0.46,0.97,47.99,0.0,True,1,304,-47.99,-12533.35,14588.96,2055.61
7051,1956-03-16,48.14,0.15,0.31,48.14,0.0,True,1,305,-48.14,-12581.49,14682.7,2101.21
7052,1956-03-19,48.59,0.45,0.94,48.59,0.0,True,1,306,-48.59,-12630.08,14868.54,2238.46
7053,1956-03-20,48.87,0.28,0.58,48.87,0.0,True,1,307,-48.87,-12678.95,15003.09,2324.14
7054,1956-03-21,48.23,-0.64,-1.31,48.87,-1.31,True,1,308,-48.23,-12727.18,14854.84,2127.66
7055,1956-03-22,48.72,0.49,1.02,48.87,-0.31,True,1,309,-48.72,-12775.9,15054.48,2278.58
7056,1956-03-23,48.83,0.11,0.23,48.87,-0.08,True,1,310,-48.83,-12824.73,15137.3,2312.57
7057,1956-03-26,48.62,-0.21,-0.43,48.87,-0.51,True,1,311,-48.62,-12873.35,15120.82,2247.47
7058,1956-03-27,48.25,-0.37,-0.76,48.87,-1.27,True,1,312,-48.25,-12921.6,15054.0,2132.4
7059,1956-03-28,48.51,0.26,0.54,48.87,-0.74,True,1,313,-48.51,-12970.11,15183.63,2213.52
7060,1956-03-29,48.48,-0.03,-0.06,48.87,-0.8,True,1,314,-48.48,-13018.59,15222.72,2204.13
7061,1956-04-02,48.7,0.22,0.45,48.87,-0.35,True,1,315,-48.7,-13067.29,15340.5,2273.21
7062,1956-04-03,48.53,-0.17,-0.35,48.87,-0.7,True,1,316,-48.53,-13115.82,15335.48,2219.66
7063,1956-04-04,48.8,0.27,0.56,48.87,-0.14,True,1,317,-48.8,-13164.62,15469.6,2304.98
7064,1956-04-05,48.57,-0.23,-0.47,48.87,-0.61,True,1,318,-48.57,-13213.19,15445.26,2232.07
7065,1956-04-06,48.85,0.28,0.58,48.87,-0.04,True,1,319,-48.85,-13262.04,15583.15,2321.11
7066,1956-04-09,48.61,-0.24,-0.49,48.87,-0.53,True,1,320,-48.61,-13310.65,15555.2,2244.55
7067,1956-04-10,47.93,-0.68,-1.4,48.87,-1.92,True,1,321,-47.93,-13358.58,15385.53,2026.95
7068,1956-04-11,48.31,0.38,0.79,48.87,-1.15,True,1,322,-48.31,-13406.89,15555.82,2148.93
7069,1956-04-12,48.02,-0.29,-0.6,48.87,-1.74,True,1,323,-48.02,-13454.91,15510.46,2055.55
7070,1956-04-13,47.95,-0.07,-0.15,48.87,-1.88,True,1,324,-47.95,-13502.86,15535.8,2032.94
7071,1956-04-16,47.96,0.01,0.02,48.87,-1.86,True,1,325,-47.96,-13550.82,15587.0,2036.18
7072,1956-04-17,47.93,-0.03,-0.06,48.87,-1.92,True,1,326,-47.93,-13598.75,15625.18,2026.43
7073,1956-04-18,47.74,-0.19,-0.4,48.87,-2.31,True,1,327,-47.74,-13646.49,15610.98,1964.49
7074,1956-04-19,47.57,-0.17,-0.36,48.87,-2.66,True,1,328,-47.57,-13694.06,15602.96,1908.9
7075,1956-04-20,47.76,0.19,0.4,48.87,-2.27,True,1,329,-47.76,-13741.82,15713.04,1971.22
7076,1956-04-23,47.65,-0.11,-0.23,48.87,-2.5,True,1,330,-47.65,-13789.47,15724.5,1935.03
7077,1956-04-24,47.26,-0.39,-0.82,48.87,-3.29,True,1,331,-47.26,-13836.73,15643.06,1806.33
7078,1956-04-25,47.09,-0.17,-0.36,48.87,-3.64,True,1,332,-47.09,-13883.82,15633.88,1750.06
7079,1956-04-26,47.49,0.4,0.85,48.87,-2.82,True,1,333,-47.49,-13931.31,15814.17,1882.86
7080,1956-04-27,47.99,0.5,1.05,48.87,-1.8,True,1,334,-47.99,-13979.3,16028.66,2049.36
7081,1956-04-30,48.38,0.39,0.81,48.87,-1.0,True,1,335,-48.38,-14027.68,16207.3,2179.62
7082,1956-05-01,48.16,-0.22,-0.46,48.87,-1.45,True,1,336,-48.16,-14075.84,16181.76,2105.92
7083,1956-05-02,48.17,0.01,0.02,48.87,-1.43,True,1,337,-48.17,-14124.01,16233.29,2109.28
7084,1956-05-03,48.34,0.17,0.35,48.87,-1.08,True,1,338,-48.34,-14172.35,16338.92,2166.57
7085,1956-05-04,48.51,0.17,0.35,48.87,-0.74,True,1,339,-48.51,-14220.86,16444.89,2224.03
7086,1956-05-07,48.22,-0.29,-0.6,48.87,-1.33,True,1,340,-48.22,-14269.08,16394.8,2125.72
7087,1956-05-08,48.02,-0.2,-0.42,48.87,-1.74,True,1,341,-48.02,-14317.1,16374.82,2057.72
7088,1956-05-09,47.94,-0.08,-0.17,48.87,-1.9,True,1,342,-47.94,-14365.04,16395.48,2030.44
7089,1956-05-10,47.16,-0.78,-1.63,48.87,-3.5,True,1,343,-47.16,-14412.2,16175.88,1763.68
7090,1956-05-11,47.12,-0.04,-0.08,48.87,-3.58,True,1,344,-47.12,-14459.32,16209.28,1749.96
7091,1956-05-14,46.86,-0.26,-0.55,48.87,-4.11,True,1,345,-46.86,-14506.18,16166.7,1660.52
7092,1956-05-15,46.37,-0.49,-1.05,48.87,-5.12,True,1,346,-46.37,-14552.55,16044.02,1491.47
7093,1956-05-16,46.05,-0.32,-0.69,48.87,-5.77,True,1,347,-46.05,-14598.6,15979.35,1380.75
7094,1956-05-17,46.61,0.56,1.22,48.87,-4.62,True,1,348,-46.61,-14645.21,16220.28,1575.07
7095,1956-05-18,46.39,-0.22,-0.47,48.87,-5.08,True,1,349,-46.39,-14691.6,16190.11,1498.51
7096,1956-05-21,45.99,-0.4,-0.86,48.87,-5.89,True,1,350,-45.99,-14737.59,16096.5,1358.91
7097,1956-05-22,45.26,-0.73,-1.59,48.87,-7.39,True,1,351,-45.26,-14782.85,15886.26,1103.41
7098,1956-05-23,45.02,-0.24,-0.53,48.87,-7.88,True,1,352,-45.02,-14827.87,15847.04,1019.17
7099,1956-05-24,44.6,-0.42,-0.93,48.87,-8.74,True,1,353,-44.6,-14872.47,15743.8,871.33
7100,1956-05-25,44.62,0.02,0.04,48.87,-8.7,True,1,354,-44.62,-14917.09,15795.48,878.39
7101,1956-05-28,44.1,-0.52,-1.16,48.87,-9.76,True,1,355,-44.1,-14961.19,15655.5,694.31
7102,1956-05-29,45.11,1.01,2.29,48.87,-7.69,True,1,356,-45.11,-15006.3,16059.16,1052.86
7103,1956-05-31,45.2,0.09,0.2,48.87,-7.51,True,1,357,-45.2,-15051.5,16136.4,1084.9
7104,1956-06-01,45.58,0.38,0.84,48.87,-6.73,True,1,358,-45.58,-15097.08,16317.64,1220.56
7105,1956-06-04,45.85,0.27,0.59,48.87,-6.18,True,1,359,-45.85,-15142.93,16460.15,1317.22
7106,1956-06-05,45.86,0.01,0.02,48.87,-6.16,True,1,360,-45.86,-15188.79,16509.6,1320.81
7107,1956-06-06,45.63,-0.23,-0.5,48.87,-6.63,True,1,361,-45.63,-15234.42,16472.43,1238.01
7108,1956-06-07,45.99,0.36,0.79,48.87,-5.89,True,1,362,-45.99,-15280.41,16648.38,1367.97
7109,1956-06-08,45.14,-0.85,-1.85,48.87,-7.63,True,1,363,-45.14,-15325.55,16385.82,1060.27
7110,1956-06-11,45.71,0.57,1.26,48.87,-6.47,True,1,364,-45.71,-15371.26,16638.44,1267.18
7111,1956-06-12,46.36,0.65,1.42,48.87,-5.14,True,1,365,-46.36,-15417.62,16921.4,1503.78
7112,1956-06-13,46.42,0.06,0.13,48.87,-5.01,True,1,366,-46.42,-15464.04,16989.72,1525.68
7113,1956-06-14,46.31,-0.11,-0.24,48.87,-5.24,True,1,367,-46.31,-15510.35,16995.77,1485.42
7114,1956-06-15,46.37,0.06,0.13,48.87,-5.12,True,1,368,-46.37,-15556.72,17064.16,1507.44
7115,1956-06-18,46.17,-0.2,-0.43,48.87,-5.52,True,1,369,-46.17,-15602.89,17036.73,1433.84
7116,1956-06-19,46.22,0.05,0.11,48.87,-5.42,True,1,370,-46.22,-15649.11,17101.4,1452.29
7117,1956-06-20,46.41,0.19,0.41,48.87,-5.03,True,1,371,-46.41,-15695.52,17218.11,1522.59
7118,1956-06-21,46.73,0.32,0.69,48.87,-4.38,True,1,372,-46.73,-15742.25,17383.56,1641.31
7119,1956-06-22,46.59,-0.14,-0.3,48.87,-4.66,True,1,373,-46.59,-15788.84,17378.07,1589.23
7120,1956-06-25,46.41,-0.18,-0.39,48.87,-5.03,True,1,374,-46.41,-15835.25,17357.34,1522.09
7121,1956-06-26,46.72,0.31,0.67,48.87,-4.4,True,1,375,-46.72,-15881.97,17520.0,1638.03
7122,1956-06-27,47.07,0.35,0.75,48.87,-3.68,True,1,376,-47.07,-15929.04,17698.32,1769.28
7123,1956-06-28,47.13,0.06,0.13,48.87,-3.56,True,1,377,-47.13,-15976.17,17768.01,1791.84
7124,1956-06-29,46.97,-0.16,-0.34,48.87,-3.89,True,1,378,-46.97,-16023.14,17754.66,1731.52
7125,1956-07-02,46.93,-0.04,-0.08,48.87,-3.97,True,1,379,-46.93,-16070.07,17786.47,1716.4
7126,1956-07-03,47.32,0.39,0.83,48.87,-3.17,True,1,380,-47.32,-16117.39,17981.6,1864.21
7127,1956-07-05,47.8,0.48,1.01,48.87,-2.19,True,1,381,-47.8,-16165.19,18211.8,2046.61
7128,1956-07-06,48.04,0.24,0.5,48.87,-1.7,True,1,382,-48.04,-16213.23,18351.28,2138.05
7129,1956-07-09,48.25,0.21,0.44,48.87,-1.27,True,1,383,-48.25,-16261.48,18479.75,2218.27
7130,1956-07-10,48.54,0.29,0.6,48.87,-0.68,True,1,384,-48.54,-16310.02,18639.36,2329.34
7131,1956-07-11,48.69,0.15,0.31,48.87,-0.37,True,1,385,-48.69,-16358.71,18745.65,2386.94
7132,1956-07-12,48.58,-0.11,-0.23,48.87,-0.59,True,1,386,-48.58,-16407.29,18751.88,2344.59
7133,1956-07-13,48.72,0.14,0.29,48.87,-0.31,True,1,387,-48.72,-16456.01,18854.64,2398.63
7134,1956-07-16,49.14,0.42,0.86,49.14,0.0,True,1,388,-49.14,-16505.15,19066.32,2561.17
7135,1956-07-17,49.31,0.17,0.35,49.31,0.0,True,1,389,-49.31,-16554.46,19181.59,2627.13
7136,1956-07-18,49.3,-0.01,-0.02,49.31,-0.02,True,1,390,-49.3,-16603.76,19227.0,2623.24
7137,1956-07-19,49.32,0.02,0.04,49.32,0.0,True,1,391,-49.32,-16653.08,19284.12,2631.04
7138,1956-07-20,49.35,0.03,0.06,49.35,0.0,True,1,392,-49.35,-16702.43,19345.2,2642.77
7139,1956-07-23,49.33,-0.02,-0.04,49.35,-0.04,True,1,393,-49.33,-16751.76,19386.69,2634.93
7140,1956-07-24,49.33,0.0,0.0,49.35,-0.04,True,1,394,-49.33,-16801.09,19436.02,2634.93
7141,1956-07-25,49.44,0.11,0.22,49.44,0.0,True,1,395,-49.44,-16850.53,19528.8,2678.27
7142,1956-07-26,49.48,0.04,0.08,49.48,0.0,True,1,396,-49.48,-16900.01,19594.08,2694.07
7143,1956-07-27,49.08,-0.4,-0.81,49.48,-0.81,True,1,397,-49.08,-16949.09,19484.76,2535.67
7144,1956-07-30,49.0,-0.08,-0.16,49.48,-0.97,True,1,398,-49.0,-16998.09,19502.0,2503.91
7145,1956-07-31,49.39,0.39,0.8,49.48,-0.18,True,1,399,-49.39,-17047.48,19706.61,2659.13
7146,1956-08-01,49.62,0.23,0.47,49.62,0.0,True,1,400,-49.62,-17097.1,19848.0,2750.9
7147,1956-08-02,49.64,0.02,0.04,49.64,0.0,True,1,401,-49.64,-17146.74,19905.64,2758.9
7148,1956-08-03,49.64,0.0,0.0,49.64,0.0,True,1,402,-49.64,-17196.38,19955.28,2758.9
7149,1956-08-06,48.96,-0.68,-1.37,49.64,-1.37,True,1,403,-48.96,-17245.34,19730.88,2485.54
7150,1956-08-07,49.16,0.2,0.41,49.64,-0.97,True,1,404,-49.16,-17294.5,19860.64,2566.14
7151,1956-08-08,49.36,0.2,0.41,49.64,-0.56,True,1,405,-49.36,-17343.86,19990.8,2646.94
7152,1956-08-09,49.32,-0.04,-0.08,49.64,-0.64,True,1,406,-49.32,-17393.18,20023.92,2630.74
7153,1956-08-10,49.09,-0.23,-0.47,49.64,-1.11,True,1,407,-49.09,-17442.27,19979.63,2537.36
7154,1956-08-13,48.58,-0.51,-1.04,49.64,-2.13,True,1,408,-48.58,-17490.85,19820.64,2329.79
7155,1956-08-14,48.0,-0.58,-1.19,49.64,-3.3,True,1,409,-48.0,-17538.85,19632.0,2093.15
7156,1956-08-15,48.99,0.99,2.06,49.64,-1.31,True,1,410,-48.99,-17587.84,20085.9,2498.06
7157,1956-08-16,48.88,-0.11,-0.22,49.64,-1.53,True,1,411,-48.88,-17636.72,20089.68,2452.96
7158,1956-08-17,48.82,-0.06,-0.12,49.64,-1.65,True,1,412,-48.82,-17685.54,20113.84,2428.3
7159,1956-08-20,48.25,-0.57,-1.17,49.64,-2.8,True,1,413,-48.25,-17733.79,19927.25,2193.46
7160,1956-08-21,47.89,-0.36,-0.75,49.64,-3.52,True,1,414,-47.89,-17781.68,19826.46,2044.78
7161,1956-08-22,47.42,-0.47,-0.98,49.64,-4.47,True,1,415,-47.42,-17829.1,19679.3,1850.2
7162,1956-08-23,48.0,0.58,1.22,49.64,-3.3,True,1,416,-48.0,-17877.1,19968.0,2090.9
7163,1956-08-24,47.95,-0.05,-0.1,49.64,-3.4,True,1,417,-47.95,-17925.05,19995.15,2070.1
7164,1956-08-27,47.66,-0.29,-0.6,49.64,-3.99,True,1,418,-47.66,-17972.71,19921.88,1949.17
7165,1956-08-28,47.57,-0.09,-0.19,49.64,-4.17,True,1,419,-47.57,-18020.28,19931.83,1911.55
7166,1956-08-29,47.36,-0.21,-0.44,49.64,-4.59,True,1,420,-47.36,-18067.64,19891.2,1823.56
7167,1956-08-30,46.94,-0.42,-0.89,49.64,-5.44,True,1,421,-46.94,-18114.58,19761.74,1647.16
7168,1956-08-31,47.51,0.57,1.21,49.64,-4.29,True,1,422,-47.51,-18162.09,20049.22,1887.13
7169,1956-09-04,47.89,0.38,0.8,49.64,-3.52,True,1,423,-47.89,-18209.98,20257.47,2047.49
7170,1956-09-05,48.02,0.13,0.27,49.64,-3.26,True,1,424,-48.02,-18258.0,20360.48,2102.48
7171,1956-09-06,48.1,0.08,0.17,49.64,-3.1,True,1,425,-48.1,-18306.1,20442.5,2136.4
7172,1956-09-07,47.81,-0.29,-0.6,49.64,-3.69,True,1,426,-47.81,-18353.91,20367.06,2013.15
7173,1956-09-10,47.56,-0.25,-0.52,49.64,-4.19,True,1,427,-47.56,-18401.47,20308.12,1906.65
7174,1956-09-11,47.38,-0.18,-0.38,49.64,-4.55,True,1,428,-47.38,-18448.85,20278.64,1829.79
7175,1956-09-12,47.05,-0.33,-0.7,49.64,-5.22,True,1,429,-47.05,-18495.9,20184.45,1688.55
7176,1956-09-13,46.09,-0.96,-2.04,49.64,-7.15,True,1,430,-46.09,-18541.99,19818.7,1276.71
7177,1956-09-14,47.21,1.12,2.43,49.64,-4.89,True,1,431,-47.21,-18589.2,20347.51,1758.31
7178,1956-09-17,47.1,-0.11,-0.23,49.64,-5.12,True,1,432,-47.1,-18636.3,20347.2,1710.9
7179,1956-09-18,46.79,-0.31,-0.66,49.64,-5.74,True,1,433,-46.79,-18683.09,20260.07,1576.98
7180,1956-09-19,46.24,-0.55,-1.18,49.64,-6.85,True,1,434,-46.24,-18729.33,20068.16,1338.83
7181,1956-09-20,46.21,-0.03,-0.06,49.64,-6.91,True,1,435,-46.21,-18775.54,20101.35,1325.81
7182,1956-09-21,46.58,0.37,0.8,49.64,-6.16,True,1,436,-46.58,-18822.12,20308.88,1486.76
7183,1956-09-24,46.4,-0.18,-0.39,49.64,-6.53,True,1,437,-46.4,-18868.52,20276.8,1408.28
7184,1956-09-25,45.75,-0.65,-1.4,49.64,-7.84,True,1,438,-45.75,-18914.27,20038.5,1124.23
7185,1956-09-26,45.82,0.07,0.15,49.64,-7.7,True,1,439,-45.82,-18960.09,20114.98,1154.89
7186,1956-09-27,45.6,-0.22,-0.48,49.64,-8.14,True,1,440,-45.6,-19005.69,20064.0,1058.31
7187,1956-09-28,45.35,-0.25,-0.55,49.64,-8.64,True,1,441,-45.35,-19051.04,19999.35,948.31
7188,1956-10-01,44.7,-0.65,-1.43,49.64,-9.95,True,1,442,-44.7,-19095.74,19757.4,661.66
7189,1956-10-02,45.52,0.82,1.83,49.64,-8.3,True,1,443,-45.52,-19141.26,20165.36,1024.1
7190,1956-10-03,46.28,0.76,1.67,49.64,-6.77,True,1,444,-46.28,-19187.54,20548.32,1360.78
7191,1956-10-04,46.29,0.01,0.02,49.64,-6.75,True,1,445,-46.29,-19233.83,20599.05,1365.22
7192,1956-10-05,46.45,0.16,0.35,49.64,-6.43,True,1,446,-46.45,-19280.28,20716.7,1436.42
7193,1956-10-08,46.43,-0.02,-0.04,49.64,-6.47,True,1,447,-46.43,-19326.71,20754.21,1427.5
7194,1956-10-09,46.2,-0.23,-0.5,49.64,-6.93,True,1,448,-46.2,-19372.91,20697.6,1324.69
7195,1956-10-10,46.84,0.64,1.38,49.64,-5.64,True,1,449,-46.84,-19419.75,21031.16,1611.41
7196,1956-10-11,46.81,-0.03,-0.06,49.64,-5.7,True,1,450,-46.81,-19466.56,21064.5,1597.94
7197,1956-10-12,47.0,0.19,0.41,49.64,-5.32,True,1,451,-47.0,-19513.56,21197.0,1683.44
7198,1956-10-15,46.86,-0.14,-0.3,49.64,-5.6,True,1,452,-46.86,-19560.42,21180.72,1620.3
7199,1956-10-16,46.62,-0.24,-0.51,49.64,-6.08,True,1,453,-46.62,-19607.04,21118.86,1511.82
7200,1956-10-17,46.26,-0.36,-0.77,49.64,-6.81,True,1,454,-46.26,-19653.3,21002.04,1348.74
7201,1956-10-18,46.34,0.08,0.17,49.64,-6.65,True,1,455,-46.34,-19699.64,21084.7,1385.06
7202,1956-10-19,46.24,-0.1,-0.22,49.64,-6.85,True,1,456,-46.24,-19745.88,21085.44,1339.56
7203,1956-10-22,46.23,-0.01,-0.02,49.64,-6.87,True,1,457,-46.23,-19792.11,21127.11,1335.0
7204,1956-10-23,46.12,-0.11,-0.24,49.64,-7.09,True,1,458,-46.12,-19838.23,21122.96,1284.73
7205,1956-10-24,45.93,-0.19,-0.41,49.64,-7.47,True,1,459,-45.93,-19884.16,21081.87,1197.71
7206,1956-10-25,45.85,-0.08,-0.17,49.64,-7.64,True,1,460,-45.85,-19930.01,21091.0,1160.99
7207,1956-10-26,46.27,0.42,0.92,49.64,-6.79,True,1,461,-46.27,-19976.28,21330.47,1354.19
7208,1956-10-29,46.4,0.13,0.28,49.64,-6.53,True,1,462,-46.4,-20022.68,21436.8,1414.12
7209,1956-10-30,46.37,-0.03,-0.06,49.64,-6.59,True,1,463,-46.37,-20069.05,21469.31,1400.26
7210,1956-10-31,45.58,-0.79,-1.7,49.64,-8.18,True,1,464,-45.58,-20114.63,21149.12,1034.49
7211,1956-11-01,46.52,0.94,2.06,49.64,-6.28,True,1,465,-46.52,-20161.15,21631.8,1470.65
7212,1956-11-02,46.98,0.46,0.99,49.64,-5.36,True,1,466,-46.98,-20208.13,21892.68,1684.55
7213,1956-11-05,47.6,0.62,1.32,49.64,-4.11,True,1,467,-47.6,-20255.73,22229.2,1973.47
7214,1956-11-07,47.11,-0.49,-1.03,49.64,-5.1,True,1,468,-47.11,-20302.84,22047.48,1744.64
7215,1956-11-08,46.73,-0.38,-0.81,49.64,-5.86,True,1,469,-46.73,-20349.57,21916.37,1566.8
7216,1956-11-09,46.34,-0.39,-0.84,49.64,-6.65,True,1,470,-46.34,-20395.91,21779.8,1383.89
7217,1956-11-12,46.49,0.15,0.32,49.64,-6.35,True,1,471,-46.49,-20442.4,21896.79,1454.39
7218,1956-11-13,46.27,-0.22,-0.47,49.64,-6.79,True,1,472,-46.27,-20488.67,21839.44,1350.77
7219,1956-11-14,46.01,-0.26,-0.56,49.64,-7.31,True,1,473,-46.01,-20534.68,21762.73,1228.05
7220,1956-11-15,45.72,-0.29,-0.63,49.64,-7.9,True,1,474,-45.72,-20580.4,21671.28,1090.88
7221,1956-11-16,45.74,0.02,0.04,49.64,-7.86,True,1,475,-45.74,-20626.14,21726.5,1100.36
7222,1956-11-19,45.29,-0.45,-0.98,49.64,-8.76,True,1,476,-45.29,-20671.43,21558.04,886.61
7223,1956-11-20,44.89,-0.4,-0.88,49.64,-9.57,True,1,477,-44.89,-20716.32,21412.53,696.21
7224,1956-11-21,44.67,-0.22,-0.49,49.64,-10.01,True,1,478,-44.67,-20760.99,21352.26,591.27
7225,1956-11-23,45.14,0.47,1.05,49.64,-9.06,True,1,479,-45.14,-20806.13,21622.06,815.93
7226,1956-11-26,44.87,-0.27,-0.6,49.64,-9.61,True,1,480,-44.87,-20851.0,21537.6,686.6
7227,1956-11-27,44.91,0.04,0.09,49.64,-9.53,True,1,481,-44.91,-20895.91,21601.71,705.8
7228,1956-11-28,44.43,-0.48,-1.07,49.64,-10.5,True,1,482,-44.43,-20940.34,21415.26,474.92
7229,1956-11-29,44.38,-0.05,-0.11,49.64,-10.6,True,1,483,-44.38,-20984.72,21435.54,450.82
7230,1956-11-30,45.08,0.7,1.58,49.64,-9.19,True,1,484,-45.08,-21029.8,21818.72,788.92
7231,1956-12-03,45.98,0.9,2.0,49.64,-7.37,True,1,485,-45.98,-21075.78,22300.3,1224.52
7232,1956-12-04,45.84,-0.14,-0.3,49.64,-7.66,True,1,486,-45.84,-21121.62,22278.24,1156.62
7233,1956-12-05,46.39,0.55,1.2,49.64,-6.55,True,1,487,-46.39,-21168.01,22591.93,1423.92
7234,1956-12-06,46.81,0.42,0.9,49.64,-5.7,True,1,488,-46.81,-21214.82,22843.28,1628.46
7235,1956-12-07,47.04,0.23,0.49,49.64,-5.24,True,1,489,-47.04,-21261.86,23002.56,1740.7
7236,1956-12-10,46.8,-0.24,-0.51,49.64,-5.72,True,1,490,-46.8,-21308.66,22932.0,1623.34
7237,1956-12-11,46.48,-0.32,-0.68,49.64,-6.37,True,1,491,-46.48,-21355.14,22821.68,1466.54
7238,1956-12-12,46.13,-0.35,-0.75,49.64,-7.07,True,1,492,-46.13,-21401.27,22695.96,1294.69
7239,1956-12-13,46.5,0.37,0.8,49.64,-6.33,True,1,493,-46.5,-21447.77,22924.5,1476.73
7240,1956-12-14,46.54,0.04,0.09,49.64,-6.24,True,1,494,-46.54,-21494.31,22990.76,1496.45
7241,1956-12-17,46.54,0.0,0.0,49.64,-6.24,True,1,495,-46.54,-21540.85,23037.3,1496.45
7242,1956-12-18,46.54,0.0,0.0,49.64,-6.24,True,1,496,-46.54,-21587.39,23083.84,1496.45
7243,1956-12-19,46.43,-0.11,-0.24,49.64,-6.47,True,1,497,-46.43,-21633.82,23075.71,1441.89
7244,1956-12-20,46.07,-0.36,-0.78,49.64,-7.19,True,1,498,-46.07,-21679.89,22942.86,1262.97
7245,1956-12-21,46.37,0.3,0.65,49.64,-6.59,True,1,499,-46.37,-21726.26,23138.63,1412.37
7246,1956-12-26,46.39,0.02,0.04,49.64,-6.55,True,1,500,-46.39,-21772.65,23195.0,1422.35
7247,1956-12-27,46.35,-0.04,-0.09,49.64,-6.63,True,1,501,-46.35,-21819.0,23221.35,1402.35
7248,1956-12-28,46.56,0.21,0.45,49.64,-6.2,True,1,502,-46.56,-21865.56,23373.12,1507.56
7249,1956-12-31,46.67,0.11,0.24,49.64,-5.98,True,1,503,-46.67,-21912.23,23475.01,1562.78
7250,1957-01-02,46.2,-0.47,-1.01,49.64,-6.93,True,1,504,-46.2,-21958.43,23284.8,1326.37
7251,1957-01-03,46.6,0.4,0.87,49.64,-6.12,True,1,505,-46.6,-22005.03,23533.0,1527.97
7252,1957-01-04,46.66,0.06,0.13,49.64,-6.0,True,1,506,-46.66,-22051.69,23609.96,1558.27
7253,1957-01-07,46.42,-0.24,-0.51,49.64,-6.49,True,1,507,-46.42,-22098.11,23534.94,1436.83
7254,1957-01-08,46.25,-0.17,-0.37,49.64,-6.83,True,1,508,-46.25,-22144.36,23495.0,1350.64
7255,1957-01-09,46.16,-0.09,-0.2,49.64,-7.01,True,1,509,-46.16,-22190.52,23495.44,1304.92
7256,1957-01-10,46.27,0.11,0.24,49.64,-6.79,True,1,510,-46.27,-22236.79,23597.7,1360.91
7257,1957-01-11,46.18,-0.09,-0.2,49.64,-6.97,True,1,511,-46.18,-22282.97,23597.98,1315.01
7258,1957-01-14,45.86,-0.32,-0.69,49.64,-7.62,True,1,512,-45.86,-22328.83,23480.32,1151.49
7259,1957-01-15,45.18,-0.68,-1.48,49.64,-8.98,True,1,513,-45.18,-22374.01,23177.34,803.33
7260,1957-01-16,45.23,0.05,0.11,49.64,-8.88,True,1,514,-45.23,-22419.24,23248.22,828.98
7261,1957-01-17,45.22,-0.01,-0.02,49.64,-8.9,True,1,515,-45.22,-22464.46,23288.3,823.84
7262,1957-01-18,44.64,-0.58,-1.28,49.64,-10.07,True,1,516,-44.64,-22509.1,23034.24,525.14
7263,1957-01-21,44.4,-0.24,-0.54,49.64,-10.56,True,1,517,-44.4,-22553.5,22954.8,401.3
7264,1957-01-22,44.53,0.13,0.29,49.64,-10.29,True,1,518,-44.53,-22598.03,23066.54,468.51
7265,1957-01-23,44.87,0.34,0.76,49.64,-9.61,True,1,519,-44.87,-22642.9,23287.53,644.63
7266,1957-01-24,45.03,0.16,0.36,49.64,-9.29,True,1,520,-45.03,-22687.93,23415.6,727.67
7267,1957-01-25,44.82,-0.21,-0.47,49.64,-9.71,True,1,521,-44.82,-22732.75,23351.22,618.47
7268,1957-01-28,44.49,-0.33,-0.74,49.64,-10.38,True,1,522,-44.49,-22777.24,23223.78,446.54
7269,1957-01-29,44.71,0.22,0.49,49.64,-9.93,True,1,523,-44.71,-22821.95,23383.33,561.38
7270,1957-01-30,44.91,0.2,0.45,49.64,-9.53,True,1,524,-44.91,-22866.86,23532.84,665.98
7271,1957-01-31,44.72,-0.19,-0.42,49.64,-9.91,True,1,525,-44.72,-22911.58,23478.0,566.42
7272,1957-02-01,44.62,-0.1,-0.22,49.64,-10.11,True,1,526,-44.62,-22956.2,23470.12,513.92
7273,1957-02-04,44.53,-0.09,-0.2,49.64,-10.29,True,1,527,-44.53,-23000.73,23467.31,466.58
7274,1957-02-05,43.89,-0.64,-1.44,49.64,-11.58,True,1,528,-43.89,-23044.62,23173.92,129.3
7275,1957-02-06,43.82,-0.07,-0.16,49.64,-11.72,True,1,529,-43.82,-23088.44,23180.78,92.34
7276,1957-02-07,43.62,-0.2,-0.46,49.64,-12.13,True,1,530,-43.62,-23132.06,23118.6,-13.46
7277,1957-02-08,43.32,-0.3,-0.69,49.64,-12.73,True,1,531,-43.32,-23175.38,23002.92,-172.46
7278,1957-02-11,42.57,-0.75,-1.73,49.64,-14.24,True,1,532,-42.57,-23217.95,22647.24,-570.71
7279,1957-02-12,42.39,-0.18,-0.42,49.64,-14.6,True,1,533,-42.39,-23260.34,22593.87,-666.47
7280,1957-02-13,43.04,0.65,1.53,49.64,-13.3,True,1,534,-43.04,-23303.38,22983.36,-320.02
7281,1957-02-14,42.99,-0.05,-0.12,49.64,-13.4,True,1,535,-42.99,-23346.37,22999.65,-346.72
7282,1957-02-15,43.51,0.52,1.21,49.64,-12.35,True,1,536,-43.51,-23389.88,23321.36,-68.52
7283,1957-02-18,43.46,-0.05,-0.12,49.64,-12.45,True,1,537,-43.46,-23433.34,23338.02,-95.32
7284,1957-02-19,43.49,0.03,0.07,49.64,-12.39,True,1,538,-43.49,-23476.83,23397.62,-79.21
7285,1957-02-20,43.63,0.14,0.32,49.64,-12.11,True,1,539,-43.63,-23520.46,23516.57,-3.89
7286,1957-02-21,43.48,-0.15,-0.34,49.64,-12.41,True,1,540,-43.48,-23563.94,23479.2,-84.74
7287,1957-02-25,43.38,-0.1,-0.23,49.64,-12.61,True,1,541,-43.38,-23607.32,23468.58,-138.74
7288,1957-02-26,43.45,0.07,0.16,49.64,-12.47,True,1,542,-43.45,-23650.77,23549.9,-100.87
7289,1957-02-27,43.41,-0.04,-0.09,49.64,-12.55,True,1,543,-43.41,-23694.18,23571.63,-122.55
7290,1957-02-28,43.26,-0.15,-0.35,49.64,-12.85,True,1,544,-43.26,-23737.44,23533.44,-204.0
7291,1957-03-01,43.74,0.48,1.11,49.64,-11.89,True,1,545,-43.74,-23781.18,23838.3,57.12
7292,1957-03-04,44.06,0.32,0.73,49.64,-11.24,True,1,546,-44.06,-23825.24,24056.76,231.52
7293,1957-03-05,44.22,0.16,0.36,49.64,-10.92,True,1,547,-44.22,-23869.46,24188.34,318.88
7294,1957-03-06,44.23,0.01,0.02,49.64,-10.9,True,1,548,-44.23,-23913.69,24238.04,324.35
7295,1957-03-07,44.21,-0.02,-0.04,49.64,-10.94,True,1,549,-44.21,-23957.9,24271.29,313.39
7296,1957-03-08,44.07,-0.14,-0.32,49.64,-11.22,True,1,550,-44.07,-24001.97,24238.5,236.53
7297,1957-03-11,43.78,-0.29,-0.66,49.64,-11.8,True,1,551,-43.78,-24045.75,24122.78,77.03
7298,1957-03-12,43.75,-0.03,-0.07,49.64,-11.86,True,1,552,-43.75,-24089.5,24150.0,60.5
7299,1957-03-13,44.04,0.29,0.66,49.64,-11.28,True,1,553,-44.04,-24133.54,24354.12,220.58
7300,1957-03-14,44.07,0.03,0.07,49.64,-11.22,True,1,554,-44.07,-24177.61,24414.78,237.17
7301,1957-03-15,44.05,-0.02,-0.04,49.64,-11.26,True,1,555,-44.05,-24221.66,24447.75,226.09
7302,1957-03-18,43.85,-0.2,-0.45,49.64,-11.66,True,1,556,-43.85,-24265.51,24380.6,115.09
7303,1957-03-19,44.04,0.19,0.43,49.64,-11.28,True,1,557,-44.04,-24309.55,24530.28,220.73
7304,1957-03-20,44.1,0.06,0.14,49.64,-11.16,True,1,558,-44.1,-24353.65,24607.8,254.15
7305,1957-03-21,44.11,0.01,0.02,49.64,-11.14,True,1,559,-44.11,-24397.76,24657.49,259.73
7306,1957-03-22,44.06,-0.05,-0.11,49.64,-11.24,True,1,560,-44.06,-24441.82,24673.6,231.78
7307,1957-03-25,43.88,-0.18,-0.41,49.64,-11.6,True,1,561,-43.88,-24485.7,24616.68,130.98
7308,1957-03-26,43.91,0.03,0.07,49.64,-11.54,True,1,562,-43.91,-24529.61,24677.42,147.81
7309,1957-03-27,44.09,0.18,0.41,49.64,-11.18,True,1,563,-44.09,-24573.7,24822.67,248.97
7310,1957-03-28,44.18,0.09,0.2,49.64,-11.0,True,1,564,-44.18,-24617.88,24917.52,299.64
7311,1957-03-29,44.11,-0.07,-0.16,49.64,-11.14,True,1,565,-44.11,-24661.99,24922.15,260.16
7312,1957-04-01,44.14,0.03,0.07,49.64,-11.08,True,1,566,-44.14,-24706.13,24983.24,277.11
7313,1957-04-02,44.42,0.28,0.63,49.64,-10.52,True,1,567,-44.42,-24750.55,25186.14,435.59
7314,1957-04-03,44.54,0.12,0.27,49.64,-10.27,True,1,568,-44.54,-24795.09,25298.72,503.63
7315,1957-04-04,44.44,-0.1,-0.22,49.64,-10.48,True,1,569,-44.44,-24839.53,25286.36,446.83
7316,1957-04-05,44.49,0.05,0.11,49.64,-10.38,True,1,570,-44.49,-24884.02,25359.3,475.28
7317,1957-04-08,44.39,-0.1,-0.22,49.64,-10.58,True,1,571,-44.39,-24928.41,25346.69,418.28
7318,1957-04-09,44.79,0.4,0.9,49.64,-9.77,True,1,572,-44.79,-24973.2,25619.88,646.68
7319,1957-04-10,44.98,0.19,0.42,49.64,-9.39,True,1,573,-44.98,-25018.18,25773.54,755.36
7320,1957-04-11,44.98,0.0,0.0,49.64,-9.39,True,1,574,-44.98,-25063.16,25818.52,755.36
7321,1957-04-12,44.98,0.0,0.0,49.64,-9.39,True,1,575,-44.98,-25108.14,25863.5,755.36
7322,1957-04-15,44.95,-0.03,-0.07,49.64,-9.45,True,1,576,-44.95,-25153.09,25891.2,738.11
7323,1957-04-16,45.02,0.07,0.16,49.64,-9.31,True,1,577,-45.02,-25198.11,25976.54,778.43
7324,1957-04-17,45.08,0.06,0.13,49.64,-9.19,True,1,578,-45.08,-25243.19,26056.24,813.05
7325,1957-04-18,45.41,0.33,0.73,49.64,-8.52,True,1,579,-45.41,-25288.6,26292.39,1003.79
7326,1957-04-22,45.48,0.07,0.15,49.64,-8.38,True,1,580,-45.48,-25334.08,26378.4,1044.32
7327,1957-04-23,45.65,0.17,0.37,49.64,-8.04,True,1,581,-45.65,-25379.73,26522.65,1142.92
7328,1957-04-24,45.72,0.07,0.15,49.64,-7.9,True,1,582,-45.72,-25425.45,26609.04,1183.59
7329,1957-04-25,45.56,-0.16,-0.35,49.64,-8.22,True,1,583,-45.56,-25471.01,26561.48,1090.47
7330,1957-04-26,45.5,-0.06,-0.13,49.64,-8.34,True,1,584,-45.5,-25516.51,26572.0,1055.49
7331,1957-04-29,45.73,0.23,0.5,49.64,-7.88,True,1,585,-45.73,-25562.24,26752.05,1189.81
7332,1957-04-30,45.74,0.01,0.02,49.64,-7.86,True,1,586,-45.74,-25607.98,26803.64,1195.66
7333,1957-05-01,46.02,0.28,0.61,49.64,-7.29,True,1,587,-46.02,-25654.0,27013.74,1359.74
7334,1957-05-02,46.39,0.37,0.8,49.64,-6.55,True,1,588,-46.39,-25700.39,27277.32,1576.93
7335,1957-05-03,46.34,-0.05,-0.11,49.64,-6.65,True,1,589,-46.34,-25746.73,27294.26,1547.53
7336,1957-05-06,46.27,-0.07,-0.15,49.64,-6.79,True,1,590,-46.27,-25793.0,27299.3,1506.3
7337,1957-05-07,46.13,-0.14,-0.3,49.64,-7.07,True,1,591,-46.13,-25839.13,27262.83,1423.7
7338,1957-05-08,46.31,0.18,0.39,49.64,-6.71,True,1,592,-46.31,-25885.44,27415.52,1530.08
7339,1957-05-09,46.36,0.05,0.11,49.64,-6.61,True,1,593,-46.36,-25931.8,27491.48,1559.68
7340,1957-05-10,46.59,0.23,0.5,49.64,-6.14,True,1,594,-46.59,-25978.39,27674.46,1696.07
7341,1957-05-13,46.88,0.29,0.62,49.64,-5.56,True,1,595,-46.88,-26025.27,27893.6,1868.33
7342,1957-05-14,46.67,-0.21,-0.45,49.64,-5.98,True,1,596,-46.67,-26071.94,27815.32,1743.38
7343,1957-05-15,46.83,0.16,0.34,49.64,-5.66,True,1,597,-46.83,-26118.77,27957.51,1838.74
7344,1957-05-16,47.02,0.19,0.41,49.64,-5.28,True,1,598,-47.02,-26165.79,28117.96,1952.17
7345,1957-05-17,47.15,0.13,0.28,49.64,-5.02,True,1,599,-47.15,-26212.94,28242.85,2029.91
7346,1957-05-20,47.35,0.2,0.42,49.64,-4.61,True,1,600,-47.35,-26260.29,28410.0,2149.71
7347,1957-05-21,47.33,-0.02,-0.04,49.64,-4.65,True,1,601,-47.33,-26307.62,28445.33,2137.71
7348,1957-05-22,47.14,-0.19,-0.4,49.64,-5.04,True,1,602,-47.14,-26354.76,28378.28,2023.52
7349,1957-05-23,47.15,0.01,0.02,49.64,-5.02,True,1,603,-47.15,-26401.91,28431.45,2029.54
7350,1957-05-24,47.21,0.06,0.13,49.64,-4.89,True,1,604,-47.21,-26449.12,28514.84,2065.72
7351,1957-05-27,46.78,-0.43,-0.91,49.64,-5.76,True,1,605,-46.78,-26495.9,28301.9,1806.0
7352,1957-05-28,46.69,-0.09,-0.19,49.64,-5.94,True,1,606,-46.69,-26542.59,28294.14,1751.55
7353,1957-05-29,47.11,0.42,0.9,49.64,-5.1,True,1,607,-47.11,-26589.7,28595.77,2006.07
7354,1957-05-31,47.43,0.32,0.68,49.64,-4.45,True,1,608,-47.43,-26637.13,28837.44,2200.31
7355,1957-06-03,47.37,-0.06,-0.13,49.64,-4.57,True,1,609,-47.37,-26684.5,28848.33,2163.83
7356,1957-06-04,47.28,-0.09,-0.19,49.64,-4.75,True,1,610,-47.28,-26731.78,28840.8,2109.02
7357,1957-06-05,47.27,-0.01,-0.02,49.64,-4.77,True,1,611,-47.27,-26779.05,28881.97,2102.92
7358,1957-06-06,47.8,0.53,1.12,49.64,-3.71,True,1,612,-47.8,-26826.85,29253.6,2426.75
7359,1957-06-07,47.85,0.05,0.1,49.64,-3.61,True,1,613,-47.85,-26874.7,29332.05,2457.35
7360,1957-06-10,47.9,0.05,0.1,49.64,-3.5,True,1,614,-47.9,-26922.6,29410.6,2488.0
7361,1957-06-11,47.94,0.04,0.08,49.64,-3.42,True,1,615,-47.94,-26970.54,29483.1,2512.56
7362,1957-06-12,48.05,0.11,0.23,49.64,-3.2,True,1,616,-48.05,-27018.59,29598.8,2580.21
7363,1957-06-13,48.14,0.09,0.19,49.64,-3.02,True,1,617,-48.14,-27066.73,29702.38,2635.65
7364,1957-06-14,48.15,0.01,0.02,49.64,-3.0,True,1,618,-48.15,-27114.88,29756.7,2641.82
7365,1957-06-17,48.24,0.09,0.19,49.64,-2.82,True,1,619,-48.24,-27163.12,29860.56,2697.44
7366,1957-06-18,48.04,-0.2,-0.42,49.64,-3.22,True,1,620,-48.04,-27211.16,29784.8,2573.64
7367,1957-06-19,47.72,-0.32,-0.67,49.64,-3.87,True,1,621,-47.72,-27258.88,29634.12,2375.24
7368,1957-06-20,47.43,-0.29,-0.61,49.64,-4.45,True,1,622,-47.43,-27306.31,29501.46,2195.15
7369,1957-06-21,47.15,-0.28,-0.59,49.64,-5.02,True,1,623,-47.15,-27353.46,29374.45,2020.99
7370,1957-06-24,46.78,-0.37,-0.78,49.64,-5.76,True,1,624,-46.78,-27400.24,29190.72,1790.48
7371,1957-06-25,47.15,0.37,0.79,49.64,-5.02,True,1,625,-47.15,-27447.39,29468.75,2021.36
7372,1957-06-26,47.09,-0.06,-0.13,49.64,-5.14,True,1,626,-47.09,-27494.48,29478.34,1983.86
7373,1957-06-27,47.26,0.17,0.36,49.64,-4.8,True,1,627,-47.26,-27541.74,29632.02,2090.28
7374,1957-06-28,47.37,0.11,0.23,49.64,-4.57,True,1,628,-47.37,-27589.11,29748.36,2159.25
7375,1957-07-01,47.43,0.06,0.13,49.64,-4.45,True,1,629,-47.43,-27636.54,29833.47,2196.93
7376,1957-07-02,47.9,0.47,0.99,49.64,-3.5,True,1,630,-47.9,-27684.44,30177.0,2492.56
7377,1957-07-03,48.46,0.56,1.17,49.64,-2.38,True,1,631,-48.46,-27732.9,30578.26,2845.36
7378,1957-07-05,48.69,0.23,0.48,49.64,-1.91,True,1,632,-48.69,-27781.59,30772.08,2990.49
7379,1957-07-08,48.9,0.21,0.43,49.64,-1.49,True,1,633,-48.9,-27830.49,30953.7,3123.21
7380,1957-07-09,48.9,0.0,0.0,49.64,-1.49,True,1,634,-48.9,-27879.39,31002.6,3123.21
7381,1957-07-10,49.0,0.1,0.2,49.64,-1.29,True,1,635,-49.0,-27928.39,31115.0,3186.61
7382,1957-07-11,48.86,-0.14,-0.29,49.64,-1.57,True,1,636,-48.86,-27977.25,31074.96,3097.71
7383,1957-07-12,49.08,0.22,0.45,49.64,-1.13,True,1,637,-49.08,-28026.33,31263.96,3237.63
7384,1957-07-15,49.13,0.05,0.1,49.64,-1.03,True,1,638,-49.13,-28075.46,31344.94,3269.48
7385,1957-07-16,48.88,-0.25,-0.51,49.64,-1.53,True,1,639,-48.88,-28124.34,31234.32,3109.98
7386,1957-07-17,48.58,-0.3,-0.61,49.64,-2.13,True,1,640,-48.58,-28172.92,31091.2,2918.28
7387,1957-07-18,48.53,-0.05,-0.1,49.64,-2.24,True,1,641,-48.53,-28221.45,31107.73,2886.28
7388,1957-07-19,48.58,0.05,0.1,49.64,-2.13,True,1,642,-48.58,-28270.03,31188.36,2918.33
7389,1957-07-22,48.47,-0.11,-0.23,49.64,-2.36,True,1,643,-48.47,-28318.5,31166.21,2847.71
7390,1957-07-23,48.56,0.09,0.19,49.64,-2.18,True,1,644,-48.56,-28367.06,31272.64,2905.58
7391,1957-07-24,48.61,0.05,0.1,49.64,-2.08,True,1,645,-48.61,-28415.67,31353.45,2937.78
7392,1957-07-25,48.61,0.0,0.0,49.64,-2.08,True,1,646,-48.61,-28464.28,31402.06,2937.78
7393,1957-07-26,48.45,-0.16,-0.33,49.64,-2.4,True,1,647,-48.45,-28512.73,31347.15,2834.42
7394,1957-07-29,47.92,-0.53,-1.09,49.64,-3.46,True,1,648,-47.92,-28560.65,31052.16,2491.51
7395,1957-07-30,47.92,0.0,0.0,49.64,-3.46,True,1,649,-47.92,-28608.57,31100.08,2491.51
7396,1957-07-31,47.91,-0.01,-0.02,49.64,-3.48,True,1,650,-47.91,-28656.48,31141.5,2485.02
7397,1957-08-01,47.79,-0.12,-0.25,49.64,-3.73,True,1,651,-47.79,-28704.27,31111.29,2407.02
7398,1957-08-02,47.68,-0.11,-0.23,49.64,-3.95,True,1,652,-47.68,-28751.95,31087.36,2335.41
7399,1957-08-05,47.26,-0.42,-0.88,49.64,-4.8,True,1,653,-47.26,-28799.21,30860.78,2061.57
7400,1957-08-06,46.67,-0.59,-1.25,49.64,-5.98,True,1,654,-46.67,-28845.88,30522.18,1676.3
7401,1957-08-07,47.03,0.36,0.77,49.64,-5.26,True,1,655,-47.03,-28892.91,30804.65,1911.74
7402,1957-08-08,46.9,-0.13,-0.28,49.64,-5.52,True,1,656,-46.9,-28939.81,30766.4,1826.59
7403,1957-08-09,46.92,0.02,0.04,49.64,-5.48,True,1,657,-46.92,-28986.73,30826.44,1839.71
7404,1957-08-12,46.33,-0.59,-1.26,49.64,-6.67,True,1,658,-46.33,-29033.06,30485.14,1452.08
7405,1957-08-13,46.3,-0.03,-0.06,49.64,-6.73,True,1,659,-46.3,-29079.36,30511.7,1432.34
7406,1957-08-14,45.73,-0.57,-1.23,49.64,-7.88,True,1,660,-45.73,-29125.09,30181.8,1056.71
7407,1957-08-15,45.75,0.02,0.04,49.64,-7.84,True,1,661,-45.75,-29170.84,30240.75,1069.91
7408,1957-08-16,45.83,0.08,0.18,49.64,-7.68,True,1,662,-45.83,-29216.67,30339.46,1122.79
7409,1957-08-19,44.91,-0.92,-2.01,49.64,-9.53,True,1,663,-44.91,-29261.58,29775.33,513.75
7410,1957-08-20,45.29,0.38,0.85,49.64,-8.76,True,1,664,-45.29,-29306.87,30072.56,765.69
7411,1957-08-21,45.49,0.2,0.44,49.64,-8.36,True,1,665,-45.49,-29352.36,30250.85,898.49
7412,1957-08-22,45.16,-0.33,-0.72,49.64,-9.02,True,1,666,-45.16,-29397.52,30076.56,679.04
7413,1957-08-23,44.51,-0.65,-1.44,49.64,-10.33,True,1,667,-44.51,-29442.03,29688.17,246.14
7414,1957-08-26,43.89,-0.62,-1.39,49.64,-11.58,True,1,668,-43.89,-29485.92,29318.52,-167.4
7415,1957-08-27,44.61,0.72,1.64,49.64,-10.13,True,1,669,-44.61,-29530.53,29844.09,313.56
7416,1957-08-28,44.64,0.03,0.07,49.64,-10.07,True,1,670,-44.64,-29575.17,29908.8,333.63
7417,1957-08-29,44.46,-0.18,-0.4,49.64,-10.44,True,1,671,-44.46,-29619.63,29832.66,213.03
7418,1957-08-30,45.22,0.76,1.71,49.64,-8.9,True,1,672,-45.22,-29664.85,30387.84,722.99
7419,1957-09-03,45.44,0.22,0.49,49.64,-8.46,True,1,673,-45.44,-29710.29,30581.12,870.83
7420,1957-09-04,45.05,-0.39,-0.86,49.64,-9.25,True,1,674,-45.05,-29755.34,30363.7,608.36
7421,1957-09-05,44.82,-0.23,-0.51,49.64,-9.71,True,1,675,-44.82,-29800.16,30253.5,453.34
7422,1957-09-06,44.68,-0.14,-0.31,49.64,-9.99,True,1,676,-44.68,-29844.84,30203.68,358.84
7423,1957-09-09,44.28,-0.4,-0.9,49.64,-10.8,True,1,677,-44.28,-29889.12,29977.56,88.44
7424,1957-09-10,43.87,-0.41,-0.93,49.64,-11.62,True,1,678,-43.87,-29932.99,29743.86,-189.13
7425,1957-09-11,44.26,0.39,0.89,49.64,-10.84,True,1,679,-44.26,-29977.25,30052.54,75.29
7426,1957-09-12,44.82,0.56,1.26,49.64,-9.71,True,1,680,-44.82,-30022.07,30477.6,455.53
7427,1957-09-13,44.8,-0.02,-0.04,49.64,-9.75,True,1,681,-44.8,-30066.87,30508.8,441.93
7428,1957-09-16,44.58,-0.22,-0.49,49.64,-10.19,True,1,682,-44.58,-30111.45,30403.56,292.11
7429,1957-09-17,44.64,0.06,0.14,49.64,-10.07,True,1,683,-44.64,-30156.09,30489.12,333.03
7430,1957-09-18,44.69,0.05,0.11,49.64,-9.97,True,1,684,-44.69,-30200.78,30567.96,367.18
7431,1957-09-19,44.4,-0.29,-0.65,49.64,-10.56,True,1,685,-44.4,-30245.18,30414.0,168.82
7432,1957-09-20,43.69,-0.71,-1.6,49.64,-11.99,True,1,686,-43.69,-30288.87,29971.34,-317.53
7433,1957-09-23,42.69,-1.0,-2.29,49.64,-14.0,True,1,687,-42.69,-30331.56,29328.03,-1003.53
7434,1957-09-24,42.98,0.29,0.68,49.64,-13.42,True,1,688,-42.98,-30374.54,29570.24,-804.3
7435,1957-09-25,42.98,0.0,0.0,49.64,-13.42,True,1,689,-42.98,-30417.52,29613.22,-804.3
7436,1957-09-26,42.57,-0.41,-0.95,49.64,-14.24,True,1,690,-42.57,-30460.09,29373.3,-1086.79
7437,1957-09-27,42.55,-0.02,-0.05,49.64,-14.28,True,1,691,-42.55,-30502.64,29402.05,-1100.59
7438,1957-09-30,42.42,-0.13,-0.31,49.64,-14.54,True,1,692,-42.42,-30545.06,29354.64,-1190.42
7439,1957-10-01,42.76,0.34,0.8,49.64,-13.86,True,1,693,-42.76,-30587.82,29632.68,-955.14
7440,1957-10-02,43.1,0.34,0.8,49.64,-13.18,True,1,694,-43.1,-30630.92,29911.4,-719.52
7441,1957-10-03,43.14,0.04,0.09,49.64,-13.09,True,1,695,-43.14,-30674.06,29982.3,-691.76
7442,1957-10-04,42.79,-0.35,-0.81,49.64,-13.8,True,1,696,-42.79,-30716.85,29781.84,-935.01
7443,1957-10-07,42.22,-0.57,-1.33,49.64,-14.95,True,1,697,-42.22,-30759.07,29427.34,-1331.73
7444,1957-10-08,41.95,-0.27,-0.64,49.64,-15.49,True,1,698,-41.95,-30801.02,29281.1,-1519.92
7445,1957-10-09,41.99,0.04,0.1,49.64,-15.41,True,1,699,-41.99,-30843.01,29351.01,-1492.0
7446,1957-10-10,40.96,-1.03,-2.45,49.64,-17.49,True,1,700,-40.96,-30883.97,28672.0,-2211.97
7447,1957-10-11,40.94,-0.02,-0.05,49.64,-17.53,True,1,701,-40.94,-30924.91,28698.94,-2225.97
7448,1957-10-14,41.24,0.3,0.73,49.64,-16.92,True,1,702,-41.24,-30966.15,28950.48,-2015.67
7449,1957-10-15,41.67,0.43,1.04,49.64,-16.06,True,1,703,-41.67,-31007.82,29294.01,-1713.81
7450,1957-10-16,41.33,-0.34,-0.82,49.64,-16.74,True,1,704,-41.33,-31049.15,29096.32,-1952.83
7451,1957-10-17,40.65,-0.68,-1.64,49.64,-18.11,True,1,705,-40.65,-31089.8,28658.25,-2431.55
7452,1957-10-18,40.33,-0.32,-0.79,49.64,-18.76,True,1,706,-40.33,-31130.13,28472.98,-2657.15
7453,1957-10-21,39.15,-1.18,-2.93,49.64,-21.13,True,1,707,-39.15,-31169.28,27679.05,-3490.23
7454,1957-10-22,38.98,-0.17,-0.43,49.64,-21.48,True,1,708,-38.98,-31208.26,27597.84,-3610.42
7455,1957-10-23,40.73,1.75,4.49,49.64,-17.95,True,1,709,-40.73,-31248.99,28877.57,-2371.42
7456,1957-10-24,40.71,-0.02,-0.05,49.64,-17.99,True,1,710,-40.71,-31289.7,28904.1,-2385.6
7457,1957-10-25,40.59,-0.12,-0.3,49.64,-18.23,True,1,711,-40.59,-31330.29,28859.49,-2470.8
7458,1957-10-28,40.42,-0.17,-0.42,49.64,-18.57,True,1,712,-40.42,-31370.71,28779.04,-2591.67
7459,1957-10-29,40.69,0.27,0.67,49.64,-18.03,True,1,713,-40.69,-31411.4,29011.97,-2399.43
7460,1957-10-30,41.02,0.33,0.81,49.64,-17.36,True,1,714,-41.02,-31452.42,29288.28,-2164.14
7461,1957-10-31,41.06,0.04,0.1,49.64,-17.28,True,1,715,-41.06,-31493.48,29357.9,-2135.58
7462,1957-11-01,40.44,-0.62,-1.51,49.64,-18.53,True,1,716,-40.44,-31533.92,28955.04,-2578.88
7463,1957-11-04,40.37,-0.07,-0.17,49.64,-18.67,True,1,717,-40.37,-31574.29,28945.29,-2629.0
7464,1957-11-06,40.43,0.06,0.15,49.64,-18.55,True,1,718,-40.43,-31614.72,29028.74,-2585.98
7465,1957-11-07,40.67,0.24,0.59,49.64,-18.07,True,1,719,-40.67,-31655.39,29241.73,-2413.66
7466,1957-11-08,40.19,-0.48,-1.18,49.64,-19.04,True,1,720,-40.19,-31695.58,28936.8,-2758.78
7467,1957-11-11,40.18,-0.01,-0.02,49.64,-19.06,True,1,721,-40.18,-31735.76,28969.78,-2765.98
7468,1957-11-12,39.6,-0.58,-1.44,49.64,-20.23,True,1,722,-39.6,-31775.36,28591.2,-3184.16
7469,1957-11-13,39.55,-0.05,-0.13,49.64,-20.33,True,1,723,-39.55,-31814.91,28594.65,-3220.26
7470,1957-11-14,39.44,-0.11,-0.28,49.64,-20.55,True,1,724,-39.44,-31854.35,28554.56,-3299.79
7471,1957-11-15,40.37,0.93,2.36,49.64,-18.67,True,1,725,-40.37,-31894.72,29268.25,-2626.47
7472,1957-11-18,40.04,-0.33,-0.82,49.64,-19.34,True,1,726,-40.04,-31934.76,29069.04,-2865.72
7473,1957-11-19,39.81,-0.23,-0.57,49.64,-19.8,True,1,727,-39.81,-31974.57,28941.87,-3032.7
7474,1957-11-20,39.92,0.11,0.28,49.64,-19.58,True,1,728,-39.92,-32014.49,29061.76,-2952.73
7475,1957-11-21,40.48,0.56,1.4,49.64,-18.45,True,1,729,-40.48,-32054.97,29509.92,-2545.05
7476,1957-11-22,40.87,0.39,0.96,49.64,-17.67,True,1,730,-40.87,-32095.84,29835.1,-2260.74
7477,1957-11-25,41.18,0.31,0.76,49.64,-17.04,True,1,731,-41.18,-32137.02,30102.58,-2034.44
7478,1957-11-26,40.09,-1.09,-2.65,49.64,-19.24,True,1,732,-40.09,-32177.11,29345.88,-2831.23
7479,1957-11-27,41.25,1.16,2.89,49.64,-16.9,True,1,733,-41.25,-32218.36,30236.25,-1982.11
7480,1957-11-29,41.72,0.47,1.14,49.64,-15.96,True,1,734,-41.72,-32260.08,30622.48,-1637.6
7481,1957-12-02,41.36,-0.36,-0.86,49.64,-16.68,True,1,735,-41.36,-32301.44,30399.6,-1901.84
7482,1957-12-03,41.37,0.01,0.02,49.64,-16.66,True,1,736,-41.37,-32342.81,30448.32,-1894.49
7483,1957-12-04,41.54,0.17,0.41,49.64,-16.32,True,1,737,-41.54,-32384.35,30614.98,-1769.37
7484,1957-12-05,41.52,-0.02,-0.05,49.64,-16.36,True,1,738,-41.52,-32425.87,30641.76,-1784.11
7485,1957-12-06,41.31,-0.21,-0.51,49.64,-16.78,True,1,739,-41.31,-32467.18,30528.09,-1939.09
7486,1957-12-09,40.92,-0.39,-0.94,49.64,-17.57,True,1,740,-40.92,-32508.1,30280.8,-2227.3
7487,1957-12-10,40.56,-0.36,-0.88,49.64,-18.29,True,1,741,-40.56,-32548.66,30054.96,-2493.7
7488,1957-12-11,40.51,-0.05,-0.12,49.64,-18.39,True,1,742,-40.51,-32589.17,30058.42,-2530.75
7489,1957-12-12,40.55,0.04,0.1,49.64,-18.31,True,1,743,-40.55,-32629.72,30128.65,-2501.07
7490,1957-12-13,40.73,0.18,0.44,49.64,-17.95,True,1,744,-40.73,-32670.45,30303.12,-2367.33
7491,1957-12-16,40.12,-0.61,-1.5,49.64,-19.18,True,1,745,-40.12,-32710.57,29889.4,-2821.17
7492,1957-12-17,39.42,-0.7,-1.74,49.64,-20.59,True,1,746,-39.42,-32749.99,29407.32,-3342.67
7493,1957-12-18,39.38,-0.04,-0.1,49.64,-20.67,True,1,747,-39.38,-32789.37,29416.86,-3372.51
7494,1957-12-19,39.8,0.42,1.07,49.64,-19.82,True,1,748,-39.8,-32829.17,29770.4,-3058.77
7495,1957-12-20,39.48,-0.32,-0.8,49.64,-20.47,True,1,749,-39.48,-32868.65,29570.52,-3298.13
7496,1957-12-23,39.48,0.0,0.0,49.64,-20.47,True,1,750,-39.48,-32908.13,29610.0,-3298.13
7497,1957-12-24,39.52,0.04,0.1,49.64,-20.39,True,1,751,-39.52,-32947.65,29679.52,-3268.13
7498,1957-12-26,39.92,0.4,1.01,49.64,-19.58,True,1,752,-39.92,-32987.57,30019.84,-2967.73
7499,1957-12-27,39.78,-0.14,-0.35,49.64,-19.86,True,1,753,-39.78,-33027.35,29954.34,-3073.01
7500,1957-12-30,39.58,-0.2,-0.5,49.64,-20.27,True,1,754,-39.58,-33066.93,29843.32,-3223.61
7501,1957-12-31,39.99,0.41,1.04,49.64,-19.44,True,1,755,-39.99,-33106.92,30192.45,-2914.47
7502,1958-01-02,40.33,0.34,0.85,49.64,-18.76,True,1,756,-40.33,-33147.25,30489.48,-2657.77
7503,1958-01-03,40.87,0.54,1.34,49.64,-17.67,True,1,757,-40.87,-33188.12,30938.59,-2249.53
7504,1958-01-06,40.68,-0.19,-0.46,49.64,-18.05,True,1,758,-40.68,-33228.8,30835.44,-2393.36
7505,1958-01-07,41.0,0.32,0.79,49.64,-17.4,True,1,759,-41.0,-33269.8,31119.0,-2150.8
7506,1958-01-08,40.99,-0.01,-0.02,49.64,-17.42,True,1,760,-40.99,-33310.79,31152.4,-2158.39
7507,1958-01-09,40.75,-0.24,-0.59,49.64,-17.91,True,1,761,-40.75,-33351.54,31010.75,-2340.79
7508,1958-01-10,40.37,-0.38,-0.93,49.64,-18.67,True,1,762,-40.37,-33391.91,30761.94,-2629.97
7509,1958-01-13,40.49,0.12,0.3,49.64,-18.43,True,1,763,-40.49,-33432.4,30893.87,-2538.53
7510,1958-01-14,40.67,0.18,0.44,49.64,-18.07,True,1,764,-40.67,-33473.07,31071.88,-2401.19
7511,1958-01-15,40.99,0.32,0.79,49.64,-17.42,True,1,765,-40.99,-33514.06,31357.35,-2156.71
7512,1958-01-16,41.06,0.07,0.17,49.64,-17.28,True,1,766,-41.06,-33555.12,31451.96,-2103.16
7513,1958-01-17,41.1,0.04,0.1,49.64,-17.2,True,1,767,-41.1,-33596.22,31523.7,-2072.52
7514,1958-01-20,41.35,0.25,0.61,49.64,-16.7,True,1,768,-41.35,-33637.57,31756.8,-1880.77
7515,1958-01-21,41.3,-0.05,-0.12,49.64,-16.8,True,1,769,-41.3,-33678.87,31759.7,-1919.17
7516,1958-01-22,41.2,-0.1,-0.24,49.64,-17.0,True,1,770,-41.2,-33720.07,31724.0,-1996.07
7517,1958-01-23,41.36,0.16,0.39,49.64,-16.68,True,1,771,-41.36,-33761.43,31888.56,-1872.87
7518,1958-01-24,41.71,0.35,0.85,49.64,-15.98,True,1,772,-41.71,-33803.14,32200.12,-1603.02
7519,1958-01-27,41.59,-0.12,-0.29,49.64,-16.22,True,1,773,-41.59,-33844.73,32149.07,-1695.66
7520,1958-01-28,41.63,0.04,0.1,49.64,-16.14,True,1,774,-41.63,-33886.36,32221.62,-1664.74
7521,1958-01-29,41.88,0.25,0.6,49.64,-15.63,True,1,775,-41.88,-33928.24,32457.0,-1471.24
7522,1958-01-30,41.68,-0.2,-0.48,49.64,-16.04,True,1,776,-41.68,-33969.92,32343.68,-1626.24
7523,1958-01-31,41.7,0.02,0.05,49.64,-16.0,True,1,777,-41.7,-34011.62,32400.9,-1610.72
7524,1958-02-03,42.04,0.34,0.82,49.64,-15.31,True,1,778,-42.04,-34053.66,32707.12,-1346.54
7525,1958-02-04,42.46,0.42,1.0,49.64,-14.46,True,1,779,-42.46,-34096.12,33076.34,-1019.78
7526,1958-02-05,42.19,-0.27,-0.64,49.64,-15.01,True,1,780,-42.19,-34138.31,32908.2,-1230.11
7527,1958-02-06,42.1,-0.09,-0.21,49.64,-15.19,True,1,781,-42.1,-34180.41,32880.1,-1300.31
7528,1958-02-07,41.73,-0.37,-0.88,49.64,-15.94,True,1,782,-41.73,-34222.14,32632.86,-1589.28
7529,1958-02-10,41.48,-0.25,-0.6,49.64,-16.44,True,1,783,-41.48,-34263.62,32478.84,-1784.78
7530,1958-02-11,41.11,-0.37,-0.89,49.64,-17.18,True,1,784,-41.11,-34304.73,32230.24,-2074.49
7531,1958-02-12,40.93,-0.18,-0.44,49.64,-17.55,True,1,785,-40.93,-34345.66,32130.05,-2215.61
7532,1958-02-13,40.94,0.01,0.02,49.64,-17.53,True,1,786,-40.94,-34386.6,32178.84,-2207.76
7533,1958-02-14,41.33,0.39,0.95,49.64,-16.74,True,1,787,-41.33,-34427.93,32526.71,-1901.22
7534,1958-02-17,41.11,-0.22,-0.53,49.64,-17.18,True,1,788,-41.11,-34469.04,32394.68,-2074.36
7535,1958-02-18,41.17,0.06,0.15,49.64,-17.06,True,1,789,-41.17,-34510.21,32483.13,-2027.08
7536,1958-02-19,41.15,-0.02,-0.05,49.64,-17.1,True,1,790,-41.15,-34551.36,32508.5,-2042.86
7537,1958-02-20,40.91,-0.24,-0.58,49.64,-17.59,True,1,791,-40.91,-34592.27,32359.81,-2232.46
7538,1958-02-21,40.88,-0.03,-0.07,49.64,-17.65,True,1,792,-40.88,-34633.15,32376.96,-2256.19
7539,1958-02-24,40.65,-0.23,-0.56,49.64,-18.11,True,1,793,-40.65,-34673.8,32235.45,-2438.35
7540,1958-02-25,40.61,-0.04,-0.1,49.64,-18.19,True,1,794,-40.61,-34714.41,32244.34,-2470.07
7541,1958-02-26,40.92,0.31,0.76,49.64,-17.57,True,1,795,-40.92,-34755.33,32531.4,-2223.93
7542,1958-02-27,40.68,-0.24,-0.59,49.64,-18.05,True,1,796,-40.68,-34796.01,32381.28,-2414.73
7543,1958-02-28,40.84,0.16,0.39,49.64,-17.73,True,1,797,-40.84,-34836.85,32549.48,-2287.37
7544,1958-03-03,41.13,0.29,0.71,49.64,-17.14,True,1,798,-41.13,-34877.98,32821.74,-2056.24
7545,1958-03-04,41.35,0.22,0.54,49.64,-16.7,True,1,799,-41.35,-34919.33,33038.65,-1880.68
7546,1958-03-05,41.47,0.12,0.29,49.64,-16.46,True,1,800,-41.47,-34960.8,33176.0,-1784.8
7547,1958-03-06,42.0,0.53,1.28,49.64,-15.39,True,1,801,-42.0,-35002.8,33642.0,-1360.8
7548,1958-03-07,42.07,0.07,0.17,49.64,-15.25,True,1,802,-42.07,-35044.87,33740.14,-1304.73
7549,1958-03-10,42.21,0.14,0.33,49.64,-14.97,True,1,803,-42.21,-35087.08,33894.63,-1192.45
7550,1958-03-11,42.51,0.3,0.71,49.64,-14.36,True,1,804,-42.51,-35129.59,34178.04,-951.55
7551,1958-03-12,42.41,-0.1,-0.24,49.64,-14.56,True,1,805,-42.41,-35172.0,34140.05,-1031.95
7552,1958-03-13,42.46,0.05,0.12,49.64,-14.46,True,1,806,-42.46,-35214.46,34222.76,-991.7
7553,1958-03-14,42.33,-0.13,-0.31,49.64,-14.73,True,1,807,-42.33,-35256.79,34160.31,-1096.48
7554,1958-03-17,42.04,-0.29,-0.68,49.64,-15.31,True,1,808,-42.04,-35298.83,33968.32,-1330.51
7555,1958-03-18,41.89,-0.15,-0.36,49.64,-15.61,True,1,809,-41.89,-35340.72,33889.01,-1451.71
7556,1958-03-19,42.09,0.2,0.48,49.64,-15.21,True,1,810,-42.09,-35382.81,34092.9,-1289.91
7557,1958-03-20,42.11,0.02,0.05,49.64,-15.17,True,1,811,-42.11,-35424.92,34151.21,-1273.71
7558,1958-03-21,42.42,0.31,0.74,49.64,-14.54,True,1,812,-42.42,-35467.34,34445.04,-1022.3
7559,1958-03-24,42.58,0.16,0.38,49.64,-14.22,True,1,813,-42.58,-35509.92,34617.54,-892.38
7560,1958-03-25,42.44,-0.14,-0.33,49.64,-14.5,True,1,814,-42.44,-35552.36,34546.16,-1006.2
7561,1958-03-26,42.3,-0.14,-0.33,49.64,-14.79,True,1,815,-42.3,-35594.66,34474.5,-1120.16
7562,1958-03-27,42.17,-0.13,-0.31,49.64,-15.05,True,1,816,-42.17,-35636.83,34410.72,-1226.11
7563,1958-03-28,42.2,0.03,0.07,49.64,-14.99,True,1,817,-42.2,-35679.03,34477.4,-1201.63
7564,1958-03-31,42.1,-0.1,-0.24,49.64,-15.19,True,1,818,-42.1,-35721.13,34437.8,-1283.33
7565,1958-04-01,41.93,-0.17,-0.4,49.64,-15.53,True,1,819,-41.93,-35763.06,34340.67,-1422.39
7566,1958-04-02,41.6,-0.33,-0.79,49.64,-16.2,True,1,820,-41.6,-35804.66,34112.0,-1692.66
7567,1958-04-03,41.48,-0.12,-0.29,49.64,-16.44,True,1,821,-41.48,-35846.14,34055.08,-1791.06
7568,1958-04-07,41.33,-0.15,-0.36,49.64,-16.74,True,1,822,-41.33,-35887.47,33973.26,-1914.21
7569,1958-04-08,41.43,0.1,0.24,49.64,-16.54,True,1,823,-41.43,-35928.9,34096.89,-1832.01
7570,1958-04-09,41.65,0.22,0.53,49.64,-16.1,True,1,824,-41.65,-35970.55,34319.6,-1650.95
7571,1958-04-10,41.7,0.05,0.12,49.64,-16.0,True,1,825,-41.7,-36012.25,34402.5,-1609.75
7572,1958-04-11,41.74,0.04,0.1,49.64,-15.92,True,1,826,-41.74,-36053.99,34477.24,-1576.75
7573,1958-04-14,42.0,0.26,0.62,49.64,-15.39,True,1,827,-42.0,-36095.99,34734.0,-1361.99
7574,1958-04-15,42.43,0.43,1.02,49.64,-14.52,True,1,828,-42.43,-36138.42,35132.04,-1006.38
7575,1958-04-16,42.1,-0.33,-0.78,49.64,-15.19,True,1,829,-42.1,-36180.52,34900.9,-1279.62
7576,1958-04-17,42.25,0.15,0.36,49.64,-14.89,True,1,830,-42.25,-36222.77,35067.5,-1155.27
7577,1958-04-18,42.71,0.46,1.09,49.64,-13.96,True,1,831,-42.71,-36265.48,35492.01,-773.47
7578,1958-04-21,42.93,0.22,0.52,49.64,-13.52,True,1,832,-42.93,-36308.41,35717.76,-590.65
7579,1958-04-22,42.8,-0.13,-0.3,49.64,-13.78,True,1,833,-42.8,-36351.21,35652.4,-698.81
7580,1958-04-23,42.8,0.0,0.0,49.64,-13.78,True,1,834,-42.8,-36394.01,35695.2,-698.81
7581,1958-04-24,43.14,0.34,0.79,49.64,-13.09,True,1,835,-43.14,-36437.15,36021.9,-415.25
7582,1958-04-25,43.36,0.22,0.51,49.64,-12.65,True,1,836,-43.36,-36480.51,36248.96,-231.55
7583,1958-04-28,43.22,-0.14,-0.32,49.64,-12.93,True,1,837,-43.22,-36523.73,36175.14,-348.59
7584,1958-04-29,43.0,-0.22,-0.51,49.64,-13.38,True,1,838,-43.0,-36566.73,36034.0,-532.73
7585,1958-04-30,43.44,0.44,1.02,49.64,-12.49,True,1,839,-43.44,-36610.17,36446.16,-164.01
7586,1958-05-01,43.54,0.1,0.23,49.64,-12.29,True,1,840,-43.54,-36653.71,36573.6,-80.11
7587,1958-05-02,43.69,0.15,0.34,49.64,-11.99,True,1,841,-43.69,-36697.4,36743.29,45.89
7588,1958-05-05,43.79,0.1,0.23,49.64,-11.78,True,1,842,-43.79,-36741.19,36871.18,129.99
7589,1958-05-06,44.01,0.22,0.5,49.64,-11.34,True,1,843,-44.01,-36785.2,37100.43,315.23
7590,1958-05-07,43.93,-0.08,-0.18,49.64,-11.5,True,1,844,-43.93,-36829.13,37076.92,247.79
7591,1958-05-08,43.99,0.06,0.14,49.64,-11.38,True,1,845,-43.99,-36873.12,37171.55,298.43
7592,1958-05-09,44.09,0.1,0.23,49.64,-11.18,True,1,846,-44.09,-36917.21,37300.14,382.93
7593,1958-05-12,43.75,-0.34,-0.77,49.64,-11.86,True,1,847,-43.75,-36960.96,37056.25,95.29
7594,1958-05-13,43.62,-0.13,-0.3,49.64,-12.13,True,1,848,-43.62,-37004.58,36989.76,-14.82
7595,1958-05-14,43.12,-0.5,-1.15,49.64,-13.14,True,1,849,-43.12,-37047.7,36608.88,-438.82
7596,1958-05-15,43.34,0.22,0.51,49.64,-12.69,True,1,850,-43.34,-37091.04,36839.0,-252.04
7597,1958-05-16,43.36,0.02,0.05,49.64,-12.65,True,1,851,-43.36,-37134.4,36899.36,-235.04
7598,1958-05-19,43.24,-0.12,-0.28,49.64,-12.89,True,1,852,-43.24,-37177.64,36840.48,-337.16
7599,1958-05-20,43.61,0.37,0.86,49.64,-12.15,True,1,853,-43.61,-37221.25,37199.33,-21.92
7600,1958-05-21,43.55,-0.06,-0.14,49.64,-12.27,True,1,854,-43.55,-37264.8,37191.7,-73.1
7601,1958-05-22,43.78,0.23,0.53,49.64,-11.8,True,1,855,-43.78,-37308.58,37431.9,123.32
7602,1958-05-23,43.87,0.09,0.21,49.64,-11.62,True,1,856,-43.87,-37352.45,37552.72,200.27
7603,1958-05-26,43.85,-0.02,-0.05,49.64,-11.66,True,1,857,-43.85,-37396.3,37579.45,183.15
7604,1958-05-27,43.79,-0.06,-0.14,49.64,-11.78,True,1,858,-43.79,-37440.09,37571.82,131.73
7605,1958-05-28,43.85,0.06,0.14,49.64,-11.66,True,1,859,-43.85,-37483.94,37667.15,183.21
7606,1958-05-29,44.09,0.24,0.55,49.64,-11.18,True,1,860,-44.09,-37528.03,37917.4,389.37
7607,1958-06-02,44.31,0.22,0.5,49.64,-10.74,True,1,861,-44.31,-37572.34,38150.91,578.57
7608,1958-06-03,44.46,0.15,0.34,49.64,-10.44,True,1,862,-44.46,-37616.8,38324.52,707.72
7609,1958-06-04,44.5,0.04,0.09,49.64,-10.36,True,1,863,-44.5,-37661.3,38403.5,742.2
7610,1958-06-05,44.55,0.05,0.11,49.64,-10.25,True,1,864,-44.55,-37705.85,38491.2,785.35
7611,1958-06-06,44.64,0.09,0.2,49.64,-10.07,True,1,865,-44.64,-37750.49,38613.6,863.11
7612,1958-06-09,44.57,-0.07,-0.16,49.64,-10.21,True,1,866,-44.57,-37795.06,38597.62,802.56
7613,1958-06-10,44.48,-0.09,-0.2,49.64,-10.4,True,1,867,-44.48,-37839.54,38564.16,724.62
7614,1958-06-11,44.49,0.01,0.02,49.64,-10.38,True,1,868,-44.49,-37884.03,38617.32,733.29
7615,1958-06-12,44.75,0.26,0.58,49.64,-9.85,True,1,869,-44.75,-37928.78,38887.75,958.97
7616,1958-06-13,45.02,0.27,0.6,49.64,-9.31,True,1,870,-45.02,-37973.8,39167.4,1193.6
7617,1958-06-16,45.18,0.16,0.36,49.64,-8.98,True,1,871,-45.18,-38018.98,39351.78,1332.8
7618,1958-06-17,44.94,-0.24,-0.53,49.64,-9.47,True,1,872,-44.94,-38063.92,39187.68,1123.76
7619,1958-06-18,45.34,0.4,0.89,49.64,-8.66,True,1,873,-45.34,-38109.26,39581.82,1472.56
7620,1958-06-19,44.61,-0.73,-1.61,49.64,-10.13,True,1,874,-44.61,-38153.87,38989.14,835.27
7621,1958-06-20,44.85,0.24,0.54,49.64,-9.65,True,1,875,-44.85,-38198.72,39243.75,1045.03
7622,1958-06-23,44.69,-0.16,-0.36,49.64,-9.97,True,1,876,-44.69,-38243.41,39148.44,905.03
7623,1958-06-24,44.52,-0.17,-0.38,49.64,-10.31,True,1,877,-44.52,-38287.93,39044.04,756.11
7624,1958-06-25,44.63,0.11,0.25,49.64,-10.09,True,1,878,-44.63,-38332.56,39185.14,852.58
7625,1958-06-26,44.84,0.21,0.47,49.64,-9.67,True,1,879,-44.84,-38377.4,39414.36,1036.96
7626,1958-06-27,44.9,0.06,0.13,49.64,-9.55,True,1,880,-44.9,-38422.3,39512.0,1089.7
7627,1958-06-30,45.24,0.34,0.76,49.64,-8.86,True,1,881,-45.24,-38467.54,39856.44,1388.9
7628,1958-07-01,45.28,0.04,0.09,49.64,-8.78,True,1,882,-45.28,-38512.82,39936.96,1424.14
7629,1958-07-02,45.32,0.04,0.09,49.64,-8.7,True,1,883,-45.32,-38558.14,40017.56,1459.42
7630,1958-07-03,45.47,0.15,0.33,49.64,-8.4,True,1,884,-45.47,-38603.61,40195.48,1591.87
7631,1958-07-07,45.62,0.15,0.33,49.64,-8.1,True,1,885,-45.62,-38649.23,40373.7,1724.47
7632,1958-07-08,45.4,-0.22,-0.48,49.64,-8.54,True,1,886,-45.4,-38694.63,40224.4,1529.77
7633,1958-07-09,45.25,-0.15,-0.33,49.64,-8.84,True,1,887,-45.25,-38739.88,40136.75,1396.87
7634,1958-07-10,45.42,0.17,0.38,49.64,-8.5,True,1,888,-45.42,-38785.3,40332.96,1547.66
7635,1958-07-11,45.72,0.3,0.66,49.64,-7.9,True,1,889,-45.72,-38831.02,40645.08,1814.06
7636,1958-07-14,45.14,-0.58,-1.27,49.64,-9.06,True,1,890,-45.14,-38876.16,40174.6,1298.44
7637,1958-07-15,45.11,-0.03,-0.07,49.64,-9.13,True,1,891,-45.11,-38921.27,40193.01,1271.74
7638,1958-07-16,45.25,0.14,0.31,49.64,-8.84,True,1,892,-45.25,-38966.52,40363.0,1396.48
7639,1958-07-17,45.55,0.3,0.66,49.64,-8.24,True,1,893,-45.55,-39012.07,40676.15,1664.08
7640,1958-07-18,45.77,0.22,0.48,49.64,-7.8,True,1,894,-45.77,-39057.84,40918.38,1860.54
7641,1958-07-21,46.33,0.56,1.22,49.64,-6.67,True,1,895,-46.33,-39104.17,41465.35,2361.18
7642,1958-07-22,46.41,0.08,0.17,49.64,-6.51,True,1,896,-46.41,-39150.58,41583.36,2432.78
7643,1958-07-23,46.4,-0.01,-0.02,49.64,-6.53,True,1,897,-46.4,-39196.98,41620.8,2423.82
7644,1958-07-24,46.65,0.25,0.54,49.64,-6.02,True,1,898,-46.65,-39243.63,41891.7,2648.07
7645,1958-07-25,46.97,0.32,0.69,49.64,-5.38,True,1,899,-46.97,-39290.6,42226.03,2935.43
7646,1958-07-28,47.15,0.18,0.38,49.64,-5.02,True,1,900,-47.15,-39337.75,42435.0,3097.25
7647,1958-07-29,46.96,-0.19,-0.4,49.64,-5.4,True,1,901,-46.96,-39384.71,42310.96,2926.25
7648,1958-07-30,47.09,0.13,0.28,49.64,-5.14,True,1,902,-47.09,-39431.8,42475.18,3043.38
7649,1958-07-31,47.19,0.1,0.21,49.64,-4.94,True,1,903,-47.19,-39478.99,42612.57,3133.58
7650,1958-08-01,47.49,0.3,0.64,49.64,-4.33,True,1,904,-47.49,-39526.48,42930.96,3404.48
7651,1958-08-04,47.94,0.45,0.95,49.64,-3.42,True,1,905,-47.94,-39574.42,43385.7,3811.28
7652,1958-08-05,47.75,-0.19,-0.4,49.64,-3.81,True,1,906,-47.75,-39622.17,43261.5,3639.33
7653,1958-08-06,47.46,-0.29,-0.61,49.64,-4.39,True,1,907,-47.46,-39669.63,43046.22,3376.59
7654,1958-08-07,47.77,0.31,0.65,49.64,-3.77,True,1,908,-47.77,-39717.4,43375.16,3657.76
7655,1958-08-08,48.05,0.28,0.59,49.64,-3.2,True,1,909,-48.05,-39765.45,43677.45,3912.0
7656,1958-08-11,48.16,0.11,0.23,49.64,-2.98,True,1,910,-48.16,-39813.61,43825.6,4011.99
7657,1958-08-12,47.73,-0.43,-0.89,49.64,-3.85,True,1,911,-47.73,-39861.34,43482.03,3620.69
7658,1958-08-13,47.81,0.08,0.17,49.64,-3.69,True,1,912,-47.81,-39909.15,43602.72,3693.57
7659,1958-08-14,47.91,0.1,0.21,49.64,-3.48,True,1,913,-47.91,-39957.06,43741.83,3784.77
7660,1958-08-15,47.5,-0.41,-0.86,49.64,-4.31,True,1,914,-47.5,-40004.56,43415.0,3410.44
7661,1958-08-18,47.22,-0.28,-0.59,49.64,-4.88,True,1,915,-47.22,-40051.78,43206.3,3154.52
7662,1958-08-19,47.3,0.08,0.17,49.64,-4.71,True,1,916,-47.3,-40099.08,43326.8,3227.72
7663,1958-08-20,47.32,0.02,0.04,49.64,-4.67,True,1,917,-47.32,-40146.4,43392.44,3246.04
7664,1958-08-21,47.63,0.31,0.66,49.64,-4.05,True,1,918,-47.63,-40194.03,43724.34,3530.31
7665,1958-08-22,47.73,0.1,0.21,49.64,-3.85,True,1,919,-47.73,-40241.76,43863.87,3622.11
7666,1958-08-25,47.74,0.01,0.02,49.64,-3.83,True,1,920,-47.74,-40289.5,43920.8,3631.3
7667,1958-08-26,47.9,0.16,0.34,49.64,-3.5,True,1,921,-47.9,-40337.4,44115.9,3778.5
7668,1958-08-27,47.91,0.01,0.02,49.64,-3.48,True,1,922,-47.91,-40385.31,44173.02,3787.71
7669,1958-08-28,47.66,-0.25,-0.52,49.64,-3.99,True,1,923,-47.66,-40432.97,43990.18,3557.21
7670,1958-08-29,47.75,0.09,0.19,49.64,-3.81,True,1,924,-47.75,-40480.72,44121.0,3640.28
7671,1958-09-02,48.0,0.25,0.52,49.64,-3.3,True,1,925,-48.0,-40528.72,44400.0,3871.28
7672,1958-09-03,48.18,0.18,0.38,49.64,-2.94,True,1,926,-48.18,-40576.9,44614.68,4037.78
7673,1958-09-04,48.1,-0.08,-0.17,49.64,-3.1,True,1,927,-48.1,-40625.0,44588.7,3963.7
7674,1958-09-05,47.97,-0.13,-0.27,49.64,-3.36,True,1,928,-47.97,-40672.97,44516.16,3843.19
7675,1958-09-08,48.13,0.16,0.33,49.64,-3.04,True,1,929,-48.13,-40721.1,44712.77,3991.67
7676,1958-09-09,48.46,0.33,0.69,49.64,-2.38,True,1,930,-48.46,-40769.56,45067.8,4298.24
7677,1958-09-10,48.31,-0.15,-0.31,49.64,-2.68,True,1,931,-48.31,-40817.87,44976.61,4158.74
7678,1958-09-11,48.64,0.33,0.68,49.64,-2.02,True,1,932,-48.64,-40866.51,45332.48,4465.97
7679,1958-09-12,48.53,-0.11,-0.23,49.64,-2.24,True,1,933,-48.53,-40915.04,45278.49,4363.45
7680,1958-09-15,48.96,0.43,0.89,49.64,-1.37,True,1,934,-48.96,-40964.0,45728.64,4764.64
7681,1958-09-16,49.35,0.39,0.8,49.64,-0.58,True,1,935,-49.35,-41013.35,46142.25,5128.9
7682,1958-09-17,49.35,0.0,0.0,49.64,-0.58,True,1,936,-49.35,-41062.7,46191.6,5128.9
7683,1958-09-18,49.38,0.03,0.06,49.64,-0.52,True,1,937,-49.38,-41112.08,46269.06,5156.98
7684,1958-09-19,49.4,0.02,0.04,49.64,-0.48,True,1,938,-49.4,-41161.48,46337.2,5175.72
7685,1958-09-22,49.2,-0.2,-0.4,49.64,-0.89,True,1,939,-49.2,-41210.68,46198.8,4988.12
7686,1958-09-23,49.56,0.36,0.73,49.64,-0.16,True,1,940,-49.56,-41260.24,46586.4,5326.16
7687,1958-09-24,49.78,0.22,0.44,49.78,0.0,True,1,941,-49.78,-41310.02,46842.98,5532.96
7688,1958-09-25,49.57,-0.21,-0.42,49.78,-0.42,True,1,942,-49.57,-41359.59,46694.94,5335.35
7689,1958-09-26,49.66,0.09,0.18,49.78,-0.24,True,1,943,-49.66,-41409.25,46829.38,5420.13
7690,1958-09-29,49.87,0.21,0.42,49.87,0.0,True,1,944,-49.87,-41459.12,47077.28,5618.16
7691,1958-09-30,50.06,0.19,0.38,50.06,0.0,True,1,945,-50.06,-41509.18,47306.7,5797.52
7692,1958-10-01,49.98,-0.08,-0.16,50.06,-0.16,True,1,946,-49.98,-41559.16,47281.08,5721.92
7693,1958-10-02,50.17,0.19,0.38,50.17,0.0,True,1,947,-50.17,-41609.33,47510.99,5901.66
7694,1958-10-03,50.37,0.2,0.4,50.37,0.0,True,1,948,-50.37,-41659.7,47750.76,6091.06
7695,1958-10-06,51.07,0.7,1.39,51.07,0.0,True,1,949,-51.07,-41710.77,48465.43,6754.66
7696,1958-10-07,51.07,0.0,0.0,51.07,0.0,True,1,950,-51.07,-41761.84,48516.5,6754.66
7697,1958-10-08,51.06,-0.01,-0.02,51.07,-0.02,True,1,951,-51.06,-41812.9,48558.06,6745.16
7698,1958-10-09,51.05,-0.01,-0.02,51.07,-0.04,True,1,952,-51.05,-41863.95,48599.6,6735.65
7699,1958-10-10,51.39,0.34,0.67,51.39,0.0,True,1,953,-51.39,-41915.34,48974.67,7059.33
7700,1958-10-13,51.62,0.23,0.45,51.62,0.0,True,1,954,-51.62,-41966.96,49245.48,7278.52
7701,1958-10-14,51.26,-0.36,-0.7,51.62,-0.7,True,1,955,-51.26,-42018.22,48953.3,6935.08
7702,1958-10-15,50.58,-0.68,-1.33,51.62,-2.02,True,1,956,-50.58,-42068.8,48354.48,6285.68
7703,1958-10-16,50.94,0.36,0.71,51.62,-1.32,True,1,957,-50.94,-42119.74,48749.58,6629.84
7704,1958-10-17,51.46,0.52,1.02,51.62,-0.31,True,1,958,-51.46,-42171.2,49298.68,7127.48
7705,1958-10-20,51.27,-0.19,-0.37,51.62,-0.68,True,1,959,-51.27,-42222.47,49167.93,6945.46
7706,1958-10-21,51.27,0.0,0.0,51.62,-0.68,True,1,960,-51.27,-42273.74,49219.2,6945.46
7707,1958-10-22,51.07,-0.2,-0.39,51.62,-1.06,True,1,961,-51.07,-42324.81,49078.27,6753.46
7708,1958-10-23,50.97,-0.1,-0.2,51.62,-1.26,True,1,962,-50.97,-42375.78,49033.14,6657.36
7709,1958-10-24,50.81,-0.16,-0.31,51.62,-1.57,True,1,963,-50.81,-42426.59,48930.03,6503.44
7710,1958-10-27,50.42,-0.39,-0.77,51.62,-2.33,True,1,964,-50.42,-42477.01,48604.88,6127.87
7711,1958-10-28,50.58,0.16,0.32,51.62,-2.02,True,1,965,-50.58,-42527.59,48809.7,6282.11
7712,1958-10-29,51.07,0.49,0.97,51.62,-1.06,True,1,966,-51.07,-42578.66,49333.62,6754.96
7713,1958-10-30,51.27,0.2,0.39,51.62,-0.68,True,1,967,-51.27,-42629.93,49578.09,6948.16
7714,1958-10-31,51.33,0.06,0.12,51.62,-0.56,True,1,968,-51.33,-42681.26,49687.44,7006.18
7715,1958-11-03,51.56,0.23,0.45,51.62,-0.12,True,1,969,-51.56,-42732.82,49961.64,7228.82
7716,1958-11-05,52.03,0.47,0.91,52.03,0.0,True,1,970,-52.03,-42784.85,50469.1,7684.25
7717,1958-11-06,52.45,0.42,0.81,52.45,0.0,True,1,971,-52.45,-42837.3,50928.95,8091.65
7718,1958-11-07,52.26,-0.19,-0.36,52.45,-0.36,True,1,972,-52.26,-42889.56,50796.72,7907.16
7719,1958-11-10,52.57,0.31,0.59,52.57,0.0,True,1,973,-52.57,-42942.13,51150.61,8208.48
7720,1958-11-11,52.98,0.41,0.78,52.98,0.0,True,1,974,-52.98,-42995.11,51602.52,8607.41
7721,1958-11-12,53.05,0.07,0.13,53.05,0.0,True,1,975,-53.05,-43048.16,51723.75,8675.59
7722,1958-11-13,52.83,-0.22,-0.42,53.05,-0.42,True,1,976,-52.83,-43100.99,51562.08,8461.09
7723,1958-11-14,53.09,0.26,0.49,53.09,0.0,True,1,977,-53.09,-43154.08,51868.93,8714.85
7724,1958-11-17,53.24,0.15,0.28,53.24,0.0,True,1,978,-53.24,-43207.32,52068.72,8861.4
7725,1958-11-18,53.13,-0.11,-0.21,53.24,-0.21,True,1,979,-53.13,-43260.45,52014.27,8753.82
7726,1958-11-19,53.2,0.07,0.13,53.24,-0.08,True,1,980,-53.2,-43313.65,52136.0,8822.35
7727,1958-11-20,53.21,0.01,0.02,53.24,-0.06,True,1,981,-53.21,-43366.86,52199.01,8832.15
7728,1958-11-21,52.7,-0.51,-0.96,53.24,-1.01,True,1,982,-52.7,-43419.56,51751.4,8331.84
7729,1958-11-24,52.03,-0.67,-1.27,53.24,-2.27,True,1,983,-52.03,-43471.59,51145.49,7673.9
7730,1958-11-25,51.02,-1.01,-1.94,53.24,-4.17,True,1,984,-51.02,-43522.61,50203.68,6681.07
7731,1958-11-26,51.9,0.88,1.72,53.24,-2.52,True,1,985,-51.9,-43574.51,51121.5,7546.99
7732,1958-11-28,52.48,0.58,1.12,53.24,-1.43,True,1,986,-52.48,-43626.99,51745.28,8118.29
7733,1958-12-01,52.69,0.21,0.4,53.24,-1.03,True,1,987,-52.69,-43679.68,52005.03,8325.35
7734,1958-12-02,52.46,-0.23,-0.44,53.24,-1.46,True,1,988,-52.46,-43732.14,51830.48,8098.34
7735,1958-12-03,52.53,0.07,0.13,53.24,-1.33,True,1,989,-52.53,-43784.67,51952.17,8167.5
7736,1958-12-04,52.55,0.02,0.04,53.24,-1.3,True,1,990,-52.55,-43837.22,52024.5,8187.28
7737,1958-12-05,52.46,-0.09,-0.17,53.24,-1.46,True,1,991,-52.46,-43889.68,51987.86,8098.18
7738,1958-12-08,52.46,0.0,0.0,53.24,-1.46,True,1,992,-52.46,-43942.14,52040.32,8098.18
7739,1958-12-09,52.82,0.36,0.69,53.24,-0.79,True,1,993,-52.82,-43994.96,52450.26,8455.3
7740,1958-12-10,53.46,0.64,1.21,53.46,0.0,True,1,994,-53.46,-44048.42,53139.24,9090.82
7741,1958-12-11,53.35,-0.11,-0.21,53.46,-0.21,True,1,995,-53.35,-44101.77,53083.25,8981.48
7742,1958-12-12,53.22,-0.13,-0.24,53.46,-0.45,True,1,996,-53.22,-44154.99,53007.12,8852.13
7743,1958-12-15,53.37,0.15,0.28,53.46,-0.17,True,1,997,-53.37,-44208.36,53209.89,9001.53
7744,1958-12-16,53.57,0.2,0.38,53.57,0.0,True,1,998,-53.57,-44261.93,53462.86,9200.93
7745,1958-12-17,53.92,0.35,0.65,53.92,0.0,True,1,999,-53.92,-44315.85,53866.08,9550.23
7746,1958-12-18,54.15,0.23,0.43,54.15,0.0,True,1,1000,-54.15,-44370.0,54150.0,9780.0
7747,1958-12-19,54.07,-0.08,-0.15,54.15,-0.15,True,1,1001,-54.07,-44424.07,54124.07,9700.0
7748,1958-12-22,53.71,-0.36,-0.67,54.15,-0.81,True,1,1002,-53.71,-44477.78,53817.42,9339.64
7749,1958-12-23,53.42,-0.29,-0.54,54.15,-1.35,True,1,1003,-53.42,-44531.2,53580.26,9049.06
7750,1958-12-24,54.11,0.69,1.29,54.15,-0.07,True,1,1004,-54.11,-44585.31,54326.44,9741.13
7751,1958-12-29,54.74,0.63,1.16,54.74,0.0,True,1,1005,-54.74,-44640.05,55013.7,10373.65
7752,1958-12-30,54.93,0.19,0.35,54.93,0.0,True,1,1006,-54.93,-44694.98,55259.58,10564.6
7753,1958-12-31,55.21,0.28,0.51,55.21,0.0,True,1,1007,-55.21,-44750.19,55596.47,10846.28
7754,1959-01-02,55.44,0.23,0.42,55.44,0.0,True,1,1008,-55.44,-44805.63,55883.52,11077.89
7755,1959-01-05,55.66,0.22,0.4,55.66,0.0,True,1,1009,-55.66,-44861.29,56160.94,11299.65
7756,1959-01-06,55.59,-0.07,-0.13,55.66,-0.13,True,1,1010,-55.59,-44916.88,56145.9,11229.02
7757,1959-01-07,54.89,-0.7,-1.26,55.66,-1.38,True,1,1011,-54.89,-44971.77,55493.79,10522.02
7758,1959-01-08,55.4,0.51,0.93,55.66,-0.47,True,1,1012,-55.4,-45027.17,56064.8,11037.63
7759,1959-01-09,55.77,0.37,0.67,55.77,0.0,True,1,1013,-55.77,-45082.94,56495.01,11412.07
7760,1959-01-12,55.78,0.01,0.02,55.78,0.0,True,1,1014,-55.78,-45138.72,56560.92,11422.2
7761,1959-01-13,55.47,-0.31,-0.56,55.78,-0.56,True,1,1015,-55.47,-45194.19,56302.05,11107.86
7762,1959-01-14,55.62,0.15,0.27,55.78,-0.29,True,1,1016,-55.62,-45249.81,56509.92,11260.11
7763,1959-01-15,55.83,0.21,0.38,55.83,0.0,True,1,1017,-55.83,-45305.64,56779.11,11473.47
7764,1959-01-16,55.81,-0.02,-0.04,55.83,-0.04,True,1,1018,-55.81,-45361.45,56814.58,11453.13
7765,1959-01-19,55.68,-0.13,-0.23,55.83,-0.27,True,1,1019,-55.68,-45417.13,56737.92,11320.79
7766,1959-01-20,55.72,0.04,0.07,55.83,-0.2,True,1,1020,-55.72,-45472.85,56834.4,11361.55
7767,1959-01-21,56.04,0.32,0.57,56.04,0.0,True,1,1021,-56.04,-45528.89,57216.84,11687.95
7768,1959-01-22,55.97,-0.07,-0.12,56.04,-0.12,True,1,1022,-55.97,-45584.86,57201.34,11616.48
7769,1959-01-23,56.0,0.03,0.05,56.04,-0.07,True,1,1023,-56.0,-45640.86,57288.0,11647.14
7770,1959-01-26,55.77,-0.23,-0.41,56.04,-0.48,True,1,1024,-55.77,-45696.63,57108.48,11411.85
7771,1959-01-27,55.78,0.01,0.02,56.04,-0.46,True,1,1025,-55.78,-45752.41,57174.5,11422.09
7772,1959-01-28,55.16,-0.62,-1.11,56.04,-1.57,True,1,1026,-55.16,-45807.57,56594.16,10786.59
7773,1959-01-29,55.2,0.04,0.07,56.04,-1.5,True,1,1027,-55.2,-45862.77,56690.4,10827.63
7774,1959-01-30,55.45,0.25,0.45,56.04,-1.05,True,1,1028,-55.45,-45918.22,57002.6,11084.38
7775,1959-02-02,55.21,-0.24,-0.43,56.04,-1.48,True,1,1029,-55.21,-45973.43,56811.09,10837.66
7776,1959-02-03,55.28,0.07,0.13,56.04,-1.36,True,1,1030,-55.28,-46028.71,56938.4,10909.69
7777,1959-02-04,55.06,-0.22,-0.4,56.04,-1.75,True,1,1031,-55.06,-46083.77,56766.86,10683.09
7778,1959-02-05,54.81,-0.25,-0.45,56.04,-2.19,True,1,1032,-54.81,-46138.58,56563.92,10425.34
7779,1959-02-06,54.37,-0.44,-0.8,56.04,-2.98,True,1,1033,-54.37,-46192.95,56164.21,9971.26
7780,1959-02-09,53.58,-0.79,-1.45,56.04,-4.39,True,1,1034,-53.58,-46246.53,55401.72,9155.19
7781,1959-02-10,54.32,0.74,1.38,56.04,-3.07,True,1,1035,-54.32,-46300.85,56221.2,9920.35
7782,1959-02-11,54.35,0.03,0.06,56.04,-3.02,True,1,1036,-54.35,-46355.2,56306.6,9951.4
7783,1959-02-12,54.0,-0.35,-0.64,56.04,-3.64,True,1,1037,-54.0,-46409.2,55998.0,9588.8
7784,1959-02-13,54.42,0.42,0.78,56.04,-2.89,True,1,1038,-54.42,-46463.62,56487.96,10024.34
7785,1959-02-16,54.5,0.08,0.15,56.04,-2.75,True,1,1039,-54.5,-46518.12,56625.5,10107.38
7786,1959-02-17,54.29,-0.21,-0.38,56.04,-3.12,True,1,1040,-54.29,-46572.41,56461.6,9889.19
7787,1959-02-18,54.3,0.01,0.02,56.04,-3.1,True,1,1041,-54.3,-46626.71,56526.3,9899.59
7788,1959-02-19,55.5,1.2,2.21,56.04,-0.96,True,1,1042,-55.5,-46682.21,57831.0,11148.79
7789,1959-02-20,55.52,0.02,0.04,56.04,-0.93,True,1,1043,-55.52,-46737.73,57907.36,11169.63
7790,1959-02-24,55.48,-0.04,-0.07,56.04,-1.0,True,1,1044,-55.48,-46793.21,57921.12,11127.91
7791,1959-02-25,55.24,-0.24,-0.43,56.04,-1.43,True,1,1045,-55.24,-46848.45,57725.8,10877.35
7792,1959-02-26,55.34,0.1,0.18,56.04,-1.25,True,1,1046,-55.34,-46903.79,57885.64,10981.85
7793,1959-02-27,55.41,0.07,0.13,56.04,-1.12,True,1,1047,-55.41,-46959.2,58014.27,11055.07
7794,1959-03-02,55.73,0.32,0.58,56.04,-0.55,True,1,1048,-55.73,-47014.93,58405.04,11390.11
7795,1959-03-03,56.25,0.52,0.93,56.25,0.0,True,1,1049,-56.25,-47071.18,59006.25,11935.07
7796,1959-03-04,56.35,0.1,0.18,56.35,0.0,True,1,1050,-56.35,-47127.53,59167.5,12039.97
7797,1959-03-05,56.43,0.08,0.14,56.43,0.0,True,1,1051,-56.43,-47183.96,59307.93,12123.97
7798,1959-03-06,56.21,-0.22,-0.39,56.43,-0.39,True,1,1052,-56.21,-47240.17,59132.92,11892.75
7799,1959-03-09,56.15,-0.06,-0.11,56.43,-0.5,True,1,1053,-56.15,-47296.32,59125.95,11829.63
7800,1959-03-10,56.31,0.16,0.28,56.43,-0.21,True,1,1054,-56.31,-47352.63,59350.74,11998.11
7801,1959-03-11,56.35,0.04,0.07,56.43,-0.14,True,1,1055,-56.35,-47408.98,59449.25,12040.27
7802,1959-03-12,56.6,0.25,0.44,56.6,0.0,True,1,1056,-56.6,-47465.58,59769.6,12304.02
7803,1959-03-13,56.67,0.07,0.12,56.67,0.0,True,1,1057,-56.67,-47522.25,59900.19,12377.94
7804,1959-03-16,56.06,-0.61,-1.08,56.67,-1.08,True,1,1058,-56.06,-47578.31,59311.48,11733.17
7805,1959-03-17,56.52,0.46,0.82,56.67,-0.26,True,1,1059,-56.52,-47634.83,59854.68,12219.85
7806,1959-03-18,56.39,-0.13,-0.23,56.67,-0.49,True,1,1060,-56.39,-47691.22,59773.4,12082.18
7807,1959-03-19,56.34,-0.05,-0.09,56.67,-0.58,True,1,1061,-56.34,-47747.56,59776.74,12029.18
7808,1959-03-20,56.39,0.05,0.09,56.67,-0.49,True,1,1062,-56.39,-47803.95,59886.18,12082.23
7809,1959-03-23,55.87,-0.52,-0.92,56.67,-1.41,True,1,1063,-55.87,-47859.82,59389.81,11529.99
7810,1959-03-24,55.96,0.09,0.16,56.67,-1.25,True,1,1064,-55.96,-47915.78,59541.44,11625.66
7811,1959-03-25,55.88,-0.08,-0.14,56.67,-1.39,True,1,1065,-55.88,-47971.66,59512.2,11540.54
7812,1959-03-26,55.76,-0.12,-0.22,56.67,-1.61,True,1,1066,-55.76,-48027.42,59440.16,11412.74
7813,1959-03-30,55.45,-0.31,-0.56,56.67,-2.15,True,1,1067,-55.45,-48082.87,59165.15,11082.28
7814,1959-03-31,55.44,-0.01,-0.02,56.67,-2.17,True,1,1068,-55.44,-48138.31,59209.92,11071.61
7815,1959-04-01,55.69,0.25,0.45,56.67,-1.73,True,1,1069,-55.69,-48194.0,59532.61,11338.61
7816,1959-04-02,56.0,0.31,0.56,56.67,-1.18,True,1,1070,-56.0,-48250.0,59920.0,11670.0
7817,1959-04-03,56.44,0.44,0.79,56.67,-0.41,True,1,1071,-56.44,-48306.44,60447.24,12140.8
7818,1959-04-06,56.6,0.16,0.28,56.67,-0.12,True,1,1072,-56.6,-48363.04,60675.2,12312.16
7819,1959-04-07,56.48,-0.12,-0.21,56.67,-0.34,True,1,1073,-56.48,-48419.52,60603.04,12183.52
7820,1959-04-08,56.21,-0.27,-0.48,56.67,-0.81,True,1,1074,-56.21,-48475.73,60369.54,11893.81
7821,1959-04-09,56.17,-0.04,-0.07,56.67,-0.88,True,1,1075,-56.17,-48531.9,60382.75,11850.85
7822,1959-04-10,56.22,0.05,0.09,56.67,-0.79,True,1,1076,-56.22,-48588.12,60492.72,11904.6
7823,1959-04-13,56.43,0.21,0.37,56.67,-0.42,True,1,1077,-56.43,-48644.55,60775.11,12130.56
7824,1959-04-14,56.71,0.28,0.5,56.71,0.0,True,1,1078,-56.71,-48701.26,61133.38,12432.12
7825,1959-04-15,56.96,0.25,0.44,56.96,0.0,True,1,1079,-56.96,-48758.22,61459.84,12701.62
7826,1959-04-16,57.43,0.47,0.82,57.43,0.0,True,1,1080,-57.43,-48815.65,62024.4,13208.75
7827,1959-04-17,57.92,0.49,0.85,57.92,0.0,True,1,1081,-57.92,-48873.57,62611.52,13737.95
7828,1959-04-20,58.17,0.25,0.43,58.17,0.0,True,1,1082,-58.17,-48931.74,62939.94,14008.2
7829,1959-04-21,58.11,-0.06,-0.1,58.17,-0.1,True,1,1083,-58.11,-48989.85,62933.13,13943.28
7830,1959-04-22,57.73,-0.38,-0.65,58.17,-0.76,True,1,1084,-57.73,-49047.58,62579.32,13531.74
7831,1959-04-23,57.6,-0.13,-0.22,58.17,-0.98,True,1,1085,-57.6,-49105.18,62496.0,13390.82
7832,1959-04-24,57.96,0.36,0.62,58.17,-0.36,True,1,1086,-57.96,-49163.14,62944.56,13781.42
7833,1959-04-27,58.14,0.18,0.31,58.17,-0.05,True,1,1087,-58.14,-49221.28,63198.18,13976.9
7834,1959-04-28,57.92,-0.22,-0.38,58.17,-0.43,True,1,1088,-57.92,-49279.2,63016.96,13737.76
7835,1959-04-29,57.69,-0.23,-0.4,58.17,-0.82,True,1,1089,-57.69,-49336.89,62824.41,13487.52
7836,1959-04-30,57.59,-0.1,-0.17,58.17,-1.0,True,1,1090,-57.59,-49394.48,62773.1,13378.62
7837,1959-05-01,57.65,0.06,0.1,58.17,-0.89,True,1,1091,-57.65,-49452.13,62896.15,13444.02
7838,1959-05-04,57.65,0.0,0.0,58.17,-0.89,True,1,1092,-57.65,-49509.78,62953.8,13444.02
7839,1959-05-05,57.75,0.1,0.17,58.17,-0.72,True,1,1093,-57.75,-49567.53,63120.75,13553.22
7840,1959-05-06,57.61,-0.14,-0.24,58.17,-0.96,True,1,1094,-57.61,-49625.14,63025.34,13400.2
7841,1959-05-07,56.88,-0.73,-1.27,58.17,-2.22,True,1,1095,-56.88,-49682.02,62283.6,12601.58
7842,1959-05-08,57.32,0.44,0.77,58.17,-1.46,True,1,1096,-57.32,-49739.34,62822.72,13083.38
7843,1959-05-11,57.96,0.64,1.12,58.17,-0.36,True,1,1097,-57.96,-49797.3,63582.12,13784.82
7844,1959-05-12,57.96,0.0,0.0,58.17,-0.36,True,1,1098,-57.96,-49855.26,63640.08,13784.82
7845,1959-05-13,57.97,0.01,0.02,58.17,-0.34,True,1,1099,-57.97,-49913.23,63709.03,13795.8
7846,1959-05-14,58.37,0.4,0.69,58.37,0.0,True,1,1100,-58.37,-49971.6,64207.0,14235.4
7847,1959-05-15,58.16,-0.21,-0.36,58.37,-0.36,True,1,1101,-58.16,-50029.76,64034.16,14004.4
7848,1959-05-18,58.15,-0.01,-0.02,58.37,-0.38,True,1,1102,-58.15,-50087.91,64081.3,13993.39
7849,1959-05-19,58.32,0.17,0.29,58.37,-0.09,True,1,1103,-58.32,-50146.23,64326.96,14180.73
7850,1959-05-20,58.09,-0.23,-0.39,58.37,-0.48,True,1,1104,-58.09,-50204.32,64131.36,13927.04
7851,1959-05-21,58.14,0.05,0.09,58.37,-0.39,True,1,1105,-58.14,-50262.46,64244.7,13982.24
7852,1959-05-22,58.33,0.19,0.33,58.37,-0.07,True,1,1106,-58.33,-50320.79,64512.98,14192.19
7853,1959-05-25,58.18,-0.15,-0.26,58.37,-0.33,True,1,1107,-58.18,-50378.97,64405.26,14026.29
7854,1959-05-26,58.09,-0.09,-0.16,58.37,-0.48,True,1,1108,-58.09,-50437.06,64363.72,13926.66
7855,1959-05-27,58.19,0.1,0.17,58.37,-0.31,True,1,1109,-58.19,-50495.25,64532.71,14037.46
7856,1959-05-28,58.39,0.2,0.34,58.39,0.0,True,1,1110,-58.39,-50553.64,64812.9,14259.26
7857,1959-05-29,58.68,0.29,0.5,58.68,0.0,True,1,1111,-58.68,-50612.32,65193.48,14581.16
7858,1959-06-01,58.63,-0.05,-0.08,58.68,-0.08,True,1,1112,-58.63,-50670.95,65196.56,14525.61
7859,1959-06-02,58.23,-0.4,-0.68,58.68,-0.77,True,1,1113,-58.23,-50729.18,64809.99,14080.81
7860,1959-06-03,58.25,0.02,0.03,58.68,-0.73,True,1,1114,-58.25,-50787.43,64890.5,14103.07
7861,1959-06-04,57.63,-0.62,-1.06,58.68,-1.79,True,1,1115,-57.63,-50845.06,64257.45,13412.39
7862,1959-06-05,57.51,-0.12,-0.21,58.68,-1.99,True,1,1116,-57.51,-50902.57,64181.16,13278.59
7863,1959-06-08,56.76,-0.75,-1.3,58.68,-3.27,True,1,1117,-56.76,-50959.33,63400.92,12441.59
7864,1959-06-09,56.36,-0.4,-0.7,58.68,-3.95,True,1,1118,-56.36,-51015.69,63010.48,11994.79
7865,1959-06-10,57.19,0.83,1.47,58.68,-2.54,True,1,1119,-57.19,-51072.88,63995.61,12922.73
7866,1959-06-11,57.25,0.06,0.1,58.68,-2.44,True,1,1120,-57.25,-51130.13,64120.0,12989.87
7867,1959-06-12,57.29,0.04,0.07,58.68,-2.37,True,1,1121,-57.29,-51187.42,64222.09,13034.67
7868,1959-06-15,56.99,-0.3,-0.52,58.68,-2.88,True,1,1122,-56.99,-51244.41,63942.78,12698.37
7869,1959-06-16,56.56,-0.43,-0.76,58.68,-3.61,True,1,1123,-56.56,-51300.97,63516.88,12215.91
7870,1959-06-17,57.09,0.53,0.94,58.68,-2.71,True,1,1124,-57.09,-51358.06,64169.16,12811.1
7871,1959-06-18,57.05,-0.04,-0.07,58.68,-2.78,True,1,1125,-57.05,-51415.11,64181.25,12766.14
7872,1959-06-19,57.13,0.08,0.14,58.68,-2.64,True,1,1126,-57.13,-51472.24,64328.38,12856.14
7873,1959-06-22,57.13,0.0,0.0,58.68,-2.64,True,1,1127,-57.13,-51529.37,64385.51,12856.14
7874,1959-06-23,57.12,-0.01,-0.02,58.68,-2.66,True,1,1128,-57.12,-51586.49,64431.36,12844.87
7875,1959-06-24,57.41,0.29,0.51,58.68,-2.16,True,1,1129,-57.41,-51643.9,64815.89,13171.99
7876,1959-06-25,57.73,0.32,0.56,58.68,-1.62,True,1,1130,-57.73,-51701.63,65234.9,13533.27
7877,1959-06-26,57.98,0.25,0.43,58.68,-1.19,True,1,1131,-57.98,-51759.61,65575.38,13815.77
7878,1959-06-29,58.37,0.39,0.67,58.68,-0.53,True,1,1132,-58.37,-51817.98,66074.84,14256.86
7879,1959-06-30,58.47,0.1,0.17,58.68,-0.36,True,1,1133,-58.47,-51876.45,66246.51,14370.06
7880,1959-07-01,58.97,0.5,0.86,58.97,0.0,True,1,1134,-58.97,-51935.42,66871.98,14936.56
7881,1959-07-02,59.28,0.31,0.53,59.28,0.0,True,1,1135,-59.28,-51994.7,67282.8,15288.1
7882,1959-07-06,59.65,0.37,0.62,59.65,0.0,True,1,1136,-59.65,-52054.35,67762.4,15708.05
7883,1959-07-07,60.01,0.36,0.6,60.01,0.0,True,1,1137,-60.01,-52114.36,68231.37,16117.01
7884,1959-07-08,60.03,0.02,0.03,60.03,0.0,True,1,1138,-60.03,-52174.39,68314.14,16139.75
7885,1959-07-09,59.97,-0.06,-0.1,60.03,-0.1,True,1,1139,-59.97,-52234.36,68305.83,16071.47
7886,1959-07-10,59.91,-0.06,-0.1,60.03,-0.2,True,1,1140,-59.91,-52294.27,68297.4,16003.13
7887,1959-07-13,59.41,-0.5,-0.84,60.03,-1.03,True,1,1141,-59.41,-52353.68,67786.81,15433.13
7888,1959-07-14,59.55,0.14,0.24,60.03,-0.8,True,1,1142,-59.55,-52413.23,68006.1,15592.87
7889,1959-07-15,59.59,0.04,0.07,60.03,-0.73,True,1,1143,-59.59,-52472.82,68111.37,15638.55
7890,1959-07-16,59.41,-0.18,-0.3,60.03,-1.03,True,1,1144,-59.41,-52532.23,67965.04,15432.81
7891,1959-07-17,59.19,-0.22,-0.37,60.03,-1.4,True,1,1145,-59.19,-52591.42,67772.55,15181.13
7892,1959-07-20,58.91,-0.28,-0.47,60.03,-1.87,True,1,1146,-58.91,-52650.33,67510.86,14860.53
7893,1959-07-21,59.41,0.5,0.85,60.03,-1.03,True,1,1147,-59.41,-52709.74,68143.27,15433.53
7894,1959-07-22,59.61,0.2,0.34,60.03,-0.7,True,1,1148,-59.61,-52769.35,68432.28,15662.93
7895,1959-07-23,59.67,0.06,0.1,60.03,-0.6,True,1,1149,-59.67,-52829.02,68560.83,15731.81
7896,1959-07-24,59.65,-0.02,-0.03,60.03,-0.63,True,1,1150,-59.65,-52888.67,68597.5,15708.83
7897,1959-07-27,60.02,0.37,0.62,60.03,-0.02,True,1,1151,-60.02,-52948.69,69083.02,16134.33
7898,1959-07-28,60.32,0.3,0.5,60.32,0.0,True,1,1152,-60.32,-53009.01,69488.64,16479.63
7899,1959-07-29,60.62,0.3,0.5,60.62,0.0,True,1,1153,-60.62,-53069.63,69894.86,16825.23
7900,1959-07-30,60.5,-0.12,-0.2,60.62,-0.2,True,1,1154,-60.5,-53130.13,69817.0,16686.87
7901,1959-07-31,60.51,0.01,0.02,60.62,-0.18,True,1,1155,-60.51,-53190.64,69889.05,16698.41
7902,1959-08-03,60.71,0.2,0.33,60.71,0.0,True,1,1156,-60.71,-53251.35,70180.76,16929.41
7903,1959-08-04,60.61,-0.1,-0.16,60.71,-0.16,True,1,1157,-60.61,-53311.96,70125.77,16813.81
7904,1959-08-05,60.3,-0.31,-0.51,60.71,-0.68,True,1,1158,-60.3,-53372.26,69827.4,16455.14
7905,1959-08-06,60.24,-0.06,-0.1,60.71,-0.77,True,1,1159,-60.24,-53432.5,69818.16,16385.66
7906,1959-08-07,59.87,-0.37,-0.61,60.71,-1.38,True,1,1160,-59.87,-53492.37,69449.2,15956.83
7907,1959-08-10,58.62,-1.25,-2.09,60.71,-3.44,True,1,1161,-58.62,-53550.99,68057.82,14506.83
7908,1959-08-11,59.39,0.77,1.31,60.71,-2.17,True,1,1162,-59.39,-53610.38,69011.18,15400.8
7909,1959-08-12,59.25,-0.14,-0.24,60.71,-2.4,True,1,1163,-59.25,-53669.63,68907.75,15238.12
7910,1959-08-13,59.15,-0.1,-0.17,60.71,-2.57,True,1,1164,-59.15,-53728.78,68850.6,15121.82
7911,1959-08-14,59.29,0.14,0.24,60.71,-2.34,True,1,1165,-59.29,-53788.07,69072.85,15284.78
7912,1959-08-17,59.17,-0.12,-0.2,60.71,-2.54,True,1,1166,-59.17,-53847.24,68992.22,15144.98
7913,1959-08-18,58.62,-0.55,-0.93,60.71,-3.44,True,1,1167,-58.62,-53905.86,68409.54,14503.68
7914,1959-08-19,58.27,-0.35,-0.6,60.71,-4.02,True,1,1168,-58.27,-53964.13,68059.36,14095.23
7915,1959-08-20,59.14,0.87,1.49,60.71,-2.59,True,1,1169,-59.14,-54023.27,69134.66,15111.39
7916,1959-08-21,59.08,-0.06,-0.1,60.71,-2.68,True,1,1170,-59.08,-54082.35,69123.6,15041.25
7917,1959-08-24,58.87,-0.21,-0.36,60.71,-3.03,True,1,1171,-58.87,-54141.22,68936.77,14795.55
7918,1959-08-25,58.99,0.12,0.2,60.71,-2.83,True,1,1172,-58.99,-54200.21,69136.28,14936.07
7919,1959-08-26,59.07,0.08,0.14,60.71,-2.7,True,1,1173,-59.07,-54259.28,69289.11,15029.83
7920,1959-08-27,59.58,0.51,0.86,60.71,-1.86,True,1,1174,-59.58,-54318.86,69946.92,15628.06
7921,1959-08-28,59.6,0.02,0.03,60.71,-1.83,True,1,1175,-59.6,-54378.46,70030.0,15651.54
7922,1959-08-31,59.6,0.0,0.0,60.71,-1.83,True,1,1176,-59.6,-54438.06,70089.6,15651.54
7923,1959-09-01,58.87,-0.73,-1.23,60.71,-3.03,True,1,1177,-58.87,-54496.93,69289.99,14793.06
7924,1959-09-02,58.92,0.05,0.08,60.71,-2.95,True,1,1178,-58.92,-54555.85,69407.76,14851.91
7925,1959-09-03,58.26,-0.66,-1.12,60.71,-4.04,True,1,1179,-58.26,-54614.11,68688.54,14074.43
7926,1959-09-04,58.54,0.28,0.48,60.71,-3.57,True,1,1180,-58.54,-54672.65,69077.2,14404.55
7927,1959-09-08,57.7,-0.84,-1.44,60.71,-4.96,True,1,1181,-57.7,-54730.35,68143.7,13413.35
7928,1959-09-09,57.29,-0.41,-0.71,60.71,-5.63,True,1,1182,-57.29,-54787.64,67716.78,12929.14
7929,1959-09-10,56.99,-0.3,-0.52,60.71,-6.13,True,1,1183,-56.99,-54844.63,67419.17,12574.54
7930,1959-09-11,57.41,0.42,0.74,60.71,-5.44,True,1,1184,-57.41,-54902.04,67973.44,13071.4
7931,1959-09-14,56.99,-0.42,-0.73,60.71,-6.13,True,1,1185,-56.99,-54959.03,67533.15,12574.12
7932,1959-09-15,56.68,-0.31,-0.54,60.71,-6.64,True,1,1186,-56.68,-55015.71,67222.48,12206.77
7933,1959-09-16,56.72,0.04,0.07,60.71,-6.57,True,1,1187,-56.72,-55072.43,67326.64,12254.21
7934,1959-09-17,56.41,-0.31,-0.55,60.71,-7.08,True,1,1188,-56.41,-55128.84,67015.08,11886.24
7935,1959-09-18,56.19,-0.22,-0.39,60.71,-7.44,True,1,1189,-56.19,-55185.03,66809.91,11624.88
7936,1959-09-21,55.27,-0.92,-1.64,60.71,-8.96,True,1,1190,-55.27,-55240.3,65771.3,10531.0
7937,1959-09-22,55.14,-0.13,-0.24,60.71,-9.18,True,1,1191,-55.14,-55295.44,65671.74,10376.3
7938,1959-09-23,55.82,0.68,1.23,60.71,-8.06,True,1,1192,-55.82,-55351.26,66537.44,11186.18
7939,1959-09-24,56.78,0.96,1.72,60.71,-6.47,True,1,1193,-56.78,-55408.04,67738.54,12330.5
7940,1959-09-25,56.73,-0.05,-0.09,60.71,-6.56,True,1,1194,-56.73,-55464.77,67735.62,12270.85
7941,1959-09-28,57.15,0.42,0.74,60.71,-5.86,True,1,1195,-57.15,-55521.92,68294.25,12772.33
7942,1959-09-29,57.51,0.36,0.63,60.71,-5.27,True,1,1196,-57.51,-55579.43,68781.96,13202.53
7943,1959-09-30,56.88,-0.63,-1.1,60.71,-6.31,True,1,1197,-56.88,-55636.31,68085.36,12449.05
7944,1959-10-01,56.94,0.06,0.1,60.71,-6.21,True,1,1198,-56.94,-55693.25,68214.12,12520.87
7945,1959-10-02,57.2,0.26,0.46,60.71,-5.78,True,1,1199,-57.2,-55750.45,68582.8,12832.35
7946,1959-10-05,57.14,-0.06,-0.1,60.71,-5.88,True,1,1200,-57.14,-55807.59,68568.0,12760.41
7947,1959-10-06,57.09,-0.05,-0.09,60.71,-5.96,True,1,1201,-57.09,-55864.68,68565.09,12700.41
7948,1959-10-07,56.94,-0.15,-0.26,60.71,-6.21,True,1,1202,-56.94,-55921.62,68441.88,12520.26
7949,1959-10-08,56.81,-0.13,-0.23,60.71,-6.42,True,1,1203,-56.81,-55978.43,68342.43,12364.0
7950,1959-10-09,57.0,0.19,0.33,60.71,-6.11,True,1,1204,-57.0,-56035.43,68628.0,12592.57
7951,1959-10-12,57.32,0.32,0.56,60.71,-5.58,True,1,1205,-57.32,-56092.75,69070.6,12977.85
7952,1959-10-13,57.16,-0.16,-0.28,60.71,-5.85,True,1,1206,-57.16,-56149.91,68934.96,12785.05
7953,1959-10-14,56.71,-0.45,-0.79,60.71,-6.59,True,1,1207,-56.71,-56206.62,68448.97,12242.35
7954,1959-10-15,56.87,0.16,0.28,60.71,-6.32,True,1,1208,-56.87,-56263.49,68698.96,12435.47
7955,1959-10-16,57.33,0.46,0.81,60.71,-5.57,True,1,1209,-57.33,-56320.82,69311.97,12991.15
7956,1959-10-19,57.01,-0.32,-0.56,60.71,-6.1,True,1,1210,-57.01,-56377.83,68982.1,12604.27
7957,1959-10-20,56.66,-0.35,-0.61,60.71,-6.67,True,1,1211,-56.66,-56434.49,68615.26,12180.77
7958,1959-10-21,56.55,-0.11,-0.19,60.71,-6.85,True,1,1212,-56.55,-56491.04,68538.6,12047.56
7959,1959-10-22,56.0,-0.55,-0.97,60.71,-7.76,True,1,1213,-56.0,-56547.04,67928.0,11380.96
7960,1959-10-23,56.56,0.56,1.0,60.71,-6.84,True,1,1214,-56.56,-56603.6,68663.84,12060.24
7961,1959-10-26,56.94,0.38,0.67,60.71,-6.21,True,1,1215,-56.94,-56660.54,69182.1,12521.56
7962,1959-10-27,57.42,0.48,0.84,60.71,-5.42,True,1,1216,-57.42,-56717.96,69822.72,13104.76
7963,1959-10-28,57.46,0.04,0.07,60.71,-5.35,True,1,1217,-57.46,-56775.42,69928.82,13153.4
7964,1959-10-29,57.41,-0.05,-0.09,60.71,-5.44,True,1,1218,-57.41,-56832.83,69925.38,13092.55
7965,1959-10-30,57.52,0.11,0.19,60.71,-5.25,True,1,1219,-57.52,-56890.35,70116.88,13226.53
7966,1959-11-02,57.41,-0.11,-0.19,60.71,-5.44,True,1,1220,-57.41,-56947.76,70040.2,13092.44
7967,1959-11-04,57.26,-0.15,-0.26,60.71,-5.68,True,1,1221,-57.26,-57005.02,69914.46,12909.44
7968,1959-11-05,57.32,0.06,0.1,60.71,-5.58,True,1,1222,-57.32,-57062.34,70045.04,12982.7
7969,1959-11-06,57.6,0.28,0.49,60.71,-5.12,True,1,1223,-57.6,-57119.94,70444.8,13324.86
7970,1959-11-09,57.5,-0.1,-0.17,60.71,-5.29,True,1,1224,-57.5,-57177.44,70380.0,13202.56
7971,1959-11-10,57.48,-0.02,-0.04,60.71,-5.32,True,1,1225,-57.48,-57234.92,70413.0,13178.08
7972,1959-11-11,57.49,0.01,0.02,60.71,-5.3,True,1,1226,-57.49,-57292.41,70482.74,13190.33
7973,1959-11-12,57.17,-0.32,-0.56,60.71,-5.83,True,1,1227,-57.17,-57349.58,70147.59,12798.01
7974,1959-11-13,56.85,-0.32,-0.56,60.71,-6.36,True,1,1228,-56.85,-57406.43,69811.8,12405.37
7975,1959-11-16,56.22,-0.63,-1.11,60.71,-7.4,True,1,1229,-56.22,-57462.65,69094.38,11631.73
7976,1959-11-17,56.38,0.16,0.28,60.71,-7.13,True,1,1230,-56.38,-57519.03,69347.4,11828.37
7977,1959-11-18,56.99,0.61,1.08,60.71,-6.13,True,1,1231,-56.99,-57576.02,70154.69,12578.67
7978,1959-11-19,56.94,-0.05,-0.09,60.71,-6.21,True,1,1232,-56.94,-57632.96,70150.08,12517.12
7979,1959-11-20,56.97,0.03,0.05,60.71,-6.16,True,1,1233,-56.97,-57689.93,70244.01,12554.08
7980,1959-11-23,57.08,0.11,0.19,60.71,-5.98,True,1,1234,-57.08,-57747.01,70436.72,12689.71
7981,1959-11-24,57.35,0.27,0.47,60.71,-5.54,True,1,1235,-57.35,-57804.36,70827.25,13022.89
7982,1959-11-25,57.44,0.09,0.16,60.71,-5.39,True,1,1236,-57.44,-57861.8,70995.84,13134.04
7983,1959-11-27,57.7,0.26,0.45,60.71,-4.96,True,1,1237,-57.7,-57919.5,71374.9,13455.4
7984,1959-11-30,58.28,0.58,1.0,60.71,-4.0,True,1,1238,-58.28,-57977.78,72150.64,14172.86
7985,1959-12-01,58.7,0.42,0.72,60.71,-3.31,True,1,1239,-58.7,-58036.48,72729.3,14692.82
7986,1959-12-02,58.6,-0.1,-0.17,60.71,-3.48,True,1,1240,-58.6,-58095.08,72664.0,14568.92
7987,1959-12-03,58.73,0.13,0.22,60.71,-3.26,True,1,1241,-58.73,-58153.81,72883.93,14730.12
7988,1959-12-04,58.85,0.12,0.2,60.71,-3.06,True,1,1242,-58.85,-58212.66,73091.7,14879.04
7989,1959-12-07,58.96,0.11,0.19,60.71,-2.88,True,1,1243,-58.96,-58271.62,73287.28,15015.66
7990,1959-12-08,59.34,0.38,0.64,60.71,-2.26,True,1,1244,-59.34,-58330.96,73818.96,15488.0
7991,1959-12-09,58.97,-0.37,-0.62,60.71,-2.87,True,1,1245,-58.97,-58389.93,73417.65,15027.72
7992,1959-12-10,59.02,0.05,0.08,60.71,-2.78,True,1,1246,-59.02,-58448.95,73538.92,15089.97
7993,1959-12-11,58.88,-0.14,-0.24,60.71,-3.01,True,1,1247,-58.88,-58507.83,73423.36,14915.53
7994,1959-12-14,59.04,0.16,0.27,60.71,-2.75,True,1,1248,-59.04,-58566.87,73681.92,15115.05
7995,1959-12-15,58.9,-0.14,-0.24,60.71,-2.98,True,1,1249,-58.9,-58625.77,73566.1,14940.33
7996,1959-12-16,58.97,0.07,0.12,60.71,-2.87,True,1,1250,-58.97,-58684.74,73712.5,15027.76
7997,1959-12-17,58.86,-0.11,-0.19,60.71,-3.05,True,1,1251,-58.86,-58743.6,73633.86,14890.26
7998,1959-12-18,59.14,0.28,0.48,60.71,-2.59,True,1,1252,-59.14,-58802.74,74043.28,15240.54
7999,1959-12-21,59.21,0.07,0.12,60.71,-2.47,True,1,1253,-59.21,-58861.95,74190.13,15328.18
8000,1959-12-22,59.14,-0.07,-0.12,60.71,-2.59,True,1,1254,-59.14,-58921.09,74161.56,15240.47
8001,1959-12-23,58.96,-0.18,-0.3,60.71,-2.88,True,1,1255,-58.96,-58980.05,73994.8,15014.75
8002,1959-12-24,59.0,0.04,0.07,60.71,-2.82,True,1,1256,-59.0,-59039.05,74104.0,15064.95
8003,1959-12-28,58.98,-0.02,-0.03,60.71,-2.85,True,1,1257,-58.98,-59098.03,74137.86,15039.83
8004,1959-12-29,59.3,0.32,0.54,60.71,-2.32,True,1,1258,-59.3,-59157.33,74599.4,15442.07
8005,1959-12-30,59.77,0.47,0.79,60.71,-1.55,True,1,1259,-59.77,-59217.1,75250.43,16033.33
8006,1959-12-31,59.89,0.12,0.2,60.71,-1.35,True,1,1260,-59.89,-59276.99,75461.4,16184.41
8007,1960-01-04,59.91,0.02,0.03,60.71,-1.32,True,1,1261,-59.91,-59336.9,75546.51,16209.61
8008,1960-01-05,60.39,0.48,0.8,60.71,-0.53,True,1,1262,-60.39,-59397.29,76212.18,16814.89
8009,1960-01-06,60.13,-0.26,-0.43,60.71,-0.96,True,1,1263,-60.13,-59457.42,75944.19,16486.77
8010,1960-01-07,59.69,-0.44,-0.73,60.71,-1.68,True,1,1264,-59.69,-59517.11,75448.16,15931.05
8011,1960-01-08,59.5,-0.19,-0.32,60.71,-1.99,True,1,1265,-59.5,-59576.61,75267.5,15690.89
8012,1960-01-11,58.77,-0.73,-1.23,60.71,-3.2,True,1,1266,-58.77,-59635.38,74402.82,14767.44
8013,1960-01-12,58.41,-0.36,-0.61,60.71,-3.79,True,1,1267,-58.41,-59693.79,74005.47,14311.68
8014,1960-01-13,58.08,-0.33,-0.56,60.71,-4.33,True,1,1268,-58.08,-59751.87,73645.44,13893.57
8015,1960-01-14,58.4,0.32,0.55,60.71,-3.8,True,1,1269,-58.4,-59810.27,74109.6,14299.33
8016,1960-01-15,58.38,-0.02,-0.03,60.71,-3.84,True,1,1270,-58.38,-59868.65,74142.6,14273.95
8017,1960-01-18,57.89,-0.49,-0.84,60.71,-4.64,True,1,1271,-57.89,-59926.54,73578.19,13651.65
8018,1960-01-19,57.27,-0.62,-1.07,60.71,-5.67,True,1,1272,-57.27,-59983.81,72847.44,12863.63
8019,1960-01-20,57.07,-0.2,-0.35,60.71,-6.0,True,1,1273,-57.07,-60040.88,72650.11,12609.23
8020,1960-01-21,57.21,0.14,0.24,60.71,-5.76,True,1,1274,-57.21,-60098.09,72885.54,12787.45
8021,1960-01-22,57.38,0.17,0.3,60.71,-5.48,True,1,1275,-57.38,-60155.47,73159.5,13004.03
8022,1960-01-25,56.78,-0.6,-1.05,60.71,-6.47,True,1,1276,-56.78,-60212.25,72451.28,12239.03
8023,1960-01-26,56.86,0.08,0.14,60.71,-6.34,True,1,1277,-56.86,-60269.11,72610.22,12341.11
8024,1960-01-27,56.72,-0.14,-0.25,60.71,-6.57,True,1,1278,-56.72,-60325.83,72488.16,12162.33
8025,1960-01-28,56.13,-0.59,-1.04,60.71,-7.54,True,1,1279,-56.13,-60381.96,71790.27,11408.31
8026,1960-01-29,55.61,-0.52,-0.93,60.71,-8.4,True,1,1280,-55.61,-60437.57,71180.8,10743.23
8027,1960-02-01,55.96,0.35,0.63,60.71,-7.82,True,1,1281,-55.96,-60493.53,71684.76,11191.23
8028,1960-02-02,56.82,0.86,1.54,60.71,-6.41,True,1,1282,-56.82,-60550.35,72843.24,12292.89
8029,1960-02-03,56.32,-0.5,-0.88,60.71,-7.23,True,1,1283,-56.32,-60606.67,72258.56,11651.89
8030,1960-02-04,56.27,-0.05,-0.09,60.71,-7.31,True,1,1284,-56.27,-60662.94,72250.68,11587.74
8031,1960-02-05,55.98,-0.29,-0.52,60.71,-7.79,True,1,1285,-55.98,-60718.92,71934.3,11215.38
8032,1960-02-08,55.32,-0.66,-1.18,60.71,-8.88,True,1,1286,-55.32,-60774.24,71141.52,10367.28
8033,1960-02-09,55.84,0.52,0.94,60.71,-8.02,True,1,1287,-55.84,-60830.08,71866.08,11036.0
8034,1960-02-10,55.49,-0.35,-0.63,60.71,-8.6,True,1,1288,-55.49,-60885.57,71471.12,10585.55
8035,1960-02-11,55.18,-0.31,-0.56,60.71,-9.11,True,1,1289,-55.18,-60940.75,71127.02,10186.27
8036,1960-02-12,55.46,0.28,0.51,60.71,-8.65,True,1,1290,-55.46,-60996.21,71543.4,10547.19
8037,1960-02-15,55.17,-0.29,-0.52,60.71,-9.12,True,1,1291,-55.17,-61051.38,71224.47,10173.09
8038,1960-02-16,54.73,-0.44,-0.8,60.71,-9.85,True,1,1292,-54.73,-61106.11,70711.16,9605.05
8039,1960-02-17,55.03,0.3,0.55,60.71,-9.36,True,1,1293,-55.03,-61161.14,71153.79,9992.65
8040,1960-02-18,55.8,0.77,1.4,60.71,-8.09,True,1,1294,-55.8,-61216.94,72205.2,10988.26
8041,1960-02-19,56.24,0.44,0.79,60.71,-7.36,True,1,1295,-56.24,-61273.18,72830.8,11557.62
8042,1960-02-23,55.94,-0.3,-0.53,60.71,-7.86,True,1,1296,-55.94,-61329.12,72498.24,11169.12
8043,1960-02-24,55.74,-0.2,-0.36,60.71,-8.19,True,1,1297,-55.74,-61384.86,72294.78,10909.92
8044,1960-02-25,55.93,0.19,0.34,60.71,-7.87,True,1,1298,-55.93,-61440.79,72597.14,11156.35
8045,1960-02-26,56.16,0.23,0.41,60.71,-7.5,True,1,1299,-56.16,-61496.95,72951.84,11454.89
8046,1960-02-29,56.12,-0.04,-0.07,60.71,-7.56,True,1,1300,-56.12,-61553.07,72956.0,11402.93
8047,1960-03-01,56.01,-0.11,-0.2,60.71,-7.74,True,1,1301,-56.01,-61609.08,72869.01,11259.93
8048,1960-03-02,55.62,-0.39,-0.7,60.71,-8.38,True,1,1302,-55.62,-61664.7,72417.24,10752.54
8049,1960-03-03,54.78,-0.84,-1.51,60.71,-9.77,True,1,1303,-54.78,-61719.48,71378.34,9658.86
8050,1960-03-04,54.57,-0.21,-0.38,60.71,-10.11,True,1,1304,-54.57,-61774.05,71159.28,9385.23
8051,1960-03-07,54.02,-0.55,-1.01,60.71,-11.02,True,1,1305,-54.02,-61828.07,70496.1,8668.03
8052,1960-03-08,53.47,-0.55,-1.02,60.71,-11.93,True,1,1306,-53.47,-61881.54,69831.82,7950.28
8053,1960-03-09,54.04,0.57,1.07,60.71,-10.99,True,1,1307,-54.04,-61935.58,70630.28,8694.7
8054,1960-03-10,53.83,-0.21,-0.39,60.71,-11.33,True,1,1308,-53.83,-61989.41,70409.64,8420.23
8055,1960-03-11,54.24,0.41,0.76,60.71,-10.66,True,1,1309,-54.24,-62043.65,71000.16,8956.51
8056,1960-03-14,54.32,0.08,0.15,60.71,-10.52,True,1,1310,-54.32,-62097.97,71159.2,9061.23
8057,1960-03-15,54.74,0.42,0.77,60.71,-9.83,True,1,1311,-54.74,-62152.71,71764.14,9611.43
8058,1960-03-16,55.04,0.3,0.55,60.71,-9.34,True,1,1312,-55.04,-62207.75,72212.48,10004.73
8059,1960-03-17,54.96,-0.08,-0.14,60.71,-9.47,True,1,1313,-54.96,-62262.71,72162.48,9899.77
8060,1960-03-18,55.01,0.05,0.09,60.71,-9.39,True,1,1314,-55.01,-62317.72,72283.14,9965.42
8061,1960-03-21,55.07,0.06,0.11,60.71,-9.29,True,1,1315,-55.07,-62372.79,72417.05,10044.26
8062,1960-03-22,55.29,0.22,0.4,60.71,-8.93,True,1,1316,-55.29,-62428.08,72761.64,10333.56
8063,1960-03-23,55.74,0.45,0.81,60.71,-8.19,True,1,1317,-55.74,-62483.82,73409.58,10925.76
8064,1960-03-24,55.98,0.24,0.43,60.71,-7.79,True,1,1318,-55.98,-62539.8,73781.64,11241.84
8065,1960-03-25,55.98,0.0,0.0,60.71,-7.79,True,1,1319,-55.98,-62595.78,73837.62,11241.84
8066,1960-03-28,55.86,-0.12,-0.21,60.71,-7.99,True,1,1320,-55.86,-62651.64,73735.2,11083.56
8067,1960-03-29,55.78,-0.08,-0.14,60.71,-8.12,True,1,1321,-55.78,-62707.42,73685.38,10977.96
8068,1960-03-30,55.66,-0.12,-0.22,60.71,-8.32,True,1,1322,-55.66,-62763.08,73582.52,10819.44
8069,1960-03-31,55.34,-0.32,-0.57,60.71,-8.85,True,1,1323,-55.34,-62818.42,73214.82,10396.4
8070,1960-04-01,55.43,0.09,0.16,60.71,-8.7,True,1,1324,-55.43,-62873.85,73389.32,10515.47
8071,1960-04-04,55.54,0.11,0.2,60.71,-8.52,True,1,1325,-55.54,-62929.39,73590.5,10661.11
8072,1960-04-05,55.37,-0.17,-0.31,60.71,-8.8,True,1,1326,-55.37,-62984.76,73420.62,10435.86
8073,1960-04-06,56.51,1.14,2.06,60.71,-6.92,True,1,1327,-56.51,-63041.27,74988.77,11947.5
8074,1960-04-07,56.52,0.01,0.02,60.71,-6.9,True,1,1328,-56.52,-63097.79,75058.56,11960.77
8075,1960-04-08,56.39,-0.13,-0.23,60.71,-7.12,True,1,1329,-56.39,-63154.18,74942.31,11788.13
8076,1960-04-11,56.17,-0.22,-0.39,60.71,-7.48,True,1,1330,-56.17,-63210.35,74706.1,11495.75
8077,1960-04-12,56.3,0.13,0.23,60.71,-7.26,True,1,1331,-56.3,-63266.65,74935.3,11668.65
8078,1960-04-13,56.3,0.0,0.0,60.71,-7.26,True,1,1332,-56.3,-63322.95,74991.6,11668.65
8079,1960-04-14,56.43,0.13,0.23,60.71,-7.05,True,1,1333,-56.43,-63379.38,75221.19,11841.81
8080,1960-04-18,56.59,0.16,0.28,60.71,-6.79,True,1,1334,-56.59,-63435.97,75491.06,12055.09
8081,1960-04-19,56.13,-0.46,-0.81,60.71,-7.54,True,1,1335,-56.13,-63492.1,74933.55,11441.45
8082,1960-04-20,55.44,-0.69,-1.23,60.71,-8.68,True,1,1336,-55.44,-63547.54,74067.84,10520.3
8083,1960-04-21,55.59,0.15,0.27,60.71,-8.43,True,1,1337,-55.59,-63603.13,74323.83,10720.7
8084,1960-04-22,55.42,-0.17,-0.31,60.71,-8.71,True,1,1338,-55.42,-63658.55,74151.96,10493.41
8085,1960-04-25,54.86,-0.56,-1.01,60.71,-9.64,True,1,1339,-54.86,-63713.41,73457.54,9744.13
8086,1960-04-26,55.04,0.18,0.33,60.71,-9.34,True,1,1340,-55.04,-63768.45,73753.6,9985.15
8087,1960-04-27,55.04,0.0,0.0,60.71,-9.34,True,1,1341,-55.04,-63823.49,73808.64,9985.15
8088,1960-04-28,54.56,-0.48,-0.87,60.71,-10.13,True,1,1342,-54.56,-63878.05,73219.52,9341.47
8089,1960-04-29,54.37,-0.19,-0.35,60.71,-10.44,True,1,1343,-54.37,-63932.42,73018.91,9086.49
8090,1960-05-02,54.13,-0.24,-0.44,60.71,-10.84,True,1,1344,-54.13,-63986.55,72750.72,8764.17
8091,1960-05-03,54.83,0.7,1.29,60.71,-9.68,True,1,1345,-54.83,-64041.38,73746.35,9704.97
8092,1960-05-04,55.04,0.21,0.38,60.71,-9.34,True,1,1346,-55.04,-64096.42,74083.84,9987.42
8093,1960-05-05,54.86,-0.18,-0.33,60.71,-9.64,True,1,1347,-54.86,-64151.28,73896.42,9745.14
8094,1960-05-06,54.75,-0.11,-0.2,60.71,-9.82,True,1,1348,-54.75,-64206.03,73803.0,9596.97
8095,1960-05-09,54.8,0.05,0.09,60.71,-9.74,True,1,1349,-54.8,-64260.83,73925.2,9664.37
8096,1960-05-10,54.42,-0.38,-0.69,60.71,-10.36,True,1,1350,-54.42,-64315.25,73467.0,9151.75
8097,1960-05-11,54.57,0.15,0.28,60.71,-10.11,True,1,1351,-54.57,-64369.82,73724.07,9354.25
8098,1960-05-12,54.85,0.28,0.51,60.71,-9.65,True,1,1352,-54.85,-64424.67,74157.2,9732.53
8099,1960-05-13,55.3,0.45,0.82,60.71,-8.91,True,1,1353,-55.3,-64479.97,74820.9,10340.93
8100,1960-05-16,55.25,-0.05,-0.09,60.71,-8.99,True,1,1354,-55.25,-64535.22,74808.5,10273.28
8101,1960-05-17,55.46,0.21,0.38,60.71,-8.65,True,1,1355,-55.46,-64590.68,75148.3,10557.62
8102,1960-05-18,55.44,-0.02,-0.04,60.71,-8.68,True,1,1356,-55.44,-64646.12,75176.64,10530.52
8103,1960-05-19,55.68,0.24,0.43,60.71,-8.28,True,1,1357,-55.68,-64701.8,75557.76,10855.96
8104,1960-05-20,55.73,0.05,0.09,60.71,-8.2,True,1,1358,-55.73,-64757.53,75681.34,10923.81
8105,1960-05-23,55.76,0.03,0.05,60.71,-8.15,True,1,1359,-55.76,-64813.29,75777.84,10964.55
8106,1960-05-24,55.7,-0.06,-0.11,60.71,-8.25,True,1,1360,-55.7,-64868.99,75752.0,10883.01
8107,1960-05-25,55.67,-0.03,-0.05,60.71,-8.3,True,1,1361,-55.67,-64924.66,75766.87,10842.21
8108,1960-05-26,55.71,0.04,0.07,60.71,-8.24,True,1,1362,-55.71,-64980.37,75877.02,10896.65
8109,1960-05-27,55.74,0.03,0.05,60.71,-8.19,True,1,1363,-55.74,-65036.11,75973.62,10937.51
8110,1960-05-31,55.83,0.09,0.16,60.71,-8.04,True,1,1364,-55.83,-65091.94,76152.12,11060.18
8111,1960-06-01,55.89,0.06,0.11,60.71,-7.94,True,1,1365,-55.89,-65147.83,76289.85,11142.02
8112,1960-06-02,56.13,0.24,0.43,60.71,-7.54,True,1,1366,-56.13,-65203.96,76673.58,11469.62
8113,1960-06-03,56.23,0.1,0.18,60.71,-7.38,True,1,1367,-56.23,-65260.19,76866.41,11606.22
8114,1960-06-06,56.89,0.66,1.17,60.71,-6.29,True,1,1368,-56.89,-65317.08,77825.52,12508.44
8115,1960-06-07,57.43,0.54,0.95,60.71,-5.4,True,1,1369,-57.43,-65374.51,78621.67,13247.16
8116,1960-06-08,57.89,0.46,0.8,60.71,-4.64,True,1,1370,-57.89,-65432.4,79309.3,13876.9
8117,1960-06-09,58.0,0.11,0.19,60.71,-4.46,True,1,1371,-58.0,-65490.4,79518.0,14027.6
8118,1960-06-10,57.97,-0.03,-0.05,60.71,-4.51,True,1,1372,-57.97,-65548.37,79534.84,13986.47
8119,1960-06-13,57.99,0.02,0.04,60.71,-4.48,True,1,1373,-57.99,-65606.36,79620.27,14013.91
8120,1960-06-14,57.91,-0.08,-0.14,60.71,-4.61,True,1,1374,-57.91,-65664.27,79568.34,13904.07
8121,1960-06-15,57.57,-0.34,-0.59,60.71,-5.17,True,1,1375,-57.57,-65721.84,79158.75,13436.91
8122,1960-06-16,57.5,-0.07,-0.12,60.71,-5.29,True,1,1376,-57.5,-65779.34,79120.0,13340.66
8123,1960-06-17,57.44,-0.06,-0.1,60.71,-5.39,True,1,1377,-57.44,-65836.78,79094.88,13258.1
8124,1960-06-20,57.16,-0.28,-0.49,60.71,-5.85,True,1,1378,-57.16,-65893.94,78766.48,12872.54
8125,1960-06-21,57.11,-0.05,-0.09,60.71,-5.93,True,1,1379,-57.11,-65951.05,78754.69,12803.64
8126,1960-06-22,57.28,0.17,0.3,60.71,-5.65,True,1,1380,-57.28,-66008.33,79046.4,13038.07
8127,1960-06-23,57.59,0.31,0.54,60.71,-5.14,True,1,1381,-57.59,-66065.92,79531.79,13465.87
8128,1960-06-24,57.68,0.09,0.16,60.71,-4.99,True,1,1382,-57.68,-66123.6,79713.76,13590.16
8129,1960-06-27,57.33,-0.35,-0.61,60.71,-5.57,True,1,1383,-57.33,-66180.93,79287.39,13106.46
8130,1960-06-28,56.94,-0.39,-0.68,60.71,-6.21,True,1,1384,-56.94,-66237.87,78804.96,12567.09
8131,1960-06-29,56.94,0.0,0.0,60.71,-6.21,True,1,1385,-56.94,-66294.81,78861.9,12567.09
8132,1960-06-30,56.92,-0.02,-0.04,60.71,-6.24,True,1,1386,-56.92,-66351.73,78891.12,12539.39
8133,1960-07-01,57.06,0.14,0.25,60.71,-6.01,True,1,1387,-57.06,-66408.79,79142.22,12733.43
8134,1960-07-05,57.02,-0.04,-0.07,60.71,-6.08,True,1,1388,-57.02,-66465.81,79143.76,12677.95
8135,1960-07-06,56.94,-0.08,-0.14,60.71,-6.21,True,1,1389,-56.94,-66522.75,79089.66,12566.91
8136,1960-07-07,57.24,0.3,0.53,60.71,-5.72,True,1,1390,-57.24,-66579.99,79563.6,12983.61
8137,1960-07-08,57.38,0.14,0.24,60.71,-5.48,True,1,1391,-57.38,-66637.37,79815.58,13178.21
8138,1960-07-11,56.87,-0.51,-0.89,60.71,-6.32,True,1,1392,-56.87,-66694.24,79163.04,12468.8
8139,1960-07-12,56.25,-0.62,-1.09,60.71,-7.35,True,1,1393,-56.25,-66750.49,78356.25,11605.76
8140,1960-07-13,56.1,-0.15,-0.27,60.71,-7.59,True,1,1394,-56.1,-66806.59,78203.4,11396.81
8141,1960-07-14,56.12,0.02,0.04,60.71,-7.56,True,1,1395,-56.12,-66862.71,78287.4,11424.69
8142,1960-07-15,56.05,-0.07,-0.12,60.71,-7.68,True,1,1396,-56.05,-66918.76,78245.8,11327.04
8143,1960-07-18,55.7,-0.35,-0.62,60.71,-8.25,True,1,1397,-55.7,-66974.46,77812.9,10838.44
8144,1960-07-19,55.7,0.0,0.0,60.71,-8.25,True,1,1398,-55.7,-67030.16,77868.6,10838.44
8145,1960-07-20,55.61,-0.09,-0.16,60.71,-8.4,True,1,1399,-55.61,-67085.77,77798.39,10712.62
8146,1960-07-21,55.1,-0.51,-0.92,60.71,-9.24,True,1,1400,-55.1,-67140.87,77140.0,9999.13
8147,1960-07-22,54.72,-0.38,-0.69,60.71,-9.87,True,1,1401,-54.72,-67195.59,76662.72,9467.13
8148,1960-07-25,54.18,-0.54,-0.99,60.71,-10.76,True,1,1402,-54.18,-67249.77,75960.36,8710.59
8149,1960-07-26,54.51,0.33,0.61,60.71,-10.21,True,1,1403,-54.51,-67304.28,76477.53,9173.25
8150,1960-07-27,54.17,-0.34,-0.62,60.71,-10.77,True,1,1404,-54.17,-67358.45,76054.68,8696.23
8151,1960-07-28,54.57,0.4,0.74,60.71,-10.11,True,1,1405,-54.57,-67413.02,76670.85,9257.83
8152,1960-07-29,55.51,0.94,1.72,60.71,-8.56,True,1,1406,-55.51,-67468.53,78047.06,10578.53
8153,1960-08-01,55.53,0.02,0.04,60.71,-8.53,True,1,1407,-55.53,-67524.06,78130.71,10606.65
8154,1960-08-02,55.04,-0.49,-0.88,60.71,-9.34,True,1,1408,-55.04,-67579.1,77496.32,9917.22
8155,1960-08-03,54.72,-0.32,-0.58,60.71,-9.87,True,1,1409,-54.72,-67633.82,77100.48,9466.66
8156,1960-08-04,54.89,0.17,0.31,60.71,-9.59,True,1,1410,-54.89,-67688.71,77394.9,9706.19
8157,1960-08-05,55.44,0.55,1.0,60.71,-8.68,True,1,1411,-55.44,-67744.15,78225.84,10481.69
8158,1960-08-08,55.52,0.08,0.14,60.71,-8.55,True,1,1412,-55.52,-67799.67,78394.24,10594.57
8159,1960-08-09,55.84,0.32,0.58,60.71,-8.02,True,1,1413,-55.84,-67855.51,78901.92,11046.41
8160,1960-08-10,56.07,0.23,0.41,60.71,-7.64,True,1,1414,-56.07,-67911.58,79282.98,11371.4
8161,1960-08-11,56.28,0.21,0.38,60.71,-7.3,True,1,1415,-56.28,-67967.86,79636.2,11668.34
8162,1960-08-12,56.66,0.38,0.68,60.71,-6.67,True,1,1416,-56.66,-68024.52,80230.56,12206.04
8163,1960-08-15,56.61,-0.05,-0.09,60.71,-6.75,True,1,1417,-56.61,-68081.13,80216.37,12135.24
8164,1960-08-16,56.72,0.11,0.19,60.71,-6.57,True,1,1418,-56.72,-68137.85,80428.96,12291.11
8165,1960-08-17,56.84,0.12,0.21,60.71,-6.38,True,1,1419,-56.84,-68194.69,80655.96,12461.27
8166,1960-08-18,56.81,-0.03,-0.05,60.71,-6.42,True,1,1420,-56.81,-68251.5,80670.2,12418.7
8167,1960-08-19,57.01,0.2,0.35,60.71,-6.1,True,1,1421,-57.01,-68308.51,81011.21,12702.7
8168,1960-08-22,57.19,0.18,0.32,60.71,-5.8,True,1,1422,-57.19,-68365.7,81324.18,12958.48
8169,1960-08-23,57.75,0.56,0.98,60.71,-4.88,True,1,1423,-57.75,-68423.45,82178.25,13754.8
8170,1960-08-24,58.07,0.32,0.55,60.71,-4.35,True,1,1424,-58.07,-68481.52,82691.68,14210.16
8171,1960-08-25,57.79,-0.28,-0.48,60.71,-4.81,True,1,1425,-57.79,-68539.31,82350.75,13811.44
8172,1960-08-26,57.6,-0.19,-0.33,60.71,-5.12,True,1,1426,-57.6,-68596.91,82137.6,13540.69
8173,1960-08-29,57.44,-0.16,-0.28,60.71,-5.39,True,1,1427,-57.44,-68654.35,81966.88,13312.53
8174,1960-08-30,56.84,-0.6,-1.04,60.71,-6.38,True,1,1428,-56.84,-68711.19,81167.52,12456.33
8175,1960-08-31,56.96,0.12,0.21,60.71,-6.18,True,1,1429,-56.96,-68768.15,81395.84,12627.69
8176,1960-09-01,57.09,0.13,0.23,60.71,-5.96,True,1,1430,-57.09,-68825.24,81638.7,12813.46
8177,1960-09-02,57.0,-0.09,-0.16,60.71,-6.11,True,1,1431,-57.0,-68882.24,81567.0,12684.76
8178,1960-09-06,56.49,-0.51,-0.9,60.71,-6.95,True,1,1432,-56.49,-68938.73,80893.68,11954.95
8179,1960-09-07,55.79,-0.7,-1.24,60.71,-8.1,True,1,1433,-55.79,-68994.52,79947.07,10952.55
8180,1960-09-08,55.74,-0.05,-0.09,60.71,-8.19,True,1,1434,-55.74,-69050.26,79931.16,10880.9
8181,1960-09-09,56.11,0.37,0.66,60.71,-7.58,True,1,1435,-56.11,-69106.37,80517.85,11411.48
8182,1960-09-12,55.72,-0.39,-0.7,60.71,-8.22,True,1,1436,-55.72,-69162.09,80013.92,10851.83
8183,1960-09-13,55.83,0.11,0.2,60.71,-8.04,True,1,1437,-55.83,-69217.92,80227.71,11009.79
8184,1960-09-14,55.44,-0.39,-0.7,60.71,-8.68,True,1,1438,-55.44,-69273.36,79722.72,10449.36
8185,1960-09-15,55.22,-0.22,-0.4,60.71,-9.04,True,1,1439,-55.22,-69328.58,79461.58,10133.0
8186,1960-09-16,55.11,-0.11,-0.2,60.71,-9.22,True,1,1440,-55.11,-69383.69,79358.4,9974.71
8187,1960-09-19,53.86,-1.25,-2.27,60.71,-11.28,True,1,1441,-53.86,-69437.55,77612.26,8174.71
8188,1960-09-20,54.01,0.15,0.28,60.71,-11.04,True,1,1442,-54.01,-69491.56,77882.42,8390.86
8189,1960-09-21,54.57,0.56,1.04,60.71,-10.11,True,1,1443,-54.57,-69546.13,78744.51,9198.38
8190,1960-09-22,54.36,-0.21,-0.38,60.71,-10.46,True,1,1444,-54.36,-69600.49,78495.84,8895.35
8191,1960-09-23,53.9,-0.46,-0.85,60.71,-11.22,True,1,1445,-53.9,-69654.39,77885.5,8231.11
8192,1960-09-26,53.06,-0.84,-1.56,60.71,-12.6,True,1,1446,-53.06,-69707.45,76724.76,7017.31
8193,1960-09-27,52.94,-0.12,-0.23,60.71,-12.8,True,1,1447,-52.94,-69760.39,76604.18,6843.79
8194,1960-09-28,52.48,-0.46,-0.87,60.71,-13.56,True,1,1448,-52.48,-69812.87,75991.04,6178.17
8195,1960-09-29,52.62,0.14,0.27,60.71,-13.33,True,1,1449,-52.62,-69865.49,76246.38,6380.89
8196,1960-09-30,53.52,0.9,1.71,60.71,-11.84,True,1,1450,-53.52,-69919.01,77604.0,7684.99
8197,1960-10-03,53.36,-0.16,-0.3,60.71,-12.11,True,1,1451,-53.36,-69972.37,77425.36,7452.99
8198,1960-10-04,52.99,-0.37,-0.69,60.71,-12.72,True,1,1452,-52.99,-70025.36,76941.48,6916.12
8199,1960-10-05,53.39,0.4,0.76,60.71,-12.06,True,1,1453,-53.39,-70078.75,77575.67,7496.92
8200,1960-10-06,53.72,0.33,0.62,60.71,-11.51,True,1,1454,-53.72,-70132.47,78108.88,7976.41
8201,1960-10-07,54.03,0.31,0.58,60.71,-11.0,True,1,1455,-54.03,-70186.5,78613.65,8427.15
8202,1960-10-10,54.14,0.11,0.2,60.71,-10.82,True,1,1456,-54.14,-70240.64,78827.84,8587.2
8203,1960-10-11,54.22,0.08,0.15,60.71,-10.69,True,1,1457,-54.22,-70294.86,78998.54,8703.68
8204,1960-10-12,54.15,-0.07,-0.13,60.71,-10.8,True,1,1458,-54.15,-70349.01,78950.7,8601.69
8205,1960-10-13,54.57,0.42,0.78,60.71,-10.11,True,1,1459,-54.57,-70403.58,79617.63,9214.05
8206,1960-10-14,54.86,0.29,0.53,60.71,-9.64,True,1,1460,-54.86,-70458.44,80095.6,9637.16
8207,1960-10-17,54.63,-0.23,-0.42,60.71,-10.02,True,1,1461,-54.63,-70513.07,79814.43,9301.36
8208,1960-10-18,54.35,-0.28,-0.51,60.71,-10.48,True,1,1462,-54.35,-70567.42,79459.7,8892.28
8209,1960-10-19,54.25,-0.1,-0.18,60.71,-10.64,True,1,1463,-54.25,-70621.67,79367.75,8746.08
8210,1960-10-20,53.86,-0.39,-0.72,60.71,-11.28,True,1,1464,-53.86,-70675.53,78851.04,8175.51
8211,1960-10-21,53.72,-0.14,-0.26,60.71,-11.51,True,1,1465,-53.72,-70729.25,78699.8,7970.55
8212,1960-10-24,52.7,-1.02,-1.9,60.71,-13.19,True,1,1466,-52.7,-70781.95,77258.2,6476.25
8213,1960-10-25,52.2,-0.5,-0.95,60.71,-14.02,True,1,1467,-52.2,-70834.15,76577.4,5743.25
8214,1960-10-26,53.05,0.85,1.63,60.71,-12.62,True,1,1468,-53.05,-70887.2,77877.4,6990.2
8215,1960-10-27,53.62,0.57,1.07,60.71,-11.68,True,1,1469,-53.62,-70940.82,78767.78,7826.96
8216,1960-10-28,53.41,-0.21,-0.39,60.71,-12.02,True,1,1470,-53.41,-70994.23,78512.7,7518.47
8217,1960-10-31,53.39,-0.02,-0.04,60.71,-12.06,True,1,1471,-53.39,-71047.62,78536.69,7489.07
8218,1960-11-01,53.94,0.55,1.03,60.71,-11.15,True,1,1472,-53.94,-71101.56,79399.68,8298.12
8219,1960-11-02,54.22,0.28,0.52,60.71,-10.69,True,1,1473,-54.22,-71155.78,79866.06,8710.28
8220,1960-11-03,54.43,0.21,0.39,60.71,-10.34,True,1,1474,-54.43,-71210.21,80229.82,9019.61
8221,1960-11-04,54.9,0.47,0.86,60.71,-9.57,True,1,1475,-54.9,-71265.11,80977.5,9712.39
8222,1960-11-07,55.11,0.21,0.38,60.71,-9.22,True,1,1476,-55.11,-71320.22,81342.36,10022.14
8223,1960-11-09,55.35,0.24,0.44,60.71,-8.83,True,1,1477,-55.35,-71375.57,81751.95,10376.38
8224,1960-11-10,56.43,1.08,1.95,60.71,-7.05,True,1,1478,-56.43,-71432.0,83403.54,11971.54
8225,1960-11-11,55.87,-0.56,-0.99,60.71,-7.97,True,1,1479,-55.87,-71487.87,82631.73,11143.86
8226,1960-11-14,55.59,-0.28,-0.5,60.71,-8.43,True,1,1480,-55.59,-71543.46,82273.2,10729.74
8227,1960-11-15,55.81,0.22,0.4,60.71,-8.07,True,1,1481,-55.81,-71599.27,82654.61,11055.34
8228,1960-11-16,55.7,-0.11,-0.2,60.71,-8.25,True,1,1482,-55.7,-71654.97,82547.4,10892.43
8229,1960-11-17,55.55,-0.15,-0.27,60.71,-8.5,True,1,1483,-55.55,-71710.52,82380.65,10670.13
8230,1960-11-18,55.82,0.27,0.49,60.71,-8.06,True,1,1484,-55.82,-71766.34,82836.88,11070.54
8231,1960-11-21,55.93,0.11,0.2,60.71,-7.87,True,1,1485,-55.93,-71822.27,83056.05,11233.78
8232,1960-11-22,55.72,-0.21,-0.38,60.71,-8.22,True,1,1486,-55.72,-71877.99,82799.92,10921.93
8233,1960-11-23,55.8,0.08,0.14,60.71,-8.09,True,1,1487,-55.8,-71933.79,82974.6,11040.81
8234,1960-11-25,56.13,0.33,0.59,60.71,-7.54,True,1,1488,-56.13,-71989.92,83521.44,11531.52
8235,1960-11-28,56.03,-0.1,-0.18,60.71,-7.71,True,1,1489,-56.03,-72045.95,83428.67,11382.72
8236,1960-11-29,55.83,-0.2,-0.36,60.71,-8.04,True,1,1490,-55.83,-72101.78,83186.7,11084.92
8237,1960-11-30,55.54,-0.29,-0.52,60.71,-8.52,True,1,1491,-55.54,-72157.32,82810.14,10652.82
8238,1960-12-01,55.3,-0.24,-0.43,60.71,-8.91,True,1,1492,-55.3,-72212.62,82507.6,10294.98
8239,1960-12-02,55.39,0.09,0.16,60.71,-8.76,True,1,1493,-55.39,-72268.01,82697.27,10429.26
8240,1960-12-05,55.31,-0.08,-0.14,60.71,-8.9,True,1,1494,-55.31,-72323.32,82633.14,10309.82
8241,1960-12-06,55.47,0.16,0.29,60.71,-8.63,True,1,1495,-55.47,-72378.79,82927.65,10548.86
8242,1960-12-07,56.02,0.55,0.99,60.71,-7.72,True,1,1496,-56.02,-72434.81,83805.92,11371.11
8243,1960-12-08,56.15,0.13,0.23,60.71,-7.51,True,1,1497,-56.15,-72490.96,84056.55,11565.59
8244,1960-12-09,56.65,0.5,0.89,60.71,-6.69,True,1,1498,-56.65,-72547.61,84861.7,12314.09
8245,1960-12-12,56.85,0.2,0.35,60.71,-6.36,True,1,1499,-56.85,-72604.46,85218.15,12613.69
8246,1960-12-13,56.88,0.03,0.05,60.71,-6.31,True,1,1500,-56.88,-72661.34,85320.0,12658.66
8247,1960-12-14,56.84,-0.04,-0.07,60.71,-6.38,True,1,1501,-56.84,-72718.18,85316.84,12598.66
8248,1960-12-15,56.68,-0.16,-0.28,60.71,-6.64,True,1,1502,-56.68,-72774.86,85133.36,12358.5
8249,1960-12-16,57.2,0.52,0.92,60.71,-5.78,True,1,1503,-57.2,-72832.06,85971.6,13139.54
8250,1960-12-19,57.13,-0.07,-0.12,60.71,-5.9,True,1,1504,-57.13,-72889.19,85923.52,13034.33
8251,1960-12-20,57.09,-0.04,-0.07,60.71,-5.96,True,1,1505,-57.09,-72946.28,85920.45,12974.17
8252,1960-12-21,57.55,0.46,0.81,60.71,-5.2,True,1,1506,-57.55,-73003.83,86670.3,13666.47
8253,1960-12-22,57.39,-0.16,-0.28,60.71,-5.47,True,1,1507,-57.39,-73061.22,86486.73,13425.51
8254,1960-12-23,57.44,0.05,0.09,60.71,-5.39,True,1,1508,-57.44,-73118.66,86619.52,13500.86
8255,1960-12-27,57.52,0.08,0.14,60.71,-5.25,True,1,1509,-57.52,-73176.18,86797.68,13621.5
8256,1960-12-28,57.78,0.26,0.45,60.71,-4.83,True,1,1510,-57.78,-73233.96,87247.8,14013.84
8257,1960-12-29,58.05,0.27,0.47,60.71,-4.38,True,1,1511,-58.05,-73292.01,87713.55,14421.54
8258,1960-12-30,58.11,0.06,0.1,60.71,-4.28,True,1,1512,-58.11,-73350.12,87862.32,14512.2
8259,1961-01-03,57.57,-0.54,-0.93,60.71,-5.17,True,1,1513,-57.57,-73407.69,87103.41,13695.72
8260,1961-01-04,58.36,0.79,1.37,60.71,-3.87,True,1,1514,-58.36,-73466.05,88357.04,14890.99
8261,1961-01-05,58.57,0.21,0.36,60.71,-3.52,True,1,1515,-58.57,-73524.62,88733.55,15208.93
8262,1961-01-06,58.4,-0.17,-0.29,60.71,-3.8,True,1,1516,-58.4,-73583.02,88534.4,14951.38
8263,1961-01-09,58.81,0.41,0.7,60.71,-3.13,True,1,1517,-58.81,-73641.83,89214.77,15572.94
8264,1961-01-10,58.97,0.16,0.27,60.71,-2.87,True,1,1518,-58.97,-73700.8,89516.46,15815.66
8265,1961-01-11,59.14,0.17,0.29,60.71,-2.59,True,1,1519,-59.14,-73759.94,89833.66,16073.72
8266,1961-01-12,59.32,0.18,0.3,60.71,-2.29,True,1,1520,-59.32,-73819.26,90166.4,16347.14
8267,1961-01-13,59.6,0.28,0.47,60.71,-1.83,True,1,1521,-59.6,-73878.86,90651.6,16772.74
8268,1961-01-16,59.58,-0.02,-0.03,60.71,-1.86,True,1,1522,-59.58,-73938.44,90680.76,16742.32
8269,1961-01-17,59.64,0.06,0.1,60.71,-1.76,True,1,1523,-59.64,-73998.08,90831.72,16833.64
8270,1961-01-18,59.68,0.04,0.07,60.71,-1.7,True,1,1524,-59.68,-74057.76,90952.32,16894.56
8271,1961-01-19,59.77,0.09,0.15,60.71,-1.55,True,1,1525,-59.77,-74117.53,91149.25,17031.72
8272,1961-01-20,59.96,0.19,0.32,60.71,-1.24,True,1,1526,-59.96,-74177.49,91498.96,17321.47
8273,1961-01-23,60.29,0.33,0.55,60.71,-0.69,True,1,1527,-60.29,-74237.78,92062.83,17825.05
8274,1961-01-24,60.45,0.16,0.26,60.71,-0.43,True,1,1528,-60.45,-74298.23,92367.6,18069.37
8275,1961-01-25,60.53,0.08,0.13,60.71,-0.3,True,1,1529,-60.53,-74358.76,92550.37,18191.61
8276,1961-01-26,60.62,0.09,0.15,60.71,-0.15,True,1,1530,-60.62,-74419.38,92748.6,18329.22
8277,1961-01-27,61.24,0.62,1.02,61.24,0.0,True,1,1531,-61.24,-74480.62,93758.44,19277.82
8278,1961-01-30,61.97,0.73,1.19,61.97,0.0,True,1,1532,-61.97,-74542.59,94938.04,20395.45
8279,1961-01-31,61.78,-0.19,-0.31,61.97,-0.31,True,1,1533,-61.78,-74604.37,94708.74,20104.37
8280,1961-02-01,61.9,0.12,0.19,61.97,-0.11,True,1,1534,-61.9,-74666.27,94954.6,20288.33
8281,1961-02-02,62.3,0.4,0.65,62.3,0.0,True,1,1535,-62.3,-74728.57,95630.5,20901.93
8282,1961-02-03,62.22,-0.08,-0.13,62.3,-0.13,True,1,1536,-62.22,-74790.79,95569.92,20779.13
8283,1961-02-06,61.76,-0.46,-0.74,62.3,-0.87,True,1,1537,-61.76,-74852.55,94925.12,20072.57
8284,1961-02-07,61.65,-0.11,-0.18,62.3,-1.04,True,1,1538,-61.65,-74914.2,94817.7,19903.5
8285,1961-02-08,62.21,0.56,0.91,62.3,-0.14,True,1,1539,-62.21,-74976.41,95741.19,20764.78
8286,1961-02-09,62.02,-0.19,-0.3,62.3,-0.45,True,1,1540,-62.02,-75038.43,95510.8,20472.37
8287,1961-02-10,61.5,-0.52,-0.84,62.3,-1.28,True,1,1541,-61.5,-75099.93,94771.5,19671.57
8288,1961-02-13,61.14,-0.36,-0.58,62.3,-1.86,True,1,1542,-61.14,-75161.07,94277.88,19116.81
8289,1961-02-14,61.41,0.27,0.44,62.3,-1.43,True,1,1543,-61.41,-75222.48,94755.63,19533.15
8290,1961-02-15,61.92,0.51,0.83,62.3,-0.61,True,1,1544,-61.92,-75284.4,95604.48,20320.08
8291,1961-02-16,62.3,0.38,0.61,62.3,0.0,True,1,1545,-62.3,-75346.7,96253.5,20906.8
8292,1961-02-17,62.1,-0.2,-0.32,62.3,-0.32,True,1,1546,-62.1,-75408.8,96006.6,20597.8
8293,1961-02-20,62.32,0.22,0.35,62.32,0.0,True,1,1547,-62.32,-75471.12,96409.04,20937.92
8294,1961-02-21,62.36,0.04,0.06,62.36,0.0,True,1,1548,-62.36,-75533.48,96533.28,20999.8
8295,1961-02-23,62.59,0.23,0.37,62.59,0.0,True,1,1549,-62.59,-75596.07,96951.91,21355.84
8296,1961-02-24,62.84,0.25,0.4,62.84,0.0,True,1,1550,-62.84,-75658.91,97402.0,21743.09
8297,1961-02-27,63.3,0.46,0.73,63.3,0.0,True,1,1551,-63.3,-75722.21,98178.3,22456.09
8298,1961-02-28,63.44,0.14,0.22,63.44,0.0,True,1,1552,-63.44,-75785.65,98458.88,22673.23
8299,1961-03-01,63.43,-0.01,-0.02,63.44,-0.02,True,1,1553,-63.43,-75849.08,98506.79,22657.71
8300,1961-03-02,63.85,0.42,0.66,63.85,0.0,True,1,1554,-63.85,-75912.93,99222.9,23309.97
8301,1961-03-03,63.95,0.1,0.16,63.95,0.0,True,1,1555,-63.95,-75976.88,99442.25,23465.37
8302,1961-03-06,64.05,0.1,0.16,64.05,0.0,True,1,1556,-64.05,-76040.93,99661.8,23620.87
8303,1961-03-07,63.47,-0.58,-0.91,64.05,-0.91,True,1,1557,-63.47,-76104.4,98822.79,22718.39
8304,1961-03-08,63.44,-0.03,-0.05,64.05,-0.95,True,1,1558,-63.44,-76167.84,98839.52,22671.68
8305,1961-03-09,63.5,0.06,0.1,64.05,-0.86,True,1,1559,-63.5,-76231.34,98996.5,22765.16
8306,1961-03-10,63.48,-0.02,-0.03,64.05,-0.89,True,1,1560,-63.48,-76294.82,99028.8,22733.98
8307,1961-03-13,63.66,0.18,0.28,64.05,-0.61,True,1,1561,-63.66,-76358.48,99373.26,23014.78
8308,1961-03-14,63.38,-0.28,-0.44,64.05,-1.05,True,1,1562,-63.38,-76421.86,98999.56,22577.7
8309,1961-03-15,63.57,0.19,0.3,64.05,-0.75,True,1,1563,-63.57,-76485.43,99359.91,22874.48
8310,1961-03-16,64.21,0.64,1.01,64.21,0.0,True,1,1564,-64.21,-76549.64,100424.44,23874.8
8311,1961-03-17,64.0,-0.21,-0.33,64.21,-0.33,True,1,1565,-64.0,-76613.64,100160.0,23546.36
8312,1961-03-20,64.86,0.86,1.34,64.86,0.0,True,1,1566,-64.86,-76678.5,101570.76,24892.26
8313,1961-03-21,64.74,-0.12,-0.18,64.86,-0.18,True,1,1567,-64.74,-76743.24,101447.58,24704.34
8314,1961-03-22,64.7,-0.04,-0.06,64.86,-0.25,True,1,1568,-64.7,-76807.94,101449.6,24641.66
8315,1961-03-23,64.53,-0.17,-0.26,64.86,-0.51,True,1,1569,-64.53,-76872.47,101247.57,24375.1
8316,1961-03-24,64.42,-0.11,-0.17,64.86,-0.68,True,1,1570,-64.42,-76936.89,101139.4,24202.51
8317,1961-03-27,64.35,-0.07,-0.11,64.86,-0.79,True,1,1571,-64.35,-77001.24,101093.85,24092.61
8318,1961-03-28,64.38,0.03,0.05,64.86,-0.74,True,1,1572,-64.38,-77065.62,101205.36,24139.74
8319,1961-03-29,64.93,0.55,0.85,64.93,0.0,True,1,1573,-64.93,-77130.55,102134.89,25004.34
8320,1961-03-30,65.06,0.13,0.2,65.06,0.0,True,1,1574,-65.06,-77195.61,102404.44,25208.83
8321,1961-04-03,65.6,0.54,0.83,65.6,0.0,True,1,1575,-65.6,-77261.21,103320.0,26058.79
8322,1961-04-04,65.66,0.06,0.09,65.66,0.0,True,1,1576,-65.66,-77326.87,103480.16,26153.29
8323,1961-04-05,65.46,-0.2,-0.3,65.66,-0.3,True,1,1577,-65.46,-77392.33,103230.42,25838.09
8324,1961-04-06,65.61,0.15,0.23,65.66,-0.08,True,1,1578,-65.61,-77457.94,103532.58,26074.64
8325,1961-04-07,65.96,0.35,0.53,65.96,0.0,True,1,1579,-65.96,-77523.9,104150.84,26626.94
8326,1961-04-10,66.53,0.57,0.86,66.53,0.0,True,1,1580,-66.53,-77590.43,105117.4,27526.97
8327,1961-04-11,66.62,0.09,0.14,66.62,0.0,True,1,1581,-66.62,-77657.05,105326.22,27669.17
8328,1961-04-12,66.31,-0.31,-0.46,66.62,-0.46,True,1,1582,-66.31,-77723.36,104902.42,27179.06
8329,1961-04-13,66.26,-0.05,-0.08,66.62,-0.54,True,1,1583,-66.26,-77789.62,104889.58,27099.96
8330,1961-04-14,66.37,0.11,0.17,66.62,-0.38,True,1,1584,-66.37,-77855.99,105130.08,27274.09
8331,1961-04-17,68.68,2.31,3.48,68.68,0.0,True,1,1585,-68.68,-77924.67,108857.8,30933.13
8332,1961-04-18,66.2,-2.48,-3.61,68.68,-3.61,True,1,1586,-66.2,-77990.87,104993.2,27002.33
8333,1961-04-19,65.81,-0.39,-0.59,68.68,-4.18,True,1,1587,-65.81,-78056.68,104440.47,26383.79
8334,1961-04-20,65.82,0.01,0.02,68.68,-4.16,True,1,1588,-65.82,-78122.5,104522.16,26399.66
8335,1961-04-21,65.77,-0.05,-0.08,68.68,-4.24,True,1,1589,-65.77,-78188.27,104508.53,26320.26
8336,1961-04-24,64.4,-1.37,-2.08,68.68,-6.23,True,1,1590,-64.4,-78252.67,102396.0,24143.33
8337,1961-04-25,65.3,0.9,1.4,68.68,-4.92,True,1,1591,-65.3,-78317.97,103892.3,25574.33
8338,1961-04-26,65.55,0.25,0.38,68.68,-4.56,True,1,1592,-65.55,-78383.52,104355.6,25972.08
8339,1961-04-27,65.46,-0.09,-0.14,68.68,-4.69,True,1,1593,-65.46,-78448.98,104277.78,25828.8
8340,1961-04-28,65.31,-0.15,-0.23,68.68,-4.91,True,1,1594,-65.31,-78514.29,104104.14,25589.85
8341,1961-05-01,65.17,-0.14,-0.21,68.68,-5.11,True,1,1595,-65.17,-78579.46,103946.15,25366.69
8342,1961-05-02,65.64,0.47,0.72,68.68,-4.43,True,1,1596,-65.64,-78645.1,104761.44,26116.34
8343,1961-05-03,66.18,0.54,0.82,68.68,-3.64,True,1,1597,-66.18,-78711.28,105689.46,26978.18
8344,1961-05-04,66.44,0.26,0.39,68.68,-3.26,True,1,1598,-66.44,-78777.72,106171.12,27393.4
8345,1961-05-05,66.52,0.08,0.12,68.68,-3.14,True,1,1599,-66.52,-78844.24,106365.48,27521.24
8346,1961-05-08,66.41,-0.11,-0.16,68.68,-3.3,True,1,1600,-66.41,-78910.65,106256.0,27345.35
8347,1961-05-09,66.47,0.06,0.09,68.68,-3.22,True,1,1601,-66.47,-78977.12,106418.47,27441.35
8348,1961-05-10,66.41,-0.06,-0.09,68.68,-3.3,True,1,1602,-66.41,-79043.53,106388.82,27345.29
8349,1961-05-11,66.39,-0.02,-0.03,68.68,-3.33,True,1,1603,-66.39,-79109.92,106423.17,27313.25
8350,1961-05-12,66.5,0.11,0.17,68.68,-3.17,True,1,1604,-66.5,-79176.42,106666.0,27489.58
8351,1961-05-15,66.83,0.33,0.5,68.68,-2.69,True,1,1605,-66.83,-79243.25,107262.15,28018.9
8352,1961-05-16,67.08,0.25,0.37,68.68,-2.33,True,1,1606,-67.08,-79310.33,107730.48,28420.15
8353,1961-05-17,67.39,0.31,0.46,68.68,-1.88,True,1,1607,-67.39,-79377.72,108295.73,28918.01
8354,1961-05-18,66.99,-0.4,-0.59,68.68,-2.46,True,1,1608,-66.99,-79444.71,107719.92,28275.21
8355,1961-05-19,67.27,0.28,0.42,68.68,-2.05,True,1,1609,-67.27,-79511.98,108237.43,28725.45
8356,1961-05-22,66.85,-0.42,-0.62,68.68,-2.66,True,1,1610,-66.85,-79578.83,107628.5,28049.67
8357,1961-05-23,66.68,-0.17,-0.25,68.68,-2.91,True,1,1611,-66.68,-79645.51,107421.48,27775.97
8358,1961-05-24,66.26,-0.42,-0.63,68.68,-3.52,True,1,1612,-66.26,-79711.77,106811.12,27099.35
8359,1961-05-25,66.01,-0.25,-0.38,68.68,-3.89,True,1,1613,-66.01,-79777.78,106474.13,26696.35
8360,1961-05-26,66.43,0.42,0.64,68.68,-3.28,True,1,1614,-66.43,-79844.21,107218.02,27373.81
8361,1961-05-31,66.56,0.13,0.2,68.68,-3.09,True,1,1615,-66.56,-79910.77,107494.4,27583.63
8362,1961-06-01,66.56,0.0,0.0,68.68,-3.09,True,1,1616,-66.56,-79977.33,107560.96,27583.63
8363,1961-06-02,66.73,0.17,0.26,68.68,-2.84,True,1,1617,-66.73,-80044.06,107902.41,27858.35
8364,1961-06-05,67.08,0.35,0.52,68.68,-2.33,True,1,1618,-67.08,-80111.14,108535.44,28424.3
8365,1961-06-06,66.89,-0.19,-0.28,68.68,-2.61,True,1,1619,-66.89,-80178.03,108294.91,28116.88
8366,1961-06-07,65.64,-1.25,-1.87,68.68,-4.43,True,1,1620,-65.64,-80243.67,106336.8,26093.13
8367,1961-06-08,66.67,1.03,1.57,68.68,-2.93,True,1,1621,-66.67,-80310.34,108072.07,27761.73
8368,1961-06-09,66.66,-0.01,-0.02,68.68,-2.94,True,1,1622,-66.66,-80377.0,108122.52,27745.52
8369,1961-06-12,66.15,-0.51,-0.76,68.68,-3.68,True,1,1623,-66.15,-80443.15,107361.45,26918.3
8370,1961-06-13,65.8,-0.35,-0.53,68.68,-4.19,True,1,1624,-65.8,-80508.95,106859.2,26350.25
8371,1961-06-14,65.98,0.18,0.27,68.68,-3.93,True,1,1625,-65.98,-80574.93,107217.5,26642.57
8372,1961-06-15,65.69,-0.29,-0.44,68.68,-4.35,True,1,1626,-65.69,-80640.62,106811.94,26171.32
8373,1961-06-16,65.18,-0.51,-0.78,68.68,-5.1,True,1,1627,-65.18,-80705.8,106047.86,25342.06
8374,1961-06-19,64.58,-0.6,-0.92,68.68,-5.97,True,1,1628,-64.58,-80770.38,105136.24,24365.86
8375,1961-06-20,65.15,0.57,0.88,68.68,-5.14,True,1,1629,-65.15,-80835.53,106129.35,25293.82
8376,1961-06-21,65.14,-0.01,-0.02,68.68,-5.15,True,1,1630,-65.14,-80900.67,106178.2,25277.53
8377,1961-06-22,64.9,-0.24,-0.37,68.68,-5.5,True,1,1631,-64.9,-80965.57,105851.9,24886.33
8378,1961-06-23,65.16,0.26,0.4,68.68,-5.12,True,1,1632,-65.16,-81030.73,106341.12,25310.39
8379,1961-06-26,64.47,-0.69,-1.06,68.68,-6.13,True,1,1633,-64.47,-81095.2,105279.51,24184.31
8380,1961-06-27,64.47,0.0,0.0,68.68,-6.13,True,1,1634,-64.47,-81159.67,105343.98,24184.31
8381,1961-06-28,64.59,0.12,0.19,68.68,-5.96,True,1,1635,-64.59,-81224.26,105604.65,24380.39
8382,1961-06-29,64.52,-0.07,-0.11,68.68,-6.06,True,1,1636,-64.52,-81288.78,105554.72,24265.94
8383,1961-06-30,64.64,0.12,0.19,68.68,-5.88,True,1,1637,-64.64,-81353.42,105815.68,24462.26
8384,1961-07-03,65.21,0.57,0.88,68.68,-5.05,True,1,1638,-65.21,-81418.63,106813.98,25395.35
8385,1961-07-05,65.63,0.42,0.64,68.68,-4.44,True,1,1639,-65.63,-81484.26,107567.57,26083.31
8386,1961-07-06,65.81,0.18,0.27,68.68,-4.18,True,1,1640,-65.81,-81550.07,107928.4,26378.33
8387,1961-07-07,65.77,-0.04,-0.06,68.68,-4.24,True,1,1641,-65.77,-81615.84,107928.57,26312.73
8388,1961-07-10,65.71,-0.06,-0.09,68.68,-4.32,True,1,1642,-65.71,-81681.55,107895.82,26214.27
8389,1961-07-11,65.69,-0.02,-0.03,68.68,-4.35,True,1,1643,-65.69,-81747.24,107928.67,26181.43
8390,1961-07-12,65.32,-0.37,-0.56,68.68,-4.89,True,1,1644,-65.32,-81812.56,107386.08,25573.52
8391,1961-07-13,64.86,-0.46,-0.7,68.68,-5.56,True,1,1645,-64.86,-81877.42,106694.7,24817.28
8392,1961-07-14,65.28,0.42,0.65,68.68,-4.95,True,1,1646,-65.28,-81942.7,107450.88,25508.18
8393,1961-07-17,64.79,-0.49,-0.75,68.68,-5.66,True,1,1647,-64.79,-82007.49,106709.13,24701.64
8394,1961-07-18,64.41,-0.38,-0.59,68.68,-6.22,True,1,1648,-64.41,-82071.9,106147.68,24075.78
8395,1961-07-19,64.7,0.29,0.45,68.68,-5.8,True,1,1649,-64.7,-82136.6,106690.3,24553.7
8396,1961-07-20,64.71,0.01,0.02,68.68,-5.78,True,1,1650,-64.71,-82201.31,106771.5,24570.19
8397,1961-07-21,64.86,0.15,0.23,68.68,-5.56,True,1,1651,-64.86,-82266.17,107083.86,24817.69
8398,1961-07-24,64.87,0.01,0.02,68.68,-5.55,True,1,1652,-64.87,-82331.04,107165.24,24834.2
8399,1961-07-25,65.23,0.36,0.56,68.68,-5.02,True,1,1653,-65.23,-82396.27,107825.19,25428.92
8400,1961-07-26,65.84,0.61,0.94,68.68,-4.14,True,1,1654,-65.84,-82462.11,108899.36,26437.25
8401,1961-07-27,66.61,0.77,1.17,68.68,-3.01,True,1,1655,-66.61,-82528.72,110239.55,27710.83
8402,1961-07-28,66.71,0.1,0.15,68.68,-2.87,True,1,1656,-66.71,-82595.43,110471.76,27876.33
8403,1961-07-31,66.76,0.05,0.08,68.68,-2.8,True,1,1657,-66.76,-82662.19,110621.32,27959.13
8404,1961-08-01,67.37,0.61,0.91,68.68,-1.91,True,1,1658,-67.37,-82729.56,111699.46,28969.9
8405,1961-08-02,66.94,-0.43,-0.64,68.68,-2.53,True,1,1659,-66.94,-82796.5,111053.46,28256.96
8406,1961-08-03,67.29,0.35,0.52,68.68,-2.02,True,1,1660,-67.29,-82863.79,111701.4,28837.61
8407,1961-08-04,67.68,0.39,0.58,68.68,-1.46,True,1,1661,-67.68,-82931.47,112416.48,29485.01
8408,1961-08-07,67.67,-0.01,-0.02,68.68,-1.47,True,1,1662,-67.67,-82999.14,112467.54,29468.4
8409,1961-08-08,67.82,0.15,0.22,68.68,-1.25,True,1,1663,-67.82,-83066.96,112784.66,29717.7
8410,1961-08-09,67.74,-0.08,-0.12,68.68,-1.37,True,1,1664,-67.74,-83134.7,112719.36,29584.66
8411,1961-08-10,67.95,0.21,0.31,68.68,-1.06,True,1,1665,-67.95,-83202.65,113136.75,29934.1
8412,1961-08-11,68.06,0.11,0.16,68.68,-0.9,True,1,1666,-68.06,-83270.71,113387.96,30117.25
8413,1961-08-14,67.72,-0.34,-0.5,68.68,-1.4,True,1,1667,-67.72,-83338.43,112889.24,29550.81
8414,1961-08-15,67.55,-0.17,-0.25,68.68,-1.64,True,1,1668,-67.55,-83405.98,112673.4,29267.42
8415,1961-08-16,67.73,0.18,0.27,68.68,-1.38,True,1,1669,-67.73,-83473.71,113041.37,29567.66
8416,1961-08-17,68.11,0.38,0.56,68.68,-0.83,True,1,1670,-68.11,-83541.82,113743.7,30201.88
8417,1961-08-18,68.29,0.18,0.26,68.68,-0.57,True,1,1671,-68.29,-83610.11,114112.59,30502.48
8418,1961-08-21,68.43,0.14,0.2,68.68,-0.36,True,1,1672,-68.43,-83678.54,114414.96,30736.42
8419,1961-08-22,68.44,0.01,0.02,68.68,-0.35,True,1,1673,-68.44,-83746.98,114500.12,30753.14
8420,1961-08-23,67.98,-0.46,-0.67,68.68,-1.02,True,1,1674,-67.98,-83814.96,113798.52,29983.56
8421,1961-08-24,67.59,-0.39,-0.57,68.68,-1.59,True,1,1675,-67.59,-83882.55,113213.25,29330.7
8422,1961-08-25,67.67,0.08,0.12,68.68,-1.47,True,1,1676,-67.67,-83950.22,113414.92,29464.7
8423,1961-08-28,67.7,0.03,0.04,68.68,-1.43,True,1,1677,-67.7,-84017.92,113532.9,29514.98
8424,1961-08-29,67.55,-0.15,-0.22,68.68,-1.64,True,1,1678,-67.55,-84085.47,113348.9,29263.43
8425,1961-08-30,67.81,0.26,0.38,68.68,-1.27,True,1,1679,-67.81,-84153.28,113852.99,29699.71
8426,1961-08-31,68.07,0.26,0.38,68.68,-0.89,True,1,1680,-68.07,-84221.35,114357.6,30136.25
8427,1961-09-01,68.19,0.12,0.18,68.68,-0.71,True,1,1681,-68.19,-84289.54,114627.39,30337.85
8428,1961-09-05,67.96,-0.23,-0.34,68.68,-1.05,True,1,1682,-67.96,-84357.5,114308.72,29951.22
8429,1961-09-06,68.46,0.5,0.74,68.68,-0.32,True,1,1683,-68.46,-84425.96,115218.18,30792.22
8430,1961-09-07,68.35,-0.11,-0.16,68.68,-0.48,True,1,1684,-68.35,-84494.31,115101.4,30607.09
8431,1961-09-08,67.88,-0.47,-0.69,68.68,-1.16,True,1,1685,-67.88,-84562.19,114377.8,29815.61
8432,1961-09-11,67.28,-0.6,-0.88,68.68,-2.04,True,1,1686,-67.28,-84629.47,113434.08,28804.61
8433,1961-09-12,67.96,0.68,1.01,68.68,-1.05,True,1,1687,-67.96,-84697.43,114648.52,29951.09
8434,1961-09-13,68.01,0.05,0.07,68.68,-0.98,True,1,1688,-68.01,-84765.44,114800.88,30035.44
8435,1961-09-14,67.53,-0.48,-0.71,68.68,-1.67,True,1,1689,-67.53,-84832.97,114058.17,29225.2
8436,1961-09-15,67.65,0.12,0.18,68.68,-1.5,True,1,1690,-67.65,-84900.62,114328.5,29427.88
8437,1961-09-18,67.21,-0.44,-0.65,68.68,-2.14,True,1,1691,-67.21,-84967.83,113652.11,28684.28
8438,1961-09-19,66.08,-1.13,-1.68,68.68,-3.79,True,1,1692,-66.08,-85033.91,111807.36,26773.45
8439,1961-09-20,66.96,0.88,1.33,68.68,-2.5,True,1,1693,-66.96,-85100.87,113363.28,28262.41
8440,1961-09-21,66.99,0.03,0.04,68.68,-2.46,True,1,1694,-66.99,-85167.86,113481.06,28313.2
8441,1961-09-22,66.72,-0.27,-0.4,68.68,-2.85,True,1,1695,-66.72,-85234.58,113090.4,27855.82
8442,1961-09-25,65.77,-0.95,-1.42,68.68,-4.24,True,1,1696,-65.77,-85300.35,111545.92,26245.57
8443,1961-09-26,65.78,0.01,0.02,68.68,-4.22,True,1,1697,-65.78,-85366.13,111628.66,26262.53
8444,1961-09-27,66.47,0.69,1.05,68.68,-3.22,True,1,1698,-66.47,-85432.6,112866.06,27433.46
8445,1961-09-28,66.58,0.11,0.16,68.68,-3.06,True,1,1699,-66.58,-85499.18,113119.42,27620.24
8446,1961-09-29,66.73,0.15,0.22,68.68,-2.84,True,1,1700,-66.73,-85565.91,113441.0,27875.09
8447,1961-10-02,66.77,0.04,0.06,68.68,-2.78,True,1,1701,-66.77,-85632.68,113575.77,27943.09
8448,1961-10-03,66.73,-0.04,-0.06,68.68,-2.84,True,1,1702,-66.73,-85699.41,113574.46,27875.05
8449,1961-10-04,67.18,0.45,0.67,68.68,-2.18,True,1,1703,-67.18,-85766.59,114407.54,28640.95
8450,1961-10-05,67.77,0.59,0.88,68.68,-1.32,True,1,1704,-67.77,-85834.36,115480.08,29645.72
8451,1961-10-06,66.97,-0.8,-1.18,68.68,-2.49,True,1,1705,-66.97,-85901.33,114183.85,28282.52
8452,1961-10-09,67.94,0.97,1.45,68.68,-1.08,True,1,1706,-67.94,-85969.27,115905.64,29936.37
8453,1961-10-10,68.11,0.17,0.25,68.68,-0.83,True,1,1707,-68.11,-86037.38,116263.77,30226.39
8454,1961-10-11,68.17,0.06,0.09,68.68,-0.74,True,1,1708,-68.17,-86105.55,116434.36,30328.81
8455,1961-10-12,68.16,-0.01,-0.02,68.68,-0.76,True,1,1709,-68.16,-86173.71,116485.44,30311.73
8456,1961-10-13,68.04,-0.12,-0.18,68.68,-0.93,True,1,1710,-68.04,-86241.75,116348.4,30106.65
8457,1961-10-16,67.85,-0.19,-0.28,68.68,-1.21,True,1,1711,-67.85,-86309.6,116091.35,29781.75
8458,1961-10-17,67.87,0.02,0.03,68.68,-1.18,True,1,1712,-67.87,-86377.47,116193.44,29815.97
8459,1961-10-18,68.21,0.34,0.5,68.68,-0.68,True,1,1713,-68.21,-86445.68,116843.73,30398.05
8460,1961-10-19,68.45,0.24,0.35,68.68,-0.34,True,1,1714,-68.45,-86514.13,117323.3,30809.17
8461,1961-10-20,68.0,-0.45,-0.66,68.68,-0.99,True,1,1715,-68.0,-86582.13,116620.0,30037.87
8462,1961-10-23,68.06,0.06,0.09,68.68,-0.9,True,1,1716,-68.06,-86650.19,116790.96,30140.77
8463,1961-10-24,67.98,-0.08,-0.12,68.68,-1.02,True,1,1717,-67.98,-86718.17,116721.66,30003.49
8464,1961-10-25,68.34,0.36,0.53,68.68,-0.5,True,1,1718,-68.34,-86786.51,117408.12,30621.61
8465,1961-10-26,68.46,0.12,0.18,68.68,-0.32,True,1,1719,-68.46,-86854.97,117682.74,30827.77
8466,1961-10-27,68.34,-0.12,-0.18,68.68,-0.5,True,1,1720,-68.34,-86923.31,117544.8,30621.49
8467,1961-10-30,68.42,0.08,0.12,68.68,-0.38,True,1,1721,-68.42,-86991.73,117750.82,30759.09
8468,1961-10-31,68.62,0.2,0.29,68.68,-0.09,True,1,1722,-68.62,-87060.35,118163.64,31103.29
8469,1961-11-01,68.73,0.11,0.16,68.73,0.0,True,1,1723,-68.73,-87129.08,118421.79,31292.71
8470,1961-11-02,69.11,0.38,0.55,69.11,0.0,True,1,1724,-69.11,-87198.19,119145.64,31947.45
8471,1961-11-03,69.47,0.36,0.52,69.47,0.0,True,1,1725,-69.47,-87267.66,119835.75,32568.09
8472,1961-11-06,70.01,0.54,0.78,70.01,0.0,True,1,1726,-70.01,-87337.67,120837.26,33499.59
8473,1961-11-08,70.87,0.86,1.23,70.87,0.0,True,1,1727,-70.87,-87408.54,122392.49,34983.95
8474,1961-11-09,70.77,-0.1,-0.14,70.87,-0.14,True,1,1728,-70.77,-87479.31,122290.56,34811.25
8475,1961-11-10,71.07,0.3,0.42,71.07,0.0,True,1,1729,-71.07,-87550.38,122880.03,35329.65
8476,1961-11-13,71.27,0.2,0.28,71.27,0.0,True,1,1730,-71.27,-87621.65,123297.1,35675.45
8477,1961-11-14,71.66,0.39,0.55,71.66,0.0,True,1,1731,-71.66,-87693.31,124043.46,36350.15
8478,1961-11-15,71.67,0.01,0.01,71.67,0.0,True,1,1732,-71.67,-87764.98,124132.44,36367.46
8479,1961-11-16,71.62,-0.05,-0.07,71.67,-0.07,True,1,1733,-71.62,-87836.6,124117.46,36280.86
8480,1961-11-17,71.62,0.0,0.0,71.67,-0.07,True,1,1734,-71.62,-87908.22,124189.08,36280.86
8481,1961-11-20,71.72,0.1,0.14,71.72,0.0,True,1,1735,-71.72,-87979.94,124434.2,36454.26
8482,1961-11-21,71.78,0.06,0.08,71.78,0.0,True,1,1736,-71.78,-88051.72,124610.08,36558.36
8483,1961-11-22,71.7,-0.08,-0.11,71.78,-0.11,True,1,1737,-71.7,-88123.42,124542.9,36419.48
8484,1961-11-24,71.84,0.14,0.2,71.84,0.0,True,1,1738,-71.84,-88195.26,124857.92,36662.66
8485,1961-11-27,71.85,0.01,0.01,71.85,0.0,True,1,1739,-71.85,-88267.11,124947.15,36680.04
8486,1961-11-28,71.75,-0.1,-0.14,71.85,-0.14,True,1,1740,-71.75,-88338.86,124845.0,36506.14
8487,1961-11-29,71.7,-0.05,-0.07,71.85,-0.21,True,1,1741,-71.7,-88410.56,124829.7,36419.14
8488,1961-11-30,71.32,-0.38,-0.53,71.85,-0.74,True,1,1742,-71.32,-88481.88,124239.44,35757.56
8489,1961-12-01,71.78,0.46,0.64,71.85,-0.1,True,1,1743,-71.78,-88553.66,125112.54,36558.88
8490,1961-12-04,72.01,0.23,0.32,72.01,0.0,True,1,1744,-72.01,-88625.67,125585.44,36959.77
8491,1961-12-05,71.93,-0.08,-0.11,72.01,-0.11,True,1,1745,-71.93,-88697.6,125517.85,36820.25
8492,1961-12-06,71.99,0.06,0.08,72.01,-0.03,True,1,1746,-71.99,-88769.59,125694.54,36924.95
8493,1961-12-07,71.7,-0.29,-0.4,72.01,-0.43,True,1,1747,-71.7,-88841.29,125259.9,36418.61
8494,1961-12-08,72.04,0.34,0.47,72.04,0.0,True,1,1748,-72.04,-88913.33,125925.92,37012.59
8495,1961-12-11,72.39,0.35,0.49,72.39,0.0,True,1,1749,-72.39,-88985.72,126610.11,37624.39
8496,1961-12-12,72.64,0.25,0.34,72.64,0.0,True,1,1750,-72.64,-89058.36,127120.0,38061.64
8497,1961-12-13,72.53,-0.11,-0.15,72.64,-0.15,True,1,1751,-72.53,-89130.89,127000.03,37869.14
8498,1961-12-14,71.98,-0.55,-0.76,72.64,-0.91,True,1,1752,-71.98,-89202.87,126108.96,36906.09
8499,1961-12-15,72.01,0.03,0.04,72.64,-0.87,True,1,1753,-72.01,-89274.88,126233.53,36958.65
8500,1961-12-18,71.76,-0.25,-0.35,72.64,-1.21,True,1,1754,-71.76,-89346.64,125867.04,36520.4
8501,1961-12-19,71.26,-0.5,-0.7,72.64,-1.9,True,1,1755,-71.26,-89417.9,125061.3,35643.4
8502,1961-12-20,71.12,-0.14,-0.2,72.64,-2.09,True,1,1756,-71.12,-89489.02,124886.72,35397.7
8503,1961-12-21,70.86,-0.26,-0.37,72.64,-2.45,True,1,1757,-70.86,-89559.88,124501.02,34941.14
8504,1961-12-22,70.91,0.05,0.07,72.64,-2.38,True,1,1758,-70.91,-89630.79,124659.78,35028.99
8505,1961-12-26,71.02,0.11,0.16,72.64,-2.23,True,1,1759,-71.02,-89701.81,124924.18,35222.37
8506,1961-12-27,71.65,0.63,0.89,72.64,-1.36,True,1,1760,-71.65,-89773.46,126104.0,36330.54
8507,1961-12-28,71.69,0.04,0.06,72.64,-1.31,True,1,1761,-71.69,-89845.15,126246.09,36400.94
8508,1961-12-29,71.55,-0.14,-0.2,72.64,-1.5,True,1,1762,-71.55,-89916.7,126071.1,36154.4
8509,1962-01-02,70.96,-0.59,-0.82,72.64,-2.31,True,1,1763,-70.96,-89987.66,125102.48,35114.82
8510,1962-01-03,71.13,0.17,0.24,72.64,-2.08,True,1,1764,-71.13,-90058.79,125473.32,35414.53
8511,1962-01-04,70.64,-0.49,-0.69,72.64,-2.75,True,1,1765,-70.64,-90129.43,124679.6,34550.17
8512,1962-01-05,69.66,-0.98,-1.39,72.64,-4.1,True,1,1766,-69.66,-90199.09,123019.56,32820.47
8513,1962-01-08,69.12,-0.54,-0.78,72.64,-4.85,True,1,1767,-69.12,-90268.21,122135.04,31866.83
8514,1962-01-09,69.15,0.03,0.04,72.64,-4.8,True,1,1768,-69.15,-90337.36,122257.2,31919.84
8515,1962-01-10,68.96,-0.19,-0.28,72.64,-5.07,True,1,1769,-68.96,-90406.32,121990.24,31583.92
8516,1962-01-11,69.37,0.41,0.6,72.64,-4.5,True,1,1770,-69.37,-90475.69,122784.9,32309.21
8517,1962-01-12,69.61,0.24,0.35,72.64,-4.17,True,1,1771,-69.61,-90545.3,123279.31,32734.01
8518,1962-01-15,69.47,-0.14,-0.2,72.64,-4.36,True,1,1772,-69.47,-90614.77,123100.84,32486.07
8519,1962-01-16,69.07,-0.4,-0.58,72.64,-4.92,True,1,1773,-69.07,-90683.84,122461.11,31777.27
8520,1962-01-17,68.32,-0.75,-1.09,72.64,-5.95,True,1,1774,-68.32,-90752.16,121199.68,30447.52
8521,1962-01-18,68.39,0.07,0.1,72.64,-5.85,True,1,1775,-68.39,-90820.55,121392.25,30571.7
8522,1962-01-19,68.75,0.36,0.53,72.64,-5.36,True,1,1776,-68.75,-90889.3,122100.0,31210.7
8523,1962-01-22,68.81,0.06,0.09,72.64,-5.27,True,1,1777,-68.81,-90958.11,122275.37,31317.26
8524,1962-01-23,68.29,-0.52,-0.76,72.64,-5.99,True,1,1778,-68.29,-91026.4,121419.62,30393.22
8525,1962-01-24,68.4,0.11,0.16,72.64,-5.84,True,1,1779,-68.4,-91094.8,121683.6,30588.8
8526,1962-01-25,68.35,-0.05,-0.07,72.64,-5.91,True,1,1780,-68.35,-91163.15,121663.0,30499.85
8527,1962-01-26,68.13,-0.22,-0.32,72.64,-6.21,True,1,1781,-68.13,-91231.28,121339.53,30108.25
8528,1962-01-29,67.9,-0.23,-0.34,72.64,-6.52,True,1,1782,-67.9,-91299.18,120997.8,29698.62
8529,1962-01-30,68.17,0.27,0.4,72.64,-6.15,True,1,1783,-68.17,-91367.35,121547.11,30179.76
8530,1962-01-31,68.84,0.67,0.98,72.64,-5.23,True,1,1784,-68.84,-91436.19,122810.56,31374.37
8531,1962-02-01,69.26,0.42,0.61,72.64,-4.65,True,1,1785,-69.26,-91505.45,123629.1,32123.65
8532,1962-02-02,69.81,0.55,0.79,72.64,-3.9,True,1,1786,-69.81,-91575.26,124680.66,33105.4
8533,1962-02-05,69.88,0.07,0.1,72.64,-3.8,True,1,1787,-69.88,-91645.14,124875.56,33230.42
8534,1962-02-06,69.96,0.08,0.11,72.64,-3.69,True,1,1788,-69.96,-91715.1,125088.48,33373.38
8535,1962-02-07,70.42,0.46,0.66,72.64,-3.06,True,1,1789,-70.42,-91785.52,125981.38,34195.86
8536,1962-02-08,70.58,0.16,0.23,72.64,-2.84,True,1,1790,-70.58,-91856.1,126338.2,34482.1
8537,1962-02-09,70.48,-0.1,-0.14,72.64,-2.97,True,1,1791,-70.48,-91926.58,126229.68,34303.1
8538,1962-02-12,70.46,-0.02,-0.03,72.64,-3.0,True,1,1792,-70.46,-91997.04,126264.32,34267.28
8539,1962-02-13,70.45,-0.01,-0.01,72.64,-3.02,True,1,1793,-70.45,-92067.49,126316.85,34249.36
8540,1962-02-14,70.42,-0.03,-0.04,72.64,-3.06,True,1,1794,-70.42,-92137.91,126333.48,34195.57
8541,1962-02-15,70.74,0.32,0.45,72.64,-2.62,True,1,1795,-70.74,-92208.65,126978.3,34769.65
8542,1962-02-16,70.59,-0.15,-0.21,72.64,-2.82,True,1,1796,-70.59,-92279.24,126779.64,34500.4
8543,1962-02-19,70.41,-0.18,-0.26,72.64,-3.07,True,1,1797,-70.41,-92349.65,126526.77,34177.12
8544,1962-02-20,70.66,0.25,0.36,72.64,-2.73,True,1,1798,-70.66,-92420.31,127046.68,34626.37
8545,1962-02-21,70.32,-0.34,-0.48,72.64,-3.19,True,1,1799,-70.32,-92490.63,126505.68,34015.05
8546,1962-02-23,70.16,-0.16,-0.23,72.64,-3.41,True,1,1800,-70.16,-92560.79,126288.0,33727.21
8547,1962-02-26,69.76,-0.4,-0.57,72.64,-3.96,True,1,1801,-69.76,-92630.55,125637.76,33007.21
8548,1962-02-27,69.89,0.13,0.19,72.64,-3.79,True,1,1802,-69.89,-92700.44,125941.78,33241.34
8549,1962-02-28,69.96,0.07,0.1,72.64,-3.69,True,1,1803,-69.96,-92770.4,126137.88,33367.48
8550,1962-03-01,70.2,0.24,0.34,72.64,-3.36,True,1,1804,-70.2,-92840.6,126640.8,33800.2
8551,1962-03-02,70.16,-0.04,-0.06,72.64,-3.41,True,1,1805,-70.16,-92910.76,126638.8,33728.04
8552,1962-03-05,70.01,-0.15,-0.21,72.64,-3.62,True,1,1806,-70.01,-92980.77,126438.06,33457.29
8553,1962-03-06,69.78,-0.23,-0.33,72.64,-3.94,True,1,1807,-69.78,-93050.55,126092.46,33041.91
8554,1962-03-07,69.69,-0.09,-0.13,72.64,-4.06,True,1,1808,-69.69,-93120.24,125999.52,32879.28
8555,1962-03-08,70.19,0.5,0.72,72.64,-3.37,True,1,1809,-70.19,-93190.43,126973.71,33783.28
8556,1962-03-09,70.42,0.23,0.33,72.64,-3.06,True,1,1810,-70.42,-93260.85,127460.2,34199.35
8557,1962-03-12,70.4,-0.02,-0.03,72.64,-3.08,True,1,1811,-70.4,-93331.25,127494.4,34163.15
8558,1962-03-13,70.6,0.2,0.28,72.64,-2.81,True,1,1812,-70.6,-93401.85,127927.2,34525.35
8559,1962-03-14,70.91,0.31,0.44,72.64,-2.38,True,1,1813,-70.91,-93472.76,128559.83,35087.07
8560,1962-03-15,71.06,0.15,0.21,72.64,-2.17,True,1,1814,-71.06,-93543.82,128902.84,35359.02
8561,1962-03-16,70.94,-0.12,-0.17,72.64,-2.34,True,1,1815,-70.94,-93614.76,128756.1,35141.34
8562,1962-03-19,70.85,-0.09,-0.13,72.64,-2.46,True,1,1816,-70.85,-93685.61,128663.6,34977.99
8563,1962-03-20,70.66,-0.19,-0.27,72.64,-2.73,True,1,1817,-70.66,-93756.27,128389.22,34632.95
8564,1962-03-21,70.51,-0.15,-0.21,72.64,-2.93,True,1,1818,-70.51,-93826.78,128187.18,34360.4
8565,1962-03-22,70.4,-0.11,-0.16,72.64,-3.08,True,1,1819,-70.4,-93897.18,128057.6,34160.42
8566,1962-03-23,70.45,0.05,0.07,72.64,-3.02,True,1,1820,-70.45,-93967.63,128219.0,34251.37
8567,1962-03-26,69.89,-0.56,-0.8,72.64,-3.79,True,1,1821,-69.89,-94037.52,127269.69,33232.17
8568,1962-03-27,69.7,-0.19,-0.27,72.64,-4.05,True,1,1822,-69.7,-94107.22,126993.4,32886.18
8569,1962-03-28,70.04,0.34,0.49,72.64,-3.58,True,1,1823,-70.04,-94177.26,127682.92,33505.66
8570,1962-03-29,70.01,-0.03,-0.04,72.64,-3.62,True,1,1824,-70.01,-94247.27,127698.24,33450.97
8571,1962-03-30,69.55,-0.46,-0.66,72.64,-4.25,True,1,1825,-69.55,-94316.82,126928.75,32611.93
8572,1962-04-02,69.37,-0.18,-0.26,72.64,-4.5,True,1,1826,-69.37,-94386.19,126669.62,32283.43
8573,1962-04-03,68.81,-0.56,-0.81,72.64,-5.27,True,1,1827,-68.81,-94455.0,125715.87,31260.87
8574,1962-04-04,68.49,-0.32,-0.46,72.64,-5.71,True,1,1828,-68.49,-94523.49,125199.72,30676.23
8575,1962-04-05,68.91,0.42,0.61,72.64,-5.14,True,1,1829,-68.91,-94592.4,126036.39,31443.99
8576,1962-04-06,68.84,-0.07,-0.1,72.64,-5.23,True,1,1830,-68.84,-94661.24,125977.2,31315.96
8577,1962-04-09,68.31,-0.53,-0.77,72.64,-5.96,True,1,1831,-68.31,-94729.55,125075.61,30346.06
8578,1962-04-10,68.56,0.25,0.37,72.64,-5.62,True,1,1832,-68.56,-94798.11,125601.92,30803.81
8579,1962-04-11,68.41,-0.15,-0.22,72.64,-5.82,True,1,1833,-68.41,-94866.52,125395.53,30529.01
8580,1962-04-12,67.9,-0.51,-0.75,72.64,-6.52,True,1,1834,-67.9,-94934.42,124528.6,29594.18
8581,1962-04-13,67.9,0.0,0.0,72.64,-6.52,True,1,1835,-67.9,-95002.32,124596.5,29594.18
8582,1962-04-16,67.6,-0.3,-0.44,72.64,-6.94,True,1,1836,-67.6,-95069.92,124113.6,29043.68
8583,1962-04-17,67.9,0.3,0.44,72.64,-6.52,True,1,1837,-67.9,-95137.82,124732.3,29594.48
8584,1962-04-18,68.27,0.37,0.55,72.64,-6.02,True,1,1838,-68.27,-95206.09,125480.26,30274.17
8585,1962-04-19,68.59,0.32,0.47,72.64,-5.58,True,1,1839,-68.59,-95274.68,126137.01,30862.33
8586,1962-04-23,68.53,-0.06,-0.09,72.64,-5.66,True,1,1840,-68.53,-95343.21,126095.2,30751.99
8587,1962-04-24,68.46,-0.07,-0.1,72.64,-5.75,True,1,1841,-68.46,-95411.67,126034.86,30623.19
8588,1962-04-25,67.71,-0.75,-1.1,72.64,-6.79,True,1,1842,-67.71,-95479.38,124721.82,29242.44
8589,1962-04-26,67.05,-0.66,-0.98,72.64,-7.7,True,1,1843,-67.05,-95546.43,123573.15,28026.72
8590,1962-04-27,66.3,-0.75,-1.12,72.64,-8.73,True,1,1844,-66.3,-95612.73,122257.2,26644.47
8591,1962-04-30,65.24,-1.06,-1.6,72.64,-10.19,True,1,1845,-65.24,-95677.97,120367.8,24689.83
8592,1962-05-01,65.7,0.46,0.7,72.64,-9.55,True,1,1846,-65.7,-95743.67,121282.2,25538.53
8593,1962-05-02,65.99,0.29,0.44,72.64,-9.15,True,1,1847,-65.99,-95809.66,121883.53,26073.87
8594,1962-05-03,66.53,0.54,0.82,72.64,-8.41,True,1,1848,-66.53,-95876.19,122947.44,27071.25
8595,1962-05-04,66.24,-0.29,-0.44,72.64,-8.81,True,1,1849,-66.24,-95942.43,122477.76,26535.33
8596,1962-05-07,66.02,-0.22,-0.33,72.64,-9.11,True,1,1850,-66.02,-96008.45,122137.0,26128.55
8597,1962-05-08,65.17,-0.85,-1.29,72.64,-10.28,True,1,1851,-65.17,-96073.62,120629.67,24556.05
8598,1962-05-09,64.26,-0.91,-1.4,72.64,-11.54,True,1,1852,-64.26,-96137.88,119009.52,22871.64
8599,1962-05-10,63.57,-0.69,-1.07,72.64,-12.49,True,1,1853,-63.57,-96201.45,117795.21,21593.76
8600,1962-05-11,62.65,-0.92,-1.45,72.64,-13.75,True,1,1854,-62.65,-96264.1,116153.1,19889.0
8601,1962-05-14,63.1,0.45,0.72,72.64,-13.13,True,1,1855,-63.1,-96327.2,117050.5,20723.3
8602,1962-05-15,64.29,1.19,1.89,72.64,-11.5,True,1,1856,-64.29,-96391.49,119322.24,22930.75
8603,1962-05-16,64.27,-0.02,-0.03,72.64,-11.52,True,1,1857,-64.27,-96455.76,119349.39,22893.63
8604,1962-05-17,63.93,-0.34,-0.53,72.64,-11.99,True,1,1858,-63.93,-96519.69,118781.94,22262.25
8605,1962-05-18,63.82,-0.11,-0.17,72.64,-12.14,True,1,1859,-63.82,-96583.51,118641.38,22057.87
8606,1962-05-21,63.59,-0.23,-0.36,72.64,-12.46,True,1,1860,-63.59,-96647.1,118277.4,21630.3
8607,1962-05-22,62.34,-1.25,-1.97,72.64,-14.18,True,1,1861,-62.34,-96709.44,116014.74,19305.3
8608,1962-05-23,61.11,-1.23,-1.97,72.64,-15.87,True,1,1862,-61.11,-96770.55,113786.82,17016.27
8609,1962-05-24,60.62,-0.49,-0.8,72.64,-16.55,True,1,1863,-60.62,-96831.17,112935.06,16103.89
8610,1962-05-25,59.47,-1.15,-1.9,72.64,-18.13,True,1,1864,-59.47,-96890.64,110852.08,13961.44
8611,1962-05-28,55.5,-3.97,-6.68,72.64,-23.6,True,1,1865,-55.5,-96946.14,103507.5,6561.36
8612,1962-05-29,58.08,2.58,4.65,72.64,-20.04,True,1,1866,-58.08,-97004.22,108377.28,11373.06
8613,1962-05-31,59.63,1.55,2.67,72.64,-17.91,True,1,1867,-59.63,-97063.85,111329.21,14265.36
8614,1962-06-01,59.38,-0.25,-0.42,72.64,-18.25,True,1,1868,-59.38,-97123.23,110921.84,13798.61
8615,1962-06-04,57.27,-2.11,-3.55,72.64,-21.16,True,1,1869,-57.27,-97180.5,107037.63,9857.13
8616,1962-06-05,57.57,0.3,0.52,72.64,-20.75,True,1,1870,-57.57,-97238.07,107655.9,10417.83
8617,1962-06-06,58.39,0.82,1.42,72.64,-19.62,True,1,1871,-58.39,-97296.46,109247.69,11951.23
8618,1962-06-07,58.4,0.01,0.02,72.64,-19.6,True,1,1872,-58.4,-97354.86,109324.8,11969.94
8619,1962-06-08,58.45,0.05,0.09,72.64,-19.54,True,1,1873,-58.45,-97413.31,109476.85,12063.54
8620,1962-06-11,57.82,-0.63,-1.08,72.64,-20.4,True,1,1874,-57.82,-97471.13,108354.68,10883.55
8621,1962-06-12,56.34,-1.48,-2.56,72.64,-22.44,True,1,1875,-56.34,-97527.47,105637.5,8110.03
8622,1962-06-13,55.5,-0.84,-1.49,72.64,-23.6,True,1,1876,-55.5,-97582.97,104118.0,6535.03
8623,1962-06-14,54.33,-1.17,-2.11,72.64,-25.21,True,1,1877,-54.33,-97637.3,101977.41,4340.11
8624,1962-06-15,55.89,1.56,2.87,72.64,-23.06,True,1,1878,-55.89,-97693.19,104961.42,7268.23
8625,1962-06-18,55.74,-0.15,-0.27,72.64,-23.26,True,1,1879,-55.74,-97748.93,104735.46,6986.53
8626,1962-06-19,55.54,-0.2,-0.36,72.64,-23.54,True,1,1880,-55.54,-97804.47,104415.2,6610.73
8627,1962-06-20,54.78,-0.76,-1.37,72.64,-24.59,True,1,1881,-54.78,-97859.25,103041.18,5181.93
8628,1962-06-21,53.59,-1.19,-2.17,72.64,-26.22,True,1,1882,-53.59,-97912.84,100856.38,2943.54
8629,1962-06-22,52.68,-0.91,-1.7,72.64,-27.48,True,1,1883,-52.68,-97965.52,99196.44,1230.92
8630,1962-06-25,52.45,-0.23,-0.44,72.64,-27.8,True,1,1884,-52.45,-98017.97,98815.8,797.83
8631,1962-06-26,52.32,-0.13,-0.25,72.64,-27.97,True,1,1885,-52.32,-98070.29,98623.2,552.91
8632,1962-06-27,52.6,0.28,0.54,72.64,-27.59,True,1,1886,-52.6,-98122.89,99203.6,1080.71
8633,1962-06-28,54.41,1.81,3.44,72.64,-25.1,True,1,1887,-54.41,-98177.3,102671.67,4494.37
8634,1962-06-29,54.75,0.34,0.62,72.64,-24.63,True,1,1888,-54.75,-98232.05,103368.0,5135.95
8635,1962-07-02,55.86,1.11,2.03,72.64,-23.1,True,1,1889,-55.86,-98287.91,105519.54,7231.63
8636,1962-07-03,56.49,0.63,1.13,72.64,-22.23,True,1,1890,-56.49,-98344.4,106766.1,8421.7
8637,1962-07-05,56.81,0.32,0.57,72.64,-21.79,True,1,1891,-56.81,-98401.21,107427.71,9026.5
8638,1962-07-06,56.17,-0.64,-1.13,72.64,-22.67,True,1,1892,-56.17,-98457.38,106273.64,7816.26
8639,1962-07-09,56.55,0.38,0.68,72.64,-22.15,True,1,1893,-56.55,-98513.93,107049.15,8535.22
8640,1962-07-10,57.2,0.65,1.15,72.64,-21.26,True,1,1894,-57.2,-98571.13,108336.8,9765.67
8641,1962-07-11,57.73,0.53,0.93,72.64,-20.53,True,1,1895,-57.73,-98628.86,109398.35,10769.49
8642,1962-07-12,58.03,0.3,0.52,72.64,-20.11,True,1,1896,-58.03,-98686.89,110024.88,11337.99
8643,1962-07-13,57.83,-0.2,-0.34,72.64,-20.39,True,1,1897,-57.83,-98744.72,109703.51,10958.79
8644,1962-07-16,57.83,0.0,0.0,72.64,-20.39,True,1,1898,-57.83,-98802.55,109761.34,10958.79
8645,1962-07-17,56.78,-1.05,-1.82,72.64,-21.83,True,1,1899,-56.78,-98859.33,107825.22,8965.89
8646,1962-07-18,56.2,-0.58,-1.02,72.64,-22.63,True,1,1900,-56.2,-98915.53,106780.0,7864.47
8647,1962-07-19,56.42,0.22,0.39,72.64,-22.33,True,1,1901,-56.42,-98971.95,107254.42,8282.47
8648,1962-07-20,56.81,0.39,0.69,72.64,-21.79,True,1,1902,-56.81,-99028.76,108052.62,9023.86
8649,1962-07-23,56.8,-0.01,-0.02,72.64,-21.81,True,1,1903,-56.8,-99085.56,108090.4,9004.84
8650,1962-07-24,56.36,-0.44,-0.78,72.64,-22.41,True,1,1904,-56.36,-99141.92,107309.44,8167.52
8651,1962-07-25,56.46,0.1,0.18,72.64,-22.27,True,1,1905,-56.46,-99198.38,107556.3,8357.92
8652,1962-07-26,56.77,0.31,0.55,72.64,-21.85,True,1,1906,-56.77,-99255.15,108203.62,8948.47
8653,1962-07-27,57.2,0.43,0.76,72.64,-21.26,True,1,1907,-57.2,-99312.35,109080.4,9768.05
8654,1962-07-30,57.83,0.63,1.1,72.64,-20.39,True,1,1908,-57.83,-99370.18,110339.64,10969.46
8655,1962-07-31,58.23,0.4,0.69,72.64,-19.84,True,1,1909,-58.23,-99428.41,111161.07,11732.66
8656,1962-08-01,57.75,-0.48,-0.82,72.64,-20.5,True,1,1910,-57.75,-99486.16,110302.5,10816.34
8657,1962-08-02,57.98,0.23,0.4,72.64,-20.18,True,1,1911,-57.98,-99544.14,110799.78,11255.64
8658,1962-08-03,58.12,0.14,0.24,72.64,-19.99,True,1,1912,-58.12,-99602.26,111125.44,11523.18
8659,1962-08-06,57.75,-0.37,-0.64,72.64,-20.5,True,1,1913,-57.75,-99660.01,110475.75,10815.74
8660,1962-08-07,57.36,-0.39,-0.68,72.64,-21.04,True,1,1914,-57.36,-99717.37,109787.04,10069.67
8661,1962-08-08,57.51,0.15,0.26,72.64,-20.83,True,1,1915,-57.51,-99774.88,110131.65,10356.77
8662,1962-08-09,57.57,0.06,0.1,72.64,-20.75,True,1,1916,-57.57,-99832.45,110304.12,10471.67
8663,1962-08-10,57.55,-0.02,-0.04,72.64,-20.77,True,1,1917,-57.55,-99890.0,110323.35,10433.35
8664,1962-08-13,57.63,0.08,0.14,72.64,-20.66,True,1,1918,-57.63,-99947.63,110534.34,10586.71
8665,1962-08-14,58.25,0.62,1.08,72.64,-19.81,True,1,1919,-58.25,-100005.88,111781.75,11775.87
8666,1962-08-15,58.66,0.41,0.7,72.64,-19.25,True,1,1920,-58.66,-100064.54,112627.2,12562.66
8667,1962-08-16,58.64,-0.02,-0.03,72.64,-19.27,True,1,1921,-58.64,-100123.18,112647.44,12524.26
8668,1962-08-17,59.01,0.37,0.63,72.64,-18.76,True,1,1922,-59.01,-100182.19,113417.22,13235.03
8669,1962-08-20,59.37,0.36,0.61,72.64,-18.27,True,1,1923,-59.37,-100241.56,114168.51,13926.95
8670,1962-08-21,59.12,-0.25,-0.42,72.64,-18.61,True,1,1924,-59.12,-100300.68,113746.88,13446.2
8671,1962-08-22,59.78,0.66,1.12,72.64,-17.7,True,1,1925,-59.78,-100360.46,115076.5,14716.04
8672,1962-08-23,59.7,-0.08,-0.13,72.64,-17.81,True,1,1926,-59.7,-100420.16,114982.2,14562.04
8673,1962-08-24,59.58,-0.12,-0.2,72.64,-17.98,True,1,1927,-59.58,-100479.74,114810.66,14330.92
8674,1962-08-27,59.55,-0.03,-0.05,72.64,-18.02,True,1,1928,-59.55,-100539.29,114812.4,14273.11
8675,1962-08-28,58.79,-0.76,-1.28,72.64,-19.07,True,1,1929,-58.79,-100598.08,113405.91,12807.83
8676,1962-08-29,58.66,-0.13,-0.22,72.64,-19.25,True,1,1930,-58.66,-100656.74,113213.8,12557.06
8677,1962-08-30,58.68,0.02,0.03,72.64,-19.22,True,1,1931,-58.68,-100715.42,113311.08,12595.66
8678,1962-08-31,59.12,0.44,0.75,72.64,-18.61,True,1,1932,-59.12,-100774.54,114219.84,13445.3
8679,1962-09-04,58.56,-0.56,-0.95,72.64,-19.38,True,1,1933,-58.56,-100833.1,113196.48,12363.38
8680,1962-09-05,58.12,-0.44,-0.75,72.64,-19.99,True,1,1934,-58.12,-100891.22,112404.08,11512.86
8681,1962-09-06,58.36,0.24,0.41,72.64,-19.66,True,1,1935,-58.36,-100949.58,112926.6,11977.02
8682,1962-09-07,58.38,0.02,0.03,72.64,-19.63,True,1,1936,-58.38,-101007.96,113023.68,12015.72
8683,1962-09-10,58.45,0.07,0.12,72.64,-19.54,True,1,1937,-58.45,-101066.41,113217.65,12151.24
8684,1962-09-11,58.59,0.14,0.24,72.64,-19.34,True,1,1938,-58.59,-101125.0,113547.42,12422.42
8685,1962-09-12,58.84,0.25,0.43,72.64,-19.0,True,1,1939,-58.84,-101183.84,114090.76,12906.92
8686,1962-09-13,58.7,-0.14,-0.24,72.64,-19.19,True,1,1940,-58.7,-101242.54,113878.0,12635.46
8687,1962-09-14,58.89,0.19,0.32,72.64,-18.93,True,1,1941,-58.89,-101301.43,114305.49,13004.06
8688,1962-09-17,59.08,0.19,0.32,72.64,-18.67,True,1,1942,-59.08,-101360.51,114733.36,13372.85
8689,1962-09-18,59.03,-0.05,-0.08,72.64,-18.74,True,1,1943,-59.03,-101419.54,114695.29,13275.75
8690,1962-09-19,58.95,-0.08,-0.14,72.64,-18.85,True,1,1944,-58.95,-101478.49,114598.8,13120.31
8691,1962-09-20,58.54,-0.41,-0.7,72.64,-19.41,True,1,1945,-58.54,-101537.03,113860.3,12323.27
8692,1962-09-21,57.69,-0.85,-1.45,72.64,-20.58,True,1,1946,-57.69,-101594.72,112264.74,10670.02
8693,1962-09-24,56.63,-1.06,-1.84,72.64,-22.04,True,1,1947,-56.63,-101651.35,110258.61,8607.26
8694,1962-09-25,56.96,0.33,0.58,72.64,-21.59,True,1,1948,-56.96,-101708.31,110958.08,9249.77
8695,1962-09-26,56.15,-0.81,-1.42,72.64,-22.7,True,1,1949,-56.15,-101764.46,109436.35,7671.89
8696,1962-09-27,55.77,-0.38,-0.68,72.64,-23.22,True,1,1950,-55.77,-101820.23,108751.5,6931.27
8697,1962-09-28,56.27,0.5,0.9,72.64,-22.54,True,1,1951,-56.27,-101876.5,109782.77,7906.27
8698,1962-10-01,55.49,-0.78,-1.39,72.64,-23.61,True,1,1952,-55.49,-101931.99,108316.48,6384.49
8699,1962-10-02,56.1,0.61,1.1,72.64,-22.77,True,1,1953,-56.1,-101988.09,109563.3,7575.21
8700,1962-10-03,56.16,0.06,0.11,72.64,-22.69,True,1,1954,-56.16,-102044.25,109736.64,7692.39
8701,1962-10-04,56.7,0.54,0.96,72.64,-21.94,True,1,1955,-56.7,-102100.95,110848.5,8747.55
8702,1962-10-05,57.07,0.37,0.65,72.64,-21.43,True,1,1956,-57.07,-102158.02,111628.92,9470.9
8703,1962-10-08,57.07,0.0,0.0,72.64,-21.43,True,1,1957,-57.07,-102215.09,111685.99,9470.9
8704,1962-10-09,57.2,0.13,0.23,72.64,-21.26,True,1,1958,-57.2,-102272.29,111997.6,9725.31
8705,1962-10-10,57.24,0.04,0.07,72.64,-21.2,True,1,1959,-57.24,-102329.53,112133.16,9803.63
8706,1962-10-11,57.05,-0.19,-0.33,72.64,-21.46,True,1,1960,-57.05,-102386.58,111818.0,9431.42
8707,1962-10-12,56.95,-0.1,-0.18,72.64,-21.6,True,1,1961,-56.95,-102443.53,111678.95,9235.42
8708,1962-10-15,57.27,0.32,0.56,72.64,-21.16,True,1,1962,-57.27,-102500.8,112363.74,9862.94
8709,1962-10-16,57.08,-0.19,-0.33,72.64,-21.42,True,1,1963,-57.08,-102557.88,112048.04,9490.16
8710,1962-10-17,56.89,-0.19,-0.33,72.64,-21.68,True,1,1964,-56.89,-102614.77,111731.96,9117.19
8711,1962-10-18,56.34,-0.55,-0.97,72.64,-22.44,True,1,1965,-56.34,-102671.11,110708.1,8036.99
8712,1962-10-19,55.59,-0.75,-1.33,72.64,-23.47,True,1,1966,-55.59,-102726.7,109289.94,6563.24
8713,1962-10-22,54.96,-0.63,-1.13,72.64,-24.34,True,1,1967,-54.96,-102781.66,108106.32,5324.66
8714,1962-10-23,53.49,-1.47,-2.68,72.64,-26.36,True,1,1968,-53.49,-102835.15,105268.32,2433.17
8715,1962-10-24,55.21,1.72,3.22,72.64,-24.0,True,1,1969,-55.21,-102890.36,108708.49,5818.13
8716,1962-10-25,54.69,-0.52,-0.94,72.64,-24.71,True,1,1970,-54.69,-102945.05,107739.3,4794.25
8717,1962-10-26,54.54,-0.15,-0.27,72.64,-24.92,True,1,1971,-54.54,-102999.59,107498.34,4498.75
8718,1962-10-29,55.72,1.18,2.16,72.64,-23.29,True,1,1972,-55.72,-103055.31,109879.84,6824.53
8719,1962-10-30,56.54,0.82,1.47,72.64,-22.16,True,1,1973,-56.54,-103111.85,111553.42,8441.57
8720,1962-10-31,56.52,-0.02,-0.04,72.64,-22.19,True,1,1974,-56.52,-103168.37,111570.48,8402.11
8721,1962-11-01,57.12,0.6,1.06,72.64,-21.37,True,1,1975,-57.12,-103225.49,112812.0,9586.51
8722,1962-11-02,57.75,0.63,1.1,72.64,-20.5,True,1,1976,-57.75,-103283.24,114114.0,10830.76
8723,1962-11-05,58.35,0.6,1.04,72.64,-19.67,True,1,1977,-58.35,-103341.59,115357.95,12016.36
8724,1962-11-07,58.71,0.36,0.62,72.64,-19.18,True,1,1978,-58.71,-103400.3,116128.38,12728.08
8725,1962-11-08,58.32,-0.39,-0.66,72.64,-19.71,True,1,1979,-58.32,-103458.62,115415.28,11956.66
8726,1962-11-09,58.78,0.46,0.79,72.64,-19.08,True,1,1980,-58.78,-103517.4,116384.4,12867.0
8727,1962-11-12,59.59,0.81,1.38,72.64,-17.96,True,1,1981,-59.59,-103576.99,118047.79,14470.8
8728,1962-11-13,59.46,-0.13,-0.22,72.64,-18.14,True,1,1982,-59.46,-103636.45,117849.72,14213.27
8729,1962-11-14,60.16,0.7,1.18,72.64,-17.18,True,1,1983,-60.16,-103696.61,119297.28,15600.67
8730,1962-11-15,59.97,-0.19,-0.32,72.64,-17.44,True,1,1984,-59.97,-103756.58,118980.48,15223.9
8731,1962-11-16,60.16,0.19,0.32,72.64,-17.18,True,1,1985,-60.16,-103816.74,119417.6,15600.86
8732,1962-11-19,59.82,-0.34,-0.56,72.64,-17.65,True,1,1986,-59.82,-103876.56,118802.52,14925.96
8733,1962-11-20,60.45,0.63,1.05,72.64,-16.78,True,1,1987,-60.45,-103937.01,120114.15,16177.14
8734,1962-11-21,60.81,0.36,0.6,72.64,-16.29,True,1,1988,-60.81,-103997.82,120890.28,16892.46
8735,1962-11-23,61.54,0.73,1.2,72.64,-15.28,True,1,1989,-61.54,-104059.36,122403.06,18343.7
8736,1962-11-26,61.36,-0.18,-0.29,72.64,-15.53,True,1,1990,-61.36,-104120.72,122106.4,17985.68
8737,1962-11-27,61.73,0.37,0.6,72.64,-15.02,True,1,1991,-61.73,-104182.45,122904.43,18721.98
8738,1962-11-28,62.12,0.39,0.63,72.64,-14.48,True,1,1992,-62.12,-104244.57,123743.04,19498.47
8739,1962-11-29,62.41,0.29,0.47,72.64,-14.08,True,1,1993,-62.41,-104306.98,124383.13,20076.15
8740,1962-11-30,62.26,-0.15,-0.24,72.64,-14.29,True,1,1994,-62.26,-104369.24,124146.44,19777.2
8741,1962-12-03,61.94,-0.32,-0.51,72.64,-14.73,True,1,1995,-61.94,-104431.18,123570.3,19139.12
8742,1962-12-04,62.64,0.7,1.13,72.64,-13.77,True,1,1996,-62.64,-104493.82,125029.44,20535.62
8743,1962-12-05,62.39,-0.25,-0.4,72.64,-14.11,True,1,1997,-62.39,-104556.21,124592.83,20036.62
8744,1962-12-06,62.93,0.54,0.87,72.64,-13.37,True,1,1998,-62.93,-104619.14,125734.14,21115.0
8745,1962-12-07,63.06,0.13,0.21,72.64,-13.19,True,1,1999,-63.06,-104682.2,126056.94,21374.74
8746,1962-12-10,62.27,-0.79,-1.25,72.64,-14.28,True,1,2000,-62.27,-104744.47,124540.0,19795.53
8747,1962-12-11,62.32,0.05,0.08,72.64,-14.21,True,1,2001,-62.32,-104806.79,124702.32,19895.53
8748,1962-12-12,62.63,0.31,0.5,72.64,-13.78,True,1,2002,-62.63,-104869.42,125385.26,20515.84
8749,1962-12-13,62.42,-0.21,-0.34,72.64,-14.07,True,1,2003,-62.42,-104931.84,125027.26,20095.42
8750,1962-12-14,62.57,0.15,0.24,72.64,-13.86,True,1,2004,-62.57,-104994.41,125390.28,20395.87
8751,1962-12-17,62.37,-0.2,-0.32,72.64,-14.14,True,1,2005,-62.37,-105056.78,125051.85,19995.07
8752,1962-12-18,62.07,-0.3,-0.48,72.64,-14.55,True,1,2006,-62.07,-105118.85,124512.42,19393.57
8753,1962-12-19,62.58,0.51,0.82,72.64,-13.85,True,1,2007,-62.58,-105181.43,125598.06,20416.63
8754,1962-12-20,62.82,0.24,0.38,72.64,-13.52,True,1,2008,-62.82,-105244.25,126142.56,20898.31
8755,1962-12-21,62.64,-0.18,-0.29,72.64,-13.77,True,1,2009,-62.64,-105306.89,125843.76,20536.87
8756,1962-12-24,62.63,-0.01,-0.02,72.64,-13.78,True,1,2010,-62.63,-105369.52,125886.3,20516.78
8757,1962-12-26,63.02,0.39,0.62,72.64,-13.24,True,1,2011,-63.02,-105432.54,126733.22,21300.68
8758,1962-12-27,62.93,-0.09,-0.14,72.64,-13.37,True,1,2012,-62.93,-105495.47,126615.16,21119.69
8759,1962-12-28,62.96,0.03,0.05,72.64,-13.33,True,1,2013,-62.96,-105558.43,126738.48,21180.05
8760,1962-12-31,63.1,0.14,0.22,72.64,-13.13,True,1,2014,-63.1,-105621.53,127083.4,21461.87
8761,1963-01-02,62.69,-0.41,-0.65,72.64,-13.7,True,1,2015,-62.69,-105684.22,126320.35,20636.13
8762,1963-01-03,63.72,1.03,1.64,72.64,-12.28,True,1,2016,-63.72,-105747.94,128459.52,22711.58
8763,1963-01-04,64.13,0.41,0.64,72.64,-11.72,True,1,2017,-64.13,-105812.07,129350.21,23538.14
8764,1963-01-07,64.12,-0.01,-0.02,72.64,-11.73,True,1,2018,-64.12,-105876.19,129394.16,23517.97
8765,1963-01-08,64.74,0.62,0.97,72.64,-10.88,True,1,2019,-64.74,-105940.93,130710.06,24769.13
8766,1963-01-09,64.59,-0.15,-0.23,72.64,-11.08,True,1,2020,-64.59,-106005.52,130471.8,24466.28
8767,1963-01-10,64.71,0.12,0.19,72.64,-10.92,True,1,2021,-64.71,-106070.23,130778.91,24708.68
8768,1963-01-11,64.85,0.14,0.22,72.64,-10.72,True,1,2022,-64.85,-106135.08,131126.7,24991.62
8769,1963-01-14,65.2,0.35,0.54,72.64,-10.24,True,1,2023,-65.2,-106200.28,131899.6,25699.32
8770,1963-01-15,65.11,-0.09,-0.14,72.64,-10.37,True,1,2024,-65.11,-106265.39,131782.64,25517.25
8771,1963-01-16,64.67,-0.44,-0.68,72.64,-10.97,True,1,2025,-64.67,-106330.06,130956.75,24626.69
8772,1963-01-17,65.13,0.46,0.71,72.64,-10.34,True,1,2026,-65.13,-106395.19,131953.38,25558.19
8773,1963-01-18,65.18,0.05,0.08,72.64,-10.27,True,1,2027,-65.18,-106460.37,132119.86,25659.49
8774,1963-01-21,65.28,0.1,0.15,72.64,-10.13,True,1,2028,-65.28,-106525.65,132387.84,25862.19
8775,1963-01-22,65.44,0.16,0.24,72.64,-9.91,True,1,2029,-65.44,-106591.09,132777.76,26186.67
8776,1963-01-23,65.62,0.18,0.28,72.64,-9.66,True,1,2030,-65.62,-106656.71,133208.6,26551.89
8777,1963-01-24,65.75,0.13,0.2,72.64,-9.48,True,1,2031,-65.75,-106722.46,133538.25,26815.79
8778,1963-01-25,65.92,0.17,0.26,72.64,-9.25,True,1,2032,-65.92,-106788.38,133949.44,27161.06
8779,1963-01-28,66.24,0.32,0.48,72.64,-8.81,True,1,2033,-66.24,-106854.62,134665.92,27811.3
8780,1963-01-29,66.23,-0.01,-0.02,72.64,-8.82,True,1,2034,-66.23,-106920.85,134711.82,27790.97
8781,1963-01-30,65.85,-0.38,-0.57,72.64,-9.35,True,1,2035,-65.85,-106986.7,134004.75,27018.05
8782,1963-01-31,66.2,0.35,0.53,72.64,-8.87,True,1,2036,-66.2,-107052.9,134783.2,27730.3
8783,1963-02-01,66.31,0.11,0.17,72.64,-8.71,True,1,2037,-66.31,-107119.21,135073.47,27954.26
8784,1963-02-04,66.17,-0.14,-0.21,72.64,-8.91,True,1,2038,-66.17,-107185.38,134854.46,27669.08
8785,1963-02-05,66.11,-0.06,-0.09,72.64,-8.99,True,1,2039,-66.11,-107251.49,134798.29,27546.8
8786,1963-02-06,66.4,0.29,0.44,72.64,-8.59,True,1,2040,-66.4,-107317.89,135456.0,28138.11
8787,1963-02-07,66.17,-0.23,-0.35,72.64,-8.91,True,1,2041,-66.17,-107384.06,135052.97,27668.91
8788,1963-02-08,66.17,0.0,0.0,72.64,-8.91,True,1,2042,-66.17,-107450.23,135119.14,27668.91
8789,1963-02-11,65.76,-0.41,-0.62,72.64,-9.47,True,1,2043,-65.76,-107515.99,134347.68,26831.69
8790,1963-02-12,65.83,0.07,0.11,72.64,-9.38,True,1,2044,-65.83,-107581.82,134556.52,26974.7
8791,1963-02-13,66.15,0.32,0.49,72.64,-8.93,True,1,2045,-66.15,-107647.97,135276.75,27628.78
8792,1963-02-14,66.35,0.2,0.3,72.64,-8.66,True,1,2046,-66.35,-107714.32,135752.1,28037.78
8793,1963-02-15,66.41,0.06,0.09,72.64,-8.58,True,1,2047,-66.41,-107780.73,135941.27,28160.54
8794,1963-02-18,66.52,0.11,0.17,72.64,-8.43,True,1,2048,-66.52,-107847.25,136232.96,28385.71
8795,1963-02-19,66.2,-0.32,-0.48,72.64,-8.87,True,1,2049,-66.2,-107913.45,135643.8,27730.35
8796,1963-02-20,65.83,-0.37,-0.56,72.64,-9.38,True,1,2050,-65.83,-107979.28,134951.5,26972.22
8797,1963-02-21,65.92,0.09,0.14,72.64,-9.25,True,1,2051,-65.92,-108045.2,135201.92,27156.72
8798,1963-02-25,65.46,-0.46,-0.7,72.64,-9.88,True,1,2052,-65.46,-108110.66,134323.92,26213.26
8799,1963-02-26,65.47,0.01,0.02,72.64,-9.87,True,1,2053,-65.47,-108176.13,134409.91,26233.78
8800,1963-02-27,65.01,-0.46,-0.7,72.64,-10.5,True,1,2054,-65.01,-108241.14,133530.54,25289.4
8801,1963-02-28,64.29,-0.72,-1.11,72.64,-11.5,True,1,2055,-64.29,-108305.43,132115.95,23810.52
8802,1963-03-01,64.1,-0.19,-0.3,72.64,-11.76,True,1,2056,-64.1,-108369.53,131789.6,23420.07
8803,1963-03-04,64.72,0.62,0.97,72.64,-10.9,True,1,2057,-64.72,-108434.25,133129.04,24694.79
8804,1963-03-05,64.74,0.02,0.03,72.64,-10.88,True,1,2058,-64.74,-108498.99,133234.92,24735.93
8805,1963-03-06,64.85,0.11,0.17,72.64,-10.72,True,1,2059,-64.85,-108563.84,133526.15,24962.31
8806,1963-03-07,65.26,0.41,0.63,72.64,-10.16,True,1,2060,-65.26,-108629.1,134435.6,25806.5
8807,1963-03-08,65.33,0.07,0.11,72.64,-10.06,True,1,2061,-65.33,-108694.43,134645.13,25950.7
8808,1963-03-11,65.51,0.18,0.28,72.64,-9.82,True,1,2062,-65.51,-108759.94,135081.62,26321.68
8809,1963-03-12,65.67,0.16,0.24,72.64,-9.6,True,1,2063,-65.67,-108825.61,135477.21,26651.6
8810,1963-03-13,65.91,0.24,0.36,72.64,-9.26,True,1,2064,-65.91,-108891.52,136038.24,27146.72
8811,1963-03-14,65.6,-0.31,-0.47,72.64,-9.69,True,1,2065,-65.6,-108957.12,135464.0,26506.88
8812,1963-03-15,65.93,0.33,0.5,72.64,-9.24,True,1,2066,-65.93,-109023.05,136211.38,27188.33
8813,1963-03-18,65.61,-0.32,-0.48,72.64,-9.68,True,1,2067,-65.61,-109088.66,135615.87,26527.21
8814,1963-03-19,65.47,-0.14,-0.21,72.64,-9.87,True,1,2068,-65.47,-109154.13,135391.96,26237.83
8815,1963-03-20,65.95,0.48,0.73,72.64,-9.21,True,1,2069,-65.95,-109220.08,136450.55,27230.47
8816,1963-03-21,65.85,-0.1,-0.15,72.64,-9.35,True,1,2070,-65.85,-109285.93,136309.5,27023.57
8817,1963-03-22,66.19,0.34,0.52,72.64,-8.88,True,1,2071,-66.19,-109352.12,137079.49,27727.37
8818,1963-03-25,66.21,0.02,0.03,72.64,-8.85,True,1,2072,-66.21,-109418.33,137187.12,27768.79
8819,1963-03-26,66.4,0.19,0.29,72.64,-8.59,True,1,2073,-66.4,-109484.73,137647.2,28162.47
8820,1963-03-27,66.68,0.28,0.42,72.64,-8.2,True,1,2074,-66.68,-109551.41,138294.32,28742.91
8821,1963-03-28,66.58,-0.1,-0.15,72.64,-8.34,True,1,2075,-66.58,-109617.99,138153.5,28535.51
8822,1963-03-29,66.57,-0.01,-0.02,72.64,-8.36,True,1,2076,-66.57,-109684.56,138199.32,28514.76
8823,1963-04-01,66.85,0.28,0.42,72.64,-7.97,True,1,2077,-66.85,-109751.41,138847.45,29096.04
8824,1963-04-02,66.84,-0.01,-0.02,72.64,-7.98,True,1,2078,-66.84,-109818.25,138893.52,29075.27
8825,1963-04-03,67.36,0.52,0.78,72.64,-7.27,True,1,2079,-67.36,-109885.61,140041.44,30155.83
8826,1963-04-04,67.85,0.49,0.73,72.64,-6.59,True,1,2080,-67.85,-109953.46,141128.0,31174.54
8827,1963-04-05,68.28,0.43,0.63,72.64,-6.0,True,1,2081,-68.28,-110021.74,142090.68,32068.94
8828,1963-04-08,68.52,0.24,0.35,72.64,-5.67,True,1,2082,-68.52,-110090.26,142658.64,32568.38
8829,1963-04-09,68.45,-0.07,-0.1,72.64,-5.77,True,1,2083,-68.45,-110158.71,142581.35,32422.64
8830,1963-04-10,68.29,-0.16,-0.23,72.64,-5.99,True,1,2084,-68.29,-110227.0,142316.36,32089.36
8831,1963-04-11,68.77,0.48,0.7,72.64,-5.33,True,1,2085,-68.77,-110295.77,143385.45,33089.68
8832,1963-04-15,69.09,0.32,0.46,72.64,-4.89,True,1,2086,-69.09,-110364.86,144121.74,33756.88
8833,1963-04-16,69.14,0.05,0.07,72.64,-4.82,True,1,2087,-69.14,-110434.0,144295.18,33861.18
8834,1963-04-17,68.92,-0.22,-0.32,72.64,-5.12,True,1,2088,-68.92,-110502.92,143904.96,33402.04
8835,1963-04-18,68.89,-0.03,-0.04,72.64,-5.16,True,1,2089,-68.89,-110571.81,143911.21,33339.4
8836,1963-04-19,69.23,0.34,0.49,72.64,-4.69,True,1,2090,-69.23,-110641.04,144690.7,34049.66
8837,1963-04-22,69.3,0.07,0.1,72.64,-4.6,True,1,2091,-69.3,-110710.34,144906.3,34195.96
8838,1963-04-23,69.53,0.23,0.33,72.64,-4.28,True,1,2092,-69.53,-110779.87,145456.76,34676.89
8839,1963-04-24,69.72,0.19,0.27,72.64,-4.02,True,1,2093,-69.72,-110849.59,145923.96,35074.37
8840,1963-04-25,69.76,0.04,0.06,72.64,-3.96,True,1,2094,-69.76,-110919.35,146077.44,35158.09
8841,1963-04-26,69.7,-0.06,-0.09,72.64,-4.05,True,1,2095,-69.7,-110989.05,146021.5,35032.45
8842,1963-04-29,69.65,-0.05,-0.07,72.64,-4.12,True,1,2096,-69.65,-111058.7,145986.4,34927.7
8843,1963-04-30,69.8,0.15,0.22,72.64,-3.91,True,1,2097,-69.8,-111128.5,146370.6,35242.1
8844,1963-05-01,69.97,0.17,0.24,72.64,-3.68,True,1,2098,-69.97,-111198.47,146797.06,35598.59
8845,1963-05-02,70.17,0.2,0.29,72.64,-3.4,True,1,2099,-70.17,-111268.64,147286.83,36018.19
8846,1963-05-03,70.03,-0.14,-0.2,72.64,-3.59,True,1,2100,-70.03,-111338.67,147063.0,35724.33
8847,1963-05-06,69.53,-0.5,-0.71,72.64,-4.28,True,1,2101,-69.53,-111408.2,146082.53,34674.33
8848,1963-05-07,69.44,-0.09,-0.13,72.64,-4.4,True,1,2102,-69.44,-111477.64,145962.88,34485.24
8849,1963-05-08,70.01,0.57,0.82,72.64,-3.62,True,1,2103,-70.01,-111547.65,147231.03,35683.38
8850,1963-05-09,70.35,0.34,0.49,72.64,-3.15,True,1,2104,-70.35,-111618.0,148016.4,36398.4
8851,1963-05-10,70.52,0.17,0.24,72.64,-2.92,True,1,2105,-70.52,-111688.52,148444.6,36756.08
8852,1963-05-13,70.48,-0.04,-0.06,72.64,-2.97,True,1,2106,-70.48,-111759.0,148430.88,36671.88
8853,1963-05-14,70.21,-0.27,-0.38,72.64,-3.34,True,1,2107,-70.21,-111829.21,147932.47,36103.26
8854,1963-05-15,70.43,0.22,0.31,72.64,-3.04,True,1,2108,-70.43,-111899.64,148466.44,36566.8
8855,1963-05-16,70.25,-0.18,-0.26,72.64,-3.29,True,1,2109,-70.25,-111969.89,148157.25,36187.36
8856,1963-05-17,70.29,0.04,0.06,72.64,-3.24,True,1,2110,-70.29,-112040.18,148311.9,36271.72
8857,1963-05-20,69.96,-0.33,-0.47,72.64,-3.69,True,1,2111,-69.96,-112110.14,147685.56,35575.42
8858,1963-05-21,70.14,0.18,0.26,72.64,-3.44,True,1,2112,-70.14,-112180.28,148135.68,35955.4
8859,1963-05-22,70.14,0.0,0.0,72.64,-3.44,True,1,2113,-70.14,-112250.42,148205.82,35955.4
8860,1963-05-23,70.1,-0.04,-0.06,72.64,-3.5,True,1,2114,-70.1,-112320.52,148191.4,35870.88
8861,1963-05-24,70.02,-0.08,-0.11,72.64,-3.61,True,1,2115,-70.02,-112390.54,148092.3,35701.76
8862,1963-05-27,69.87,-0.15,-0.21,72.64,-3.81,True,1,2116,-69.87,-112460.41,147844.92,35384.51
8863,1963-05-28,70.01,0.14,0.2,72.64,-3.62,True,1,2117,-70.01,-112530.42,148211.17,35680.75
8864,1963-05-29,70.33,0.32,0.46,72.64,-3.18,True,1,2118,-70.33,-112600.75,148958.94,36358.19
8865,1963-05-31,70.8,0.47,0.67,72.64,-2.53,True,1,2119,-70.8,-112671.55,150025.2,37353.65
8866,1963-06-03,70.69,-0.11,-0.16,72.64,-2.68,True,1,2120,-70.69,-112742.24,149862.8,37120.56
8867,1963-06-04,70.7,0.01,0.01,72.64,-2.67,True,1,2121,-70.7,-112812.94,149954.7,37141.76
8868,1963-06-05,70.53,-0.17,-0.24,72.64,-2.9,True,1,2122,-70.53,-112883.47,149664.66,36781.19
8869,1963-06-06,70.58,0.05,0.07,72.64,-2.84,True,1,2123,-70.58,-112954.05,149841.34,36887.29
8870,1963-06-07,70.41,-0.17,-0.24,72.64,-3.07,True,1,2124,-70.41,-113024.46,149550.84,36526.38
8871,1963-06-10,69.94,-0.47,-0.67,72.64,-3.72,True,1,2125,-69.94,-113094.4,148622.5,35528.1
8872,1963-06-11,70.03,0.09,0.13,72.64,-3.59,True,1,2126,-70.03,-113164.43,148883.78,35719.35
8873,1963-06-12,70.41,0.38,0.54,72.64,-3.07,True,1,2127,-70.41,-113234.84,149762.07,36527.23
8874,1963-06-13,70.23,-0.18,-0.26,72.64,-3.32,True,1,2128,-70.23,-113305.07,149449.44,36144.37
8875,1963-06-14,70.25,0.02,0.03,72.64,-3.29,True,1,2129,-70.25,-113375.32,149562.25,36186.93
8876,1963-06-17,69.95,-0.3,-0.43,72.64,-3.7,True,1,2130,-69.95,-113445.27,148993.5,35548.23
8877,1963-06-18,70.02,0.07,0.1,72.64,-3.61,True,1,2131,-70.02,-113515.29,149212.62,35697.33
8878,1963-06-19,70.09,0.07,0.1,72.64,-3.51,True,1,2132,-70.09,-113585.38,149431.88,35846.5
8879,1963-06-20,70.01,-0.08,-0.11,72.64,-3.62,True,1,2133,-70.01,-113655.39,149331.33,35675.94
8880,1963-06-21,70.25,0.24,0.34,72.64,-3.29,True,1,2134,-70.25,-113725.64,149913.5,36187.86
8881,1963-06-24,70.2,-0.05,-0.07,72.64,-3.36,True,1,2135,-70.2,-113795.84,149877.0,36081.16
8882,1963-06-25,70.04,-0.16,-0.23,72.64,-3.58,True,1,2136,-70.04,-113865.88,149605.44,35739.56
8883,1963-06-26,69.41,-0.63,-0.9,72.64,-4.45,True,1,2137,-69.41,-113935.29,148329.17,34393.88
8884,1963-06-27,69.07,-0.34,-0.49,72.64,-4.92,True,1,2138,-69.07,-114004.36,147671.66,33667.3
8885,1963-06-28,69.37,0.3,0.43,72.64,-4.5,True,1,2139,-69.37,-114073.73,148382.43,34308.7
8886,1963-07-01,68.86,-0.51,-0.74,72.64,-5.2,True,1,2140,-68.86,-114142.59,147360.4,33217.81
8887,1963-07-02,69.46,0.6,0.87,72.64,-4.38,True,1,2141,-69.46,-114212.05,148713.86,34501.81
8888,1963-07-03,69.94,0.48,0.69,72.64,-3.72,True,1,2142,-69.94,-114281.99,149811.48,35529.49
8889,1963-07-05,70.22,0.28,0.4,72.64,-3.33,True,1,2143,-70.22,-114352.21,150481.46,36129.25
8890,1963-07-08,69.74,-0.48,-0.68,72.64,-3.99,True,1,2144,-69.74,-114421.95,149522.56,35100.61
8891,1963-07-09,70.04,0.3,0.43,72.64,-3.58,True,1,2145,-70.04,-114491.99,150235.8,35743.81
8892,1963-07-10,69.89,-0.15,-0.21,72.64,-3.79,True,1,2146,-69.89,-114561.88,149983.94,35422.06
8893,1963-07-11,69.76,-0.13,-0.19,72.64,-3.96,True,1,2147,-69.76,-114631.64,149774.72,35143.08
8894,1963-07-12,69.64,-0.12,-0.17,72.64,-4.13,True,1,2148,-69.64,-114701.28,149586.72,34885.44
8895,1963-07-15,69.2,-0.44,-0.63,72.64,-4.74,True,1,2149,-69.2,-114770.48,148710.8,33940.32
8896,1963-07-16,69.14,-0.06,-0.09,72.64,-4.82,True,1,2150,-69.14,-114839.62,148651.0,33811.38
8897,1963-07-17,68.93,-0.21,-0.3,72.64,-5.11,True,1,2151,-68.93,-114908.55,148268.43,33359.88
8898,1963-07-18,68.49,-0.44,-0.64,72.64,-5.71,True,1,2152,-68.49,-114977.04,147390.48,32413.44
8899,1963-07-19,68.35,-0.14,-0.2,72.64,-5.91,True,1,2153,-68.35,-115045.39,147157.55,32112.16
8900,1963-07-22,67.9,-0.45,-0.66,72.64,-6.52,True,1,2154,-67.9,-115113.29,146256.6,31143.31
8901,1963-07-23,67.91,0.01,0.02,72.64,-6.51,True,1,2155,-67.91,-115181.2,146346.05,31164.85
8902,1963-07-24,68.28,0.37,0.55,72.64,-6.0,True,1,2156,-68.28,-115249.48,147211.68,31962.2
8903,1963-07-25,68.26,-0.02,-0.03,72.64,-6.03,True,1,2157,-68.26,-115317.74,147236.82,31919.08
8904,1963-07-26,68.54,0.28,0.41,72.64,-5.64,True,1,2158,-68.54,-115386.28,147909.32,32523.04
8905,1963-07-29,68.67,0.13,0.19,72.64,-5.46,True,1,2159,-68.67,-115454.95,148258.53,32803.58
8906,1963-07-30,69.24,0.57,0.83,72.64,-4.68,True,1,2160,-69.24,-115524.19,149558.4,34034.21
8907,1963-07-31,69.13,-0.11,-0.16,72.64,-4.83,True,1,2161,-69.13,-115593.32,149389.93,33796.61
8908,1963-08-01,69.07,-0.06,-0.09,72.64,-4.92,True,1,2162,-69.07,-115662.39,149329.34,33666.95
8909,1963-08-02,69.3,0.23,0.33,72.64,-4.6,True,1,2163,-69.3,-115731.69,149895.9,34164.21
8910,1963-08-05,69.71,0.41,0.59,72.64,-4.03,True,1,2164,-69.71,-115801.4,150852.44,35051.04
8911,1963-08-06,70.17,0.46,0.66,72.64,-3.4,True,1,2165,-70.17,-115871.57,151918.05,36046.48
8912,1963-08-07,69.96,-0.21,-0.3,72.64,-3.69,True,1,2166,-69.96,-115941.53,151533.36,35591.83
8913,1963-08-08,70.02,0.06,0.09,72.64,-3.61,True,1,2167,-70.02,-116011.55,151733.34,35721.79
8914,1963-08-09,70.48,0.46,0.66,72.64,-2.97,True,1,2168,-70.48,-116082.03,152800.64,36718.61
8915,1963-08-12,70.59,0.11,0.16,72.64,-2.82,True,1,2169,-70.59,-116152.62,153109.71,36957.09
8916,1963-08-13,70.79,0.2,0.28,72.64,-2.55,True,1,2170,-70.79,-116223.41,153614.3,37390.89
8917,1963-08-14,71.07,0.28,0.4,72.64,-2.16,True,1,2171,-71.07,-116294.48,154292.97,37998.49
8918,1963-08-15,71.38,0.31,0.44,72.64,-1.74,True,1,2172,-71.38,-116365.86,155037.36,38671.5
8919,1963-08-16,71.49,0.11,0.15,72.64,-1.58,True,1,2173,-71.49,-116437.35,155347.77,38910.42
8920,1963-08-19,71.44,-0.05,-0.07,72.64,-1.65,True,1,2174,-71.44,-116508.79,155310.56,38801.77
8921,1963-08-20,71.38,-0.06,-0.08,72.64,-1.74,True,1,2175,-71.38,-116580.17,155251.5,38671.33
8922,1963-08-21,71.29,-0.09,-0.13,72.64,-1.86,True,1,2176,-71.29,-116651.46,155127.04,38475.58
8923,1963-08-22,71.54,0.25,0.35,72.64,-1.51,True,1,2177,-71.54,-116723.0,155742.58,39019.58
8924,1963-08-23,71.76,0.22,0.31,72.64,-1.21,True,1,2178,-71.76,-116794.76,156293.28,39498.52
8925,1963-08-26,71.91,0.15,0.21,72.64,-1.0,True,1,2179,-71.91,-116866.67,156691.89,39825.22
8926,1963-08-27,71.52,-0.39,-0.54,72.64,-1.54,True,1,2180,-71.52,-116938.19,155913.6,38975.41
8927,1963-08-28,72.04,0.52,0.73,72.64,-0.83,True,1,2181,-72.04,-117010.23,157119.24,40109.01
8928,1963-08-29,72.16,0.12,0.17,72.64,-0.66,True,1,2182,-72.16,-117082.39,157453.12,40370.73
8929,1963-08-30,72.5,0.34,0.47,72.64,-0.19,True,1,2183,-72.5,-117154.89,158267.5,41112.61
8930,1963-09-03,72.66,0.16,0.22,72.66,0.0,True,1,2184,-72.66,-117227.55,158689.44,41461.89
8931,1963-09-04,72.64,-0.02,-0.03,72.66,-0.03,True,1,2185,-72.64,-117300.19,158718.4,41418.21
8932,1963-09-05,73.0,0.36,0.5,73.0,0.0,True,1,2186,-73.0,-117373.19,159578.0,42204.81
8933,1963-09-06,72.84,-0.16,-0.22,73.0,-0.22,True,1,2187,-72.84,-117446.03,159301.08,41855.05
8934,1963-09-09,72.58,-0.26,-0.36,73.0,-0.57,True,1,2188,-72.58,-117518.61,158805.04,41286.43
8935,1963-09-10,72.99,0.41,0.56,73.0,-0.01,True,1,2189,-72.99,-117591.6,159775.11,42183.51
8936,1963-09-11,73.2,0.21,0.29,73.2,0.0,True,1,2190,-73.2,-117664.8,160308.0,42643.2
8937,1963-09-12,73.15,-0.05,-0.07,73.2,-0.07,True,1,2191,-73.15,-117737.95,160271.65,42533.7
8938,1963-09-13,73.17,0.02,0.03,73.2,-0.04,True,1,2192,-73.17,-117811.12,160388.64,42577.52
8939,1963-09-16,73.07,-0.1,-0.14,73.2,-0.18,True,1,2193,-73.07,-117884.19,160242.51,42358.32
8940,1963-09-17,73.12,0.05,0.07,73.2,-0.11,True,1,2194,-73.12,-117957.31,160425.28,42467.97
8941,1963-09-18,72.8,-0.32,-0.44,73.2,-0.55,True,1,2195,-72.8,-118030.11,159796.0,41765.89
8942,1963-09-19,73.22,0.42,0.58,73.22,0.0,True,1,2196,-73.22,-118103.33,160791.12,42687.79
8943,1963-09-20,73.3,0.08,0.11,73.3,0.0,True,1,2197,-73.3,-118176.63,161040.1,42863.47
8944,1963-09-23,72.96,-0.34,-0.46,73.3,-0.46,True,1,2198,-72.96,-118249.59,160366.08,42116.49
8945,1963-09-24,73.3,0.34,0.47,73.3,0.0,True,1,2199,-73.3,-118322.89,161186.7,42863.81
8946,1963-09-25,72.89,-0.41,-0.56,73.3,-0.56,True,1,2200,-72.89,-118395.78,160358.0,41962.22
8947,1963-09-26,72.27,-0.62,-0.85,73.3,-1.4,True,1,2201,-72.27,-118468.05,159066.27,40598.22
8948,1963-09-27,72.13,-0.14,-0.19,73.3,-1.6,True,1,2202,-72.13,-118540.18,158830.26,40290.08
8949,1963-09-30,71.7,-0.43,-0.6,73.3,-2.18,True,1,2203,-71.7,-118611.88,157955.1,39343.22
8950,1963-10-01,72.22,0.52,0.72,73.3,-1.47,True,1,2204,-72.22,-118684.1,159172.88,40488.78
8951,1963-10-02,72.3,0.08,0.11,73.3,-1.36,True,1,2205,-72.3,-118756.4,159421.5,40665.1
8952,1963-10-03,72.83,0.53,0.73,73.3,-0.64,True,1,2206,-72.83,-118829.23,160662.98,41833.75
8953,1963-10-04,72.85,0.02,0.03,73.3,-0.61,True,1,2207,-72.85,-118902.08,160779.95,41877.87
8954,1963-10-07,72.7,-0.15,-0.21,73.3,-0.82,True,1,2208,-72.7,-118974.78,160521.6,41546.82
8955,1963-10-08,72.6,-0.1,-0.14,73.3,-0.96,True,1,2209,-72.6,-119047.38,160373.4,41326.02
8956,1963-10-09,71.87,-0.73,-1.01,73.3,-1.95,True,1,2210,-71.87,-119119.25,158832.7,39713.45
8957,1963-10-10,72.2,0.33,0.46,73.3,-1.5,True,1,2211,-72.2,-119191.45,159634.2,40442.75
8958,1963-10-11,72.27,0.07,0.1,73.3,-1.4,True,1,2212,-72.27,-119263.72,159861.24,40597.52
8959,1963-10-14,72.3,0.03,0.04,73.3,-1.36,True,1,2213,-72.3,-119336.02,159999.9,40663.88
8960,1963-10-15,72.4,0.1,0.14,73.3,-1.23,True,1,2214,-72.4,-119408.42,160293.6,40885.18
8961,1963-10-16,72.97,0.57,0.79,73.3,-0.45,True,1,2215,-72.97,-119481.39,161628.55,42147.16
8962,1963-10-17,73.26,0.29,0.4,73.3,-0.06,True,1,2216,-73.26,-119554.65,162344.16,42789.51
8963,1963-10-18,73.32,0.06,0.08,73.32,0.0,True,1,2217,-73.32,-119627.97,162550.44,42922.47
8964,1963-10-21,73.38,0.06,0.08,73.38,0.0,True,1,2218,-73.38,-119701.35,162756.84,43055.49
8965,1963-10-22,72.96,-0.42,-0.57,73.38,-0.57,True,1,2219,-72.96,-119774.31,161898.24,42123.93
8966,1963-10-23,73.0,0.04,0.06,73.38,-0.52,True,1,2220,-73.0,-119847.31,162060.0,42212.69
8967,1963-10-24,73.28,0.28,0.38,73.38,-0.14,True,1,2221,-73.28,-119920.59,162754.88,42834.29
8968,1963-10-25,74.01,0.73,1.0,74.01,0.0,True,1,2222,-74.01,-119994.6,164450.22,44455.62
8969,1963-10-28,74.48,0.47,0.64,74.48,0.0,True,1,2223,-74.48,-120069.08,165569.04,45499.96
8970,1963-10-29,74.46,-0.02,-0.03,74.48,-0.03,True,1,2224,-74.46,-120143.54,165599.04,45455.5
8971,1963-10-30,73.8,-0.66,-0.89,74.48,-0.91,True,1,2225,-73.8,-120217.34,164205.0,43987.66
8972,1963-10-31,74.01,0.21,0.28,74.48,-0.63,True,1,2226,-74.01,-120291.35,164746.26,44454.91
8973,1963-11-01,73.83,-0.18,-0.24,74.48,-0.87,True,1,2227,-73.83,-120365.18,164419.41,44054.23
8974,1963-11-04,73.45,-0.38,-0.52,74.48,-1.38,True,1,2228,-73.45,-120438.63,163646.6,43207.97
8975,1963-11-06,72.81,-0.64,-0.87,74.48,-2.24,True,1,2229,-72.81,-120511.44,162293.49,41782.05
8976,1963-11-07,73.06,0.25,0.34,74.48,-1.91,True,1,2230,-73.06,-120584.5,162923.8,42339.3
8977,1963-11-08,73.36,0.3,0.41,74.48,-1.5,True,1,2231,-73.36,-120657.86,163666.16,43008.3
8978,1963-11-11,73.52,0.16,0.22,74.48,-1.29,True,1,2232,-73.52,-120731.38,164096.64,43365.26
8979,1963-11-12,73.23,-0.29,-0.39,74.48,-1.68,True,1,2233,-73.23,-120804.61,163522.59,42717.98
8980,1963-11-13,73.29,0.06,0.08,74.48,-1.6,True,1,2234,-73.29,-120877.9,163729.86,42851.96
8981,1963-11-14,72.95,-0.34,-0.46,74.48,-2.05,True,1,2235,-72.95,-120950.85,163043.25,42092.4
8982,1963-11-15,72.35,-0.6,-0.82,74.48,-2.86,True,1,2236,-72.35,-121023.2,161774.6,40751.4
8983,1963-11-18,71.83,-0.52,-0.72,74.48,-3.56,True,1,2237,-71.83,-121095.03,160683.71,39588.68
8984,1963-11-19,71.9,0.07,0.1,74.48,-3.46,True,1,2238,-71.9,-121166.93,160912.2,39745.27
8985,1963-11-20,72.56,0.66,0.92,74.48,-2.58,True,1,2239,-72.56,-121239.49,162461.84,41222.35
8986,1963-11-21,71.62,-0.94,-1.3,74.48,-3.84,True,1,2240,-71.62,-121311.11,160428.8,39117.69
8987,1963-11-22,69.61,-2.01,-2.81,74.48,-6.54,True,1,2241,-69.61,-121380.72,155996.01,34615.29
8988,1963-11-26,72.38,2.77,3.98,74.48,-2.82,True,1,2242,-72.38,-121453.1,162275.96,40822.86
8989,1963-11-27,72.25,-0.13,-0.18,74.48,-2.99,True,1,2243,-72.25,-121525.35,162056.75,40531.4
8990,1963-11-29,73.23,0.98,1.36,74.48,-1.68,True,1,2244,-73.23,-121598.58,164328.12,42729.54
8991,1963-12-02,73.66,0.43,0.59,74.48,-1.1,True,1,2245,-73.66,-121672.24,165366.7,43694.46
8992,1963-12-03,73.62,-0.04,-0.05,74.48,-1.16,True,1,2246,-73.62,-121745.86,165350.52,43604.66
8993,1963-12-04,73.8,0.18,0.24,74.48,-0.91,True,1,2247,-73.8,-121819.66,165828.6,44008.94
8994,1963-12-05,74.28,0.48,0.65,74.48,-0.27,True,1,2248,-74.28,-121893.94,166981.44,45087.5
8995,1963-12-06,74.0,-0.28,-0.38,74.48,-0.64,True,1,2249,-74.0,-121967.94,166426.0,44458.06
8996,1963-12-09,73.96,-0.04,-0.05,74.48,-0.7,True,1,2250,-73.96,-122041.9,166410.0,44368.1
8997,1963-12-10,73.99,0.03,0.04,74.48,-0.66,True,1,2251,-73.99,-122115.89,166551.49,44435.6
8998,1963-12-11,73.9,-0.09,-0.12,74.48,-0.78,True,1,2252,-73.9,-122189.79,166422.8,44233.01
8999,1963-12-12,73.91,0.01,0.01,74.48,-0.76,True,1,2253,-73.91,-122263.7,166519.23,44255.53
9000,1963-12-13,74.06,0.15,0.2,74.48,-0.56,True,1,2254,-74.06,-122337.76,166931.24,44593.48
9001,1963-12-16,74.3,0.24,0.32,74.48,-0.24,True,1,2255,-74.3,-122412.06,167546.5,45134.44
9002,1963-12-17,74.74,0.44,0.59,74.74,0.0,True,1,2256,-74.74,-122486.8,168613.44,46126.64
9003,1963-12-18,74.63,-0.11,-0.15,74.74,-0.15,True,1,2257,-74.63,-122561.43,168439.91,45878.48
9004,1963-12-19,74.4,-0.23,-0.31,74.74,-0.46,True,1,2258,-74.4,-122635.83,167995.2,45359.37
9005,1963-12-20,74.28,-0.12,-0.16,74.74,-0.62,True,1,2259,-74.28,-122710.11,167798.52,45088.41
9006,1963-12-23,73.81,-0.47,-0.63,74.74,-1.24,True,1,2260,-73.81,-122783.92,166810.6,44026.68
9007,1963-12-24,73.97,0.16,0.22,74.74,-1.03,True,1,2261,-73.97,-122857.89,167246.17,44388.28
9008,1963-12-26,74.32,0.35,0.47,74.74,-0.56,True,1,2262,-74.32,-122932.21,168111.84,45179.63
9009,1963-12-27,74.44,0.12,0.16,74.74,-0.4,True,1,2263,-74.44,-123006.65,168457.72,45451.07
9010,1963-12-30,74.56,0.12,0.16,74.74,-0.24,True,1,2264,-74.56,-123081.21,168803.84,45722.63
9011,1963-12-31,75.02,0.46,0.62,75.02,0.0,True,1,2265,-75.02,-123156.23,169920.3,46764.07
9012,1964-01-02,75.43,0.41,0.55,75.43,0.0,True,1,2266,-75.43,-123231.66,170924.38,47692.72
9013,1964-01-03,75.5,0.07,0.09,75.5,0.0,True,1,2267,-75.5,-123307.16,171158.5,47851.34
9014,1964-01-06,75.67,0.17,0.22,75.67,0.0,True,1,2268,-75.67,-123382.83,171619.56,48236.73
9015,1964-01-07,75.69,0.02,0.03,75.69,0.0,True,1,2269,-75.69,-123458.52,171740.61,48282.09
9016,1964-01-08,76.0,0.31,0.41,76.0,0.0,True,1,2270,-76.0,-123534.52,172520.0,48985.48
9017,1964-01-09,76.28,0.28,0.37,76.28,0.0,True,1,2271,-76.28,-123610.8,173231.88,49621.08
9018,1964-01-10,76.24,-0.04,-0.05,76.28,-0.05,True,1,2272,-76.24,-123687.04,173217.28,49530.24
9019,1964-01-13,76.22,-0.02,-0.03,76.28,-0.08,True,1,2273,-76.22,-123763.26,173248.06,49484.8
9020,1964-01-14,76.36,0.14,0.18,76.36,0.0,True,1,2274,-76.36,-123839.62,173642.64,49803.02
9021,1964-01-15,76.64,0.28,0.37,76.64,0.0,True,1,2275,-76.64,-123916.26,174356.0,50439.74
9022,1964-01-16,76.55,-0.09,-0.12,76.64,-0.12,True,1,2276,-76.55,-123992.81,174227.8,50234.99
9023,1964-01-17,76.56,0.01,0.01,76.64,-0.1,True,1,2277,-76.56,-124069.37,174327.12,50257.75
9024,1964-01-20,76.41,-0.15,-0.2,76.64,-0.3,True,1,2278,-76.41,-124145.78,174061.98,49916.2
9025,1964-01-21,76.62,0.21,0.28,76.64,-0.03,True,1,2279,-76.62,-124222.4,174616.98,50394.58
9026,1964-01-22,77.03,0.41,0.54,77.03,0.0,True,1,2280,-77.03,-124299.43,175628.4,51328.97
9027,1964-01-23,77.09,0.06,0.08,77.09,0.0,True,1,2281,-77.09,-124376.52,175842.29,51465.77
9028,1964-01-24,77.11,0.02,0.03,77.11,0.0,True,1,2282,-77.11,-124453.63,175965.02,51511.39
9029,1964-01-27,77.08,-0.03,-0.04,77.11,-0.04,True,1,2283,-77.08,-124530.71,175973.64,51442.93
9030,1964-01-28,77.1,0.02,0.03,77.11,-0.01,True,1,2284,-77.1,-124607.81,176096.4,51488.59
9031,1964-01-29,76.63,-0.47,-0.61,77.11,-0.62,True,1,2285,-76.63,-124684.44,175099.55,50415.11
9032,1964-01-30,76.7,0.07,0.09,77.11,-0.53,True,1,2286,-76.7,-124761.14,175336.2,50575.06
9033,1964-01-31,77.04,0.34,0.44,77.11,-0.09,True,1,2287,-77.04,-124838.18,176190.48,51352.3
9034,1964-02-03,76.97,-0.07,-0.09,77.11,-0.18,True,1,2288,-76.97,-124915.15,176107.36,51192.21
9035,1964-02-04,76.88,-0.09,-0.12,77.11,-0.3,True,1,2289,-76.88,-124992.03,175978.32,50986.29
9036,1964-02-05,76.75,-0.13,-0.17,77.11,-0.47,True,1,2290,-76.75,-125068.78,175757.5,50688.72
9037,1964-02-06,76.93,0.18,0.24,77.11,-0.23,True,1,2291,-76.93,-125145.71,176246.63,51100.92
9038,1964-02-07,77.18,0.25,0.32,77.18,0.0,True,1,2292,-77.18,-125222.89,176896.56,51673.67
9039,1964-02-10,77.05,-0.13,-0.17,77.18,-0.17,True,1,2293,-77.05,-125299.94,176675.65,51375.71
9040,1964-02-11,77.33,0.28,0.36,77.33,0.0,True,1,2294,-77.33,-125377.27,177395.02,52017.75
9041,1964-02-12,77.57,0.24,0.31,77.57,0.0,True,1,2295,-77.57,-125454.84,178023.15,52568.31
9042,1964-02-13,77.52,-0.05,-0.06,77.57,-0.06,True,1,2296,-77.52,-125532.36,177985.92,52453.56
9043,1964-02-14,77.48,-0.04,-0.05,77.57,-0.12,True,1,2297,-77.48,-125609.84,177971.56,52361.72
9044,1964-02-17,77.46,-0.02,-0.03,77.57,-0.14,True,1,2298,-77.46,-125687.3,178003.08,52315.78
9045,1964-02-18,77.47,0.01,0.01,77.57,-0.13,True,1,2299,-77.47,-125764.77,178103.53,52338.76
9046,1964-02-19,77.55,0.08,0.1,77.57,-0.03,True,1,2300,-77.55,-125842.32,178365.0,52522.68
9047,1964-02-20,77.62,0.07,0.09,77.62,0.0,True,1,2301,-77.62,-125919.94,178603.62,52683.68
9048,1964-02-24,77.68,0.06,0.08,77.68,0.0,True,1,2302,-77.68,-125997.62,178819.36,52821.74
9049,1964-02-25,77.68,0.0,0.0,77.68,0.0,True,1,2303,-77.68,-126075.3,178897.04,52821.74
9050,1964-02-26,77.87,0.19,0.24,77.87,0.0,True,1,2304,-77.87,-126153.17,179412.48,53259.31
9051,1964-02-27,77.62,-0.25,-0.32,77.87,-0.32,True,1,2305,-77.62,-126230.79,178914.1,52683.31
9052,1964-02-28,77.8,0.18,0.23,77.87,-0.09,True,1,2306,-77.8,-126308.59,179406.8,53098.21
9053,1964-03-02,77.97,0.17,0.22,77.97,0.0,True,1,2307,-77.97,-126386.56,179876.79,53490.23
9054,1964-03-03,78.22,0.25,0.32,78.22,0.0,True,1,2308,-78.22,-126464.78,180531.76,54066.98
9055,1964-03-04,78.07,-0.15,-0.19,78.22,-0.19,True,1,2309,-78.07,-126542.85,180263.63,53720.78
9056,1964-03-05,78.06,-0.01,-0.01,78.22,-0.2,True,1,2310,-78.06,-126620.91,180318.6,53697.69
9057,1964-03-06,78.31,0.25,0.32,78.31,0.0,True,1,2311,-78.31,-126699.22,180974.41,54275.19
9058,1964-03-09,78.33,0.02,0.03,78.33,0.0,True,1,2312,-78.33,-126777.55,181098.96,54321.41
9059,1964-03-10,78.59,0.26,0.33,78.59,0.0,True,1,2313,-78.59,-126856.14,181778.67,54922.53
9060,1964-03-11,78.95,0.36,0.46,78.95,0.0,True,1,2314,-78.95,-126935.09,182690.3,55755.21
9061,1964-03-12,79.08,0.13,0.16,79.08,0.0,True,1,2315,-79.08,-127014.17,183070.2,56056.03
9062,1964-03-13,79.14,0.06,0.08,79.14,0.0,True,1,2316,-79.14,-127093.31,183288.24,56194.93
9063,1964-03-16,79.14,0.0,0.0,79.14,0.0,True,1,2317,-79.14,-127172.45,183367.38,56194.93
9064,1964-03-17,79.32,0.18,0.23,79.32,0.0,True,1,2318,-79.32,-127251.77,183863.76,56611.99
9065,1964-03-18,79.38,0.06,0.08,79.38,0.0,True,1,2319,-79.38,-127331.15,184082.22,56751.07
9066,1964-03-19,79.3,-0.08,-0.1,79.38,-0.1,True,1,2320,-79.3,-127410.45,183976.0,56565.55
9067,1964-03-20,78.92,-0.38,-0.48,79.38,-0.58,True,1,2321,-78.92,-127489.37,183173.32,55683.95
9068,1964-03-23,78.93,0.01,0.01,79.38,-0.57,True,1,2322,-78.93,-127568.3,183275.46,55707.16
9069,1964-03-24,78.79,-0.14,-0.18,79.38,-0.74,True,1,2323,-78.79,-127647.09,183029.17,55382.08
9070,1964-03-25,78.98,0.19,0.24,79.38,-0.5,True,1,2324,-78.98,-127726.07,183549.52,55823.45
9071,1964-03-26,79.19,0.21,0.27,79.38,-0.24,True,1,2325,-79.19,-127805.26,184116.75,56311.49
9072,1964-03-30,79.14,-0.05,-0.06,79.38,-0.3,True,1,2326,-79.14,-127884.4,184079.64,56195.24
9073,1964-03-31,78.98,-0.16,-0.2,79.38,-0.5,True,1,2327,-78.98,-127963.38,183786.46,55823.08
9074,1964-04-01,79.24,0.26,0.33,79.38,-0.18,True,1,2328,-79.24,-128042.62,184470.72,56428.1
9075,1964-04-02,79.7,0.46,0.58,79.7,0.0,True,1,2329,-79.7,-128122.32,185621.3,57498.98
9076,1964-04-03,79.94,0.24,0.3,79.94,0.0,True,1,2330,-79.94,-128202.26,186260.2,58057.94
9077,1964-04-06,80.02,0.08,0.1,80.02,0.0,True,1,2331,-80.02,-128282.28,186526.62,58244.34
9078,1964-04-07,79.74,-0.28,-0.35,80.02,-0.35,True,1,2332,-79.74,-128362.02,185953.68,57591.66
9079,1964-04-08,79.75,0.01,0.01,80.02,-0.34,True,1,2333,-79.75,-128441.77,186056.75,57614.98
9080,1964-04-09,79.7,-0.05,-0.06,80.02,-0.4,True,1,2334,-79.7,-128521.47,186019.8,57498.33
9081,1964-04-10,79.85,0.15,0.19,80.02,-0.21,True,1,2335,-79.85,-128601.32,186449.75,57848.43
9082,1964-04-13,79.77,-0.08,-0.1,80.02,-0.31,True,1,2336,-79.77,-128681.09,186342.72,57661.63
9083,1964-04-14,79.99,0.22,0.28,80.02,-0.04,True,1,2337,-79.99,-128761.08,186936.63,58175.55
9084,1964-04-15,80.09,0.1,0.12,80.09,0.0,True,1,2338,-80.09,-128841.17,187250.42,58409.25
9085,1964-04-16,80.2,0.11,0.14,80.2,0.0,True,1,2339,-80.2,-128921.37,187587.8,58666.43
9086,1964-04-17,80.55,0.35,0.44,80.55,0.0,True,1,2340,-80.55,-129001.92,188487.0,59485.08
9087,1964-04-20,80.5,-0.05,-0.06,80.55,-0.06,True,1,2341,-80.5,-129082.42,188450.5,59368.08
9088,1964-04-21,80.54,0.04,0.05,80.55,-0.01,True,1,2342,-80.54,-129162.96,188624.68,59461.72
9089,1964-04-22,80.49,-0.05,-0.06,80.55,-0.07,True,1,2343,-80.49,-129243.45,188588.07,59344.62
9090,1964-04-23,80.38,-0.11,-0.14,80.55,-0.21,True,1,2344,-80.38,-129323.83,188410.72,59086.89
9091,1964-04-24,79.75,-0.63,-0.78,80.55,-0.99,True,1,2345,-79.75,-129403.58,187013.75,57610.17
9092,1964-04-27,79.35,-0.4,-0.5,80.55,-1.49,True,1,2346,-79.35,-129482.93,186155.1,56672.17
9093,1964-04-28,79.9,0.55,0.69,80.55,-0.81,True,1,2347,-79.9,-129562.83,187525.3,57962.47
9094,1964-04-29,79.7,-0.2,-0.25,80.55,-1.06,True,1,2348,-79.7,-129642.53,187135.6,57493.07
9095,1964-04-30,79.46,-0.24,-0.3,80.55,-1.35,True,1,2349,-79.46,-129721.99,186651.54,56929.55
9096,1964-05-01,80.17,0.71,0.89,80.55,-0.47,True,1,2350,-80.17,-129802.16,188399.5,58597.34
9097,1964-05-04,80.47,0.3,0.37,80.55,-0.1,True,1,2351,-80.47,-129882.63,189184.97,59302.34
9098,1964-05-05,80.88,0.41,0.51,80.88,0.0,True,1,2352,-80.88,-129963.51,190229.76,60266.25
9099,1964-05-06,81.06,0.18,0.22,81.06,0.0,True,1,2353,-81.06,-130044.57,190734.18,60689.61
9100,1964-05-07,81.15,0.09,0.11,81.15,0.0,True,1,2354,-81.15,-130125.72,191027.1,60901.38
9101,1964-05-08,81.0,-0.15,-0.18,81.15,-0.18,True,1,2355,-81.0,-130206.72,190755.0,60548.28
9102,1964-05-11,80.9,-0.1,-0.12,81.15,-0.31,True,1,2356,-80.9,-130287.62,190600.4,60312.78
9103,1964-05-12,81.16,0.26,0.32,81.16,0.0,True,1,2357,-81.16,-130368.78,191294.12,60925.34
9104,1964-05-13,80.97,-0.19,-0.23,81.16,-0.23,True,1,2358,-80.97,-130449.75,190927.26,60477.51
9105,1964-05-14,80.86,-0.11,-0.14,81.16,-0.37,True,1,2359,-80.86,-130530.61,190748.74,60218.13
9106,1964-05-15,81.1,0.24,0.3,81.16,-0.07,True,1,2360,-81.1,-130611.71,191396.0,60784.29
9107,1964-05-18,80.72,-0.38,-0.47,81.16,-0.54,True,1,2361,-80.72,-130692.43,190579.92,59887.49
9108,1964-05-19,80.3,-0.42,-0.52,81.16,-1.06,True,1,2362,-80.3,-130772.73,189668.6,58895.87
9109,1964-05-20,80.66,0.36,0.45,81.16,-0.62,True,1,2363,-80.66,-130853.39,190599.58,59746.19
9110,1964-05-21,80.94,0.28,0.35,81.16,-0.27,True,1,2364,-80.94,-130934.33,191342.16,60407.83
9111,1964-05-22,80.73,-0.21,-0.26,81.16,-0.53,True,1,2365,-80.73,-131015.06,190926.45,59911.39
9112,1964-05-25,80.56,-0.17,-0.21,81.16,-0.74,True,1,2366,-80.56,-131095.62,190604.96,59509.34
9113,1964-05-26,80.39,-0.17,-0.21,81.16,-0.95,True,1,2367,-80.39,-131176.01,190283.13,59107.12
9114,1964-05-27,80.26,-0.13,-0.16,81.16,-1.11,True,1,2368,-80.26,-131256.27,190055.68,58799.41
9115,1964-05-28,80.37,0.11,0.14,81.16,-0.97,True,1,2369,-80.37,-131336.64,190396.53,59059.89
9116,1964-06-01,80.11,-0.26,-0.32,81.16,-1.29,True,1,2370,-80.11,-131416.75,189860.7,58443.95
9117,1964-06-02,79.7,-0.41,-0.51,81.16,-1.8,True,1,2371,-79.7,-131496.45,188968.7,57472.25
9118,1964-06-03,79.49,-0.21,-0.26,81.16,-2.06,True,1,2372,-79.49,-131575.94,188550.28,56974.34
9119,1964-06-04,78.67,-0.82,-1.03,81.16,-3.07,True,1,2373,-78.67,-131654.61,186683.91,55029.3
9120,1964-06-05,79.02,0.35,0.44,81.16,-2.64,True,1,2374,-79.02,-131733.63,187593.48,55859.85
9121,1964-06-08,78.64,-0.38,-0.48,81.16,-3.1,True,1,2375,-78.64,-131812.27,186770.0,54957.73
9122,1964-06-09,79.14,0.5,0.64,81.16,-2.49,True,1,2376,-79.14,-131891.41,188036.64,56145.23
9123,1964-06-10,79.44,0.3,0.38,81.16,-2.12,True,1,2377,-79.44,-131970.85,188828.88,56858.03
9124,1964-06-11,79.73,0.29,0.36,81.16,-1.76,True,1,2378,-79.73,-132050.58,189597.94,57547.36
9125,1964-06-12,79.6,-0.13,-0.16,81.16,-1.92,True,1,2379,-79.6,-132130.18,189368.4,57238.22
9126,1964-06-15,79.97,0.37,0.46,81.16,-1.47,True,1,2380,-79.97,-132210.15,190328.6,58118.45
9127,1964-06-16,80.4,0.43,0.54,81.16,-0.94,True,1,2381,-80.4,-132290.55,191432.4,59141.85
9128,1964-06-17,80.81,0.41,0.51,81.16,-0.43,True,1,2382,-80.81,-132371.36,192489.42,60118.06
9129,1964-06-18,80.79,-0.02,-0.02,81.16,-0.46,True,1,2383,-80.79,-132452.15,192522.57,60070.42
9130,1964-06-19,80.89,0.1,0.12,81.16,-0.33,True,1,2384,-80.89,-132533.04,192841.76,60308.72
9131,1964-06-22,81.11,0.22,0.27,81.16,-0.06,True,1,2385,-81.11,-132614.15,193447.35,60833.2
9132,1964-06-23,80.77,-0.34,-0.42,81.16,-0.48,True,1,2386,-80.77,-132694.92,192717.22,60022.3
9133,1964-06-24,81.06,0.29,0.36,81.16,-0.12,True,1,2387,-81.06,-132775.98,193490.22,60714.24
9134,1964-06-25,81.21,0.15,0.18,81.21,0.0,True,1,2388,-81.21,-132857.19,193929.48,61072.29
9135,1964-06-26,81.46,0.25,0.31,81.46,0.0,True,1,2389,-81.46,-132938.65,194607.94,61669.29
9136,1964-06-29,81.64,0.18,0.22,81.64,0.0,True,1,2390,-81.64,-133020.29,195119.6,62099.31
9137,1964-06-30,81.69,0.05,0.06,81.69,0.0,True,1,2391,-81.69,-133101.98,195320.79,62218.81
9138,1964-07-01,82.27,0.58,0.71,82.27,0.0,True,1,2392,-82.27,-133184.25,196789.84,63605.59
9139,1964-07-02,82.6,0.33,0.4,82.6,0.0,True,1,2393,-82.6,-133266.85,197661.8,64394.95
9140,1964-07-06,82.98,0.38,0.46,82.98,0.0,True,1,2394,-82.98,-133349.83,198654.12,65304.29
9141,1964-07-07,83.12,0.14,0.17,83.12,0.0,True,1,2395,-83.12,-133432.95,199072.4,65639.45
9142,1964-07-08,83.12,0.0,0.0,83.12,0.0,True,1,2396,-83.12,-133516.07,199155.52,65639.45
9143,1964-07-09,83.22,0.1,0.12,83.22,0.0,True,1,2397,-83.22,-133599.29,199478.34,65879.05
9144,1964-07-10,83.36,0.14,0.17,83.36,0.0,True,1,2398,-83.36,-133682.65,199897.28,66214.63
9145,1964-07-13,83.31,-0.05,-0.06,83.36,-0.06,True,1,2399,-83.31,-133765.96,199860.69,66094.73
9146,1964-07-14,83.06,-0.25,-0.3,83.36,-0.36,True,1,2400,-83.06,-133849.02,199344.0,65494.98
9147,1964-07-15,83.34,0.28,0.34,83.36,-0.02,True,1,2401,-83.34,-133932.36,200099.34,66166.98
9148,1964-07-16,83.64,0.3,0.36,83.64,0.0,True,1,2402,-83.64,-134016.0,200903.28,66887.28
9149,1964-07-17,84.01,0.37,0.44,84.01,0.0,True,1,2403,-84.01,-134100.01,201876.03,67776.02
9150,1964-07-20,83.74,-0.27,-0.32,84.01,-0.32,True,1,2404,-83.74,-134183.75,201310.96,67127.21
9151,1964-07-21,83.54,-0.2,-0.24,84.01,-0.56,True,1,2405,-83.54,-134267.29,200913.7,66646.41
9152,1964-07-22,83.52,-0.02,-0.02,84.01,-0.58,True,1,2406,-83.52,-134350.81,200949.12,66598.31
9153,1964-07-23,83.48,-0.04,-0.05,84.01,-0.63,True,1,2407,-83.48,-134434.29,200936.36,66502.07
9154,1964-07-24,83.46,-0.02,-0.02,84.01,-0.66,True,1,2408,-83.46,-134517.75,200971.68,66453.93
9155,1964-07-27,83.08,-0.38,-0.46,84.01,-1.11,True,1,2409,-83.08,-134600.83,200139.72,65538.89
9156,1964-07-28,82.85,-0.23,-0.28,84.01,-1.38,True,1,2410,-82.85,-134683.68,199668.5,64984.82
9157,1964-07-29,82.92,0.07,0.08,84.01,-1.3,True,1,2411,-82.92,-134766.6,199920.12,65153.52
9158,1964-07-30,83.09,0.17,0.2,84.01,-1.1,True,1,2412,-83.09,-134849.69,200413.08,65563.39
9159,1964-07-31,83.18,0.09,0.11,84.01,-0.99,True,1,2413,-83.18,-134932.87,200713.34,65780.47
9160,1964-08-03,83.0,-0.18,-0.22,84.01,-1.2,True,1,2414,-83.0,-135015.87,200362.0,65346.13
9161,1964-08-04,81.96,-1.04,-1.25,84.01,-2.44,True,1,2415,-81.96,-135097.83,197933.4,62835.57
9162,1964-08-05,82.09,0.13,0.16,84.01,-2.28,True,1,2416,-82.09,-135179.92,198329.44,63149.52
9163,1964-08-06,81.34,-0.75,-0.91,84.01,-3.18,True,1,2417,-81.34,-135261.26,196598.78,61337.52
9164,1964-08-07,81.86,0.52,0.64,84.01,-2.56,True,1,2418,-81.86,-135343.12,197937.48,62594.36
9165,1964-08-10,81.78,-0.08,-0.1,84.01,-2.65,True,1,2419,-81.78,-135424.9,197825.82,62400.92
9166,1964-08-11,81.76,-0.02,-0.02,84.01,-2.68,True,1,2420,-81.76,-135506.66,197859.2,62352.54
9167,1964-08-12,82.17,0.41,0.5,84.01,-2.19,True,1,2421,-82.17,-135588.83,198933.57,63344.74
9168,1964-08-13,82.41,0.24,0.29,84.01,-1.9,True,1,2422,-82.41,-135671.24,199597.02,63925.78
9169,1964-08-14,82.35,-0.06,-0.07,84.01,-1.98,True,1,2423,-82.35,-135753.59,199534.05,63780.46
9170,1964-08-17,82.36,0.01,0.01,84.01,-1.96,True,1,2424,-82.36,-135835.95,199640.64,63804.69
9171,1964-08-18,82.4,0.04,0.05,84.01,-1.92,True,1,2425,-82.4,-135918.35,199820.0,63901.65
9172,1964-08-19,82.32,-0.08,-0.1,84.01,-2.01,True,1,2426,-82.32,-136000.67,199708.32,63707.65
9173,1964-08-20,81.94,-0.38,-0.46,84.01,-2.46,True,1,2427,-81.94,-136082.61,198868.38,62785.77
9174,1964-08-21,82.07,0.13,0.16,84.01,-2.31,True,1,2428,-82.07,-136164.68,199265.96,63101.28
9175,1964-08-24,81.91,-0.16,-0.2,84.01,-2.5,True,1,2429,-81.91,-136246.59,198959.39,62712.8
9176,1964-08-25,81.44,-0.47,-0.57,84.01,-3.06,True,1,2430,-81.44,-136328.03,197899.2,61571.17
9177,1964-08-26,81.32,-0.12,-0.15,84.01,-3.2,True,1,2431,-81.32,-136409.35,197688.92,61279.57
9178,1964-08-27,81.7,0.38,0.47,84.01,-2.75,True,1,2432,-81.7,-136491.05,198694.4,62203.35
9179,1964-08-28,81.99,0.29,0.36,84.01,-2.4,True,1,2433,-81.99,-136573.04,199481.67,62908.63
9180,1964-08-31,81.83,-0.16,-0.2,84.01,-2.6,True,1,2434,-81.83,-136654.87,199174.22,62519.35
9181,1964-09-01,82.18,0.35,0.43,84.01,-2.18,True,1,2435,-82.18,-136737.05,200108.3,63371.25
9182,1964-09-02,82.31,0.13,0.16,84.01,-2.02,True,1,2436,-82.31,-136819.36,200507.16,63687.8
9183,1964-09-03,82.56,0.25,0.3,84.01,-1.73,True,1,2437,-82.56,-136901.92,201198.72,64296.8
9184,1964-09-04,82.76,0.2,0.24,84.01,-1.49,True,1,2438,-82.76,-136984.68,201768.88,64784.2
9185,1964-09-08,82.87,0.11,0.13,84.01,-1.36,True,1,2439,-82.87,-137067.55,202119.93,65052.38
9186,1964-09-09,83.05,0.18,0.22,84.01,-1.14,True,1,2440,-83.05,-137150.6,202642.0,65491.4
9187,1964-09-10,83.1,0.05,0.06,84.01,-1.08,True,1,2441,-83.1,-137233.7,202847.1,65613.4
9188,1964-09-11,83.45,0.35,0.42,84.01,-0.67,True,1,2442,-83.45,-137317.15,203784.9,66467.75
9189,1964-09-14,83.22,-0.23,-0.28,84.01,-0.94,True,1,2443,-83.22,-137400.37,203306.46,65906.09
9190,1964-09-15,83.0,-0.22,-0.26,84.01,-1.2,True,1,2444,-83.0,-137483.37,202852.0,65368.63
9191,1964-09-16,83.24,0.24,0.29,84.01,-0.92,True,1,2445,-83.24,-137566.61,203521.8,65955.19
9192,1964-09-17,83.79,0.55,0.66,84.01,-0.26,True,1,2446,-83.79,-137650.4,204950.34,67299.94
9193,1964-09-18,83.48,-0.31,-0.37,84.01,-0.63,True,1,2447,-83.48,-137733.88,204275.56,66541.68
9194,1964-09-21,83.86,0.38,0.46,84.01,-0.18,True,1,2448,-83.86,-137817.74,205289.28,67471.54
9195,1964-09-22,83.89,0.03,0.04,84.01,-0.14,True,1,2449,-83.89,-137901.63,205446.61,67544.98
9196,1964-09-23,83.91,0.02,0.02,84.01,-0.12,True,1,2450,-83.91,-137985.54,205579.5,67593.96
9197,1964-09-24,84.0,0.09,0.11,84.01,-0.01,True,1,2451,-84.0,-138069.54,205884.0,67814.46
9198,1964-09-25,84.21,0.21,0.25,84.21,0.0,True,1,2452,-84.21,-138153.75,206482.92,68329.17
9199,1964-09-28,84.28,0.07,0.08,84.28,0.0,True,1,2453,-84.28,-138238.03,206738.84,68500.81
9200,1964-09-29,84.24,-0.04,-0.05,84.28,-0.05,True,1,2454,-84.24,-138322.27,206724.96,68402.69
9201,1964-09-30,84.18,-0.06,-0.07,84.28,-0.12,True,1,2455,-84.18,-138406.45,206661.9,68255.45
9202,1964-10-01,84.08,-0.1,-0.12,84.28,-0.24,True,1,2456,-84.08,-138490.53,206500.48,68009.95
9203,1964-10-02,84.36,0.28,0.33,84.36,0.0,True,1,2457,-84.36,-138574.89,207272.52,68697.63
9204,1964-10-05,84.74,0.38,0.45,84.74,0.0,True,1,2458,-84.74,-138659.63,208290.92,69631.29
9205,1964-10-06,84.79,0.05,0.06,84.79,0.0,True,1,2459,-84.79,-138744.42,208498.61,69754.19
9206,1964-10-07,84.8,0.01,0.01,84.8,0.0,True,1,2460,-84.8,-138829.22,208608.0,69778.78
9207,1964-10-08,85.04,0.24,0.28,85.04,0.0,True,1,2461,-85.04,-138914.26,209283.44,70369.18
9208,1964-10-09,85.22,0.18,0.21,85.22,0.0,True,1,2462,-85.22,-138999.48,209811.64,70812.16
9209,1964-10-12,85.24,0.02,0.02,85.24,0.0,True,1,2463,-85.24,-139084.72,209946.12,70861.4
9210,1964-10-13,84.96,-0.28,-0.33,85.24,-0.33,True,1,2464,-84.96,-139169.68,209341.44,70171.76
9211,1964-10-14,84.79,-0.17,-0.2,85.24,-0.53,True,1,2465,-84.79,-139254.47,209007.35,69752.88
9212,1964-10-15,84.25,-0.54,-0.64,85.24,-1.16,True,1,2466,-84.25,-139338.72,207760.5,68421.78
9213,1964-10-16,84.83,0.58,0.69,85.24,-0.48,True,1,2467,-84.83,-139423.55,209275.61,69852.06
9214,1964-10-19,84.93,0.1,0.12,85.24,-0.36,True,1,2468,-84.93,-139508.48,209607.24,70098.76
9215,1964-10-20,85.18,0.25,0.29,85.24,-0.07,True,1,2469,-85.18,-139593.66,210309.42,70715.76
9216,1964-10-21,85.1,-0.08,-0.09,85.24,-0.16,True,1,2470,-85.1,-139678.76,210197.0,70518.24
9217,1964-10-22,84.94,-0.16,-0.19,85.24,-0.35,True,1,2471,-84.94,-139763.7,209886.74,70123.04
9218,1964-10-23,85.14,0.2,0.24,85.24,-0.12,True,1,2472,-85.14,-139848.84,210466.08,70617.24
9219,1964-10-26,85.0,-0.14,-0.16,85.24,-0.28,True,1,2473,-85.0,-139933.84,210205.0,70271.16
9220,1964-10-27,85.0,0.0,0.0,85.24,-0.28,True,1,2474,-85.0,-140018.84,210290.0,70271.16
9221,1964-10-28,84.69,-0.31,-0.36,85.24,-0.64,True,1,2475,-84.69,-140103.53,209607.75,69504.22
9222,1964-10-29,84.73,0.04,0.05,85.24,-0.6,True,1,2476,-84.73,-140188.26,209791.48,69603.22
9223,1964-10-30,84.86,0.13,0.15,85.24,-0.45,True,1,2477,-84.86,-140273.12,210198.22,69925.1
9224,1964-11-02,85.18,0.32,0.38,85.24,-0.07,True,1,2478,-85.18,-140358.3,211076.04,70717.74
9225,1964-11-04,85.14,-0.04,-0.05,85.24,-0.12,True,1,2479,-85.14,-140443.44,211062.06,70618.62
9226,1964-11-05,85.16,0.02,0.02,85.24,-0.09,True,1,2480,-85.16,-140528.6,211196.8,70668.2
9227,1964-11-06,85.23,0.07,0.08,85.24,-0.01,True,1,2481,-85.23,-140613.83,211455.63,70841.8
9228,1964-11-09,85.19,-0.04,-0.05,85.24,-0.06,True,1,2482,-85.19,-140699.02,211441.58,70742.56
9229,1964-11-10,84.84,-0.35,-0.41,85.24,-0.47,True,1,2483,-84.84,-140783.86,210657.72,69873.86
9230,1964-11-11,85.08,0.24,0.28,85.24,-0.19,True,1,2484,-85.08,-140868.94,211338.72,70469.78
9231,1964-11-12,85.19,0.11,0.13,85.24,-0.06,True,1,2485,-85.19,-140954.13,211697.15,70743.02
9232,1964-11-13,85.21,0.02,0.02,85.24,-0.04,True,1,2486,-85.21,-141039.34,211832.06,70792.72
9233,1964-11-16,85.65,0.44,0.52,85.65,0.0,True,1,2487,-85.65,-141124.99,213011.55,71886.56
9234,1964-11-17,86.03,0.38,0.44,86.03,0.0,True,1,2488,-86.03,-141211.02,214042.64,72831.62
9235,1964-11-18,86.22,0.19,0.22,86.22,0.0,True,1,2489,-86.22,-141297.24,214601.58,73304.34
9236,1964-11-19,86.18,-0.04,-0.05,86.22,-0.05,True,1,2490,-86.18,-141383.42,214588.2,73204.78
9237,1964-11-20,86.28,0.1,0.12,86.28,0.0,True,1,2491,-86.28,-141469.7,214923.48,73453.78
9238,1964-11-23,86.0,-0.28,-0.32,86.28,-0.32,True,1,2492,-86.0,-141555.7,214312.0,72756.3
9239,1964-11-24,85.73,-0.27,-0.31,86.28,-0.64,True,1,2493,-85.73,-141641.43,213724.89,72083.46
9240,1964-11-25,85.44,-0.29,-0.34,86.28,-0.97,True,1,2494,-85.44,-141726.87,213087.36,71360.49
9241,1964-11-27,85.16,-0.28,-0.33,86.28,-1.3,True,1,2495,-85.16,-141812.03,212474.2,70662.17
9242,1964-11-30,84.42,-0.74,-0.87,86.28,-2.16,True,1,2496,-84.42,-141896.45,210712.32,68815.87
9243,1964-12-01,83.55,-0.87,-1.03,86.28,-3.16,True,1,2497,-83.55,-141980.0,208624.35,66644.35
9244,1964-12-02,83.79,0.24,0.29,86.28,-2.89,True,1,2498,-83.79,-142063.79,209307.42,67243.63
9245,1964-12-03,84.18,0.39,0.46,86.28,-2.43,True,1,2499,-84.18,-142147.97,210365.82,68217.85
9246,1964-12-04,84.35,0.17,0.2,86.28,-2.24,True,1,2500,-84.35,-142232.32,210875.0,68642.68
9247,1964-12-07,84.33,-0.02,-0.02,86.28,-2.26,True,1,2501,-84.33,-142316.65,210909.33,68592.68
9248,1964-12-08,84.0,-0.33,-0.39,86.28,-2.64,True,1,2502,-84.0,-142400.65,210168.0,67767.35
9249,1964-12-09,83.46,-0.54,-0.64,86.28,-3.27,True,1,2503,-83.46,-142484.11,208900.38,66416.27
9250,1964-12-10,83.45,-0.01,-0.01,86.28,-3.28,True,1,2504,-83.45,-142567.56,208958.8,66391.24
9251,1964-12-11,83.66,0.21,0.25,86.28,-3.04,True,1,2505,-83.66,-142651.22,209568.3,66917.08
9252,1964-12-14,83.45,-0.21,-0.25,86.28,-3.28,True,1,2506,-83.45,-142734.67,209125.7,66391.03
9253,1964-12-15,83.22,-0.23,-0.28,86.28,-3.55,True,1,2507,-83.22,-142817.89,208632.54,65814.65
9254,1964-12-16,83.55,0.33,0.4,86.28,-3.16,True,1,2508,-83.55,-142901.44,209543.4,66641.96
9255,1964-12-17,83.9,0.35,0.42,86.28,-2.76,True,1,2509,-83.9,-142985.34,210505.1,67519.76
9256,1964-12-18,84.29,0.39,0.46,86.28,-2.31,True,1,2510,-84.29,-143069.63,211567.9,68498.27
9257,1964-12-21,84.38,0.09,0.11,86.28,-2.2,True,1,2511,-84.38,-143154.01,211878.18,68724.17
9258,1964-12-22,84.33,-0.05,-0.06,86.28,-2.26,True,1,2512,-84.33,-143238.34,211836.96,68598.62
9259,1964-12-23,84.15,-0.18,-0.21,86.28,-2.47,True,1,2513,-84.15,-143322.49,211468.95,68146.46
9260,1964-12-24,84.15,0.0,0.0,86.28,-2.47,True,1,2514,-84.15,-143406.64,211553.1,68146.46
9261,1964-12-28,84.07,-0.08,-0.1,86.28,-2.56,True,1,2515,-84.07,-143490.71,211436.05,67945.34
9262,1964-12-29,83.81,-0.26,-0.31,86.28,-2.86,True,1,2516,-83.81,-143574.52,210865.96,67291.44
9263,1964-12-30,84.3,0.49,0.58,86.28,-2.3,True,1,2517,-84.3,-143658.82,212183.1,68524.28
9264,1964-12-31,84.75,0.45,0.53,86.28,-1.77,True,1,2518,-84.75,-143743.57,213400.5,69656.93
9265,1965-01-04,84.23,-0.52,-0.61,86.28,-2.38,True,1,2519,-84.23,-143827.8,212175.37,68347.57
9266,1965-01-05,84.63,0.4,0.48,86.28,-1.91,True,1,2520,-84.63,-143912.43,213267.6,69355.17
9267,1965-01-06,84.89,0.26,0.31,86.28,-1.61,True,1,2521,-84.89,-143997.32,214007.69,70010.37
9268,1965-01-07,85.26,0.37,0.44,86.28,-1.18,True,1,2522,-85.26,-144082.58,215025.72,70943.14
9269,1965-01-08,85.37,0.11,0.13,86.28,-1.06,True,1,2523,-85.37,-144167.95,215388.51,71220.56
9270,1965-01-11,85.4,0.03,0.04,86.28,-1.02,True,1,2524,-85.4,-144253.35,215549.6,71296.25
9271,1965-01-12,85.61,0.21,0.25,86.28,-0.78,True,1,2525,-85.61,-144338.96,216165.25,71826.29
9272,1965-01-13,85.84,0.23,0.27,86.28,-0.51,True,1,2526,-85.84,-144424.8,216831.84,72407.04
9273,1965-01-14,85.84,0.0,0.0,86.28,-0.51,True,1,2527,-85.84,-144510.64,216917.68,72407.04
9274,1965-01-15,86.21,0.37,0.43,86.28,-0.08,True,1,2528,-86.21,-144596.85,217938.88,73342.03
9275,1965-01-18,86.49,0.28,0.32,86.49,0.0,True,1,2529,-86.49,-144683.34,218733.21,74049.87
9276,1965-01-19,86.63,0.14,0.16,86.63,0.0,True,1,2530,-86.63,-144769.97,219173.9,74403.93
9277,1965-01-20,86.6,-0.03,-0.04,86.63,-0.04,True,1,2531,-86.6,-144856.57,219184.6,74328.03
9278,1965-01-21,86.52,-0.08,-0.09,86.63,-0.13,True,1,2532,-86.52,-144943.09,219068.64,74125.55
9279,1965-01-22,86.74,0.22,0.25,86.74,0.0,True,1,2533,-86.74,-145029.83,219712.42,74682.59
9280,1965-01-25,86.86,0.12,0.14,86.86,0.0,True,1,2534,-86.86,-145116.69,220103.24,74986.55
9281,1965-01-26,86.94,0.08,0.09,86.94,0.0,True,1,2535,-86.94,-145203.63,220392.9,75189.27
9282,1965-01-27,87.23,0.29,0.33,87.23,0.0,True,1,2536,-87.23,-145290.86,221215.28,75924.42
9283,1965-01-28,87.48,0.25,0.29,87.48,0.0,True,1,2537,-87.48,-145378.34,221936.76,76558.42
9284,1965-01-29,87.56,0.08,0.09,87.56,0.0,True,1,2538,-87.56,-145465.9,222227.28,76761.38
9285,1965-02-01,87.58,0.02,0.02,87.58,0.0,True,1,2539,-87.58,-145553.48,222365.62,76812.14
9286,1965-02-02,87.55,-0.03,-0.03,87.58,-0.03,True,1,2540,-87.55,-145641.03,222377.0,76735.97
9287,1965-02-03,87.63,0.08,0.09,87.63,0.0,True,1,2541,-87.63,-145728.66,222667.83,76939.17
9288,1965-02-04,87.57,-0.06,-0.07,87.63,-0.07,True,1,2542,-87.57,-145816.23,222602.94,76786.71
9289,1965-02-05,87.29,-0.28,-0.32,87.63,-0.39,True,1,2543,-87.29,-145903.52,221978.47,76074.95
9290,1965-02-08,86.95,-0.34,-0.39,87.63,-0.78,True,1,2544,-86.95,-145990.47,221200.8,75210.33
9291,1965-02-09,87.24,0.29,0.33,87.63,-0.44,True,1,2545,-87.24,-146077.71,222025.8,75948.09
9292,1965-02-10,86.46,-0.78,-0.89,87.63,-1.34,True,1,2546,-86.46,-146164.17,220127.16,73962.99
9293,1965-02-11,85.54,-0.92,-1.06,87.63,-2.38,True,1,2547,-85.54,-146249.71,217870.38,71620.67
9294,1965-02-12,86.17,0.63,0.74,87.63,-1.67,True,1,2548,-86.17,-146335.88,219561.16,73225.28
9295,1965-02-15,86.07,-0.1,-0.12,87.63,-1.78,True,1,2549,-86.07,-146421.95,219392.43,72970.48
9296,1965-02-16,85.67,-0.4,-0.46,87.63,-2.24,True,1,2550,-85.67,-146507.62,218458.5,71950.88
9297,1965-02-17,85.77,0.1,0.12,87.63,-2.12,True,1,2551,-85.77,-146593.39,218799.27,72205.88
9298,1965-02-18,86.05,0.28,0.33,87.63,-1.8,True,1,2552,-86.05,-146679.44,219599.6,72920.16
9299,1965-02-19,86.21,0.16,0.19,87.63,-1.62,True,1,2553,-86.21,-146765.65,220094.13,73328.48
9300,1965-02-23,86.64,0.43,0.5,87.63,-1.13,True,1,2554,-86.64,-146852.29,221278.56,74426.27
9301,1965-02-24,87.17,0.53,0.61,87.63,-0.52,True,1,2555,-87.17,-146939.46,222719.35,75779.89
9302,1965-02-25,87.2,0.03,0.03,87.63,-0.49,True,1,2556,-87.2,-147026.66,222883.2,75856.54
9303,1965-02-26,87.43,0.23,0.26,87.63,-0.23,True,1,2557,-87.43,-147114.09,223558.51,76444.42
9304,1965-03-01,87.25,-0.18,-0.21,87.63,-0.43,True,1,2558,-87.25,-147201.34,223185.5,75984.16
9305,1965-03-02,87.4,0.15,0.17,87.63,-0.26,True,1,2559,-87.4,-147288.74,223656.6,76367.86
9306,1965-03-03,87.26,-0.14,-0.16,87.63,-0.42,True,1,2560,-87.26,-147376.0,223385.6,76009.6
9307,1965-03-04,86.98,-0.28,-0.32,87.63,-0.74,True,1,2561,-86.98,-147462.98,222755.78,75292.8
9308,1965-03-05,86.8,-0.18,-0.21,87.63,-0.95,True,1,2562,-86.8,-147549.78,222381.6,74831.82
9309,1965-03-08,86.83,0.03,0.04,87.63,-0.91,True,1,2563,-86.83,-147636.61,222545.29,74908.68
9310,1965-03-09,86.69,-0.14,-0.16,87.63,-1.07,True,1,2564,-86.69,-147723.3,222273.16,74549.86
9311,1965-03-10,86.54,-0.15,-0.17,87.63,-1.24,True,1,2565,-86.54,-147809.84,221975.1,74165.26
9312,1965-03-11,86.9,0.36,0.42,87.63,-0.83,True,1,2566,-86.9,-147896.74,222985.4,75088.66
9313,1965-03-12,87.21,0.31,0.36,87.63,-0.48,True,1,2567,-87.21,-147983.95,223868.07,75884.12
9314,1965-03-15,87.24,0.03,0.03,87.63,-0.44,True,1,2568,-87.24,-148071.19,224032.32,75961.13
9315,1965-03-16,87.13,-0.11,-0.13,87.63,-0.57,True,1,2569,-87.13,-148158.32,223836.97,75678.65
9316,1965-03-17,87.02,-0.11,-0.13,87.63,-0.7,True,1,2570,-87.02,-148245.34,223641.4,75396.06
9317,1965-03-18,86.81,-0.21,-0.24,87.63,-0.94,True,1,2571,-86.81,-148332.15,223188.51,74856.36
9318,1965-03-19,86.84,0.03,0.04,87.63,-0.9,True,1,2572,-86.84,-148418.99,223352.48,74933.49
9319,1965-03-22,86.83,-0.01,-0.01,87.63,-0.91,True,1,2573,-86.83,-148505.82,223413.59,74907.77
9320,1965-03-23,86.93,0.1,0.12,87.63,-0.8,True,1,2574,-86.93,-148592.75,223757.82,75165.07
9321,1965-03-24,87.09,0.16,0.18,87.63,-0.62,True,1,2575,-87.09,-148679.84,224256.75,75576.91
9322,1965-03-25,86.84,-0.25,-0.29,87.63,-0.9,True,1,2576,-86.84,-148766.68,223699.84,74933.16
9323,1965-03-26,86.2,-0.64,-0.74,87.63,-1.63,True,1,2577,-86.2,-148852.88,222137.4,73284.52
9324,1965-03-29,86.03,-0.17,-0.2,87.63,-1.83,True,1,2578,-86.03,-148938.91,221785.34,72846.43
9325,1965-03-30,86.2,0.17,0.2,87.63,-1.63,True,1,2579,-86.2,-149025.11,222309.8,73284.69
9326,1965-03-31,86.16,-0.04,-0.05,87.63,-1.68,True,1,2580,-86.16,-149111.27,222292.8,73181.53
9327,1965-04-01,86.32,0.16,0.19,87.63,-1.5,True,1,2581,-86.32,-149197.59,222791.92,73594.33
9328,1965-04-02,86.53,0.21,0.24,87.63,-1.25,True,1,2582,-86.53,-149284.12,223420.46,74136.34
9329,1965-04-05,86.53,0.0,0.0,87.63,-1.25,True,1,2583,-86.53,-149370.65,223506.99,74136.34
9330,1965-04-06,86.5,-0.03,-0.04,87.63,-1.29,True,1,2584,-86.5,-149457.15,223516.0,74058.85
9331,1965-04-07,86.55,0.05,0.06,87.63,-1.23,True,1,2585,-86.55,-149543.7,223731.75,74188.05
9332,1965-04-08,87.04,0.49,0.57,87.63,-0.67,True,1,2586,-87.04,-149630.74,225085.44,75454.7
9333,1965-04-09,87.56,0.52,0.6,87.63,-0.08,True,1,2587,-87.56,-149718.3,226517.72,76799.42
9334,1965-04-12,87.94,0.38,0.43,87.94,0.0,True,1,2588,-87.94,-149806.24,227588.72,77782.48
9335,1965-04-13,88.04,0.1,0.11,88.04,0.0,True,1,2589,-88.04,-149894.28,227935.56,78041.28
9336,1965-04-14,88.24,0.2,0.23,88.24,0.0,True,1,2590,-88.24,-149982.52,228541.6,78559.08
9337,1965-04-15,88.15,-0.09,-0.1,88.24,-0.1,True,1,2591,-88.15,-150070.67,228396.65,78325.98
9338,1965-04-19,88.51,0.36,0.41,88.51,0.0,True,1,2592,-88.51,-150159.18,229417.92,79258.74
9339,1965-04-20,88.46,-0.05,-0.06,88.51,-0.06,True,1,2593,-88.46,-150247.64,229376.78,79129.14
9340,1965-04-21,88.3,-0.16,-0.18,88.51,-0.24,True,1,2594,-88.3,-150335.94,229050.2,78714.26
9341,1965-04-22,88.78,0.48,0.54,88.78,0.0,True,1,2595,-88.78,-150424.72,230384.1,79959.38
9342,1965-04-23,88.88,0.1,0.11,88.88,0.0,True,1,2596,-88.88,-150513.6,230732.48,80218.88
9343,1965-04-26,88.89,0.01,0.01,88.89,0.0,True,1,2597,-88.89,-150602.49,230847.33,80244.84
9344,1965-04-27,89.04,0.15,0.17,89.04,0.0,True,1,2598,-89.04,-150691.53,231325.92,80634.39
9345,1965-04-28,89.0,-0.04,-0.04,89.04,-0.04,True,1,2599,-89.0,-150780.53,231311.0,80530.47
9346,1965-04-29,88.93,-0.07,-0.08,89.04,-0.12,True,1,2600,-88.93,-150869.46,231218.0,80348.54
9347,1965-04-30,89.11,0.18,0.2,89.11,0.0,True,1,2601,-89.11,-150958.57,231775.11,80816.54
9348,1965-05-03,89.23,0.12,0.14,89.23,0.0,True,1,2602,-89.23,-151047.8,232176.46,81128.66
9349,1965-05-04,89.51,0.28,0.31,89.51,0.0,True,1,2603,-89.51,-151137.31,232994.53,81857.22
9350,1965-05-05,89.71,0.2,0.22,89.71,0.0,True,1,2604,-89.71,-151227.02,233604.84,82377.82
9351,1965-05-06,89.92,0.21,0.23,89.92,0.0,True,1,2605,-89.92,-151316.94,234241.6,82924.66
9352,1965-05-07,89.85,-0.07,-0.08,89.92,-0.08,True,1,2606,-89.85,-151406.79,234149.1,82742.31
9353,1965-05-10,89.66,-0.19,-0.21,89.92,-0.29,True,1,2607,-89.66,-151496.45,233743.62,82247.17
9354,1965-05-11,89.55,-0.11,-0.12,89.92,-0.41,True,1,2608,-89.55,-151586.0,233546.4,81960.4
9355,1965-05-12,89.94,0.39,0.44,89.94,0.0,True,1,2609,-89.94,-151675.94,234653.46,82977.52
9356,1965-05-13,90.27,0.33,0.37,90.27,0.0,True,1,2610,-90.27,-151766.21,235604.7,83838.49
9357,1965-05-14,90.1,-0.17,-0.19,90.27,-0.19,True,1,2611,-90.1,-151856.31,235251.1,83394.79
9358,1965-05-17,89.54,-0.56,-0.62,90.27,-0.81,True,1,2612,-89.54,-151945.85,233878.48,81932.63
9359,1965-05-18,89.46,-0.08,-0.09,90.27,-0.9,True,1,2613,-89.46,-152035.31,233758.98,81723.67
9360,1965-05-19,89.67,0.21,0.24,90.27,-0.66,True,1,2614,-89.67,-152124.98,234397.38,82272.4
9361,1965-05-20,89.18,-0.49,-0.55,90.27,-1.21,True,1,2615,-89.18,-152214.16,233205.7,80991.54
9362,1965-05-21,88.75,-0.43,-0.48,90.27,-1.68,True,1,2616,-88.75,-152302.91,232170.0,79867.09
9363,1965-05-24,88.09,-0.66,-0.74,90.27,-2.42,True,1,2617,-88.09,-152391.0,230531.53,78140.53
9364,1965-05-25,88.6,0.51,0.58,90.27,-1.85,True,1,2618,-88.6,-152479.6,231954.8,79475.2
9365,1965-05-26,88.3,-0.3,-0.34,90.27,-2.18,True,1,2619,-88.3,-152567.9,231257.7,78689.8
9366,1965-05-27,87.84,-0.46,-0.52,90.27,-2.69,True,1,2620,-87.84,-152655.74,230140.8,77485.06
9367,1965-05-28,88.42,0.58,0.66,90.27,-2.05,True,1,2621,-88.42,-152744.16,231748.82,79004.66
9368,1965-06-01,88.72,0.3,0.34,90.27,-1.72,True,1,2622,-88.72,-152832.88,232623.84,79790.96
9369,1965-06-02,87.09,-1.63,-1.84,90.27,-3.52,True,1,2623,-87.09,-152919.97,228437.07,75517.1
9370,1965-06-03,86.9,-0.19,-0.22,90.27,-3.73,True,1,2624,-86.9,-153006.87,228025.6,75018.73
9371,1965-06-04,87.11,0.21,0.24,90.27,-3.5,True,1,2625,-87.11,-153093.98,228663.75,75569.77
9372,1965-06-07,86.88,-0.23,-0.26,90.27,-3.76,True,1,2626,-86.88,-153180.86,228146.88,74966.02
9373,1965-06-08,85.93,-0.95,-1.09,90.27,-4.81,True,1,2627,-85.93,-153266.79,225738.11,72471.32
9374,1965-06-09,85.04,-0.89,-1.04,90.27,-5.79,True,1,2628,-85.04,-153351.83,223485.12,70133.29
9375,1965-06-10,84.73,-0.31,-0.36,90.27,-6.14,True,1,2629,-84.73,-153436.56,222755.17,69318.61
9376,1965-06-11,85.12,0.39,0.46,90.27,-5.7,True,1,2630,-85.12,-153521.68,223865.6,70343.92
9377,1965-06-14,84.01,-1.11,-1.3,90.27,-6.94,True,1,2631,-84.01,-153605.69,221030.31,67424.62
9378,1965-06-15,84.49,0.48,0.57,90.27,-6.4,True,1,2632,-84.49,-153690.18,222377.68,68687.5
9379,1965-06-16,85.2,0.71,0.84,90.27,-5.62,True,1,2633,-85.2,-153775.38,224331.6,70556.22
9380,1965-06-17,85.74,0.54,0.63,90.27,-5.02,True,1,2634,-85.74,-153861.12,225839.16,71978.04
9381,1965-06-18,85.34,-0.4,-0.47,90.27,-5.46,True,1,2635,-85.34,-153946.46,224870.9,70924.44
9382,1965-06-21,85.05,-0.29,-0.34,90.27,-5.78,True,1,2636,-85.05,-154031.51,224191.8,70160.29
9383,1965-06-22,85.21,0.16,0.19,90.27,-5.6,True,1,2637,-85.21,-154116.72,224698.77,70582.05
9384,1965-06-23,84.67,-0.54,-0.63,90.27,-6.2,True,1,2638,-84.67,-154201.39,223359.46,69158.07
9385,1965-06-24,83.56,-1.11,-1.31,90.27,-7.43,True,1,2639,-83.56,-154284.95,220514.84,66229.89
9386,1965-06-25,83.06,-0.5,-0.6,90.27,-7.99,True,1,2640,-83.06,-154368.01,219278.4,64910.39
9387,1965-06-28,81.6,-1.46,-1.76,90.27,-9.6,True,1,2641,-81.6,-154449.61,215505.6,61055.99
9388,1965-06-29,82.41,0.81,0.99,90.27,-8.71,True,1,2642,-82.41,-154532.02,217727.22,63195.2
9389,1965-06-30,84.12,1.71,2.08,90.27,-6.81,True,1,2643,-84.12,-154616.14,222329.16,67713.02
9390,1965-07-01,84.48,0.36,0.43,90.27,-6.41,True,1,2644,-84.48,-154700.62,223365.12,68664.5
9391,1965-07-02,85.16,0.68,0.8,90.27,-5.66,True,1,2645,-85.16,-154785.78,225248.2,70462.42
9392,1965-07-06,84.99,-0.17,-0.2,90.27,-5.85,True,1,2646,-84.99,-154870.77,224883.54,70012.77
9393,1965-07-07,84.67,-0.32,-0.38,90.27,-6.2,True,1,2647,-84.67,-154955.44,224121.49,69166.05
9394,1965-07-08,85.39,0.72,0.85,90.27,-5.41,True,1,2648,-85.39,-155040.83,226112.72,71071.89
9395,1965-07-09,85.71,0.32,0.38,90.27,-5.05,True,1,2649,-85.71,-155126.54,227045.79,71919.25
9396,1965-07-12,85.69,-0.02,-0.02,90.27,-5.07,True,1,2650,-85.69,-155212.23,227078.5,71866.27
9397,1965-07-13,85.59,-0.1,-0.12,90.27,-5.18,True,1,2651,-85.59,-155297.82,226899.09,71601.27
9398,1965-07-14,85.87,0.28,0.33,90.27,-4.87,True,1,2652,-85.87,-155383.69,227727.24,72343.55
9399,1965-07-15,85.72,-0.15,-0.18,90.27,-5.04,True,1,2653,-85.72,-155469.41,227415.16,71945.75
9400,1965-07-16,85.69,-0.03,-0.04,90.27,-5.07,True,1,2654,-85.69,-155555.1,227421.26,71866.16
9401,1965-07-19,85.63,-0.06,-0.07,90.27,-5.14,True,1,2655,-85.63,-155640.73,227347.65,71706.92
9402,1965-07-20,84.55,-1.08,-1.26,90.27,-6.34,True,1,2656,-84.55,-155725.28,224564.8,68839.52
9403,1965-07-21,84.07,-0.48,-0.57,90.27,-6.87,True,1,2657,-84.07,-155809.35,223373.99,67564.64
9404,1965-07-22,83.85,-0.22,-0.26,90.27,-7.11,True,1,2658,-83.85,-155893.2,222873.3,66980.1
9405,1965-07-23,84.07,0.22,0.26,90.27,-6.87,True,1,2659,-84.07,-155977.27,223542.13,67564.86
9406,1965-07-26,84.05,-0.02,-0.02,90.27,-6.89,True,1,2660,-84.05,-156061.32,223573.0,67511.68
9407,1965-07-27,83.87,-0.18,-0.21,90.27,-7.09,True,1,2661,-83.87,-156145.19,223178.07,67032.88
9408,1965-07-28,84.03,0.16,0.19,90.27,-6.91,True,1,2662,-84.03,-156229.22,223687.86,67458.64
9409,1965-07-29,84.68,0.65,0.77,90.27,-6.19,True,1,2663,-84.68,-156313.9,225502.84,69188.94
9410,1965-07-30,85.25,0.57,0.67,90.27,-5.56,True,1,2664,-85.25,-156399.15,227106.0,70706.85
9411,1965-08-02,85.42,0.17,0.2,90.27,-5.37,True,1,2665,-85.42,-156484.57,227644.3,71159.73
9412,1965-08-03,85.46,0.04,0.05,90.27,-5.33,True,1,2666,-85.46,-156570.03,227836.36,71266.33
9413,1965-08-04,85.79,0.33,0.39,90.27,-4.96,True,1,2667,-85.79,-156655.82,228801.93,72146.11
9414,1965-08-05,85.79,0.0,0.0,90.27,-4.96,True,1,2668,-85.79,-156741.61,228887.72,72146.11
9415,1965-08-06,86.07,0.28,0.33,90.27,-4.65,True,1,2669,-86.07,-156827.68,229720.83,72893.15
9416,1965-08-09,85.86,-0.21,-0.24,90.27,-4.88,True,1,2670,-85.86,-156913.54,229246.2,72332.66
9417,1965-08-10,85.87,0.01,0.01,90.27,-4.87,True,1,2671,-85.87,-156999.41,229358.77,72359.36
9418,1965-08-11,86.13,0.26,0.3,90.27,-4.59,True,1,2672,-86.13,-157085.54,230139.36,73053.82
9419,1965-08-12,86.38,0.25,0.29,90.27,-4.31,True,1,2673,-86.38,-157171.92,230893.74,73721.82
9420,1965-08-13,86.77,0.39,0.45,90.27,-3.88,True,1,2674,-86.77,-157258.69,232022.98,74764.29
9421,1965-08-16,86.87,0.1,0.12,90.27,-3.77,True,1,2675,-86.87,-157345.56,232377.25,75031.69
9422,1965-08-17,87.04,0.17,0.2,90.27,-3.58,True,1,2676,-87.04,-157432.6,232919.04,75486.44
9423,1965-08-18,86.99,-0.05,-0.06,90.27,-3.63,True,1,2677,-86.99,-157519.59,232872.23,75352.64
9424,1965-08-19,86.79,-0.2,-0.23,90.27,-3.86,True,1,2678,-86.79,-157606.38,232423.62,74817.24
9425,1965-08-20,86.69,-0.1,-0.12,90.27,-3.97,True,1,2679,-86.69,-157693.07,232242.51,74549.44
9426,1965-08-23,86.56,-0.13,-0.15,90.27,-4.11,True,1,2680,-86.56,-157779.63,231980.8,74201.17
9427,1965-08-24,86.71,0.15,0.17,90.27,-3.94,True,1,2681,-86.71,-157866.34,232469.51,74603.17
9428,1965-08-25,86.81,0.1,0.12,90.27,-3.83,True,1,2682,-86.81,-157953.15,232824.42,74871.27
9429,1965-08-26,87.14,0.33,0.38,90.27,-3.47,True,1,2683,-87.14,-158040.29,233796.62,75756.33
9430,1965-08-27,87.2,0.06,0.07,90.27,-3.4,True,1,2684,-87.2,-158127.49,234044.8,75917.31
9431,1965-08-30,87.21,0.01,0.01,90.27,-3.39,True,1,2685,-87.21,-158214.7,234158.85,75944.15
9432,1965-08-31,87.17,-0.04,-0.05,90.27,-3.43,True,1,2686,-87.17,-158301.87,234138.62,75836.75
9433,1965-09-01,87.17,0.0,0.0,90.27,-3.43,True,1,2687,-87.17,-158389.04,234225.79,75836.75
9434,1965-09-02,87.65,0.48,0.55,90.27,-2.9,True,1,2688,-87.65,-158476.69,235603.2,77126.51
9435,1965-09-03,88.06,0.41,0.47,90.27,-2.45,True,1,2689,-88.06,-158564.75,236793.34,78228.59
9436,1965-09-07,88.36,0.3,0.34,90.27,-2.12,True,1,2690,-88.36,-158653.11,237688.4,79035.29
9437,1965-09-08,88.66,0.3,0.34,90.27,-1.78,True,1,2691,-88.66,-158741.77,238584.06,79842.29
9438,1965-09-09,88.89,0.23,0.26,90.27,-1.53,True,1,2692,-88.89,-158830.66,239291.88,80461.22
9439,1965-09-10,89.12,0.23,0.26,90.27,-1.27,True,1,2693,-89.12,-158919.78,240000.16,81080.38
9440,1965-09-13,89.38,0.26,0.29,90.27,-0.99,True,1,2694,-89.38,-159009.16,240789.72,81780.56
9441,1965-09-14,89.03,-0.35,-0.39,90.27,-1.37,True,1,2695,-89.03,-159098.19,239935.85,80837.66
9442,1965-09-15,89.52,0.49,0.55,90.27,-0.83,True,1,2696,-89.52,-159187.71,241345.92,82158.21
9443,1965-09-16,90.02,0.5,0.56,90.27,-0.28,True,1,2697,-90.02,-159277.73,242783.94,83506.21
9444,1965-09-17,90.05,0.03,0.03,90.27,-0.24,True,1,2698,-90.05,-159367.78,242954.9,83587.12
9445,1965-09-20,90.08,0.03,0.03,90.27,-0.21,True,1,2699,-90.08,-159457.86,243125.92,83668.06
9446,1965-09-21,89.81,-0.27,-0.3,90.27,-0.51,True,1,2700,-89.81,-159547.67,242487.0,82939.33
9447,1965-09-22,90.22,0.41,0.46,90.27,-0.06,True,1,2701,-90.22,-159637.89,243684.22,84046.33
9448,1965-09-23,89.86,-0.36,-0.4,90.27,-0.45,True,1,2702,-89.86,-159727.75,242801.72,83073.97
9449,1965-09-24,90.02,0.16,0.18,90.27,-0.28,True,1,2703,-90.02,-159817.77,243324.06,83506.29
9450,1965-09-27,90.65,0.63,0.7,90.65,0.0,True,1,2704,-90.65,-159908.42,245117.6,85209.18
9451,1965-09-28,90.43,-0.22,-0.24,90.65,-0.24,True,1,2705,-90.43,-159998.85,244613.15,84614.3
9452,1965-09-29,90.02,-0.41,-0.45,90.65,-0.7,True,1,2706,-90.02,-160088.87,243594.12,83505.25
9453,1965-09-30,89.96,-0.06,-0.07,90.65,-0.76,True,1,2707,-89.96,-160178.83,243521.72,83342.89
9454,1965-10-01,89.9,-0.06,-0.07,90.65,-0.83,True,1,2708,-89.9,-160268.73,243449.2,83180.47
9455,1965-10-04,90.08,0.18,0.2,90.65,-0.63,True,1,2709,-90.08,-160358.81,244026.72,83667.91
9456,1965-10-05,90.63,0.55,0.61,90.65,-0.02,True,1,2710,-90.63,-160449.44,245607.3,85157.86
9457,1965-10-06,90.54,-0.09,-0.1,90.65,-0.12,True,1,2711,-90.54,-160539.98,245453.94,84913.96
9458,1965-10-07,90.47,-0.07,-0.08,90.65,-0.2,True,1,2712,-90.47,-160630.45,245354.64,84724.19
9459,1965-10-08,90.85,0.38,0.42,90.85,0.0,True,1,2713,-90.85,-160721.3,246476.05,85754.75
9460,1965-10-11,91.37,0.52,0.57,91.37,0.0,True,1,2714,-91.37,-160812.67,247978.18,87165.51
9461,1965-10-12,91.35,-0.02,-0.02,91.37,-0.02,True,1,2715,-91.35,-160904.02,248015.25,87111.23
9462,1965-10-13,91.34,-0.01,-0.01,91.37,-0.03,True,1,2716,-91.34,-160995.36,248079.44,87084.08
9463,1965-10-14,91.19,-0.15,-0.16,91.37,-0.2,True,1,2717,-91.19,-161086.55,247763.23,86676.68
9464,1965-10-15,91.38,0.19,0.21,91.38,0.0,True,1,2718,-91.38,-161177.93,248370.84,87192.91
9465,1965-10-18,91.68,0.3,0.33,91.68,0.0,True,1,2719,-91.68,-161269.61,249277.92,88008.31
9466,1965-10-19,91.8,0.12,0.13,91.8,0.0,True,1,2720,-91.8,-161361.41,249696.0,88334.59
9467,1965-10-20,91.78,-0.02,-0.02,91.8,-0.02,True,1,2721,-91.78,-161453.19,249733.38,88280.19
9468,1965-10-21,91.94,0.16,0.17,91.94,0.0,True,1,2722,-91.94,-161545.13,250260.68,88715.55
9469,1965-10-22,91.98,0.04,0.04,91.98,0.0,True,1,2723,-91.98,-161637.11,250461.54,88824.43
9470,1965-10-25,91.67,-0.31,-0.34,91.98,-0.34,True,1,2724,-91.67,-161728.78,249709.08,87980.3
9471,1965-10-26,92.2,0.53,0.58,92.2,0.0,True,1,2725,-92.2,-161820.98,251245.0,89424.02
9472,1965-10-27,92.51,0.31,0.34,92.51,0.0,True,1,2726,-92.51,-161913.49,252182.26,90268.77
9473,1965-10-28,92.21,-0.3,-0.32,92.51,-0.32,True,1,2727,-92.21,-162005.7,251456.67,89450.97
9474,1965-10-29,92.42,0.21,0.23,92.51,-0.1,True,1,2728,-92.42,-162098.12,252121.76,90023.64
9475,1965-11-01,92.23,-0.19,-0.21,92.51,-0.3,True,1,2729,-92.23,-162190.35,251695.67,89505.32
9476,1965-11-03,92.31,0.08,0.09,92.51,-0.22,True,1,2730,-92.31,-162282.66,252006.3,89723.64
9477,1965-11-04,92.46,0.15,0.16,92.51,-0.05,True,1,2731,-92.46,-162375.12,252508.26,90133.14
9478,1965-11-05,92.37,-0.09,-0.1,92.51,-0.15,True,1,2732,-92.37,-162467.49,252354.84,89887.35
9479,1965-11-08,92.23,-0.14,-0.15,92.51,-0.3,True,1,2733,-92.23,-162559.72,252064.59,89504.87
9480,1965-11-09,91.93,-0.3,-0.32,92.51,-0.63,True,1,2734,-91.93,-162651.65,251336.62,88684.97
9481,1965-11-10,91.83,-0.1,-0.11,92.51,-0.74,True,1,2735,-91.83,-162743.48,251155.05,88411.57
9482,1965-11-11,92.11,0.28,0.3,92.51,-0.43,True,1,2736,-92.11,-162835.59,252012.96,89177.37
9483,1965-11-12,92.55,0.44,0.48,92.55,0.0,True,1,2737,-92.55,-162928.14,253309.35,90381.21
9484,1965-11-15,92.63,0.08,0.09,92.63,0.0,True,1,2738,-92.63,-163020.77,253620.94,90600.17
9485,1965-11-16,92.41,-0.22,-0.24,92.63,-0.24,True,1,2739,-92.41,-163113.18,253110.99,89997.81
9486,1965-11-17,92.6,0.19,0.21,92.63,-0.03,True,1,2740,-92.6,-163205.78,253724.0,90518.22
9487,1965-11-18,92.22,-0.38,-0.41,92.63,-0.44,True,1,2741,-92.22,-163298.0,252775.02,89477.02
9488,1965-11-19,92.24,0.02,0.02,92.63,-0.42,True,1,2742,-92.24,-163390.24,252922.08,89531.84
9489,1965-11-22,91.64,-0.6,-0.65,92.63,-1.07,True,1,2743,-91.64,-163481.88,251368.52,87886.64
9490,1965-11-23,91.78,0.14,0.15,92.63,-0.92,True,1,2744,-91.78,-163573.66,251844.32,88270.66
9491,1965-11-24,91.94,0.16,0.17,92.63,-0.74,True,1,2745,-91.94,-163665.6,252375.3,88709.7
9492,1965-11-26,92.03,0.09,0.1,92.63,-0.65,True,1,2746,-92.03,-163757.63,252714.38,88956.75
9493,1965-11-29,91.8,-0.23,-0.25,92.63,-0.9,True,1,2747,-91.8,-163849.43,252174.6,88325.17
9494,1965-11-30,91.61,-0.19,-0.21,92.63,-1.1,True,1,2748,-91.61,-163941.04,251744.28,87803.24
9495,1965-12-01,91.5,-0.11,-0.12,92.63,-1.22,True,1,2749,-91.5,-164032.54,251533.5,87500.96
9496,1965-12-02,91.21,-0.29,-0.32,92.63,-1.53,True,1,2750,-91.21,-164123.75,250827.5,86703.75
9497,1965-12-03,91.27,0.06,0.07,92.63,-1.47,True,1,2751,-91.27,-164215.02,251083.77,86868.75
9498,1965-12-06,90.59,-0.68,-0.74,92.63,-2.2,True,1,2752,-90.59,-164305.61,249303.68,84998.07
9499,1965-12-07,91.39,0.8,0.88,92.63,-1.34,True,1,2753,-91.39,-164397.0,251596.67,87199.67
9500,1965-12-08,91.28,-0.11,-0.12,92.63,-1.46,True,1,2754,-91.28,-164488.28,251385.12,86896.84
9501,1965-12-09,91.56,0.28,0.31,92.63,-1.16,True,1,2755,-91.56,-164579.84,252247.8,87667.96
9502,1965-12-10,91.8,0.24,0.26,92.63,-0.9,True,1,2756,-91.8,-164671.64,253000.8,88329.16
9503,1965-12-13,91.83,0.03,0.03,92.63,-0.86,True,1,2757,-91.83,-164763.47,253175.31,88411.84
9504,1965-12-14,91.88,0.05,0.05,92.63,-0.81,True,1,2758,-91.88,-164855.35,253405.04,88549.69
9505,1965-12-15,92.02,0.14,0.15,92.63,-0.66,True,1,2759,-92.02,-164947.37,253883.18,88935.81
9506,1965-12-16,92.12,0.1,0.11,92.63,-0.55,True,1,2760,-92.12,-165039.49,254251.2,89211.71
9507,1965-12-17,92.08,-0.04,-0.04,92.63,-0.59,True,1,2761,-92.08,-165131.57,254232.88,89101.31
9508,1965-12-20,91.65,-0.43,-0.47,92.63,-1.06,True,1,2762,-91.65,-165223.22,253137.3,87914.08
9509,1965-12-21,92.01,0.36,0.39,92.63,-0.67,True,1,2763,-92.01,-165315.23,254223.63,88908.4
9510,1965-12-22,92.29,0.28,0.3,92.63,-0.37,True,1,2764,-92.29,-165407.52,255089.56,89682.04
9511,1965-12-23,92.19,-0.1,-0.11,92.63,-0.48,True,1,2765,-92.19,-165499.71,254905.35,89405.64
9512,1965-12-27,91.52,-0.67,-0.73,92.63,-1.2,True,1,2766,-91.52,-165591.23,253144.32,87553.09
9513,1965-12-28,91.53,0.01,0.01,92.63,-1.19,True,1,2767,-91.53,-165682.76,253263.51,87580.75
9514,1965-12-29,91.81,0.28,0.31,92.63,-0.88,True,1,2768,-91.81,-165774.57,254130.08,88355.51
9515,1965-12-30,92.2,0.39,0.42,92.63,-0.46,True,1,2769,-92.2,-165866.77,255301.8,89435.03
9516,1965-12-31,92.43,0.23,0.25,92.63,-0.22,True,1,2770,-92.43,-165959.2,256031.1,90071.9
9517,1966-01-03,92.18,-0.25,-0.27,92.63,-0.49,True,1,2771,-92.18,-166051.38,255430.78,89379.4
9518,1966-01-04,92.26,0.08,0.09,92.63,-0.4,True,1,2772,-92.26,-166143.64,255744.72,89601.08
9519,1966-01-05,92.85,0.59,0.64,92.85,0.0,True,1,2773,-92.85,-166236.49,257473.05,91236.56
9520,1966-01-06,93.06,0.21,0.23,93.06,0.0,True,1,2774,-93.06,-166329.55,258148.44,91818.89
9521,1966-01-07,93.14,0.08,0.09,93.14,0.0,True,1,2775,-93.14,-166422.69,258463.5,92040.81
9522,1966-01-10,93.33,0.19,0.2,93.33,0.0,True,1,2776,-93.33,-166516.02,259084.08,92568.06
9523,1966-01-11,93.41,0.08,0.09,93.41,0.0,True,1,2777,-93.41,-166609.43,259399.57,92790.14
9524,1966-01-12,93.19,-0.22,-0.24,93.41,-0.24,True,1,2778,-93.19,-166702.62,258881.82,92179.2
9525,1966-01-13,93.36,0.17,0.18,93.41,-0.05,True,1,2779,-93.36,-166795.98,259447.44,92651.46
9526,1966-01-14,93.5,0.14,0.15,93.5,0.0,True,1,2780,-93.5,-166889.48,259930.0,93040.52
9527,1966-01-17,93.77,0.27,0.29,93.77,0.0,True,1,2781,-93.77,-166983.25,260774.37,93791.12
9528,1966-01-18,93.95,0.18,0.19,93.95,0.0,True,1,2782,-93.95,-167077.2,261368.9,94291.7
9529,1966-01-19,93.69,-0.26,-0.28,93.95,-0.28,True,1,2783,-93.69,-167170.89,260739.27,93568.38
9530,1966-01-20,93.36,-0.33,-0.35,93.95,-0.63,True,1,2784,-93.36,-167264.25,259914.24,92649.99
9531,1966-01-21,93.47,0.11,0.12,93.95,-0.51,True,1,2785,-93.47,-167357.72,260313.95,92956.23
9532,1966-01-24,93.71,0.24,0.26,93.95,-0.26,True,1,2786,-93.71,-167451.43,261076.06,93624.63
9533,1966-01-25,93.85,0.14,0.15,93.95,-0.11,True,1,2787,-93.85,-167545.28,261559.95,94014.67
9534,1966-01-26,93.7,-0.15,-0.16,93.95,-0.27,True,1,2788,-93.7,-167638.98,261235.6,93596.62
9535,1966-01-27,93.67,-0.03,-0.03,93.95,-0.3,True,1,2789,-93.67,-167732.65,261245.63,93512.98
9536,1966-01-28,93.31,-0.36,-0.38,93.95,-0.68,True,1,2790,-93.31,-167825.96,260334.9,92508.94
9537,1966-01-31,92.88,-0.43,-0.46,93.95,-1.14,True,1,2791,-92.88,-167918.84,259228.08,91309.24
9538,1966-02-01,92.16,-0.72,-0.78,93.95,-1.9,True,1,2792,-92.16,-168011.0,257310.72,89299.72
9539,1966-02-02,92.53,0.37,0.4,93.95,-1.51,True,1,2793,-92.53,-168103.53,258436.29,90332.76
9540,1966-02-03,92.65,0.12,0.13,93.95,-1.38,True,1,2794,-92.65,-168196.18,258864.1,90667.92
9541,1966-02-04,93.26,0.61,0.66,93.95,-0.73,True,1,2795,-93.26,-168289.44,260661.7,92372.26
9542,1966-02-07,93.59,0.33,0.35,93.95,-0.38,True,1,2796,-93.59,-168383.03,261677.64,93294.61
9543,1966-02-08,93.55,-0.04,-0.04,93.95,-0.43,True,1,2797,-93.55,-168476.58,261659.35,93182.77
9544,1966-02-09,94.06,0.51,0.55,94.06,0.0,True,1,2798,-94.06,-168570.64,263179.88,94609.24
9545,1966-02-10,93.83,-0.23,-0.24,94.06,-0.24,True,1,2799,-93.83,-168664.47,262630.17,93965.7
9546,1966-02-11,93.81,-0.02,-0.02,94.06,-0.27,True,1,2800,-93.81,-168758.28,262668.0,93909.72
9547,1966-02-14,93.53,-0.28,-0.3,94.06,-0.56,True,1,2801,-93.53,-168851.81,261977.53,93125.72
9548,1966-02-15,93.17,-0.36,-0.38,94.06,-0.95,True,1,2802,-93.17,-168944.98,261062.34,92117.36
9549,1966-02-16,93.16,-0.01,-0.01,94.06,-0.96,True,1,2803,-93.16,-169038.14,261127.48,92089.34
9550,1966-02-17,92.66,-0.5,-0.54,94.06,-1.49,True,1,2804,-92.66,-169130.8,259818.64,90687.84
9551,1966-02-18,92.41,-0.25,-0.27,94.06,-1.75,True,1,2805,-92.41,-169223.21,259210.05,89986.84
9552,1966-02-21,91.87,-0.54,-0.58,94.06,-2.33,True,1,2806,-91.87,-169315.08,257787.22,88472.14
9553,1966-02-23,91.48,-0.39,-0.42,94.06,-2.74,True,1,2807,-91.48,-169406.56,256784.36,87377.8
9554,1966-02-24,90.89,-0.59,-0.64,94.06,-3.37,True,1,2808,-90.89,-169497.45,255219.12,85721.67
9555,1966-02-25,91.14,0.25,0.28,94.06,-3.1,True,1,2809,-91.14,-169588.59,256012.26,86423.67
9556,1966-02-28,91.22,0.08,0.09,94.06,-3.02,True,1,2810,-91.22,-169679.81,256328.2,86648.39
9557,1966-03-01,90.06,-1.16,-1.27,94.06,-4.25,True,1,2811,-90.06,-169769.87,253158.66,83388.79
9558,1966-03-02,89.15,-0.91,-1.01,94.06,-5.22,True,1,2812,-89.15,-169859.02,250689.8,80830.78
9559,1966-03-03,89.47,0.32,0.36,94.06,-4.88,True,1,2813,-89.47,-169948.49,251679.11,81730.62
9560,1966-03-04,89.24,-0.23,-0.26,94.06,-5.12,True,1,2814,-89.24,-170037.73,251121.36,81083.63
9561,1966-03-07,88.04,-1.2,-1.34,94.06,-6.4,True,1,2815,-88.04,-170125.77,247832.6,77706.83
9562,1966-03-08,88.18,0.14,0.16,94.06,-6.25,True,1,2816,-88.18,-170213.95,248314.88,78100.93
9563,1966-03-09,88.96,0.78,0.88,94.06,-5.42,True,1,2817,-88.96,-170302.91,250600.32,80297.41
9564,1966-03-10,88.96,0.0,0.0,94.06,-5.42,True,1,2818,-88.96,-170391.87,250689.28,80297.41
9565,1966-03-11,88.85,-0.11,-0.12,94.06,-5.54,True,1,2819,-88.85,-170480.72,250468.15,79987.43
9566,1966-03-14,87.85,-1.0,-1.12,94.06,-6.6,True,1,2820,-87.85,-170568.57,247737.0,77168.43
9567,1966-03-15,87.35,-0.5,-0.57,94.06,-7.13,True,1,2821,-87.35,-170655.92,246414.35,75758.43
9568,1966-03-16,87.86,0.51,0.58,94.06,-6.59,True,1,2822,-87.86,-170743.78,247940.92,77197.14
9569,1966-03-17,88.17,0.31,0.35,94.06,-6.26,True,1,2823,-88.17,-170831.95,248903.91,78071.96
9570,1966-03-18,88.53,0.36,0.41,94.06,-5.88,True,1,2824,-88.53,-170920.48,250008.72,79088.24
9571,1966-03-21,89.2,0.67,0.76,94.06,-5.17,True,1,2825,-89.2,-171009.68,251990.0,80980.32
9572,1966-03-22,89.46,0.26,0.29,94.06,-4.89,True,1,2826,-89.46,-171099.14,252813.96,81714.82
9573,1966-03-23,89.13,-0.33,-0.37,94.06,-5.24,True,1,2827,-89.13,-171188.27,251970.51,80782.24
9574,1966-03-24,89.29,0.16,0.18,94.06,-5.07,True,1,2828,-89.29,-171277.56,252512.12,81234.56
9575,1966-03-25,89.54,0.25,0.28,94.06,-4.8,True,1,2829,-89.54,-171367.1,253308.66,81941.56
9576,1966-03-28,89.62,0.08,0.09,94.06,-4.72,True,1,2830,-89.62,-171456.72,253624.6,82167.88
9577,1966-03-29,89.27,-0.35,-0.39,94.06,-5.09,True,1,2831,-89.27,-171545.99,252723.37,81177.38
9578,1966-03-30,88.78,-0.49,-0.55,94.06,-5.61,True,1,2832,-88.78,-171634.77,251424.96,79790.19
9579,1966-03-31,89.23,0.45,0.51,94.06,-5.14,True,1,2833,-89.23,-171724.0,252788.59,81064.59
9580,1966-04-01,89.94,0.71,0.8,94.06,-4.38,True,1,2834,-89.94,-171813.94,254889.96,83076.02
9581,1966-04-04,90.76,0.82,0.91,94.06,-3.51,True,1,2835,-90.76,-171904.7,257304.6,85399.9
9582,1966-04-05,91.31,0.55,0.61,94.06,-2.92,True,1,2836,-91.31,-171996.01,258955.16,86959.15
9583,1966-04-06,91.56,0.25,0.27,94.06,-2.66,True,1,2837,-91.56,-172087.57,259755.72,87668.15
9584,1966-04-07,91.76,0.2,0.22,94.06,-2.44,True,1,2838,-91.76,-172179.33,260414.88,88235.55
9585,1966-04-11,91.79,0.03,0.03,94.06,-2.41,True,1,2839,-91.79,-172271.12,260591.81,88320.69
9586,1966-04-12,91.45,-0.34,-0.37,94.06,-2.78,True,1,2840,-91.45,-172362.57,259718.0,87355.43
9587,1966-04-13,91.54,0.09,0.1,94.06,-2.68,True,1,2841,-91.54,-172454.11,260065.14,87611.03
9588,1966-04-14,91.87,0.33,0.36,94.06,-2.33,True,1,2842,-91.87,-172545.98,261094.54,88548.56
9589,1966-04-15,91.99,0.12,0.13,94.06,-2.2,True,1,2843,-91.99,-172637.97,261527.57,88889.6
9590,1966-04-18,91.58,-0.41,-0.45,94.06,-2.64,True,1,2844,-91.58,-172729.55,260453.52,87723.97
9591,1966-04-19,91.57,-0.01,-0.01,94.06,-2.65,True,1,2845,-91.57,-172821.12,260516.65,87695.53
9592,1966-04-20,92.08,0.51,0.56,94.06,-2.1,True,1,2846,-92.08,-172913.2,262059.68,89146.48
9593,1966-04-21,92.42,0.34,0.37,94.06,-1.74,True,1,2847,-92.42,-173005.62,263119.74,90114.12
9594,1966-04-22,92.27,-0.15,-0.16,94.06,-1.9,True,1,2848,-92.27,-173097.89,262784.96,89687.07
9595,1966-04-25,92.08,-0.19,-0.21,94.06,-2.1,True,1,2849,-92.08,-173189.97,262335.92,89145.95
9596,1966-04-26,91.99,-0.09,-0.1,94.06,-2.2,True,1,2850,-91.99,-173281.96,262171.5,88889.54
9597,1966-04-27,91.76,-0.23,-0.25,94.06,-2.44,True,1,2851,-91.76,-173373.72,261607.76,88234.04
9598,1966-04-28,91.13,-0.63,-0.69,94.06,-3.12,True,1,2852,-91.13,-173464.85,259902.76,86437.91
9599,1966-04-29,91.06,-0.07,-0.08,94.06,-3.19,True,1,2853,-91.06,-173555.91,259794.18,86238.27
9600,1966-05-02,90.9,-0.16,-0.18,94.06,-3.36,True,1,2854,-90.9,-173646.81,259428.6,85781.79
9601,1966-05-03,89.85,-1.05,-1.16,94.06,-4.48,True,1,2855,-89.85,-173736.66,256521.75,82785.09
9602,1966-05-04,89.39,-0.46,-0.51,94.06,-4.96,True,1,2856,-89.39,-173826.05,255297.84,81471.79
9603,1966-05-05,87.93,-1.46,-1.63,94.06,-6.52,True,1,2857,-87.93,-173913.98,251216.01,77302.03
9604,1966-05-06,87.84,-0.09,-0.1,94.06,-6.61,True,1,2858,-87.84,-174001.82,251046.72,77044.9
9605,1966-05-09,86.32,-1.52,-1.73,94.06,-8.23,True,1,2859,-86.32,-174088.14,246788.88,72700.74
9606,1966-05-10,87.08,0.76,0.88,94.06,-7.42,True,1,2860,-87.08,-174175.22,249048.8,74873.58
9607,1966-05-11,87.23,0.15,0.17,94.06,-7.26,True,1,2861,-87.23,-174262.45,249565.03,75302.58
9608,1966-05-12,86.23,-1.0,-1.15,94.06,-8.32,True,1,2862,-86.23,-174348.68,246790.26,72441.58
9609,1966-05-13,85.47,-0.76,-0.88,94.06,-9.13,True,1,2863,-85.47,-174434.15,244700.61,70266.46
9610,1966-05-16,84.41,-1.06,-1.24,94.06,-10.26,True,1,2864,-84.41,-174518.56,241750.24,67231.68
9611,1966-05-17,83.63,-0.78,-0.92,94.06,-11.09,True,1,2865,-83.63,-174602.19,239599.95,64997.76
9612,1966-05-18,85.12,1.49,1.78,94.06,-9.51,True,1,2866,-85.12,-174687.31,243953.92,69266.61
9613,1966-05-19,85.02,-0.1,-0.12,94.06,-9.61,True,1,2867,-85.02,-174772.33,243752.34,68980.01
9614,1966-05-20,85.43,0.41,0.48,94.06,-9.18,True,1,2868,-85.43,-174857.76,245013.24,70155.48
9615,1966-05-23,86.2,0.77,0.9,94.06,-8.36,True,1,2869,-86.2,-174943.96,247307.8,72363.84
9616,1966-05-24,86.77,0.57,0.66,94.06,-7.75,True,1,2870,-86.77,-175030.73,249029.9,73999.17
9617,1966-05-25,87.07,0.3,0.35,94.06,-7.43,True,1,2871,-87.07,-175117.8,249977.97,74860.17
9618,1966-05-26,87.07,0.0,0.0,94.06,-7.43,True,1,2872,-87.07,-175204.87,250065.04,74860.17
9619,1966-05-27,87.33,0.26,0.3,94.06,-7.16,True,1,2873,-87.33,-175292.2,250899.09,75606.89
9620,1966-05-31,86.13,-1.2,-1.37,94.06,-8.43,True,1,2874,-86.13,-175378.33,247537.62,72159.29
9621,1966-06-01,86.1,-0.03,-0.04,94.06,-8.46,True,1,2875,-86.1,-175464.43,247537.5,72073.07
9622,1966-06-02,85.96,-0.14,-0.16,94.06,-8.61,True,1,2876,-85.96,-175550.39,247220.96,71670.57
9623,1966-06-03,86.06,0.1,0.12,94.06,-8.51,True,1,2877,-86.06,-175636.45,247594.62,71958.17
9624,1966-06-06,85.42,-0.64,-0.74,94.06,-9.19,True,1,2878,-85.42,-175721.87,245838.76,70116.89
9625,1966-06-07,84.83,-0.59,-0.69,94.06,-9.81,True,1,2879,-84.83,-175806.7,244225.57,68418.87
9626,1966-06-08,84.93,0.1,0.12,94.06,-9.71,True,1,2880,-84.93,-175891.63,244598.4,68706.77
9627,1966-06-09,85.5,0.57,0.67,94.06,-9.1,True,1,2881,-85.5,-175977.13,246325.5,70348.37
9628,1966-06-10,86.44,0.94,1.1,94.06,-8.1,True,1,2882,-86.44,-176063.57,249120.08,73056.51
9629,1966-06-13,86.83,0.39,0.45,94.06,-7.69,True,1,2883,-86.83,-176150.4,250330.89,74180.49
9630,1966-06-14,87.07,0.24,0.28,94.06,-7.43,True,1,2884,-87.07,-176237.47,251109.88,74872.41
9631,1966-06-15,86.73,-0.34,-0.39,94.06,-7.79,True,1,2885,-86.73,-176324.2,250216.05,73891.85
9632,1966-06-16,86.47,-0.26,-0.3,94.06,-8.07,True,1,2886,-86.47,-176410.67,249552.42,73141.75
9633,1966-06-17,86.51,0.04,0.05,94.06,-8.03,True,1,2887,-86.51,-176497.18,249754.37,73257.19
9634,1966-06-20,86.48,-0.03,-0.04,94.06,-8.06,True,1,2888,-86.48,-176583.66,249754.24,73170.58
9635,1966-06-21,86.71,0.23,0.27,94.06,-7.81,True,1,2889,-86.71,-176670.37,250505.19,73834.82
9636,1966-06-22,86.85,0.14,0.16,94.06,-7.66,True,1,2890,-86.85,-176757.22,250996.5,74239.28
9637,1966-06-23,86.5,-0.35,-0.4,94.06,-8.04,True,1,2891,-86.5,-176843.72,250071.5,73227.78
9638,1966-06-24,86.58,0.08,0.09,94.06,-7.95,True,1,2892,-86.58,-176930.3,250389.36,73459.06
9639,1966-06-27,86.08,-0.5,-0.58,94.06,-8.48,True,1,2893,-86.08,-177016.38,249029.44,72013.06
9640,1966-06-28,85.67,-0.41,-0.48,94.06,-8.92,True,1,2894,-85.67,-177102.05,247928.98,70826.93
9641,1966-06-29,84.86,-0.81,-0.94,94.06,-9.78,True,1,2895,-84.86,-177186.91,245669.7,68482.79
9642,1966-06-30,84.74,-0.12,-0.14,94.06,-9.91,True,1,2896,-84.74,-177271.65,245407.04,68135.39
9643,1966-07-01,85.61,0.87,1.03,94.06,-8.98,True,1,2897,-85.61,-177357.26,248012.17,70654.91
9644,1966-07-05,85.82,0.21,0.24,94.06,-8.76,True,1,2898,-85.82,-177443.08,248706.36,71263.28
9645,1966-07-06,87.06,1.24,1.44,94.06,-7.44,True,1,2899,-87.06,-177530.14,252386.94,74856.8
9646,1966-07-07,87.38,0.32,0.37,94.06,-7.1,True,1,2900,-87.38,-177617.52,253402.0,75784.48
9647,1966-07-08,87.61,0.23,0.26,94.06,-6.86,True,1,2901,-87.61,-177705.13,254156.61,76451.48
9648,1966-07-11,87.45,-0.16,-0.18,94.06,-7.03,True,1,2902,-87.45,-177792.58,253779.9,75987.32
9649,1966-07-12,86.88,-0.57,-0.65,94.06,-7.63,True,1,2903,-86.88,-177879.46,252212.64,74333.18
9650,1966-07-13,86.3,-0.58,-0.67,94.06,-8.25,True,1,2904,-86.3,-177965.76,250615.2,72649.44
9651,1966-07-14,86.82,0.52,0.6,94.06,-7.7,True,1,2905,-86.82,-178052.58,252212.1,74159.52
9652,1966-07-15,87.08,0.26,0.3,94.06,-7.42,True,1,2906,-87.08,-178139.66,253054.48,74914.82
9653,1966-07-18,86.99,-0.09,-0.1,94.06,-7.52,True,1,2907,-86.99,-178226.65,252879.93,74653.28
9654,1966-07-19,86.33,-0.66,-0.76,94.06,-8.22,True,1,2908,-86.33,-178312.98,251047.64,72734.66
9655,1966-07-20,85.51,-0.82,-0.95,94.06,-9.09,True,1,2909,-85.51,-178398.49,248748.59,70350.1
9656,1966-07-21,85.52,0.01,0.01,94.06,-9.08,True,1,2910,-85.52,-178484.01,248863.2,70379.19
9657,1966-07-22,85.41,-0.11,-0.13,94.06,-9.2,True,1,2911,-85.41,-178569.42,248628.51,70059.09
9658,1966-07-25,83.83,-1.58,-1.85,94.06,-10.88,True,1,2912,-83.83,-178653.25,244112.96,65459.71
9659,1966-07-26,83.7,-0.13,-0.16,94.06,-11.01,True,1,2913,-83.7,-178736.95,243818.1,65081.15
9660,1966-07-27,84.1,0.4,0.48,94.06,-10.59,True,1,2914,-84.1,-178821.05,245067.4,66246.35
9661,1966-07-28,83.77,-0.33,-0.39,94.06,-10.94,True,1,2915,-83.77,-178904.82,244189.55,65284.73
9662,1966-07-29,83.6,-0.17,-0.2,94.06,-11.12,True,1,2916,-83.6,-178988.42,243777.6,64789.18
9663,1966-08-01,82.31,-1.29,-1.54,94.06,-12.49,True,1,2917,-82.31,-179070.73,240098.27,61027.54
9664,1966-08-02,82.33,0.02,0.02,94.06,-12.47,True,1,2918,-82.33,-179153.06,240238.94,61085.88
9665,1966-08-03,83.15,0.82,1.0,94.06,-11.6,True,1,2919,-83.15,-179236.21,242714.85,63478.64
9666,1966-08-04,83.93,0.78,0.94,94.06,-10.77,True,1,2920,-83.93,-179320.14,245075.6,65755.46
9667,1966-08-05,84.0,0.07,0.08,94.06,-10.7,True,1,2921,-84.0,-179404.14,245364.0,65959.86
9668,1966-08-08,83.75,-0.25,-0.3,94.06,-10.96,True,1,2922,-83.75,-179487.89,244717.5,65229.61
9669,1966-08-09,83.49,-0.26,-0.31,94.06,-11.24,True,1,2923,-83.49,-179571.38,244041.27,64469.89
9670,1966-08-10,83.11,-0.38,-0.46,94.06,-11.64,True,1,2924,-83.11,-179654.49,243013.64,63359.15
9671,1966-08-11,83.02,-0.09,-0.11,94.06,-11.74,True,1,2925,-83.02,-179737.51,242833.5,63095.99
9672,1966-08-12,83.17,0.15,0.18,94.06,-11.58,True,1,2926,-83.17,-179820.68,243355.42,63534.74
9673,1966-08-15,82.74,-0.43,-0.52,94.06,-12.04,True,1,2927,-82.74,-179903.42,242179.98,62276.56
9674,1966-08-16,81.63,-1.11,-1.34,94.06,-13.22,True,1,2928,-81.63,-179985.05,239012.64,59027.59
9675,1966-08-17,81.18,-0.45,-0.55,94.06,-13.69,True,1,2929,-81.18,-180066.23,237776.22,57709.99
9676,1966-08-18,80.16,-1.02,-1.26,94.06,-14.78,True,1,2930,-80.16,-180146.39,234868.8,54722.41
9677,1966-08-19,79.62,-0.54,-0.67,94.06,-15.35,True,1,2931,-79.62,-180226.01,233366.22,53140.21
9678,1966-08-22,78.24,-1.38,-1.73,94.06,-16.82,True,1,2932,-78.24,-180304.25,229399.68,49095.43
9679,1966-08-23,78.11,-0.13,-0.17,94.06,-16.96,True,1,2933,-78.11,-180382.36,229096.63,48714.27
9680,1966-08-24,79.07,0.96,1.23,94.06,-15.94,True,1,2934,-79.07,-180461.43,231991.38,51529.95
9681,1966-08-25,78.06,-1.01,-1.28,94.06,-17.01,True,1,2935,-78.06,-180539.49,229106.1,48566.61
9682,1966-08-26,76.41,-1.65,-2.11,94.06,-18.76,True,1,2936,-76.41,-180615.9,224339.76,43723.86
9683,1966-08-29,74.53,-1.88,-2.46,94.06,-20.76,True,1,2937,-74.53,-180690.43,218894.61,38204.18
9684,1966-08-30,75.86,1.33,1.78,94.06,-19.35,True,1,2938,-75.86,-180766.29,222876.68,42110.39
9685,1966-08-31,77.1,1.24,1.64,94.06,-18.03,True,1,2939,-77.1,-180843.39,226596.9,45753.51
9686,1966-09-01,77.7,0.6,0.78,94.06,-17.39,True,1,2940,-77.7,-180921.09,228438.0,47516.91
9687,1966-09-02,77.42,-0.28,-0.36,94.06,-17.69,True,1,2941,-77.42,-180998.51,227692.22,46693.71
9688,1966-09-06,76.96,-0.46,-0.59,94.06,-18.18,True,1,2942,-76.96,-181075.47,226416.32,45340.85
9689,1966-09-07,76.37,-0.59,-0.77,94.06,-18.81,True,1,2943,-76.37,-181151.84,224756.91,43605.07
9690,1966-09-08,76.05,-0.32,-0.42,94.06,-19.15,True,1,2944,-76.05,-181227.89,223891.2,42663.31
9691,1966-09-09,76.29,0.24,0.32,94.06,-18.89,True,1,2945,-76.29,-181304.18,224674.05,43369.87
9692,1966-09-12,77.91,1.62,2.12,94.06,-17.17,True,1,2946,-77.91,-181382.09,229522.86,48140.77
9693,1966-09-13,78.32,0.41,0.53,94.06,-16.73,True,1,2947,-78.32,-181460.41,230809.04,49348.63
9694,1966-09-14,79.13,0.81,1.03,94.06,-15.87,True,1,2948,-79.13,-181539.54,233275.24,51735.7
9695,1966-09-15,80.08,0.95,1.2,94.06,-14.86,True,1,2949,-80.08,-181619.62,236155.92,54536.3
9696,1966-09-16,79.99,-0.09,-0.11,94.06,-14.96,True,1,2950,-79.99,-181699.61,235970.5,54270.89
9697,1966-09-19,79.59,-0.4,-0.5,94.06,-15.38,True,1,2951,-79.59,-181779.2,234870.09,53090.89
9698,1966-09-20,79.04,-0.55,-0.69,94.06,-15.97,True,1,2952,-79.04,-181858.24,233326.08,51467.84
9699,1966-09-21,77.71,-1.33,-1.68,94.06,-17.38,True,1,2953,-77.71,-181935.95,229477.63,47541.68
9700,1966-09-22,77.94,0.23,0.3,94.06,-17.14,True,1,2954,-77.94,-182013.89,230234.76,48220.87
9701,1966-09-23,77.67,-0.27,-0.35,94.06,-17.42,True,1,2955,-77.67,-182091.56,229514.85,47423.29
9702,1966-09-26,77.86,0.19,0.24,94.06,-17.22,True,1,2956,-77.86,-182169.42,230154.16,47984.74
9703,1966-09-27,78.1,0.24,0.31,94.06,-16.97,True,1,2957,-78.1,-182247.52,230941.7,48694.18
9704,1966-09-28,77.11,-0.99,-1.27,94.06,-18.02,True,1,2958,-77.11,-182324.63,228091.38,45766.75
9705,1966-09-29,76.31,-0.8,-1.04,94.06,-18.87,True,1,2959,-76.31,-182400.94,225801.29,43400.35
9706,1966-09-30,76.56,0.25,0.33,94.06,-18.6,True,1,2960,-76.56,-182477.5,226617.6,44140.1
9707,1966-10-03,74.9,-1.66,-2.17,94.06,-20.37,True,1,2961,-74.9,-182552.4,221778.9,39226.5
9708,1966-10-04,75.1,0.2,0.27,94.06,-20.16,True,1,2962,-75.1,-182627.5,222446.2,39818.7
9709,1966-10-05,74.69,-0.41,-0.55,94.06,-20.59,True,1,2963,-74.69,-182702.19,221306.47,38604.28
9710,1966-10-06,74.05,-0.64,-0.86,94.06,-21.27,True,1,2964,-74.05,-182776.24,219484.2,36707.96
9711,1966-10-07,73.2,-0.85,-1.15,94.06,-22.18,True,1,2965,-73.2,-182849.44,217038.0,34188.56
9712,1966-10-10,74.53,1.33,1.82,94.06,-20.76,True,1,2966,-74.53,-182923.97,221055.98,38132.01
9713,1966-10-11,74.91,0.38,0.51,94.06,-20.36,True,1,2967,-74.91,-182998.88,222257.97,39259.09
9714,1966-10-12,77.04,2.13,2.84,94.06,-18.1,True,1,2968,-77.04,-183075.92,228654.72,45578.8
9715,1966-10-13,76.89,-0.15,-0.2,94.06,-18.25,True,1,2969,-76.89,-183152.81,228286.41,45133.6
9716,1966-10-14,76.6,-0.29,-0.38,94.06,-18.56,True,1,2970,-76.6,-183229.41,227502.0,44272.59
9717,1966-10-17,77.47,0.87,1.14,94.06,-17.64,True,1,2971,-77.47,-183306.88,230163.37,46856.49
9718,1966-10-18,78.68,1.21,1.56,94.06,-16.35,True,1,2972,-78.68,-183385.56,233836.96,50451.4
9719,1966-10-19,78.05,-0.63,-0.8,94.06,-17.02,True,1,2973,-78.05,-183463.61,232042.65,48579.04
9720,1966-10-20,77.84,-0.21,-0.27,94.06,-17.24,True,1,2974,-77.84,-183541.45,231496.16,47954.71
9721,1966-10-21,78.19,0.35,0.45,94.06,-16.87,True,1,2975,-78.19,-183619.64,232615.25,48995.61
9722,1966-10-24,78.42,0.23,0.29,94.06,-16.63,True,1,2976,-78.42,-183698.06,233377.92,49679.86
9723,1966-10-25,78.9,0.48,0.61,94.06,-16.12,True,1,2977,-78.9,-183776.96,234885.3,51108.34
9724,1966-10-26,79.58,0.68,0.86,94.06,-15.39,True,1,2978,-79.58,-183856.54,236989.24,53132.7
9725,1966-10-27,80.23,0.65,0.82,94.06,-14.7,True,1,2979,-80.23,-183936.77,239005.17,55068.4
9726,1966-10-28,80.24,0.01,0.01,94.06,-14.69,True,1,2980,-80.24,-184017.01,239115.2,55098.19
9727,1966-10-31,80.2,-0.04,-0.05,94.06,-14.74,True,1,2981,-80.2,-184097.21,239076.2,54978.99
9728,1966-11-01,80.81,0.61,0.76,94.06,-14.09,True,1,2982,-80.81,-184178.02,240975.42,56797.4
9729,1966-11-02,80.88,0.07,0.09,94.06,-14.01,True,1,2983,-80.88,-184258.9,241265.04,57006.14
9730,1966-11-03,80.56,-0.32,-0.4,94.06,-14.35,True,1,2984,-80.56,-184339.46,240391.04,56051.58
9731,1966-11-04,80.81,0.25,0.31,94.06,-14.09,True,1,2985,-80.81,-184420.27,241217.85,56797.58
9732,1966-11-07,80.73,-0.08,-0.1,94.06,-14.17,True,1,2986,-80.73,-184501.0,241059.78,56558.78
9733,1966-11-09,81.38,0.65,0.8,94.06,-13.48,True,1,2987,-81.38,-184582.38,243082.06,58499.68
9734,1966-11-10,81.89,0.51,0.63,94.06,-12.94,True,1,2988,-81.89,-184664.27,244687.32,60023.05
9735,1966-11-11,81.94,0.05,0.06,94.06,-12.88,True,1,2989,-81.94,-184746.21,244918.66,60172.45
9736,1966-11-14,81.37,-0.57,-0.7,94.06,-13.49,True,1,2990,-81.37,-184827.58,243296.3,58468.72
9737,1966-11-15,81.69,0.32,0.39,94.06,-13.15,True,1,2991,-81.69,-184909.27,244334.79,59425.52
9738,1966-11-16,82.37,0.68,0.83,94.06,-12.43,True,1,2992,-82.37,-184991.64,246451.04,61459.4
9739,1966-11-17,81.8,-0.57,-0.69,94.06,-13.03,True,1,2993,-81.8,-185073.44,244827.4,59753.96
9740,1966-11-18,81.26,-0.54,-0.66,94.06,-13.61,True,1,2994,-81.26,-185154.7,243292.44,58137.74
9741,1966-11-21,80.09,-1.17,-1.44,94.06,-14.85,True,1,2995,-80.09,-185234.79,239869.55,54634.76
9742,1966-11-22,79.67,-0.42,-0.52,94.06,-15.3,True,1,2996,-79.67,-185314.46,238691.32,53376.86
9743,1966-11-23,80.21,0.54,0.68,94.06,-14.72,True,1,2997,-80.21,-185394.67,240389.37,54994.7
9744,1966-11-25,80.85,0.64,0.8,94.06,-14.04,True,1,2998,-80.85,-185475.52,242388.3,56912.78
9745,1966-11-28,80.71,-0.14,-0.17,94.06,-14.19,True,1,2999,-80.71,-185556.23,242049.29,56493.06
9746,1966-11-29,80.42,-0.29,-0.36,94.06,-14.5,True,1,3000,-80.42,-185636.65,241260.0,55623.35
9747,1966-11-30,80.45,0.03,0.04,94.06,-14.47,True,1,3001,-80.45,-185717.1,241430.45,55713.35
9748,1966-12-01,80.08,-0.37,-0.46,94.06,-14.86,True,1,3002,-80.08,-185797.18,240400.16,54602.98
9749,1966-12-02,80.13,0.05,0.06,94.06,-14.81,True,1,3003,-80.13,-185877.31,240630.39,54753.08
9750,1966-12-05,80.24,0.11,0.14,94.06,-14.69,True,1,3004,-80.24,-185957.55,241040.96,55083.41
9751,1966-12-06,80.84,0.6,0.75,94.06,-14.06,True,1,3005,-80.84,-186038.39,242924.2,56885.81
9752,1966-12-07,81.72,0.88,1.09,94.06,-13.12,True,1,3006,-81.72,-186120.11,245650.32,59530.21
9753,1966-12-08,82.05,0.33,0.4,94.06,-12.77,True,1,3007,-82.05,-186202.16,246724.35,60522.19
9754,1966-12-09,82.14,0.09,0.11,94.06,-12.67,True,1,3008,-82.14,-186284.3,247077.12,60792.82
9755,1966-12-12,83.0,0.86,1.05,94.06,-11.76,True,1,3009,-83.0,-186367.3,249747.0,63379.7
9756,1966-12-13,82.73,-0.27,-0.32,94.06,-12.04,True,1,3010,-82.73,-186450.03,249017.3,62567.27
9757,1966-12-14,82.64,-0.09,-0.11,94.06,-12.14,True,1,3011,-82.64,-186532.67,248829.04,62296.37
9758,1966-12-15,81.64,-1.0,-1.21,94.06,-13.2,True,1,3012,-81.64,-186614.31,245899.68,59285.37
9759,1966-12-16,81.58,-0.06,-0.07,94.06,-13.27,True,1,3013,-81.58,-186695.89,245800.54,59104.65
9760,1966-12-19,81.27,-0.31,-0.38,94.06,-13.6,True,1,3014,-81.27,-186777.16,244947.78,58170.62
9761,1966-12-20,80.96,-0.31,-0.38,94.06,-13.93,True,1,3015,-80.96,-186858.12,244094.4,57236.28
9762,1966-12-21,81.38,0.42,0.52,94.06,-13.48,True,1,3016,-81.38,-186939.5,245442.08,58502.58
9763,1966-12-22,81.69,0.31,0.38,94.06,-13.15,True,1,3017,-81.69,-187021.19,246458.73,59437.54
9764,1966-12-23,81.47,-0.22,-0.27,94.06,-13.38,True,1,3018,-81.47,-187102.66,245876.46,58773.8
9765,1966-12-27,81.0,-0.47,-0.58,94.06,-13.88,True,1,3019,-81.0,-187183.66,244539.0,57355.34
9766,1966-12-28,80.61,-0.39,-0.48,94.06,-14.3,True,1,3020,-80.61,-187264.27,243442.2,56177.93
9767,1966-12-29,80.37,-0.24,-0.3,94.06,-14.56,True,1,3021,-80.37,-187344.64,242797.77,55453.13
9768,1966-12-30,80.33,-0.04,-0.05,94.06,-14.6,True,1,3022,-80.33,-187424.97,242757.26,55332.29
9769,1967-01-03,80.38,0.05,0.06,94.06,-14.54,True,1,3023,-80.38,-187505.35,242988.74,55483.39
9770,1967-01-04,80.55,0.17,0.21,94.06,-14.36,True,1,3024,-80.55,-187585.9,243583.2,55997.3
9771,1967-01-05,81.6,1.05,1.3,94.06,-13.25,True,1,3025,-81.6,-187667.5,246840.0,59172.5
9772,1967-01-06,82.18,0.58,0.71,94.06,-12.63,True,1,3026,-82.18,-187749.68,248676.68,60927.0
9773,1967-01-09,82.81,0.63,0.77,94.06,-11.96,True,1,3027,-82.81,-187832.49,250665.87,62833.38
9774,1967-01-10,82.81,0.0,0.0,94.06,-11.96,True,1,3028,-82.81,-187915.3,250748.68,62833.38
9775,1967-01-11,83.47,0.66,0.8,94.06,-11.26,True,1,3029,-83.47,-187998.77,252830.63,64831.86
9776,1967-01-12,83.91,0.44,0.53,94.06,-10.79,True,1,3030,-83.91,-188082.68,254247.3,66164.62
9777,1967-01-13,84.53,0.62,0.74,94.06,-10.13,True,1,3031,-84.53,-188167.21,256210.43,68043.22
9778,1967-01-16,84.31,-0.22,-0.26,94.06,-10.37,True,1,3032,-84.31,-188251.52,255627.92,67376.4
9779,1967-01-17,85.24,0.93,1.1,94.06,-9.38,True,1,3033,-85.24,-188336.76,258532.92,70196.16
9780,1967-01-18,85.79,0.55,0.64,94.06,-8.79,True,1,3034,-85.79,-188422.55,260286.86,71864.31
9781,1967-01-19,85.82,0.03,0.04,94.06,-8.76,True,1,3035,-85.82,-188508.37,260463.7,71955.33
9782,1967-01-20,86.07,0.25,0.29,94.06,-8.49,True,1,3036,-86.07,-188594.44,261308.52,72714.08
9783,1967-01-23,86.39,0.32,0.37,94.06,-8.15,True,1,3037,-86.39,-188680.83,262366.43,73685.6
9784,1967-01-24,86.51,0.12,0.14,94.06,-8.03,True,1,3038,-86.51,-188767.34,262817.38,74050.04
9785,1967-01-25,85.85,-0.66,-0.76,94.06,-8.73,True,1,3039,-85.85,-188853.19,260898.15,72044.96
9786,1967-01-26,85.81,-0.04,-0.05,94.06,-8.77,True,1,3040,-85.81,-188939.0,260862.4,71923.4
9787,1967-01-27,86.16,0.35,0.41,94.06,-8.4,True,1,3041,-86.16,-189025.16,262012.56,72987.4
9788,1967-01-30,86.66,0.5,0.58,94.06,-7.87,True,1,3042,-86.66,-189111.82,263619.72,74507.9
9789,1967-01-31,86.61,-0.05,-0.06,94.06,-7.92,True,1,3043,-86.61,-189198.43,263554.23,74355.8
9790,1967-02-01,86.43,-0.18,-0.21,94.06,-8.11,True,1,3044,-86.43,-189284.86,263092.92,73808.06
9791,1967-02-02,86.73,0.3,0.35,94.06,-7.79,True,1,3045,-86.73,-189371.59,264092.85,74721.26
9792,1967-02-03,87.36,0.63,0.73,94.06,-7.12,True,1,3046,-87.36,-189458.95,266098.56,76639.61
9793,1967-02-06,87.18,-0.18,-0.21,94.06,-7.31,True,1,3047,-87.18,-189546.13,265637.46,76091.33
9794,1967-02-07,86.95,-0.23,-0.26,94.06,-7.56,True,1,3048,-86.95,-189633.08,265023.6,75390.52
9795,1967-02-08,87.72,0.77,0.89,94.06,-6.74,True,1,3049,-87.72,-189720.8,267458.28,77737.48
9796,1967-02-09,87.36,-0.36,-0.41,94.06,-7.12,True,1,3050,-87.36,-189808.16,266448.0,76639.84
9797,1967-02-10,87.63,0.27,0.31,94.06,-6.84,True,1,3051,-87.63,-189895.79,267359.13,77463.34
9798,1967-02-13,87.58,-0.05,-0.06,94.06,-6.89,True,1,3052,-87.58,-189983.37,267294.16,77310.79
9799,1967-02-14,88.17,0.59,0.67,94.06,-6.26,True,1,3053,-88.17,-190071.54,269183.01,79111.47
9800,1967-02-15,88.27,0.1,0.11,94.06,-6.16,True,1,3054,-88.27,-190159.81,269576.58,79416.77
9801,1967-02-16,87.86,-0.41,-0.46,94.06,-6.59,True,1,3055,-87.86,-190247.67,268412.3,78164.63
9802,1967-02-17,87.89,0.03,0.03,94.06,-6.56,True,1,3056,-87.89,-190335.56,268591.84,78256.28
9803,1967-02-20,87.4,-0.49,-0.56,94.06,-7.08,True,1,3057,-87.4,-190422.96,267181.8,76758.84
9804,1967-02-21,87.34,-0.06,-0.07,94.06,-7.14,True,1,3058,-87.34,-190510.3,267085.72,76575.42
9805,1967-02-23,87.45,0.11,0.13,94.06,-7.03,True,1,3059,-87.45,-190597.75,267509.55,76911.8
9806,1967-02-24,87.41,-0.04,-0.05,94.06,-7.07,True,1,3060,-87.41,-190685.16,267474.6,76789.44
9807,1967-02-27,86.46,-0.95,-1.09,94.06,-8.08,True,1,3061,-86.46,-190771.62,264654.06,73882.44
9808,1967-02-28,86.78,0.32,0.37,94.06,-7.74,True,1,3062,-86.78,-190858.4,265720.36,74861.96
9809,1967-03-01,87.68,0.9,1.04,94.06,-6.78,True,1,3063,-87.68,-190946.08,268563.84,77617.76
9810,1967-03-02,88.16,0.48,0.55,94.06,-6.27,True,1,3064,-88.16,-191034.24,270122.24,79088.0
9811,1967-03-03,88.29,0.13,0.15,94.06,-6.13,True,1,3065,-88.29,-191122.53,270608.85,79486.32
9812,1967-03-06,88.1,-0.19,-0.22,94.06,-6.34,True,1,3066,-88.1,-191210.63,270114.6,78903.97
9813,1967-03-07,88.16,0.06,0.07,94.06,-6.27,True,1,3067,-88.16,-191298.79,270386.72,79087.93
9814,1967-03-08,88.27,0.11,0.12,94.06,-6.16,True,1,3068,-88.27,-191387.06,270812.36,79425.3
9815,1967-03-09,88.53,0.26,0.3,94.06,-5.88,True,1,3069,-88.53,-191475.59,271698.57,80222.98
9816,1967-03-10,88.89,0.36,0.41,94.06,-5.5,True,1,3070,-88.89,-191564.48,272892.3,81327.82
9817,1967-03-13,88.43,-0.46,-0.52,94.06,-5.99,True,1,3071,-88.43,-191652.91,271568.53,79915.62
9818,1967-03-14,88.35,-0.08,-0.09,94.06,-6.07,True,1,3072,-88.35,-191741.26,271411.2,79669.94
9819,1967-03-15,89.19,0.84,0.95,94.06,-5.18,True,1,3073,-89.19,-191830.45,274080.87,82250.42
9820,1967-03-16,90.09,0.9,1.01,94.06,-4.22,True,1,3074,-90.09,-191920.54,276936.66,85016.12
9821,1967-03-17,90.25,0.16,0.18,94.06,-4.05,True,1,3075,-90.25,-192010.79,277518.75,85507.96
9822,1967-03-20,90.2,-0.05,-0.06,94.06,-4.1,True,1,3076,-90.2,-192100.99,277455.2,85354.21
9823,1967-03-21,90.0,-0.2,-0.22,94.06,-4.32,True,1,3077,-90.0,-192190.99,276930.0,84739.01
9824,1967-03-22,90.25,0.25,0.28,94.06,-4.05,True,1,3078,-90.25,-192281.24,277789.5,85508.26
9825,1967-03-23,90.94,0.69,0.76,94.06,-3.32,True,1,3079,-90.94,-192372.18,280004.26,87632.08
9826,1967-03-27,90.87,-0.07,-0.08,94.06,-3.39,True,1,3080,-90.87,-192463.05,279879.6,87416.55
9827,1967-03-28,90.91,0.04,0.04,94.06,-3.35,True,1,3081,-90.91,-192553.96,280093.71,87539.75
9828,1967-03-29,90.73,-0.18,-0.2,94.06,-3.54,True,1,3082,-90.73,-192644.69,279629.86,86985.17
9829,1967-03-30,90.7,-0.03,-0.03,94.06,-3.57,True,1,3083,-90.7,-192735.39,279628.1,86892.71
9830,1967-03-31,90.2,-0.5,-0.55,94.06,-4.1,True,1,3084,-90.2,-192825.59,278176.8,85351.21
9831,1967-04-03,89.24,-0.96,-1.06,94.06,-5.12,True,1,3085,-89.24,-192914.83,275305.4,82390.57
9832,1967-04-04,89.22,-0.02,-0.02,94.06,-5.15,True,1,3086,-89.22,-193004.05,275332.92,82328.87
9833,1967-04-05,89.79,0.57,0.64,94.06,-4.54,True,1,3087,-89.79,-193093.84,277181.73,84087.89
9834,1967-04-06,89.94,0.15,0.17,94.06,-4.38,True,1,3088,-89.94,-193183.78,277734.72,84550.94
9835,1967-04-07,89.36,-0.58,-0.64,94.06,-5.0,True,1,3089,-89.36,-193273.14,276033.04,82759.9
9836,1967-04-10,88.24,-1.12,-1.25,94.06,-6.19,True,1,3090,-88.24,-193361.38,272661.6,79300.22
9837,1967-04-11,88.88,0.64,0.72,94.06,-5.51,True,1,3091,-88.88,-193450.26,274728.08,81277.82
9838,1967-04-12,88.78,-0.1,-0.11,94.06,-5.61,True,1,3092,-88.78,-193539.04,274507.76,80968.72
9839,1967-04-13,89.46,0.68,0.77,94.06,-4.89,True,1,3093,-89.46,-193628.5,276699.78,83071.28
9840,1967-04-14,90.43,0.97,1.08,94.06,-3.86,True,1,3094,-90.43,-193718.93,279790.42,86071.49
9841,1967-04-17,91.07,0.64,0.71,94.06,-3.18,True,1,3095,-91.07,-193810.0,281861.65,88051.65
9842,1967-04-18,91.86,0.79,0.87,94.06,-2.34,True,1,3096,-91.86,-193901.86,284398.56,90496.7
9843,1967-04-19,91.94,0.08,0.09,94.06,-2.25,True,1,3097,-91.94,-193993.8,284738.18,90744.38
9844,1967-04-20,92.11,0.17,0.18,94.06,-2.07,True,1,3098,-92.11,-194085.91,285356.78,91270.87
9845,1967-04-21,92.3,0.19,0.21,94.06,-1.87,True,1,3099,-92.3,-194178.21,286037.7,91859.49
9846,1967-04-24,92.62,0.32,0.35,94.06,-1.53,True,1,3100,-92.62,-194270.83,287122.0,92851.17
9847,1967-04-25,93.11,0.49,0.53,94.06,-1.01,True,1,3101,-93.11,-194363.94,288734.11,94370.17
9848,1967-04-26,93.02,-0.09,-0.1,94.06,-1.11,True,1,3102,-93.02,-194456.96,288548.04,94091.08
9849,1967-04-27,93.81,0.79,0.85,94.06,-0.27,True,1,3103,-93.81,-194550.77,291092.43,96541.66
9850,1967-04-28,94.01,0.2,0.21,94.06,-0.05,True,1,3104,-94.01,-194644.78,291807.04,97162.26
9851,1967-05-01,93.84,-0.17,-0.18,94.06,-0.23,True,1,3105,-93.84,-194738.62,291373.2,96634.58
9852,1967-05-02,93.67,-0.17,-0.18,94.06,-0.42,True,1,3106,-93.67,-194832.29,290939.02,96106.73
9853,1967-05-03,93.91,0.24,0.26,94.06,-0.16,True,1,3107,-93.91,-194926.2,291778.37,96852.17
9854,1967-05-04,94.32,0.41,0.44,94.32,0.0,True,1,3108,-94.32,-195020.52,293146.56,98126.04
9855,1967-05-05,94.44,0.12,0.13,94.44,0.0,True,1,3109,-94.44,-195114.96,293613.96,98499.0
9856,1967-05-08,94.58,0.14,0.15,94.58,0.0,True,1,3110,-94.58,-195209.54,294143.8,98934.26
9857,1967-05-09,93.6,-0.98,-1.04,94.58,-1.04,True,1,3111,-93.6,-195303.14,291189.6,95886.46
9858,1967-05-10,93.35,-0.25,-0.27,94.58,-1.3,True,1,3112,-93.35,-195396.49,290505.2,95108.71
9859,1967-05-11,93.75,0.4,0.43,94.58,-0.88,True,1,3113,-93.75,-195490.24,291843.75,96353.51
9860,1967-05-12,93.48,-0.27,-0.29,94.58,-1.16,True,1,3114,-93.48,-195583.72,291096.72,95513.0
9861,1967-05-15,92.71,-0.77,-0.82,94.58,-1.98,True,1,3115,-92.71,-195676.43,288791.65,93115.22
9862,1967-05-16,93.14,0.43,0.46,94.58,-1.52,True,1,3116,-93.14,-195769.57,290224.24,94454.67
9863,1967-05-17,92.78,-0.36,-0.39,94.58,-1.9,True,1,3117,-92.78,-195862.35,289195.26,93332.91
9864,1967-05-18,92.53,-0.25,-0.27,94.58,-2.17,True,1,3118,-92.53,-195954.88,288508.54,92553.66
9865,1967-05-19,92.07,-0.46,-0.5,94.58,-2.65,True,1,3119,-92.07,-196046.95,287166.33,91119.38
9866,1967-05-22,91.67,-0.4,-0.43,94.58,-3.08,True,1,3120,-91.67,-196138.62,286010.4,89871.78
9867,1967-05-23,91.23,-0.44,-0.48,94.58,-3.54,True,1,3121,-91.23,-196229.85,284728.83,88498.98
9868,1967-05-24,90.18,-1.05,-1.15,94.58,-4.65,True,1,3122,-90.18,-196320.03,281541.96,85221.93
9869,1967-05-25,91.19,1.01,1.12,94.58,-3.58,True,1,3123,-91.19,-196411.22,284786.37,88375.15
9870,1967-05-26,90.98,-0.21,-0.23,94.58,-3.81,True,1,3124,-90.98,-196502.2,284221.52,87719.32
9871,1967-05-29,90.49,-0.49,-0.54,94.58,-4.32,True,1,3125,-90.49,-196592.69,282781.25,86188.56
9872,1967-05-31,89.08,-1.41,-1.56,94.58,-5.82,True,1,3126,-89.08,-196681.77,278464.08,81782.31
9873,1967-06-01,90.23,1.15,1.29,94.58,-4.6,True,1,3127,-90.23,-196772.0,282149.21,85377.21
9874,1967-06-02,89.79,-0.44,-0.49,94.58,-5.06,True,1,3128,-89.79,-196861.79,280863.12,84001.33
9875,1967-06-05,88.43,-1.36,-1.52,94.58,-6.5,True,1,3129,-88.43,-196950.22,276697.47,79747.25
9876,1967-06-06,90.23,1.8,2.04,94.58,-4.6,True,1,3130,-90.23,-197040.45,282419.9,85379.45
9877,1967-06-07,90.91,0.68,0.75,94.58,-3.88,True,1,3131,-90.91,-197131.36,284639.21,87507.85
9878,1967-06-08,91.4,0.49,0.54,94.58,-3.36,True,1,3132,-91.4,-197222.76,286264.8,89042.04
9879,1967-06-09,91.56,0.16,0.18,94.58,-3.19,True,1,3133,-91.56,-197314.32,286857.48,89543.16
9880,1967-06-12,92.04,0.48,0.52,94.58,-2.69,True,1,3134,-92.04,-197406.36,288453.36,91047.0
9881,1967-06-13,92.62,0.58,0.63,94.58,-2.07,True,1,3135,-92.62,-197498.98,290363.7,92864.72
9882,1967-06-14,92.4,-0.22,-0.24,94.58,-2.31,True,1,3136,-92.4,-197591.38,289766.4,92175.02
9883,1967-06-15,92.49,0.09,0.1,94.58,-2.21,True,1,3137,-92.49,-197683.87,290141.13,92457.26
9884,1967-06-16,92.54,0.05,0.05,94.58,-2.16,True,1,3138,-92.54,-197776.41,290390.52,92614.11
9885,1967-06-19,92.51,-0.03,-0.03,94.58,-2.19,True,1,3139,-92.51,-197868.92,290388.89,92519.97
9886,1967-06-20,92.48,-0.03,-0.03,94.58,-2.22,True,1,3140,-92.48,-197961.4,290387.2,92425.8
9887,1967-06-21,92.2,-0.28,-0.3,94.58,-2.52,True,1,3141,-92.2,-198053.6,289600.2,91546.6
9888,1967-06-22,91.97,-0.23,-0.25,94.58,-2.76,True,1,3142,-91.97,-198145.57,288969.74,90824.17
9889,1967-06-23,92.0,0.03,0.03,94.58,-2.73,True,1,3143,-92.0,-198237.57,289156.0,90918.43
9890,1967-06-26,91.64,-0.36,-0.39,94.58,-3.11,True,1,3144,-91.64,-198329.21,288116.16,89786.95
9891,1967-06-27,91.3,-0.34,-0.37,94.58,-3.47,True,1,3145,-91.3,-198420.51,287138.5,88717.99
9892,1967-06-28,91.31,0.01,0.01,94.58,-3.46,True,1,3146,-91.31,-198511.82,287261.26,88749.44
9893,1967-06-29,90.85,-0.46,-0.5,94.58,-3.94,True,1,3147,-90.85,-198602.67,285904.95,87302.28
9894,1967-06-30,90.64,-0.21,-0.23,94.58,-4.17,True,1,3148,-90.64,-198693.31,285334.72,86641.41
9895,1967-07-03,90.91,0.27,0.3,94.58,-3.88,True,1,3149,-90.91,-198784.22,286275.59,87491.37
9896,1967-07-05,91.36,0.45,0.5,94.58,-3.4,True,1,3150,-91.36,-198875.58,287784.0,88908.42
9897,1967-07-06,91.32,-0.04,-0.04,94.58,-3.45,True,1,3151,-91.32,-198966.9,287749.32,88782.42
9898,1967-07-07,91.69,0.37,0.4,94.58,-3.06,True,1,3152,-91.69,-199058.59,289006.88,89948.29
9899,1967-07-10,92.05,0.36,0.39,94.58,-2.68,True,1,3153,-92.05,-199150.64,290233.65,91083.01
9900,1967-07-11,92.48,0.43,0.47,94.58,-2.22,True,1,3154,-92.48,-199243.12,291681.92,92438.8
9901,1967-07-12,92.4,-0.08,-0.09,94.58,-2.31,True,1,3155,-92.4,-199335.52,291522.0,92186.48
9902,1967-07-13,92.42,0.02,0.02,94.58,-2.28,True,1,3156,-92.42,-199427.94,291677.52,92249.58
9903,1967-07-14,92.74,0.32,0.35,94.58,-1.94,True,1,3157,-92.74,-199520.68,292780.18,93259.5
9904,1967-07-17,92.75,0.01,0.01,94.58,-1.94,True,1,3158,-92.75,-199613.43,292904.5,93291.07
9905,1967-07-18,93.5,0.75,0.81,94.58,-1.14,True,1,3159,-93.5,-199706.93,295366.5,95659.57
9906,1967-07-19,93.65,0.15,0.16,94.58,-0.98,True,1,3160,-93.65,-199800.58,295934.0,96133.42
9907,1967-07-20,93.85,0.2,0.21,94.58,-0.77,True,1,3161,-93.85,-199894.43,296659.85,96765.42
9908,1967-07-21,94.04,0.19,0.2,94.58,-0.57,True,1,3162,-94.04,-199988.47,297354.48,97366.01
9909,1967-07-24,93.73,-0.31,-0.33,94.58,-0.9,True,1,3163,-93.73,-200082.2,296467.99,96385.79
9910,1967-07-25,93.24,-0.49,-0.52,94.58,-1.42,True,1,3164,-93.24,-200175.44,295011.36,94835.92
9911,1967-07-26,94.06,0.82,0.88,94.58,-0.55,True,1,3165,-94.06,-200269.5,297699.9,97430.4
9912,1967-07-27,94.35,0.29,0.31,94.58,-0.24,True,1,3166,-94.35,-200363.85,298712.1,98348.25
9913,1967-07-28,94.49,0.14,0.15,94.58,-0.1,True,1,3167,-94.49,-200458.34,299249.83,98791.49
9914,1967-07-31,94.75,0.26,0.28,94.75,0.0,True,1,3168,-94.75,-200553.09,300168.0,99614.91
9915,1967-08-01,95.37,0.62,0.65,95.37,0.0,True,1,3169,-95.37,-200648.46,302227.53,101579.07
9916,1967-08-02,95.78,0.41,0.43,95.78,0.0,True,1,3170,-95.78,-200744.24,303622.6,102878.36
9917,1967-08-03,95.66,-0.12,-0.12,95.78,-0.12,True,1,3171,-95.66,-200839.9,303337.86,102497.96
9918,1967-08-04,95.83,0.17,0.18,95.83,0.0,True,1,3172,-95.83,-200935.73,303972.76,103037.03
9919,1967-08-07,95.58,-0.25,-0.26,95.83,-0.26,True,1,3173,-95.58,-201031.31,303275.34,102244.03
9920,1967-08-08,95.69,0.11,0.12,95.83,-0.15,True,1,3174,-95.69,-201127.0,303720.06,102593.06
9921,1967-08-09,95.78,0.09,0.09,95.83,-0.05,True,1,3175,-95.78,-201222.78,304101.5,102878.72
9922,1967-08-10,95.53,-0.25,-0.26,95.83,-0.31,True,1,3176,-95.53,-201318.31,303403.28,102084.97
9923,1967-08-11,95.15,-0.38,-0.4,95.83,-0.71,True,1,3177,-95.15,-201413.46,302291.55,100878.09
9924,1967-08-14,94.64,-0.51,-0.54,95.83,-1.24,True,1,3178,-94.64,-201508.1,300765.92,99257.82
9925,1967-08-15,94.77,0.13,0.14,95.83,-1.11,True,1,3179,-94.77,-201602.87,301273.83,99670.96
9926,1967-08-16,94.55,-0.22,-0.23,95.83,-1.34,True,1,3180,-94.55,-201697.42,300669.0,98971.58
9927,1967-08-17,94.63,0.08,0.08,95.83,-1.25,True,1,3181,-94.63,-201792.05,301018.03,99225.98
9928,1967-08-18,94.78,0.15,0.16,95.83,-1.1,True,1,3182,-94.78,-201886.83,301589.96,99703.13
9929,1967-08-21,94.25,-0.53,-0.56,95.83,-1.65,True,1,3183,-94.25,-201981.08,299997.75,98016.67
9930,1967-08-22,93.74,-0.51,-0.54,95.83,-2.18,True,1,3184,-93.74,-202074.82,298468.16,96393.34
9931,1967-08-23,93.61,-0.13,-0.14,95.83,-2.32,True,1,3185,-93.61,-202168.43,298147.85,95979.42
9932,1967-08-24,93.09,-0.52,-0.56,95.83,-2.86,True,1,3186,-93.09,-202261.52,296584.74,94323.22
9933,1967-08-25,92.7,-0.39,-0.42,95.83,-3.27,True,1,3187,-92.7,-202354.22,295434.9,93080.68
9934,1967-08-28,92.64,-0.06,-0.06,95.83,-3.33,True,1,3188,-92.64,-202446.86,295336.32,92889.46
9935,1967-08-29,92.88,0.24,0.26,95.83,-3.08,True,1,3189,-92.88,-202539.74,296194.32,93654.58
9936,1967-08-30,93.07,0.19,0.2,95.83,-2.88,True,1,3190,-93.07,-202632.81,296893.3,94260.49
9937,1967-08-31,93.64,0.57,0.61,95.83,-2.28,True,1,3191,-93.64,-202726.45,298805.24,96078.79
9938,1967-09-01,93.68,0.04,0.04,95.83,-2.24,True,1,3192,-93.68,-202820.13,299026.56,96206.43
9939,1967-09-05,94.21,0.53,0.57,95.83,-1.69,True,1,3193,-94.21,-202914.34,300812.53,97898.19
9940,1967-09-06,94.39,0.18,0.19,95.83,-1.5,True,1,3194,-94.39,-203008.73,301481.66,98472.93
9941,1967-09-07,94.33,-0.06,-0.06,95.83,-1.56,True,1,3195,-94.33,-203103.06,301384.35,98281.29
9942,1967-09-08,94.36,0.03,0.03,95.83,-1.53,True,1,3196,-94.36,-203197.42,301574.56,98377.14
9943,1967-09-11,94.54,0.18,0.19,95.83,-1.35,True,1,3197,-94.54,-203291.96,302244.38,98952.42
9944,1967-09-12,94.99,0.45,0.48,95.83,-0.88,True,1,3198,-94.99,-203386.95,303778.02,100391.07
9945,1967-09-13,95.99,1.0,1.05,95.99,0.0,True,1,3199,-95.99,-203482.94,307072.01,103589.07
9946,1967-09-14,96.2,0.21,0.22,96.2,0.0,True,1,3200,-96.2,-203579.14,307840.0,104260.86
9947,1967-09-15,96.27,0.07,0.07,96.27,0.0,True,1,3201,-96.27,-203675.41,308160.27,104484.86
9948,1967-09-18,96.53,0.26,0.27,96.53,0.0,True,1,3202,-96.53,-203771.94,309089.06,105317.12
9949,1967-09-19,96.17,-0.36,-0.37,96.53,-0.37,True,1,3203,-96.17,-203868.11,308032.51,104164.4
9950,1967-09-20,96.13,-0.04,-0.04,96.53,-0.41,True,1,3204,-96.13,-203964.24,308000.52,104036.28
9951,1967-09-21,96.75,0.62,0.64,96.75,0.0,True,1,3205,-96.75,-204060.99,310083.75,106022.76
9952,1967-09-22,97.0,0.25,0.26,97.0,0.0,True,1,3206,-97.0,-204157.99,310982.0,106824.01
9953,1967-09-25,97.59,0.59,0.61,97.59,0.0,True,1,3207,-97.59,-204255.58,312971.13,108715.55
9954,1967-09-26,96.76,-0.83,-0.85,97.59,-0.85,True,1,3208,-96.76,-204352.34,310406.08,106053.74
9955,1967-09-27,96.79,0.03,0.03,97.59,-0.82,True,1,3209,-96.79,-204449.13,310599.11,106149.98
9956,1967-09-28,96.79,0.0,0.0,97.59,-0.82,True,1,3210,-96.79,-204545.92,310695.9,106149.98
9957,1967-09-29,96.71,-0.08,-0.08,97.59,-0.9,True,1,3211,-96.71,-204642.63,310535.81,105893.18
9958,1967-10-02,96.32,-0.39,-0.4,97.59,-1.3,True,1,3212,-96.32,-204738.95,309379.84,104640.89
9959,1967-10-03,96.65,0.33,0.34,97.59,-0.96,True,1,3213,-96.65,-204835.6,310536.45,105700.85
9960,1967-10-04,96.43,-0.22,-0.23,97.59,-1.19,True,1,3214,-96.43,-204932.03,309926.02,104993.99
9961,1967-10-05,96.67,0.24,0.25,97.59,-0.94,True,1,3215,-96.67,-205028.7,310794.05,105765.35
9962,1967-10-06,97.26,0.59,0.61,97.59,-0.34,True,1,3216,-97.26,-205125.96,312788.16,107662.2
9963,1967-10-09,97.51,0.25,0.26,97.59,-0.08,True,1,3217,-97.51,-205223.47,313689.67,108466.2
9964,1967-10-10,96.84,-0.67,-0.69,97.59,-0.77,True,1,3218,-96.84,-205320.31,311631.12,106310.81
9965,1967-10-11,96.37,-0.47,-0.48,97.59,-1.25,True,1,3219,-96.37,-205416.68,310215.03,104798.35
9966,1967-10-12,95.75,-0.62,-0.64,97.59,-1.88,True,1,3220,-95.75,-205512.43,308315.0,102802.57
9967,1967-10-13,96.0,0.25,0.26,97.59,-1.63,True,1,3221,-96.0,-205608.43,309216.0,103607.57
9968,1967-10-16,95.25,-0.75,-0.78,97.59,-2.4,True,1,3222,-95.25,-205703.68,306895.5,101191.82
9969,1967-10-17,95.0,-0.25,-0.26,97.59,-2.65,True,1,3223,-95.0,-205798.68,306185.0,100386.32
9970,1967-10-18,95.25,0.25,0.26,97.59,-2.4,True,1,3224,-95.25,-205893.93,307086.0,101192.07
9971,1967-10-19,95.43,0.18,0.19,97.59,-2.21,True,1,3225,-95.43,-205989.36,307761.75,101772.39
9972,1967-10-20,95.38,-0.05,-0.05,97.59,-2.26,True,1,3226,-95.38,-206084.74,307695.88,101611.14
9973,1967-10-23,94.96,-0.42,-0.44,97.59,-2.7,True,1,3227,-94.96,-206179.7,306435.92,100256.22
9974,1967-10-24,94.42,-0.54,-0.57,97.59,-3.25,True,1,3228,-94.42,-206274.12,304787.76,98513.64
9975,1967-10-25,94.52,0.1,0.11,97.59,-3.15,True,1,3229,-94.52,-206368.64,305205.08,98836.44
9976,1967-10-26,94.94,0.42,0.44,97.59,-2.72,True,1,3230,-94.94,-206463.58,306656.2,100192.62
9977,1967-10-27,94.96,0.02,0.02,97.59,-2.7,True,1,3231,-94.96,-206558.54,306815.76,100257.22
9978,1967-10-30,94.79,-0.17,-0.18,97.59,-2.87,True,1,3232,-94.79,-206653.33,306361.28,99707.95
9979,1967-10-31,93.3,-1.49,-1.57,97.59,-4.4,True,1,3233,-93.3,-206746.63,301638.9,94892.27
9980,1967-11-01,92.71,-0.59,-0.63,97.59,-5.0,True,1,3234,-92.71,-206839.34,299824.14,92984.8
9981,1967-11-02,92.34,-0.37,-0.4,97.59,-5.38,True,1,3235,-92.34,-206931.68,298719.9,91788.22
9982,1967-11-03,91.78,-0.56,-0.61,97.59,-5.95,True,1,3236,-91.78,-207023.46,297000.08,89976.62
9983,1967-11-06,91.48,-0.3,-0.33,97.59,-6.26,True,1,3237,-91.48,-207114.94,296120.76,89005.82
9984,1967-11-08,91.14,-0.34,-0.37,97.59,-6.61,True,1,3238,-91.14,-207206.08,295111.32,87905.24
9985,1967-11-09,91.59,0.45,0.49,97.59,-6.15,True,1,3239,-91.59,-207297.67,296660.01,89362.34
9986,1967-11-10,92.21,0.62,0.68,97.59,-5.51,True,1,3240,-92.21,-207389.88,298760.4,91370.52
9987,1967-11-13,91.97,-0.24,-0.26,97.59,-5.76,True,1,3241,-91.97,-207481.85,298074.77,90592.92
9988,1967-11-14,91.39,-0.58,-0.63,97.59,-6.35,True,1,3242,-91.39,-207573.24,296286.38,88713.14
9989,1967-11-15,91.76,0.37,0.4,97.59,-5.97,True,1,3243,-91.76,-207665.0,297577.68,89912.68
9990,1967-11-16,92.6,0.84,0.92,97.59,-5.11,True,1,3244,-92.6,-207757.6,300394.4,92636.8
9991,1967-11-17,92.82,0.22,0.24,97.59,-4.89,True,1,3245,-92.82,-207850.42,301200.9,93350.48
9992,1967-11-20,91.65,-1.17,-1.26,97.59,-6.09,True,1,3246,-91.65,-207942.07,297495.9,89553.83
9993,1967-11-21,93.1,1.45,1.58,97.59,-4.6,True,1,3247,-93.1,-208035.17,302295.7,94260.53
9994,1967-11-22,93.65,0.55,0.59,97.59,-4.04,True,1,3248,-93.65,-208128.82,304175.2,96046.38
9995,1967-11-24,93.9,0.25,0.27,97.59,-3.78,True,1,3249,-93.9,-208222.72,305081.1,96858.38
9996,1967-11-27,94.17,0.27,0.29,97.59,-3.5,True,1,3250,-94.17,-208316.89,306052.5,97735.61
9997,1967-11-28,94.49,0.32,0.34,97.59,-3.18,True,1,3251,-94.49,-208411.38,307186.99,98775.61
9998,1967-11-29,94.47,-0.02,-0.02,97.59,-3.2,True,1,3252,-94.47,-208505.85,307216.44,98710.59
9999,1967-11-30,94.0,-0.47,-0.5,97.59,-3.68,True,1,3253,-94.0,-208599.85,305782.0,97182.15
10000,1967-12-01,94.5,0.5,0.53,97.59,-3.17,True,1,3254,-94.5,-208694.35,307503.0,98808.65
10001,1967-12-04,95.1,0.6,0.64,97.59,-2.55,True,1,3255,-95.1,-208789.45,309550.5,100761.05
10002,1967-12-05,95.23,0.13,0.14,97.59,-2.42,True,1,3256,-95.23,-208884.68,310068.88,101184.2
10003,1967-12-06,95.64,0.41,0.43,97.59,-2.0,True,1,3257,-95.64,-208980.32,311499.48,102519.16
10004,1967-12-07,95.53,-0.11,-0.12,97.59,-2.11,True,1,3258,-95.53,-209075.85,311236.74,102160.89
10005,1967-12-08,95.42,-0.11,-0.12,97.59,-2.22,True,1,3259,-95.42,-209171.27,310973.78,101802.51
10006,1967-12-11,95.12,-0.3,-0.31,97.59,-2.53,True,1,3260,-95.12,-209266.39,310091.2,100824.81
10007,1967-12-12,95.01,-0.11,-0.12,97.59,-2.64,True,1,3261,-95.01,-209361.4,309827.61,100466.21
10008,1967-12-13,95.34,0.33,0.35,97.59,-2.31,True,1,3262,-95.34,-209456.74,310999.08,101542.34
10009,1967-12-14,95.47,0.13,0.14,97.59,-2.17,True,1,3263,-95.47,-209552.21,311518.61,101966.4
10010,1967-12-15,95.03,-0.44,-0.46,97.59,-2.62,True,1,3264,-95.03,-209647.24,310177.92,100530.68
10011,1967-12-18,94.77,-0.26,-0.27,97.59,-2.89,True,1,3265,-94.77,-209742.01,309424.05,99682.04
10012,1967-12-19,94.63,-0.14,-0.15,97.59,-3.03,True,1,3266,-94.63,-209836.64,309061.58,99224.94
10013,1967-12-20,95.15,0.52,0.55,97.59,-2.5,True,1,3267,-95.15,-209931.79,310855.05,100923.26
10014,1967-12-21,95.38,0.23,0.24,97.59,-2.26,True,1,3268,-95.38,-210027.17,311701.84,101674.67
10015,1967-12-22,95.2,-0.18,-0.19,97.59,-2.45,True,1,3269,-95.2,-210122.37,311208.8,101086.43
10016,1967-12-26,95.26,0.06,0.06,97.59,-2.39,True,1,3270,-95.26,-210217.63,311500.2,101282.57
10017,1967-12-27,95.91,0.65,0.68,97.59,-1.72,True,1,3271,-95.91,-210313.54,313721.61,103408.07
10018,1967-12-28,95.89,-0.02,-0.02,97.59,-1.74,True,1,3272,-95.89,-210409.43,313752.08,103342.65
10019,1967-12-29,96.47,0.58,0.6,97.59,-1.15,True,1,3273,-96.47,-210505.9,315746.31,105240.41
10020,1968-01-02,96.11,-0.36,-0.37,97.59,-1.52,True,1,3274,-96.11,-210602.01,314664.14,104062.13
10021,1968-01-03,95.67,-0.44,-0.46,97.59,-1.97,True,1,3275,-95.67,-210697.68,313319.25,102621.57
10022,1968-01-04,95.36,-0.31,-0.32,97.59,-2.28,True,1,3276,-95.36,-210793.04,312399.36,101606.32
10023,1968-01-05,95.94,0.58,0.61,97.59,-1.69,True,1,3277,-95.94,-210888.98,314395.38,103506.4
10024,1968-01-08,96.62,0.68,0.71,97.59,-0.99,True,1,3278,-96.62,-210985.6,316720.36,105734.76
10025,1968-01-09,96.5,-0.12,-0.12,97.59,-1.12,True,1,3279,-96.5,-211082.1,316423.5,105341.4
10026,1968-01-10,96.52,0.02,0.02,97.59,-1.1,True,1,3280,-96.52,-211178.62,316585.6,105406.98
10027,1968-01-11,96.62,0.1,0.1,97.59,-0.99,True,1,3281,-96.62,-211275.24,317010.22,105734.98
10028,1968-01-12,96.72,0.1,0.1,97.59,-0.89,True,1,3282,-96.72,-211371.96,317435.04,106063.08
10029,1968-01-15,96.42,-0.3,-0.31,97.59,-1.2,True,1,3283,-96.42,-211468.38,316546.86,105078.48
10030,1968-01-16,95.82,-0.6,-0.62,97.59,-1.81,True,1,3284,-95.82,-211564.2,314672.88,103108.68
10031,1968-01-17,95.64,-0.18,-0.19,97.59,-2.0,True,1,3285,-95.64,-211659.84,314177.4,102517.56
10032,1968-01-18,95.56,-0.08,-0.08,97.59,-2.08,True,1,3286,-95.56,-211755.4,314010.16,102254.76
10033,1968-01-19,95.24,-0.32,-0.34,97.59,-2.41,True,1,3287,-95.24,-211850.64,313053.88,101203.24
10034,1968-01-22,94.03,-1.21,-1.27,97.59,-3.65,True,1,3288,-94.03,-211944.67,309170.64,97225.97
10035,1968-01-23,93.66,-0.37,-0.39,97.59,-4.03,True,1,3289,-93.66,-212038.33,308047.74,96009.41
10036,1968-01-24,93.17,-0.49,-0.52,97.59,-4.53,True,1,3290,-93.17,-212131.5,306529.3,94397.8
10037,1968-01-25,93.3,0.13,0.14,97.59,-4.4,True,1,3291,-93.3,-212224.8,307050.3,94825.5
10038,1968-01-26,93.45,0.15,0.16,97.59,-4.24,True,1,3292,-93.45,-212318.25,307637.4,95319.15
10039,1968-01-29,93.35,-0.1,-0.11,97.59,-4.34,True,1,3293,-93.35,-212411.6,307401.55,94989.95
10040,1968-01-30,92.89,-0.46,-0.49,97.59,-4.82,True,1,3294,-92.89,-212504.49,305979.66,93475.17
10041,1968-01-31,92.24,-0.65,-0.7,97.59,-5.48,True,1,3295,-92.24,-212596.73,303930.8,91334.07
10042,1968-02-01,92.56,0.32,0.35,97.59,-5.15,True,1,3296,-92.56,-212689.29,305077.76,92388.47
10043,1968-02-02,92.27,-0.29,-0.31,97.59,-5.45,True,1,3297,-92.27,-212781.56,304214.19,91432.63
10044,1968-02-05,91.87,-0.4,-0.43,97.59,-5.86,True,1,3298,-91.87,-212873.43,302987.26,90113.83
10045,1968-02-06,91.9,0.03,0.03,97.59,-5.83,True,1,3299,-91.9,-212965.33,303178.1,90212.77
10046,1968-02-07,92.06,0.16,0.17,97.59,-5.67,True,1,3300,-92.06,-213057.39,303798.0,90740.61
10047,1968-02-08,90.9,-1.16,-1.26,97.59,-6.86,True,1,3301,-90.9,-213148.29,300060.9,86912.61
10048,1968-02-09,89.86,-1.04,-1.14,97.59,-7.92,True,1,3302,-89.86,-213238.15,296717.72,83479.57
10049,1968-02-13,89.07,-0.79,-0.88,97.59,-8.73,True,1,3303,-89.07,-213327.22,294198.21,80870.99
10050,1968-02-14,90.14,1.07,1.2,97.59,-7.63,True,1,3304,-90.14,-213417.36,297822.56,84405.2
10051,1968-02-15,90.3,0.16,0.18,97.59,-7.47,True,1,3305,-90.3,-213507.66,298441.5,84933.84
10052,1968-02-16,89.96,-0.34,-0.38,97.59,-7.82,True,1,3306,-89.96,-213597.62,297407.76,83810.14
10053,1968-02-19,90.31,0.35,0.39,97.59,-7.46,True,1,3307,-90.31,-213687.93,298655.17,84967.24
10054,1968-02-20,91.24,0.93,1.03,97.59,-6.51,True,1,3308,-91.24,-213779.17,301821.92,88042.75
10055,1968-02-21,91.24,0.0,0.0,97.59,-6.51,True,1,3309,-91.24,-213870.41,301913.16,88042.75
10056,1968-02-23,90.89,-0.35,-0.38,97.59,-6.86,True,1,3310,-90.89,-213961.3,300845.9,86884.6
10057,1968-02-26,90.18,-0.71,-0.78,97.59,-7.59,True,1,3311,-90.18,-214051.48,298585.98,84534.5
10058,1968-02-27,90.53,0.35,0.39,97.59,-7.23,True,1,3312,-90.53,-214142.01,299835.36,85693.35
10059,1968-02-28,90.08,-0.45,-0.5,97.59,-7.7,True,1,3313,-90.08,-214232.09,298435.04,84202.95
10060,1968-02-29,89.36,-0.72,-0.8,97.59,-8.43,True,1,3314,-89.36,-214321.45,296139.04,81817.59
10061,1968-03-01,89.11,-0.25,-0.28,97.59,-8.69,True,1,3315,-89.11,-214410.56,295399.65,80989.09
10062,1968-03-04,87.92,-1.19,-1.34,97.59,-9.91,True,1,3316,-87.92,-214498.48,291542.72,77044.24
10063,1968-03-05,87.72,-0.2,-0.23,97.59,-10.11,True,1,3317,-87.72,-214586.2,290967.24,76381.04
10064,1968-03-06,89.26,1.54,1.76,97.59,-8.54,True,1,3318,-89.26,-214675.46,296164.68,81489.22
10065,1968-03-07,89.1,-0.16,-0.18,97.59,-8.7,True,1,3319,-89.1,-214764.56,295722.9,80958.34
10066,1968-03-08,89.03,-0.07,-0.08,97.59,-8.77,True,1,3320,-89.03,-214853.59,295579.6,80726.01
10067,1968-03-11,90.13,1.1,1.24,97.59,-7.64,True,1,3321,-90.13,-214943.72,299321.73,84378.01
10068,1968-03-12,90.23,0.1,0.11,97.59,-7.54,True,1,3322,-90.23,-215033.95,299744.06,84710.11
10069,1968-03-13,90.03,-0.2,-0.22,97.59,-7.75,True,1,3323,-90.03,-215123.98,299169.69,84045.71
10070,1968-03-14,88.32,-1.71,-1.9,97.59,-9.5,True,1,3324,-88.32,-215212.3,293575.68,78363.38
10071,1968-03-15,89.1,0.78,0.88,97.59,-8.7,True,1,3325,-89.1,-215301.4,296257.5,80956.1
10072,1968-03-18,89.59,0.49,0.55,97.59,-8.2,True,1,3326,-89.59,-215390.99,297976.34,82585.35
10073,1968-03-19,88.99,-0.6,-0.67,97.59,-8.81,True,1,3327,-88.99,-215479.98,296069.73,80589.75
10074,1968-03-20,88.98,-0.01,-0.01,97.59,-8.82,True,1,3328,-88.98,-215568.96,296125.44,80556.48
10075,1968-03-21,88.33,-0.65,-0.73,97.59,-9.49,True,1,3329,-88.33,-215657.29,294050.57,78393.28
10076,1968-03-22,88.42,0.09,0.1,97.59,-9.4,True,1,3330,-88.42,-215745.71,294438.6,78692.89
10077,1968-03-25,88.33,-0.09,-0.1,97.59,-9.49,True,1,3331,-88.33,-215834.04,294227.23,78393.19
10078,1968-03-26,88.93,0.6,0.68,97.59,-8.87,True,1,3332,-88.93,-215922.97,296314.76,80391.79
10079,1968-03-27,89.66,0.73,0.82,97.59,-8.13,True,1,3333,-89.66,-216012.63,298836.78,82824.15
10080,1968-03-28,89.57,-0.09,-0.1,97.59,-8.22,True,1,3334,-89.57,-216102.2,298626.38,82524.18
10081,1968-03-29,90.2,0.63,0.7,97.59,-7.57,True,1,3335,-90.2,-216192.4,300817.0,84624.6
10082,1968-04-01,92.48,2.28,2.53,97.59,-5.24,True,1,3336,-92.48,-216284.88,308513.28,92228.4
10083,1968-04-02,92.64,0.16,0.17,97.59,-5.07,True,1,3337,-92.64,-216377.52,309139.68,92762.16
10084,1968-04-03,93.47,0.83,0.9,97.59,-4.22,True,1,3338,-93.47,-216470.99,312002.86,95531.87
10085,1968-04-04,93.84,0.37,0.4,97.59,-3.84,True,1,3339,-93.84,-216564.83,313331.76,96766.93
10086,1968-04-05,93.29,-0.55,-0.59,97.59,-4.41,True,1,3340,-93.29,-216658.12,311588.6,94930.48
10087,1968-04-08,94.95,1.66,1.78,97.59,-2.7,True,1,3341,-94.95,-216753.07,317227.95,100474.88
10088,1968-04-10,95.67,0.72,0.76,97.59,-1.97,True,1,3342,-95.67,-216848.74,319729.14,102880.4
10089,1968-04-11,96.53,0.86,0.9,97.59,-1.09,True,1,3343,-96.53,-216945.27,322699.79,105754.52
10090,1968-04-15,96.59,0.06,0.06,97.59,-1.02,True,1,3344,-96.59,-217041.86,322996.96,105955.1
10091,1968-04-16,96.62,0.03,0.03,97.59,-0.99,True,1,3345,-96.62,-217138.48,323193.9,106055.42
10092,1968-04-17,96.81,0.19,0.2,97.59,-0.8,True,1,3346,-96.81,-217235.29,323926.26,106690.97
10093,1968-04-18,97.08,0.27,0.28,97.59,-0.52,True,1,3347,-97.08,-217332.37,324926.76,107594.39
10094,1968-04-19,95.85,-1.23,-1.27,97.59,-1.78,True,1,3348,-95.85,-217428.22,320905.8,103477.58
10095,1968-04-22,95.32,-0.53,-0.55,97.59,-2.33,True,1,3349,-95.32,-217523.54,319226.68,101703.14
10096,1968-04-23,96.62,1.3,1.36,97.59,-0.99,True,1,3350,-96.62,-217620.16,323677.0,106056.84
10097,1968-04-24,96.92,0.3,0.31,97.59,-0.69,True,1,3351,-96.92,-217717.08,324778.92,107061.84
10098,1968-04-25,96.62,-0.3,-0.31,97.59,-0.99,True,1,3352,-96.62,-217813.7,323870.24,106056.54
10099,1968-04-26,97.21,0.59,0.61,97.59,-0.39,True,1,3353,-97.21,-217910.91,325945.13,108034.22
10100,1968-04-29,97.97,0.76,0.78,97.97,0.0,True,1,3354,-97.97,-218008.88,328591.38,110582.5
10101,1968-04-30,97.46,-0.51,-0.52,97.97,-0.52,True,1,3355,-97.46,-218106.34,326978.3,108871.96
10102,1968-05-01,97.97,0.51,0.52,97.97,0.0,True,1,3356,-97.97,-218204.31,328787.32,110583.01
10103,1968-05-02,98.59,0.62,0.63,98.59,0.0,True,1,3357,-98.59,-218302.9,330966.63,112663.73
10104,1968-05-03,98.66,0.07,0.07,98.66,0.0,True,1,3358,-98.66,-218401.56,331300.28,112898.72
10105,1968-05-06,98.35,-0.31,-0.31,98.66,-0.31,True,1,3359,-98.35,-218499.91,330357.65,111857.74
10106,1968-05-07,98.9,0.55,0.56,98.9,0.0,True,1,3360,-98.9,-218598.81,332304.0,113705.19
10107,1968-05-08,98.91,0.01,0.01,98.91,0.0,True,1,3361,-98.91,-218697.72,332436.51,113738.79
10108,1968-05-09,98.39,-0.52,-0.53,98.91,-0.53,True,1,3362,-98.39,-218796.11,330787.18,111991.07
10109,1968-05-10,98.5,0.11,0.11,98.91,-0.42,True,1,3363,-98.5,-218894.61,331255.5,112360.89
10110,1968-05-13,98.19,-0.31,-0.32,98.91,-0.73,True,1,3364,-98.19,-218992.8,330311.16,111318.36
10111,1968-05-14,98.12,-0.07,-0.07,98.91,-0.8,True,1,3365,-98.12,-219090.92,330173.8,111082.88
10112,1968-05-15,98.07,-0.05,-0.05,98.91,-0.85,True,1,3366,-98.07,-219188.99,330103.62,110914.63
10113,1968-05-16,97.6,-0.47,-0.48,98.91,-1.32,True,1,3367,-97.6,-219286.59,328619.2,109332.61
10114,1968-05-17,96.9,-0.7,-0.72,98.91,-2.03,True,1,3368,-96.9,-219383.49,326359.2,106975.71
10115,1968-05-20,96.45,-0.45,-0.46,98.91,-2.49,True,1,3369,-96.45,-219479.94,324940.05,105460.11
10116,1968-05-21,96.93,0.48,0.5,98.91,-2.0,True,1,3370,-96.93,-219576.87,326654.1,107077.23
10117,1968-05-22,97.18,0.25,0.26,98.91,-1.75,True,1,3371,-97.18,-219674.05,327593.78,107919.73
10118,1968-05-23,96.97,-0.21,-0.22,98.91,-1.96,True,1,3372,-96.97,-219771.02,326982.84,107211.82
10119,1968-05-24,97.15,0.18,0.19,98.91,-1.78,True,1,3373,-97.15,-219868.17,327686.95,107818.78
10120,1968-05-27,96.99,-0.16,-0.16,98.91,-1.94,True,1,3374,-96.99,-219965.16,327244.26,107279.1
10121,1968-05-28,97.62,0.63,0.65,98.91,-1.3,True,1,3375,-97.62,-220062.78,329467.5,109404.72
10122,1968-05-29,97.92,0.3,0.31,98.91,-1.0,True,1,3376,-97.92,-220160.7,330577.92,110417.22
10123,1968-05-31,98.68,0.76,0.78,98.91,-0.23,True,1,3377,-98.68,-220259.38,333242.36,112982.98
10124,1968-06-03,99.99,1.31,1.33,99.99,0.0,True,1,3378,-99.99,-220359.37,337766.22,117406.85
10125,1968-06-04,100.38,0.39,0.39,100.38,0.0,True,1,3379,-100.38,-220459.75,339184.02,118724.27
10126,1968-06-05,99.89,-0.49,-0.49,100.38,-0.49,True,1,3380,-99.89,-220559.64,337628.2,117068.56
10127,1968-06-06,100.65,0.76,0.76,100.65,0.0,True,1,3381,-100.65,-220660.29,340297.65,119637.36
10128,1968-06-07,101.27,0.62,0.62,101.27,0.0,True,1,3382,-101.27,-220761.56,342495.14,121733.58
10129,1968-06-10,101.41,0.14,0.14,101.41,0.0,True,1,3383,-101.41,-220862.97,343070.03,122207.06
10130,1968-06-11,101.66,0.25,0.25,101.66,0.0,True,1,3384,-101.66,-220964.63,344017.44,123052.81
10131,1968-06-13,101.25,-0.41,-0.4,101.66,-0.4,True,1,3385,-101.25,-221065.88,342731.25,121665.37
10132,1968-06-14,101.13,-0.12,-0.12,101.66,-0.52,True,1,3386,-101.13,-221167.01,342426.18,121259.17
10133,1968-06-17,100.13,-1.0,-0.99,101.66,-1.5,True,1,3387,-100.13,-221267.14,339140.31,117873.17
10134,1968-06-18,99.99,-0.14,-0.14,101.66,-1.64,True,1,3388,-99.99,-221367.13,338766.12,117398.99
10135,1968-06-20,101.51,1.52,1.52,101.66,-0.15,True,1,3389,-101.51,-221468.64,344017.39,122548.75
10136,1968-06-21,100.66,-0.85,-0.84,101.66,-0.98,True,1,3390,-100.66,-221569.3,341237.4,119668.1
10137,1968-06-24,100.39,-0.27,-0.27,101.66,-1.25,True,1,3391,-100.39,-221669.69,340422.49,118752.8
10138,1968-06-25,100.08,-0.31,-0.31,101.66,-1.55,True,1,3392,-100.08,-221769.77,339471.36,117701.59
10139,1968-06-27,99.98,-0.1,-0.1,101.66,-1.65,True,1,3393,-99.98,-221869.75,339232.14,117362.39
10140,1968-06-28,99.58,-0.4,-0.4,101.66,-2.05,True,1,3394,-99.58,-221969.33,337974.52,116005.19
10141,1968-07-01,99.4,-0.18,-0.18,101.66,-2.22,True,1,3395,-99.4,-222068.73,337463.0,115394.27
10142,1968-07-02,99.74,0.34,0.34,101.66,-1.89,True,1,3396,-99.74,-222168.47,338717.04,116548.57
10143,1968-07-03,100.91,1.17,1.17,101.66,-0.74,True,1,3397,-100.91,-222269.38,342791.27,120521.89
10144,1968-07-08,101.94,1.03,1.02,101.94,0.0,True,1,3398,-101.94,-222371.32,346392.12,124020.8
10145,1968-07-09,102.23,0.29,0.28,102.23,0.0,True,1,3399,-102.23,-222473.55,347479.77,125006.22
10146,1968-07-11,102.39,0.16,0.16,102.39,0.0,True,1,3400,-102.39,-222575.94,348126.0,125550.06
10147,1968-07-12,102.34,-0.05,-0.05,102.39,-0.05,True,1,3401,-102.34,-222678.28,348058.34,125380.06
10148,1968-07-15,102.26,-0.08,-0.08,102.39,-0.13,True,1,3402,-102.26,-222780.54,347888.52,125107.98
10149,1968-07-16,101.7,-0.56,-0.55,102.39,-0.67,True,1,3403,-101.7,-222882.24,346085.1,123202.86
10150,1968-07-18,101.44,-0.26,-0.26,102.39,-0.93,True,1,3404,-101.44,-222983.68,345301.76,122318.08
10151,1968-07-19,100.46,-0.98,-0.97,102.39,-1.88,True,1,3405,-100.46,-223084.14,342066.3,118982.16
10152,1968-07-22,99.33,-1.13,-1.12,102.39,-2.99,True,1,3406,-99.33,-223183.47,338317.98,115134.51
10153,1968-07-23,99.21,-0.12,-0.12,102.39,-3.11,True,1,3407,-99.21,-223282.68,338008.47,114725.79
10154,1968-07-25,97.94,-1.27,-1.28,102.39,-4.35,True,1,3408,-97.94,-223380.62,333779.52,110398.9
10155,1968-07-26,98.34,0.4,0.41,102.39,-3.96,True,1,3409,-98.34,-223478.96,335241.06,111762.1
10156,1968-07-29,97.65,-0.69,-0.7,102.39,-4.63,True,1,3410,-97.65,-223576.61,332986.5,109409.89
10157,1968-07-30,97.74,0.09,0.09,102.39,-4.54,True,1,3411,-97.74,-223674.35,333391.14,109716.79
10158,1968-08-01,97.28,-0.46,-0.47,102.39,-4.99,True,1,3412,-97.28,-223771.63,331919.36,108147.73
10159,1968-08-02,96.63,-0.65,-0.67,102.39,-5.63,True,1,3413,-96.63,-223868.26,329798.19,105929.93
10160,1968-08-05,96.85,0.22,0.23,102.39,-5.41,True,1,3414,-96.85,-223965.11,330645.9,106680.79
10161,1968-08-06,97.25,0.4,0.41,102.39,-5.02,True,1,3415,-97.25,-224062.36,332108.75,108046.39
10162,1968-08-08,97.04,-0.21,-0.22,102.39,-5.22,True,1,3416,-97.04,-224159.4,331488.64,107329.24
10163,1968-08-09,97.01,-0.03,-0.03,102.39,-5.25,True,1,3417,-97.01,-224256.41,331483.17,107226.76
10164,1968-08-12,98.01,1.0,1.03,102.39,-4.28,True,1,3418,-98.01,-224354.42,334998.18,110643.76
10165,1968-08-13,98.53,0.52,0.53,102.39,-3.77,True,1,3419,-98.53,-224452.95,336874.07,112421.12
10166,1968-08-15,98.07,-0.46,-0.47,102.39,-4.22,True,1,3420,-98.07,-224551.02,335399.4,110848.38
10167,1968-08-16,98.68,0.61,0.62,102.39,-3.62,True,1,3421,-98.68,-224649.7,337584.28,112934.58
10168,1968-08-19,99.0,0.32,0.32,102.39,-3.31,True,1,3422,-99.0,-224748.7,338778.0,114029.3
10169,1968-08-20,98.96,-0.04,-0.04,102.39,-3.35,True,1,3423,-98.96,-224847.66,338740.08,113892.42
10170,1968-08-22,98.7,-0.26,-0.26,102.39,-3.6,True,1,3424,-98.7,-224946.36,337948.8,113002.44
10171,1968-08-23,98.69,-0.01,-0.01,102.39,-3.61,True,1,3425,-98.69,-225045.05,338013.25,112968.2
10172,1968-08-26,98.94,0.25,0.25,102.39,-3.37,True,1,3426,-98.94,-225143.99,338968.44,113824.45
10173,1968-08-27,98.81,-0.13,-0.13,102.39,-3.5,True,1,3427,-98.81,-225242.8,338621.87,113379.07
10174,1968-08-29,98.74,-0.07,-0.07,102.39,-3.56,True,1,3428,-98.74,-225341.54,338480.72,113139.18
10175,1968-08-30,98.86,0.12,0.12,102.39,-3.45,True,1,3429,-98.86,-225440.4,338990.94,113550.54
10176,1968-09-03,99.32,0.46,0.46,102.39,-3.0,True,1,3430,-99.32,-225539.72,340667.6,115127.88
10177,1968-09-04,100.02,0.7,0.7,102.39,-2.32,True,1,3431,-100.02,-225639.74,343168.62,117528.88
10178,1968-09-05,100.74,0.72,0.72,102.39,-1.61,True,1,3432,-100.74,-225740.48,345739.68,119999.2
10179,1968-09-06,101.2,0.46,0.46,102.39,-1.16,True,1,3433,-101.2,-225841.68,347419.6,121577.92
10180,1968-09-09,101.23,0.03,0.03,102.39,-1.13,True,1,3434,-101.23,-225942.91,347623.82,121680.91
10181,1968-09-10,100.73,-0.5,-0.49,102.39,-1.62,True,1,3435,-100.73,-226043.64,346007.55,119963.91
10182,1968-09-12,100.52,-0.21,-0.21,102.39,-1.83,True,1,3436,-100.52,-226144.16,345386.72,119242.56
10183,1968-09-13,100.86,0.34,0.34,102.39,-1.49,True,1,3437,-100.86,-226245.02,346655.82,120410.8
10184,1968-09-16,101.24,0.38,0.38,102.39,-1.12,True,1,3438,-101.24,-226346.26,348063.12,121716.86
10185,1968-09-17,101.5,0.26,0.26,102.39,-0.87,True,1,3439,-101.5,-226447.76,349058.5,122610.74
10186,1968-09-19,101.59,0.09,0.09,102.39,-0.78,True,1,3440,-101.59,-226549.35,349469.6,122920.25
10187,1968-09-20,101.66,0.07,0.07,102.39,-0.71,True,1,3441,-101.66,-226651.01,349812.06,123161.05
10188,1968-09-23,102.24,0.58,0.57,102.39,-0.15,True,1,3442,-102.24,-226753.25,351910.08,125156.83
10189,1968-09-24,102.59,0.35,0.34,102.59,0.0,True,1,3443,-102.59,-226855.84,353217.37,126361.53
10190,1968-09-26,102.36,-0.23,-0.22,102.59,-0.22,True,1,3444,-102.36,-226958.2,352527.84,125569.64
10191,1968-09-27,102.31,-0.05,-0.05,102.59,-0.27,True,1,3445,-102.31,-227060.51,352457.95,125397.44
10192,1968-09-30,102.67,0.36,0.35,102.67,0.0,True,1,3446,-102.67,-227163.18,353800.82,126637.64
10193,1968-10-01,102.86,0.19,0.18,102.86,0.0,True,1,3447,-102.86,-227266.04,354558.42,127292.38
10194,1968-10-03,103.22,0.36,0.35,103.22,0.0,True,1,3448,-103.22,-227369.26,355902.56,128533.3
10195,1968-10-04,103.71,0.49,0.48,103.71,0.0,True,1,3449,-103.71,-227472.97,357695.79,130222.82
10196,1968-10-07,103.7,-0.01,-0.01,103.71,-0.01,True,1,3450,-103.7,-227576.67,357765.0,130188.33
10197,1968-10-08,103.74,0.04,0.04,103.74,0.0,True,1,3451,-103.74,-227680.41,358006.74,130326.33
10198,1968-10-10,103.29,-0.45,-0.43,103.74,-0.43,True,1,3452,-103.29,-227783.7,356557.08,128773.38
10199,1968-10-11,103.18,-0.11,-0.11,103.74,-0.54,True,1,3453,-103.18,-227886.88,356280.54,128393.66
10200,1968-10-14,103.32,0.14,0.14,103.74,-0.4,True,1,3454,-103.32,-227990.2,356867.28,128877.08
10201,1968-10-15,103.53,0.21,0.2,103.74,-0.2,True,1,3455,-103.53,-228093.73,357696.15,129602.42
10202,1968-10-17,104.01,0.48,0.46,104.01,0.0,True,1,3456,-104.01,-228197.74,359458.56,131260.82
10203,1968-10-18,104.82,0.81,0.78,104.82,0.0,True,1,3457,-104.82,-228302.56,362362.74,134060.18
10204,1968-10-21,104.99,0.17,0.16,104.99,0.0,True,1,3458,-104.99,-228407.55,363055.42,134647.87
10205,1968-10-22,104.57,-0.42,-0.4,104.99,-0.4,True,1,3459,-104.57,-228512.12,361707.63,133195.51
10206,1968-10-24,103.84,-0.73,-0.7,104.99,-1.1,True,1,3460,-103.84,-228615.96,359286.4,130670.44
10207,1968-10-25,104.2,0.36,0.35,104.99,-0.75,True,1,3461,-104.2,-228720.16,360636.2,131916.04
10208,1968-10-28,103.9,-0.3,-0.29,104.99,-1.04,True,1,3462,-103.9,-228824.06,359701.8,130877.74
10209,1968-10-29,103.3,-0.6,-0.58,104.99,-1.61,True,1,3463,-103.3,-228927.36,357727.9,128800.54
10210,1968-10-31,103.41,0.11,0.11,104.99,-1.5,True,1,3464,-103.41,-229030.77,358212.24,129181.47
10211,1968-11-01,103.06,-0.35,-0.34,104.99,-1.84,True,1,3465,-103.06,-229133.83,357102.9,127969.07
10212,1968-11-04,103.1,0.04,0.04,104.99,-1.8,True,1,3466,-103.1,-229236.93,357344.6,128107.67
10213,1968-11-06,103.27,0.17,0.16,104.99,-1.64,True,1,3467,-103.27,-229340.2,358037.09,128696.89
10214,1968-11-07,103.5,0.23,0.22,104.99,-1.42,True,1,3468,-103.5,-229443.7,358938.0,129494.3
10215,1968-11-08,103.95,0.45,0.44,104.99,-0.99,True,1,3469,-103.95,-229547.65,360602.55,131054.9
10216,1968-11-12,104.62,0.67,0.64,104.99,-0.35,True,1,3470,-104.62,-229652.27,363031.4,133379.13
10217,1968-11-13,105.13,0.51,0.49,105.13,0.0,True,1,3471,-105.13,-229757.4,364906.23,135148.83
10218,1968-11-14,105.2,0.07,0.07,105.2,0.0,True,1,3472,-105.2,-229862.6,365254.4,135391.8
10219,1968-11-15,105.78,0.58,0.55,105.78,0.0,True,1,3473,-105.78,-229968.38,367373.94,137405.56
10220,1968-11-18,105.92,0.14,0.13,105.92,0.0,True,1,3474,-105.92,-230074.3,367966.08,137891.78
10221,1968-11-19,106.14,0.22,0.21,106.14,0.0,True,1,3475,-106.14,-230180.44,368836.5,138656.06
10222,1968-11-21,105.97,-0.17,-0.16,106.14,-0.16,True,1,3476,-105.97,-230286.41,368351.72,138065.31
10223,1968-11-22,106.3,0.33,0.31,106.3,0.0,True,1,3477,-106.3,-230392.71,369605.1,139212.39
10224,1968-11-25,106.48,0.18,0.17,106.48,0.0,True,1,3478,-106.48,-230499.19,370337.44,139838.25
10225,1968-11-26,107.26,0.78,0.73,107.26,0.0,True,1,3479,-107.26,-230606.45,373157.54,142551.09
10226,1968-11-27,107.76,0.5,0.47,107.76,0.0,True,1,3480,-107.76,-230714.21,375004.8,144290.59
10227,1968-11-29,108.37,0.61,0.57,108.37,0.0,True,1,3481,-108.37,-230822.58,377235.97,146413.39
10228,1968-12-02,108.12,-0.25,-0.23,108.37,-0.23,True,1,3482,-108.12,-230930.7,376473.84,145543.14
10229,1968-12-03,108.02,-0.1,-0.09,108.37,-0.32,True,1,3483,-108.02,-231038.72,376233.66,145194.94
10230,1968-12-05,107.67,-0.35,-0.32,108.37,-0.65,True,1,3484,-107.67,-231146.39,375122.28,143975.89
10231,1968-12-06,107.93,0.26,0.24,108.37,-0.41,True,1,3485,-107.93,-231254.32,376136.05,144881.73
10232,1968-12-09,107.66,-0.27,-0.25,108.37,-0.66,True,1,3486,-107.66,-231361.98,375302.76,143940.78
10233,1968-12-10,107.39,-0.27,-0.25,108.37,-0.9,True,1,3487,-107.39,-231469.37,374468.93,142999.56
10234,1968-12-12,107.32,-0.07,-0.06,108.37,-0.97,True,1,3488,-107.32,-231576.69,374332.16,142755.47
10235,1968-12-13,107.58,0.26,0.24,108.37,-0.73,True,1,3489,-107.58,-231684.27,375346.62,143662.35
10236,1968-12-16,107.1,-0.48,-0.45,108.37,-1.17,True,1,3490,-107.1,-231791.37,373779.0,141987.63
10237,1968-12-17,106.66,-0.44,-0.41,108.37,-1.58,True,1,3491,-106.66,-231898.03,372350.06,140452.03
10238,1968-12-19,106.97,0.31,0.29,108.37,-1.29,True,1,3492,-106.97,-232005.0,373539.24,141534.24
10239,1968-12-20,106.34,-0.63,-0.59,108.37,-1.87,True,1,3493,-106.34,-232111.34,371445.62,139334.28
10240,1968-12-23,105.21,-1.13,-1.06,108.37,-2.92,True,1,3494,-105.21,-232216.55,367603.74,135387.19
10241,1968-12-24,105.04,-0.17,-0.16,108.37,-3.07,True,1,3495,-105.04,-232321.59,367114.8,134793.21
10242,1968-12-26,105.15,0.11,0.1,108.37,-2.97,True,1,3496,-105.15,-232426.74,367604.4,135177.66
10243,1968-12-27,104.74,-0.41,-0.39,108.37,-3.35,True,1,3497,-104.74,-232531.48,366275.78,133744.3
10244,1968-12-30,103.8,-0.94,-0.9,108.37,-4.22,True,1,3498,-103.8,-232635.28,363092.4,130457.12
10245,1968-12-31,103.86,0.06,0.06,108.37,-4.16,True,1,3499,-103.86,-232739.14,363406.14,130667.0
10246,1969-01-02,103.93,0.07,0.07,108.37,-4.1,True,1,3500,-103.93,-232843.07,363755.0,130911.93
10247,1969-01-03,103.99,0.06,0.06,108.37,-4.04,True,1,3501,-103.99,-232947.06,364068.99,131121.93
10248,1969-01-06,102.47,-1.52,-1.46,108.37,-5.44,True,1,3502,-102.47,-233049.53,358849.94,125800.41
10249,1969-01-07,101.22,-1.25,-1.22,108.37,-6.6,True,1,3503,-101.22,-233150.75,354573.66,121422.91
10250,1969-01-08,100.8,-0.42,-0.42,108.37,-6.98,True,1,3504,-100.8,-233251.55,353203.2,119951.65
10251,1969-01-09,101.22,0.42,0.42,108.37,-6.6,True,1,3505,-101.22,-233352.77,354776.1,121423.33
10252,1969-01-10,100.93,-0.29,-0.29,108.37,-6.86,True,1,3506,-100.93,-233453.7,353860.58,120406.88
10253,1969-01-13,100.44,-0.49,-0.48,108.37,-7.32,True,1,3507,-100.44,-233554.14,352243.08,118688.94
10254,1969-01-14,101.13,0.69,0.69,108.37,-6.68,True,1,3508,-101.13,-233655.27,354764.04,121108.77
10255,1969-01-15,101.62,0.49,0.48,108.37,-6.23,True,1,3509,-101.62,-233756.89,356584.58,122827.69
10256,1969-01-16,102.18,0.56,0.55,108.37,-5.71,True,1,3510,-102.18,-233859.07,358651.8,124792.73
10257,1969-01-17,102.03,-0.15,-0.15,108.37,-5.85,True,1,3511,-102.03,-233961.1,358227.33,124266.23
10258,1969-01-20,101.69,-0.34,-0.33,108.37,-6.16,True,1,3512,-101.69,-234062.79,357135.28,123072.49
10259,1969-01-21,101.63,-0.06,-0.06,108.37,-6.22,True,1,3513,-101.63,-234164.42,357026.19,122861.77
10260,1969-01-22,101.98,0.35,0.34,108.37,-5.9,True,1,3514,-101.98,-234266.4,358357.72,124091.32
10261,1969-01-23,102.43,0.45,0.44,108.37,-5.48,True,1,3515,-102.43,-234368.83,360041.45,125672.62
10262,1969-01-24,102.38,-0.05,-0.05,108.37,-5.53,True,1,3516,-102.38,-234471.21,359968.08,125496.87
10263,1969-01-27,102.4,0.02,0.02,108.37,-5.51,True,1,3517,-102.4,-234573.61,360140.8,125567.19
10264,1969-01-28,102.41,0.01,0.01,108.37,-5.5,True,1,3518,-102.41,-234676.02,360278.38,125602.36
10265,1969-01-29,102.51,0.1,0.1,108.37,-5.41,True,1,3519,-102.51,-234778.53,360732.69,125954.16
10266,1969-01-30,102.55,0.04,0.04,108.37,-5.37,True,1,3520,-102.55,-234881.08,360976.0,126094.92
10267,1969-01-31,103.01,0.46,0.45,108.37,-4.95,True,1,3521,-103.01,-234984.09,362698.21,127714.12
10268,1969-02-03,102.89,-0.12,-0.12,108.37,-5.06,True,1,3522,-102.89,-235086.98,362378.58,127291.6
10269,1969-02-04,102.92,0.03,0.03,108.37,-5.03,True,1,3523,-102.92,-235189.9,362587.16,127397.26
10270,1969-02-05,103.2,0.28,0.27,108.37,-4.77,True,1,3524,-103.2,-235293.1,363676.8,128383.7
10271,1969-02-06,103.54,0.34,0.33,108.37,-4.46,True,1,3525,-103.54,-235396.64,364978.5,129581.86
10272,1969-02-07,103.53,-0.01,-0.01,108.37,-4.47,True,1,3526,-103.53,-235500.17,365046.78,129546.61
10273,1969-02-11,103.65,0.12,0.12,108.37,-4.36,True,1,3527,-103.65,-235603.82,365573.55,129969.73
10274,1969-02-12,103.63,-0.02,-0.02,108.37,-4.37,True,1,3528,-103.63,-235707.45,365606.64,129899.19
10275,1969-02-13,103.71,0.08,0.08,108.37,-4.3,True,1,3529,-103.71,-235811.16,365992.59,130181.43
10276,1969-02-14,103.61,-0.1,-0.1,108.37,-4.39,True,1,3530,-103.61,-235914.77,365743.3,129828.53
10277,1969-02-17,102.44,-1.17,-1.13,108.37,-5.47,True,1,3531,-102.44,-236017.21,361715.64,125698.43
10278,1969-02-18,101.4,-1.04,-1.01,108.37,-6.43,True,1,3532,-101.4,-236118.61,358144.8,122026.19
10279,1969-02-19,100.65,-0.75,-0.74,108.37,-7.12,True,1,3533,-100.65,-236219.26,355596.45,119377.19
10280,1969-02-20,99.79,-0.86,-0.85,108.37,-7.92,True,1,3534,-99.79,-236319.05,352657.86,116338.81
10281,1969-02-24,98.6,-1.19,-1.19,108.37,-9.02,True,1,3535,-98.6,-236417.65,348551.0,112133.35
10282,1969-02-25,97.98,-0.62,-0.63,108.37,-9.59,True,1,3536,-97.98,-236515.63,346457.28,109941.65
10283,1969-02-26,98.45,0.47,0.48,108.37,-9.15,True,1,3537,-98.45,-236614.08,348217.65,111603.57
10284,1969-02-27,98.14,-0.31,-0.32,108.37,-9.44,True,1,3538,-98.14,-236712.22,347219.32,110507.1
10285,1969-02-28,98.13,-0.01,-0.01,108.37,-9.45,True,1,3539,-98.13,-236810.35,347282.07,110471.72
10286,1969-03-03,98.38,0.25,0.26,108.37,-9.22,True,1,3540,-98.38,-236908.73,348265.2,111356.47
10287,1969-03-04,99.32,0.94,0.96,108.37,-8.35,True,1,3541,-99.32,-237008.05,351692.12,114684.07
10288,1969-03-05,99.71,0.39,0.39,108.37,-7.99,True,1,3542,-99.71,-237107.76,353172.82,116065.06
10289,1969-03-06,98.7,-1.01,-1.01,108.37,-8.92,True,1,3543,-98.7,-237206.46,349694.1,112487.64
10290,1969-03-07,98.65,-0.05,-0.05,108.37,-8.97,True,1,3544,-98.65,-237305.11,349615.6,112310.49
10291,1969-03-10,98.99,0.34,0.34,108.37,-8.66,True,1,3545,-98.99,-237404.1,350919.55,113515.45
10292,1969-03-11,99.32,0.33,0.33,108.37,-8.35,True,1,3546,-99.32,-237503.42,352188.72,114685.3
10293,1969-03-12,99.05,-0.27,-0.27,108.37,-8.6,True,1,3547,-99.05,-237602.47,351330.35,113727.88
10294,1969-03-13,98.39,-0.66,-0.67,108.37,-9.21,True,1,3548,-98.39,-237700.86,349087.72,111386.86
10295,1969-03-14,98.0,-0.39,-0.4,108.37,-9.57,True,1,3549,-98.0,-237798.86,347802.0,110003.14
10296,1969-03-17,98.25,0.25,0.26,108.37,-9.34,True,1,3550,-98.25,-237897.11,348787.5,110890.39
10297,1969-03-18,98.49,0.24,0.24,108.37,-9.12,True,1,3551,-98.49,-237995.6,349737.99,111742.39
10298,1969-03-19,99.21,0.72,0.73,108.37,-8.45,True,1,3552,-99.21,-238094.81,352393.92,114299.11
10299,1969-03-20,99.84,0.63,0.64,108.37,-7.87,True,1,3553,-99.84,-238194.65,354731.52,116536.87
10300,1969-03-21,99.63,-0.21,-0.21,108.37,-8.06,True,1,3554,-99.63,-238294.28,354085.02,115790.74
10301,1969-03-24,99.5,-0.13,-0.13,108.37,-8.18,True,1,3555,-99.5,-238393.78,353722.5,115328.72
10302,1969-03-25,99.66,0.16,0.16,108.37,-8.04,True,1,3556,-99.66,-238493.44,354390.96,115897.52
10303,1969-03-26,100.39,0.73,0.73,108.37,-7.36,True,1,3557,-100.39,-238593.83,357087.23,118493.4
10304,1969-03-27,101.1,0.71,0.71,108.37,-6.71,True,1,3558,-101.1,-238694.93,359713.8,121018.87
10305,1969-03-28,101.51,0.41,0.41,108.37,-6.33,True,1,3559,-101.51,-238796.44,361274.09,122477.65
10306,1969-04-01,101.42,-0.09,-0.09,108.37,-6.41,True,1,3560,-101.42,-238897.86,361055.2,122157.34
10307,1969-04-02,100.78,-0.64,-0.63,108.37,-7.0,True,1,3561,-100.78,-238998.64,358877.58,119878.94
10308,1969-04-03,100.68,-0.1,-0.1,108.37,-7.1,True,1,3562,-100.68,-239099.32,358622.16,119522.84
10309,1969-04-07,99.89,-0.79,-0.78,108.37,-7.82,True,1,3563,-99.89,-239199.21,355908.07,116708.86
10310,1969-04-08,100.14,0.25,0.25,108.37,-7.59,True,1,3564,-100.14,-239299.35,356898.96,117599.61
10311,1969-04-09,101.02,0.88,0.88,108.37,-6.78,True,1,3565,-101.02,-239400.37,360136.3,120735.93
10312,1969-04-10,101.55,0.53,0.52,108.37,-6.29,True,1,3566,-101.55,-239501.92,362127.3,122625.38
10313,1969-04-11,101.65,0.1,0.1,108.37,-6.2,True,1,3567,-101.65,-239603.57,362585.55,122981.98
10314,1969-04-14,101.57,-0.08,-0.08,108.37,-6.28,True,1,3568,-101.57,-239705.14,362401.76,122696.62
10315,1969-04-15,101.53,-0.04,-0.04,108.37,-6.31,True,1,3569,-101.53,-239806.67,362360.57,122553.9
10316,1969-04-16,100.63,-0.9,-0.89,108.37,-7.14,True,1,3570,-100.63,-239907.3,359249.1,119341.8
10317,1969-04-17,100.78,0.15,0.15,108.37,-7.0,True,1,3571,-100.78,-240008.08,359885.38,119877.3
10318,1969-04-18,101.24,0.46,0.46,108.37,-6.58,True,1,3572,-101.24,-240109.32,361629.28,121519.96
10319,1969-04-21,100.56,-0.68,-0.67,108.37,-7.21,True,1,3573,-100.56,-240209.88,359300.88,119091.0
10320,1969-04-22,100.78,0.22,0.22,108.37,-7.0,True,1,3574,-100.78,-240310.66,360187.72,119877.06
10321,1969-04-23,100.8,0.02,0.02,108.37,-6.98,True,1,3575,-100.8,-240411.46,360360.0,119948.54
10322,1969-04-24,101.27,0.47,0.47,108.37,-6.55,True,1,3576,-101.27,-240512.73,362141.52,121628.79
10323,1969-04-25,101.72,0.45,0.44,108.37,-6.14,True,1,3577,-101.72,-240614.45,363852.44,123237.99
10324,1969-04-28,102.03,0.31,0.3,108.37,-5.85,True,1,3578,-102.03,-240716.48,365063.34,124346.86
10325,1969-04-29,102.79,0.76,0.74,108.37,-5.15,True,1,3579,-102.79,-240819.27,367885.41,127066.14
10326,1969-04-30,103.69,0.9,0.88,108.37,-4.32,True,1,3580,-103.69,-240922.96,371210.2,130287.24
10327,1969-05-01,103.51,-0.18,-0.17,108.37,-4.49,True,1,3581,-103.51,-241026.47,370669.31,129642.84
10328,1969-05-02,104.0,0.49,0.47,108.37,-4.03,True,1,3582,-104.0,-241130.47,372528.0,131397.53
10329,1969-05-05,104.37,0.37,0.36,108.37,-3.69,True,1,3583,-104.37,-241234.84,373957.71,132722.87
10330,1969-05-06,104.86,0.49,0.47,108.37,-3.24,True,1,3584,-104.86,-241339.7,375818.24,134478.54
10331,1969-05-07,104.67,-0.19,-0.18,108.37,-3.41,True,1,3585,-104.67,-241444.37,375241.95,133797.58
10332,1969-05-08,105.1,0.43,0.41,108.37,-3.02,True,1,3586,-105.1,-241549.47,376888.6,135339.13
10333,1969-05-09,105.05,-0.05,-0.05,108.37,-3.06,True,1,3587,-105.05,-241654.52,376814.35,135159.83
10334,1969-05-12,104.89,-0.16,-0.15,108.37,-3.21,True,1,3588,-104.89,-241759.41,376345.32,134585.91
10335,1969-05-13,105.34,0.45,0.43,108.37,-2.8,True,1,3589,-105.34,-241864.75,378065.26,136200.51
10336,1969-05-14,106.16,0.82,0.78,108.37,-2.04,True,1,3590,-106.16,-241970.91,381114.4,139143.49
10337,1969-05-15,105.85,-0.31,-0.29,108.37,-2.33,True,1,3591,-105.85,-242076.76,380107.35,138030.59
10338,1969-05-16,105.94,0.09,0.08,108.37,-2.24,True,1,3592,-105.94,-242182.7,380536.48,138353.78
10339,1969-05-19,104.97,-0.97,-0.92,108.37,-3.14,True,1,3593,-104.97,-242287.67,377157.21,134869.54
10340,1969-05-20,104.04,-0.93,-0.89,108.37,-4.0,True,1,3594,-104.04,-242391.71,373919.76,131528.05
10341,1969-05-21,104.47,0.43,0.41,108.37,-3.6,True,1,3595,-104.47,-242496.18,375569.65,133073.47
10342,1969-05-22,104.6,0.13,0.12,108.37,-3.48,True,1,3596,-104.6,-242600.78,376141.6,133540.82
10343,1969-05-23,104.59,-0.01,-0.01,108.37,-3.49,True,1,3597,-104.59,-242705.37,376210.23,133504.86
10344,1969-05-26,104.36,-0.23,-0.22,108.37,-3.7,True,1,3598,-104.36,-242809.73,375487.28,132677.55
10345,1969-05-27,103.57,-0.79,-0.76,108.37,-4.43,True,1,3599,-103.57,-242913.3,372748.43,129835.13
10346,1969-05-28,103.26,-0.31,-0.3,108.37,-4.72,True,1,3600,-103.26,-243016.56,371736.0,128719.44
10347,1969-05-29,103.46,0.2,0.19,108.37,-4.53,True,1,3601,-103.46,-243120.02,372559.46,129439.44
10348,1969-06-02,102.94,-0.52,-0.5,108.37,-5.01,True,1,3602,-102.94,-243222.96,370789.88,127566.92
10349,1969-06-03,102.63,-0.31,-0.3,108.37,-5.3,True,1,3603,-102.63,-243325.59,369775.89,126450.3
10350,1969-06-04,102.59,-0.04,-0.04,108.37,-5.33,True,1,3604,-102.59,-243428.18,369734.36,126306.18
10351,1969-06-05,102.76,0.17,0.17,108.37,-5.18,True,1,3605,-102.76,-243530.94,370449.8,126918.86
10352,1969-06-06,102.12,-0.64,-0.62,108.37,-5.77,True,1,3606,-102.12,-243633.06,368244.72,124611.66
10353,1969-06-09,101.2,-0.92,-0.9,108.37,-6.62,True,1,3607,-101.2,-243734.26,365028.4,121294.14
10354,1969-06-10,100.42,-0.78,-0.77,108.37,-7.34,True,1,3608,-100.42,-243834.68,362315.36,118480.68
10355,1969-06-11,99.05,-1.37,-1.36,108.37,-8.6,True,1,3609,-99.05,-243933.73,357471.45,113537.72
10356,1969-06-12,98.26,-0.79,-0.8,108.37,-9.33,True,1,3610,-98.26,-244031.99,354718.6,110686.61
10357,1969-06-13,98.65,0.39,0.4,108.37,-8.97,True,1,3611,-98.65,-244130.64,356225.15,112094.51
10358,1969-06-16,98.32,-0.33,-0.34,108.37,-9.27,True,1,3612,-98.32,-244228.96,355131.84,110902.88
10359,1969-06-17,97.95,-0.37,-0.38,108.37,-9.62,True,1,3613,-97.95,-244326.91,353893.35,109566.44
10360,1969-06-18,97.81,-0.14,-0.14,108.37,-9.74,True,1,3614,-97.81,-244424.72,353485.34,109060.62
10361,1969-06-19,97.24,-0.57,-0.58,108.37,-10.27,True,1,3615,-97.24,-244521.96,351522.6,107000.64
10362,1969-06-20,96.67,-0.57,-0.59,108.37,-10.8,True,1,3616,-96.67,-244618.63,349558.72,104940.09
10363,1969-06-23,96.23,-0.44,-0.46,108.37,-11.2,True,1,3617,-96.23,-244714.86,348063.91,103349.05
10364,1969-06-24,97.32,1.09,1.13,108.37,-10.2,True,1,3618,-97.32,-244812.18,352103.76,107291.58
10365,1969-06-25,97.01,-0.31,-0.32,108.37,-10.48,True,1,3619,-97.01,-244909.19,351079.19,106170.0
10366,1969-06-26,97.25,0.24,0.25,108.37,-10.26,True,1,3620,-97.25,-245006.44,352045.0,107038.56
10367,1969-06-27,97.33,0.08,0.08,108.37,-10.19,True,1,3621,-97.33,-245103.77,352431.93,107328.16
10368,1969-06-30,97.71,0.38,0.39,108.37,-9.84,True,1,3622,-97.71,-245201.48,353905.62,108704.14
10369,1969-07-01,98.08,0.37,0.38,108.37,-9.49,True,1,3623,-98.08,-245299.56,355343.84,110044.28
10370,1969-07-02,98.94,0.86,0.88,108.37,-8.7,True,1,3624,-98.94,-245398.5,358558.56,113160.06
10371,1969-07-03,99.61,0.67,0.68,108.37,-8.08,True,1,3625,-99.61,-245498.11,361086.25,115588.14
10372,1969-07-07,99.03,-0.58,-0.58,108.37,-8.62,True,1,3626,-99.03,-245597.14,359082.78,113485.64
10373,1969-07-08,97.63,-1.4,-1.41,108.37,-9.91,True,1,3627,-97.63,-245694.77,354104.01,108409.24
10374,1969-07-09,96.88,-0.75,-0.77,108.37,-10.6,True,1,3628,-96.88,-245791.65,351480.64,105688.99
10375,1969-07-10,95.38,-1.5,-1.55,108.37,-11.99,True,1,3629,-95.38,-245887.03,346134.02,100246.99
10376,1969-07-11,95.77,0.39,0.41,108.37,-11.63,True,1,3630,-95.77,-245982.8,347645.1,101662.3
10377,1969-07-14,94.55,-1.22,-1.27,108.37,-12.75,True,1,3631,-94.55,-246077.35,343311.05,97233.7
10378,1969-07-15,94.24,-0.31,-0.33,108.37,-13.04,True,1,3632,-94.24,-246171.59,342279.68,96108.09
10379,1969-07-16,95.18,0.94,1.0,108.37,-12.17,True,1,3633,-95.18,-246266.77,345788.94,99522.17
10380,1969-07-17,95.76,0.58,0.61,108.37,-11.64,True,1,3634,-95.76,-246362.53,347991.84,101629.31
10381,1969-07-18,94.95,-0.81,-0.85,108.37,-12.38,True,1,3635,-94.95,-246457.48,345143.25,98685.77
10382,1969-07-22,93.52,-1.43,-1.51,108.37,-13.7,True,1,3636,-93.52,-246551.0,340038.72,93487.72
10383,1969-07-23,93.12,-0.4,-0.43,108.37,-14.07,True,1,3637,-93.12,-246644.12,338677.44,92033.32
10384,1969-07-24,92.8,-0.32,-0.34,108.37,-14.37,True,1,3638,-92.8,-246736.92,337606.4,90869.48
10385,1969-07-25,92.06,-0.74,-0.8,108.37,-15.05,True,1,3639,-92.06,-246828.98,335006.34,88177.36
10386,1969-07-28,90.21,-1.85,-2.01,108.37,-16.76,True,1,3640,-90.21,-246919.19,328364.4,81445.21
10387,1969-07-29,89.48,-0.73,-0.81,108.37,-17.43,True,1,3641,-89.48,-247008.67,325796.68,78788.01
10388,1969-07-30,89.93,0.45,0.5,108.37,-17.02,True,1,3642,-89.93,-247098.6,327525.06,80426.46
10389,1969-07-31,91.83,1.9,2.11,108.37,-15.26,True,1,3643,-91.83,-247190.43,334536.69,87346.26
10390,1969-08-01,93.47,1.64,1.79,108.37,-13.75,True,1,3644,-93.47,-247283.9,340604.68,93320.78
10391,1969-08-04,92.99,-0.48,-0.51,108.37,-14.19,True,1,3645,-92.99,-247376.89,338948.55,91571.66
10392,1969-08-05,93.41,0.42,0.45,108.37,-13.8,True,1,3646,-93.41,-247470.3,340572.86,93102.56
10393,1969-08-06,93.92,0.51,0.55,108.37,-13.33,True,1,3647,-93.92,-247564.22,342526.24,94962.02
10394,1969-08-07,93.99,0.07,0.08,108.37,-13.27,True,1,3648,-93.99,-247658.21,342875.52,95217.31
10395,1969-08-08,93.94,-0.05,-0.05,108.37,-13.32,True,1,3649,-93.94,-247752.15,342787.06,95034.91
10396,1969-08-11,93.36,-0.58,-0.62,108.37,-13.85,True,1,3650,-93.36,-247845.51,340764.0,92918.49
10397,1969-08-12,92.63,-0.73,-0.78,108.37,-14.52,True,1,3651,-92.63,-247938.14,338192.13,90253.99
10398,1969-08-13,92.7,0.07,0.08,108.37,-14.46,True,1,3652,-92.7,-248030.84,338540.4,90509.56
10399,1969-08-14,93.34,0.64,0.69,108.37,-13.87,True,1,3653,-93.34,-248124.18,340971.02,92846.84
10400,1969-08-15,94.0,0.66,0.71,108.37,-13.26,True,1,3654,-94.0,-248218.18,343476.0,95257.82
10401,1969-08-18,94.57,0.57,0.61,108.37,-12.73,True,1,3655,-94.57,-248312.75,345653.35,97340.6
10402,1969-08-19,95.07,0.5,0.53,108.37,-12.27,True,1,3656,-95.07,-248407.82,347575.92,99168.1
10403,1969-08-20,95.07,0.0,0.0,108.37,-12.27,True,1,3657,-95.07,-248502.89,347670.99,99168.1
10404,1969-08-21,95.35,0.28,0.3,108.37,-12.01,True,1,3658,-95.35,-248598.24,348790.3,100192.06
10405,1969-08-22,95.92,0.57,0.6,108.37,-11.49,True,1,3659,-95.92,-248694.16,350971.28,102277.12
10406,1969-08-25,94.93,-0.99,-1.03,108.37,-12.4,True,1,3660,-94.93,-248789.09,347443.8,98654.71
10407,1969-08-26,94.3,-0.63,-0.66,108.37,-12.98,True,1,3661,-94.3,-248883.39,345232.3,96348.91
10408,1969-08-27,94.49,0.19,0.2,108.37,-12.81,True,1,3662,-94.49,-248977.88,346022.38,97044.5
10409,1969-08-28,94.89,0.4,0.42,108.37,-12.44,True,1,3663,-94.89,-249072.77,347582.07,98509.3
10410,1969-08-29,95.51,0.62,0.65,108.37,-11.87,True,1,3664,-95.51,-249168.28,349948.64,100780.36
10411,1969-09-02,95.54,0.03,0.03,108.37,-11.84,True,1,3665,-95.54,-249263.82,350154.1,100890.28
10412,1969-09-03,94.98,-0.56,-0.59,108.37,-12.36,True,1,3666,-94.98,-249358.8,348196.68,98837.88
10413,1969-09-04,94.2,-0.78,-0.82,108.37,-13.08,True,1,3667,-94.2,-249453.0,345431.4,95978.4
10414,1969-09-05,93.64,-0.56,-0.59,108.37,-13.59,True,1,3668,-93.64,-249546.64,343471.52,93924.88
10415,1969-09-08,92.7,-0.94,-1.0,108.37,-14.46,True,1,3669,-92.7,-249639.34,340116.3,90476.96
10416,1969-09-09,93.38,0.68,0.73,108.37,-13.83,True,1,3670,-93.38,-249732.72,342704.6,92971.88
10417,1969-09-10,94.95,1.57,1.68,108.37,-12.38,True,1,3671,-94.95,-249827.67,348561.45,98733.78
10418,1969-09-11,94.22,-0.73,-0.77,108.37,-13.06,True,1,3672,-94.22,-249921.89,345975.84,96053.95
10419,1969-09-12,94.13,-0.09,-0.1,108.37,-13.14,True,1,3673,-94.13,-250016.02,345739.49,95723.47
10420,1969-09-15,94.87,0.74,0.79,108.37,-12.46,True,1,3674,-94.87,-250110.89,348552.38,98441.49
10421,1969-09-16,94.95,0.08,0.08,108.37,-12.38,True,1,3675,-94.95,-250205.84,348941.25,98735.41
10422,1969-09-17,94.76,-0.19,-0.2,108.37,-12.56,True,1,3676,-94.76,-250300.6,348337.76,98037.16
10423,1969-09-18,94.9,0.14,0.15,108.37,-12.43,True,1,3677,-94.9,-250395.5,348947.3,98551.8
10424,1969-09-19,95.19,0.29,0.31,108.37,-12.16,True,1,3678,-95.19,-250490.69,350108.82,99618.13
10425,1969-09-22,95.63,0.44,0.46,108.37,-11.76,True,1,3679,-95.63,-250586.32,351822.77,101236.45
10426,1969-09-23,95.63,0.0,0.0,108.37,-11.76,True,1,3680,-95.63,-250681.95,351918.4,101236.45
10427,1969-09-24,95.5,-0.13,-0.14,108.37,-11.88,True,1,3681,-95.5,-250777.45,351535.5,100758.05
10428,1969-09-25,94.77,-0.73,-0.76,108.37,-12.55,True,1,3682,-94.77,-250872.22,348943.14,98070.92
10429,1969-09-26,94.16,-0.61,-0.64,108.37,-13.11,True,1,3683,-94.16,-250966.38,346791.28,95824.9
10430,1969-09-29,93.41,-0.75,-0.8,108.37,-13.8,True,1,3684,-93.41,-251059.79,344122.44,93062.65
10431,1969-09-30,93.12,-0.29,-0.31,108.37,-14.07,True,1,3685,-93.12,-251152.91,343147.2,91994.29
10432,1969-10-01,92.52,-0.6,-0.64,108.37,-14.63,True,1,3686,-92.52,-251245.43,341028.72,89783.29
10433,1969-10-02,93.24,0.72,0.78,108.37,-13.96,True,1,3687,-93.24,-251338.67,343775.88,92437.21
10434,1969-10-03,93.19,-0.05,-0.05,108.37,-14.01,True,1,3688,-93.19,-251431.86,343684.72,92252.86
10435,1969-10-06,93.38,0.19,0.2,108.37,-13.83,True,1,3689,-93.38,-251525.24,344478.82,92953.58
10436,1969-10-07,93.09,-0.29,-0.31,108.37,-14.1,True,1,3690,-93.09,-251618.33,343502.1,91883.77
10437,1969-10-08,92.67,-0.42,-0.45,108.37,-14.49,True,1,3691,-92.67,-251711.0,342044.97,90333.97
10438,1969-10-09,93.03,0.36,0.39,108.37,-14.16,True,1,3692,-93.03,-251804.03,343466.76,91662.73
10439,1969-10-10,93.56,0.53,0.57,108.37,-13.67,True,1,3693,-93.56,-251897.59,345517.08,93619.49
10440,1969-10-13,94.55,0.99,1.06,108.37,-12.75,True,1,3694,-94.55,-251992.14,349267.7,97275.56
10441,1969-10-14,95.7,1.15,1.22,108.37,-11.69,True,1,3695,-95.7,-252087.84,353611.5,101523.66
10442,1969-10-15,95.72,0.02,0.02,108.37,-11.67,True,1,3696,-95.72,-252183.56,353781.12,101597.56
10443,1969-10-16,96.37,0.65,0.68,108.37,-11.07,True,1,3697,-96.37,-252279.93,356279.89,103999.96
10444,1969-10-17,96.26,-0.11,-0.11,108.37,-11.18,True,1,3698,-96.26,-252376.19,355969.48,103593.29
10445,1969-10-20,96.46,0.2,0.21,108.37,-10.99,True,1,3699,-96.46,-252472.65,356805.54,104332.89
10446,1969-10-21,97.2,0.74,0.77,108.37,-10.31,True,1,3700,-97.2,-252569.85,359640.0,107070.15
10447,1969-10-22,97.83,0.63,0.65,108.37,-9.73,True,1,3701,-97.83,-252667.68,362068.83,109401.15
10448,1969-10-23,97.46,-0.37,-0.38,108.37,-10.07,True,1,3702,-97.46,-252765.14,360796.92,108031.78
10449,1969-10-24,98.12,0.66,0.68,108.37,-9.46,True,1,3703,-98.12,-252863.26,363338.36,110475.1
10450,1969-10-27,97.97,-0.15,-0.15,108.37,-9.6,True,1,3704,-97.97,-252961.23,362880.88,109919.65
10451,1969-10-28,97.66,-0.31,-0.32,108.37,-9.88,True,1,3705,-97.66,-253058.89,361830.3,108771.41
10452,1969-10-29,96.81,-0.85,-0.87,108.37,-10.67,True,1,3706,-96.81,-253155.7,358777.86,105622.16
10453,1969-10-30,96.93,0.12,0.12,108.37,-10.56,True,1,3707,-96.93,-253252.63,359319.51,106066.88
10454,1969-10-31,97.12,0.19,0.2,108.37,-10.38,True,1,3708,-97.12,-253349.75,360120.96,106771.21
10455,1969-11-03,97.15,0.03,0.03,108.37,-10.35,True,1,3709,-97.15,-253446.9,360329.35,106882.45
10456,1969-11-04,97.21,0.06,0.06,108.37,-10.3,True,1,3710,-97.21,-253544.11,360649.1,107104.99
10457,1969-11-05,97.64,0.43,0.44,108.37,-9.9,True,1,3711,-97.64,-253641.75,362342.04,108700.29
10458,1969-11-06,97.67,0.03,0.03,108.37,-9.87,True,1,3712,-97.67,-253739.42,362551.04,108811.62
10459,1969-11-07,98.26,0.59,0.6,108.37,-9.33,True,1,3713,-98.26,-253837.68,364839.38,111001.7
10460,1969-11-10,98.33,0.07,0.07,108.37,-9.26,True,1,3714,-98.33,-253936.01,365197.62,111261.61
10461,1969-11-11,98.07,-0.26,-0.26,108.37,-9.5,True,1,3715,-98.07,-254034.08,364330.05,110295.97
10462,1969-11-12,97.89,-0.18,-0.18,108.37,-9.67,True,1,3716,-97.89,-254131.97,363759.24,109627.27
10463,1969-11-13,97.42,-0.47,-0.48,108.37,-10.1,True,1,3717,-97.42,-254229.39,362110.14,107880.75
10464,1969-11-14,97.07,-0.35,-0.36,108.37,-10.43,True,1,3718,-97.07,-254326.46,360906.26,106579.8
10465,1969-11-17,96.41,-0.66,-0.68,108.37,-11.04,True,1,3719,-96.41,-254422.87,358548.79,104125.92
10466,1969-11-18,96.39,-0.02,-0.02,108.37,-11.06,True,1,3720,-96.39,-254519.26,358570.8,104051.54
10467,1969-11-19,95.9,-0.49,-0.51,108.37,-11.51,True,1,3721,-95.9,-254615.16,356843.9,102228.74
10468,1969-11-20,94.91,-0.99,-1.03,108.37,-12.42,True,1,3722,-94.91,-254710.07,353255.02,98544.95
10469,1969-11-21,94.32,-0.59,-0.62,108.37,-12.96,True,1,3723,-94.32,-254804.39,351153.36,96348.97
10470,1969-11-24,93.24,-1.08,-1.14,108.37,-13.96,True,1,3724,-93.24,-254897.63,347225.76,92328.13
10471,1969-11-25,92.94,-0.3,-0.32,108.37,-14.24,True,1,3725,-92.94,-254990.57,346201.5,91210.93
10472,1969-11-26,93.27,0.33,0.36,108.37,-13.93,True,1,3726,-93.27,-255083.84,347524.02,92440.18
10473,1969-11-28,93.81,0.54,0.58,108.37,-13.44,True,1,3727,-93.81,-255177.65,349629.87,94452.22
10474,1969-12-01,93.22,-0.59,-0.63,108.37,-13.98,True,1,3728,-93.22,-255270.87,347524.16,92253.29
10475,1969-12-02,92.65,-0.57,-0.61,108.37,-14.51,True,1,3729,-92.65,-255363.52,345491.85,90128.33
10476,1969-12-03,91.65,-1.0,-1.08,108.37,-15.43,True,1,3730,-91.65,-255455.17,341854.5,86399.33
10477,1969-12-04,91.95,0.3,0.33,108.37,-15.15,True,1,3731,-91.95,-255547.12,343065.45,87518.33
10478,1969-12-05,91.73,-0.22,-0.24,108.37,-15.36,True,1,3732,-91.73,-255638.85,342336.36,86697.51
10479,1969-12-08,90.84,-0.89,-0.97,108.37,-16.18,True,1,3733,-90.84,-255729.69,339105.72,83376.03
10480,1969-12-09,90.55,-0.29,-0.32,108.37,-16.44,True,1,3734,-90.55,-255820.24,338113.7,82293.46
10481,1969-12-10,90.48,-0.07,-0.08,108.37,-16.51,True,1,3735,-90.48,-255910.72,337942.8,82032.08
10482,1969-12-11,90.52,0.04,0.04,108.37,-16.47,True,1,3736,-90.52,-256001.24,338182.72,82181.48
10483,1969-12-12,90.81,0.29,0.32,108.37,-16.2,True,1,3737,-90.81,-256092.05,339356.97,83264.92
10484,1969-12-15,90.54,-0.27,-0.3,108.37,-16.45,True,1,3738,-90.54,-256182.59,338438.52,82255.93
10485,1969-12-16,89.72,-0.82,-0.91,108.37,-17.21,True,1,3739,-89.72,-256272.31,335463.08,79190.77
10486,1969-12-17,89.2,-0.52,-0.58,108.37,-17.69,True,1,3740,-89.2,-256361.51,333608.0,77246.49
10487,1969-12-18,90.61,1.41,1.58,108.37,-16.39,True,1,3741,-90.61,-256452.12,338972.01,82519.89
10488,1969-12-19,91.38,0.77,0.85,108.37,-15.68,True,1,3742,-91.38,-256543.5,341943.96,85400.46
10489,1969-12-22,90.58,-0.8,-0.88,108.37,-16.42,True,1,3743,-90.58,-256634.08,339040.94,82406.86
10490,1969-12-23,90.23,-0.35,-0.39,108.37,-16.74,True,1,3744,-90.23,-256724.31,337821.12,81096.81
10491,1969-12-24,91.18,0.95,1.05,108.37,-15.86,True,1,3745,-91.18,-256815.49,341469.1,84653.61
10492,1969-12-26,91.89,0.71,0.78,108.37,-15.21,True,1,3746,-91.89,-256907.38,344219.94,87312.56
10493,1969-12-29,91.25,-0.64,-0.7,108.37,-15.8,True,1,3747,-91.25,-256998.63,341913.75,84915.12
10494,1969-12-30,91.6,0.35,0.38,108.37,-15.48,True,1,3748,-91.6,-257090.23,343316.8,86226.57
10495,1969-12-31,92.06,0.46,0.5,108.37,-15.05,True,1,3749,-92.06,-257182.29,345132.94,87950.65
10496,1970-01-02,93.0,0.94,1.02,108.37,-14.18,True,1,3750,-93.0,-257275.29,348750.0,91474.71
10497,1970-01-05,93.46,0.46,0.5,108.37,-13.76,True,1,3751,-93.46,-257368.75,350568.46,93199.71
10498,1970-01-06,92.82,-0.64,-0.68,108.37,-14.35,True,1,3752,-92.82,-257461.57,348260.64,90799.07
10499,1970-01-07,92.63,-0.19,-0.2,108.37,-14.52,True,1,3753,-92.63,-257554.2,347640.39,90086.19
10500,1970-01-08,92.68,0.05,0.05,108.37,-14.48,True,1,3754,-92.68,-257646.88,347920.72,90273.84
10501,1970-01-09,92.4,-0.28,-0.3,108.37,-14.74,True,1,3755,-92.4,-257739.28,346962.0,89222.72
10502,1970-01-12,91.7,-0.7,-0.76,108.37,-15.38,True,1,3756,-91.7,-257830.98,344425.2,86594.22
10503,1970-01-13,91.92,0.22,0.24,108.37,-15.18,True,1,3757,-91.92,-257922.9,345343.44,87420.54
10504,1970-01-14,91.65,-0.27,-0.29,108.37,-15.43,True,1,3758,-91.65,-258014.55,344420.7,86406.15
10505,1970-01-15,91.68,0.03,0.03,108.37,-15.4,True,1,3759,-91.68,-258106.23,344625.12,86518.89
10506,1970-01-16,90.92,-0.76,-0.83,108.37,-16.1,True,1,3760,-90.92,-258197.15,341859.2,83662.05
10507,1970-01-19,89.65,-1.27,-1.4,108.37,-17.27,True,1,3761,-89.65,-258286.8,337173.65,78886.85
10508,1970-01-20,89.83,0.18,0.2,108.37,-17.11,True,1,3762,-89.83,-258376.63,337940.46,79563.83
10509,1970-01-21,89.95,0.12,0.13,108.37,-17.0,True,1,3763,-89.95,-258466.58,338481.85,80015.27
10510,1970-01-22,90.04,0.09,0.1,108.37,-16.91,True,1,3764,-90.04,-258556.62,338910.56,80353.94
10511,1970-01-23,89.37,-0.67,-0.74,108.37,-17.53,True,1,3765,-89.37,-258645.99,336478.05,77832.06
10512,1970-01-26,88.17,-1.2,-1.34,108.37,-18.64,True,1,3766,-88.17,-258734.16,332048.22,73314.06
10513,1970-01-27,87.62,-0.55,-0.62,108.37,-19.15,True,1,3767,-87.62,-258821.78,330064.54,71242.76
10514,1970-01-28,86.79,-0.83,-0.95,108.37,-19.91,True,1,3768,-86.79,-258908.57,327024.72,68116.15
10515,1970-01-29,85.69,-1.1,-1.27,108.37,-20.93,True,1,3769,-85.69,-258994.26,322965.61,63971.35
10516,1970-01-30,85.02,-0.67,-0.78,108.37,-21.55,True,1,3770,-85.02,-259079.28,320525.4,61446.12
10517,1970-02-02,85.75,0.73,0.86,108.37,-20.87,True,1,3771,-85.75,-259165.03,323363.25,64198.22
10518,1970-02-03,86.77,1.02,1.19,108.37,-19.93,True,1,3772,-86.77,-259251.8,327296.44,68044.64
10519,1970-02-04,86.24,-0.53,-0.61,108.37,-20.42,True,1,3773,-86.24,-259338.04,325383.52,66045.48
10520,1970-02-05,85.9,-0.34,-0.39,108.37,-20.74,True,1,3774,-85.9,-259423.94,324186.6,64762.66
10521,1970-02-06,86.33,0.43,0.5,108.37,-20.34,True,1,3775,-86.33,-259510.27,325895.75,66385.48
10522,1970-02-09,87.01,0.68,0.79,108.37,-19.71,True,1,3776,-87.01,-259597.28,328549.76,68952.48
10523,1970-02-10,86.1,-0.91,-1.05,108.37,-20.55,True,1,3777,-86.1,-259683.38,325199.7,65516.32
10524,1970-02-11,86.94,0.84,0.98,108.37,-19.77,True,1,3778,-86.94,-259770.32,328459.32,68689.0
10525,1970-02-12,86.73,-0.21,-0.24,108.37,-19.97,True,1,3779,-86.73,-259857.05,327752.67,67895.62
10526,1970-02-13,86.54,-0.19,-0.22,108.37,-20.14,True,1,3780,-86.54,-259943.59,327121.2,67177.61
10527,1970-02-16,86.47,-0.07,-0.08,108.37,-20.21,True,1,3781,-86.47,-260030.06,326943.07,66913.01
10528,1970-02-17,86.37,-0.1,-0.12,108.37,-20.3,True,1,3782,-86.37,-260116.43,326651.34,66534.91
10529,1970-02-18,87.44,1.07,1.24,108.37,-19.31,True,1,3783,-87.44,-260203.87,330785.52,70581.65
10530,1970-02-19,87.76,0.32,0.37,108.37,-19.02,True,1,3784,-87.76,-260291.63,332083.84,71792.21
10531,1970-02-20,88.03,0.27,0.31,108.37,-18.77,True,1,3785,-88.03,-260379.66,333193.55,72813.89
10532,1970-02-24,87.99,-0.04,-0.04,108.37,-18.81,True,1,3786,-87.99,-260467.65,333130.14,72662.49
10533,1970-02-25,89.35,1.36,1.55,108.37,-17.55,True,1,3787,-89.35,-260557.0,338368.45,77811.45
10534,1970-02-26,88.9,-0.45,-0.5,108.37,-17.97,True,1,3788,-88.9,-260645.9,336753.2,76107.3
10535,1970-02-27,89.5,0.6,0.68,108.37,-17.41,True,1,3789,-89.5,-260735.4,339115.5,78380.1
10536,1970-03-02,89.71,0.21,0.24,108.37,-17.22,True,1,3790,-89.71,-260825.11,340000.9,79175.79
10537,1970-03-03,90.23,0.52,0.58,108.37,-16.74,True,1,3791,-90.23,-260915.34,342061.93,81146.59
10538,1970-03-04,90.04,-0.19,-0.21,108.37,-16.91,True,1,3792,-90.04,-261005.38,341431.68,80426.3
10539,1970-03-05,90.0,-0.04,-0.04,108.37,-16.95,True,1,3793,-90.0,-261095.38,341370.0,80274.62
10540,1970-03-06,89.44,-0.56,-0.62,108.37,-17.47,True,1,3794,-89.44,-261184.82,339335.36,78150.54
10541,1970-03-09,88.51,-0.93,-1.04,108.37,-18.33,True,1,3795,-88.51,-261273.33,335895.45,74622.12
10542,1970-03-10,88.75,0.24,0.27,108.37,-18.1,True,1,3796,-88.75,-261362.08,336895.0,75532.92
10543,1970-03-11,88.69,-0.06,-0.07,108.37,-18.16,True,1,3797,-88.69,-261450.77,336755.93,75305.16
10544,1970-03-12,88.33,-0.36,-0.41,108.37,-18.49,True,1,3798,-88.33,-261539.1,335477.34,73938.24
10545,1970-03-13,87.86,-0.47,-0.53,108.37,-18.93,True,1,3799,-87.86,-261626.96,333780.14,72153.18
10546,1970-03-16,86.91,-0.95,-1.08,108.37,-19.8,True,1,3800,-86.91,-261713.87,330258.0,68544.13
10547,1970-03-17,87.29,0.38,0.44,108.37,-19.45,True,1,3801,-87.29,-261801.16,331789.29,69988.13
10548,1970-03-18,87.54,0.25,0.29,108.37,-19.22,True,1,3802,-87.54,-261888.7,332827.08,70938.38
10549,1970-03-19,87.42,-0.12,-0.14,108.37,-19.33,True,1,3803,-87.42,-261976.12,332458.26,70482.14
10550,1970-03-20,87.06,-0.36,-0.41,108.37,-19.66,True,1,3804,-87.06,-262063.18,331176.24,69113.06
10551,1970-03-23,86.99,-0.07,-0.08,108.37,-19.73,True,1,3805,-86.99,-262150.17,330996.95,68846.78
10552,1970-03-24,87.98,0.99,1.14,108.37,-18.82,True,1,3806,-87.98,-262238.15,334851.88,72613.73
10553,1970-03-25,89.77,1.79,2.04,108.37,-17.16,True,1,3807,-89.77,-262327.92,341754.39,79426.47
10554,1970-03-26,89.92,0.15,0.17,108.37,-17.02,True,1,3808,-89.92,-262417.84,342415.36,79997.52
10555,1970-03-30,89.63,-0.29,-0.32,108.37,-17.29,True,1,3809,-89.63,-262507.47,341400.67,78893.2
10556,1970-03-31,89.63,0.0,0.0,108.37,-17.29,True,1,3810,-89.63,-262597.1,341490.3,78893.2
10557,1970-04-01,90.07,0.44,0.49,108.37,-16.89,True,1,3811,-90.07,-262687.17,343256.77,80569.6
10558,1970-04-02,89.79,-0.28,-0.31,108.37,-17.14,True,1,3812,-89.79,-262776.96,342279.48,79502.52
10559,1970-04-03,89.39,-0.4,-0.44,108.37,-17.51,True,1,3813,-89.39,-262866.35,340844.07,77977.72
10560,1970-04-06,88.76,-0.63,-0.7,108.37,-18.1,True,1,3814,-88.76,-262955.11,338530.64,75575.53
10561,1970-04-07,88.52,-0.24,-0.27,108.37,-18.32,True,1,3815,-88.52,-263043.63,337703.8,74660.17
10562,1970-04-08,88.49,-0.03,-0.03,108.37,-18.34,True,1,3816,-88.49,-263132.12,337677.84,74545.72
10563,1970-04-09,88.53,0.04,0.04,108.37,-18.31,True,1,3817,-88.53,-263220.65,337919.01,74698.36
10564,1970-04-10,88.24,-0.29,-0.33,108.37,-18.58,True,1,3818,-88.24,-263308.89,336900.32,73591.43
10565,1970-04-13,87.64,-0.6,-0.68,108.37,-19.13,True,1,3819,-87.64,-263396.53,334697.16,71300.63
10566,1970-04-14,86.89,-0.75,-0.86,108.37,-19.82,True,1,3820,-86.89,-263483.42,331919.8,68436.38
10567,1970-04-15,86.73,-0.16,-0.18,108.37,-19.97,True,1,3821,-86.73,-263570.15,331395.33,67825.18
10568,1970-04-16,85.88,-0.85,-0.98,108.37,-20.75,True,1,3822,-85.88,-263656.03,328233.36,64577.33
10569,1970-04-17,85.67,-0.21,-0.24,108.37,-20.95,True,1,3823,-85.67,-263741.7,327516.41,63774.71
10570,1970-04-20,85.83,0.16,0.19,108.37,-20.8,True,1,3824,-85.83,-263827.53,328213.92,64386.39
10571,1970-04-21,85.38,-0.45,-0.52,108.37,-21.21,True,1,3825,-85.38,-263912.91,326578.5,62665.59
10572,1970-04-22,84.27,-1.11,-1.3,108.37,-22.24,True,1,3826,-84.27,-263997.18,322417.02,58419.84
10573,1970-04-23,83.04,-1.23,-1.46,108.37,-23.37,True,1,3827,-83.04,-264080.22,317794.08,53713.86
10574,1970-04-24,82.77,-0.27,-0.32,108.37,-23.62,True,1,3828,-82.77,-264162.99,316843.56,52680.57
10575,1970-04-27,81.46,-1.31,-1.58,108.37,-24.83,True,1,3829,-81.46,-264244.45,311910.34,47665.89
10576,1970-04-28,80.27,-1.19,-1.46,108.37,-25.93,True,1,3830,-80.27,-264324.72,307434.1,43109.38
10577,1970-04-29,81.81,1.54,1.92,108.37,-24.51,True,1,3831,-81.81,-264406.53,313414.11,49007.58
10578,1970-04-30,81.52,-0.29,-0.35,108.37,-24.78,True,1,3832,-81.52,-264488.05,312384.64,47896.59
10579,1970-05-01,81.44,-0.08,-0.1,108.37,-24.85,True,1,3833,-81.44,-264569.49,312159.52,47590.03
10580,1970-05-04,79.37,-2.07,-2.54,108.37,-26.76,True,1,3834,-79.37,-264648.86,304304.58,39655.72
10581,1970-05-05,78.6,-0.77,-0.97,108.37,-27.47,True,1,3835,-78.6,-264727.46,301431.0,36703.54
10582,1970-05-06,79.47,0.87,1.11,108.37,-26.67,True,1,3836,-79.47,-264806.93,304846.92,40039.99
10583,1970-05-07,79.83,0.36,0.45,108.37,-26.34,True,1,3837,-79.83,-264886.76,306307.71,41420.95
10584,1970-05-08,79.44,-0.39,-0.49,108.37,-26.7,True,1,3838,-79.44,-264966.2,304890.72,39924.52
10585,1970-05-11,78.6,-0.84,-1.06,108.37,-27.47,True,1,3839,-78.6,-265044.8,301745.4,36700.6
10586,1970-05-12,77.85,-0.75,-0.95,108.37,-28.16,True,1,3840,-77.85,-265122.65,298944.0,33821.35
10587,1970-05-13,76.53,-1.32,-1.7,108.37,-29.38,True,1,3841,-76.53,-265199.18,293951.73,28752.55
10588,1970-05-14,75.44,-1.09,-1.42,108.37,-30.39,True,1,3842,-75.44,-265274.62,289840.48,24565.86
10589,1970-05-15,76.9,1.46,1.94,108.37,-29.04,True,1,3843,-76.9,-265351.52,295526.7,30175.18
10590,1970-05-18,76.96,0.06,0.08,108.37,-28.98,True,1,3844,-76.96,-265428.48,295834.24,30405.76
10591,1970-05-19,75.46,-1.5,-1.95,108.37,-30.37,True,1,3845,-75.46,-265503.94,290143.7,24639.76
10592,1970-05-20,73.52,-1.94,-2.57,108.37,-32.16,True,1,3846,-73.52,-265577.46,282757.92,17180.46
10593,1970-05-21,72.16,-1.36,-1.85,108.37,-33.41,True,1,3847,-72.16,-265649.62,277599.52,11949.9
10594,1970-05-22,72.25,0.09,0.12,108.37,-33.33,True,1,3848,-72.25,-265721.87,278018.0,12296.13
10595,1970-05-25,70.25,-2.0,-2.77,108.37,-35.18,True,1,3849,-70.25,-265792.12,270392.25,4600.13
10596,1970-05-26,69.29,-0.96,-1.37,108.37,-36.06,True,1,3850,-69.29,-265861.41,266766.5,905.09
10597,1970-05-27,72.77,3.48,5.02,108.37,-32.85,True,1,3851,-72.77,-265934.18,280237.27,14303.09
10598,1970-05-28,74.61,1.84,2.53,108.37,-31.15,True,1,3852,-74.61,-266008.79,287397.72,21388.93
10599,1970-05-29,76.55,1.94,2.6,108.37,-29.36,True,1,3853,-76.55,-266085.34,294947.15,28861.81
10600,1970-06-01,77.84,1.29,1.68,108.37,-28.17,True,1,3854,-77.84,-266163.18,299995.36,33832.18
10601,1970-06-02,77.84,0.0,0.0,108.37,-28.17,True,1,3855,-77.84,-266241.02,300073.2,33832.18
10602,1970-06-03,78.52,0.68,0.87,108.37,-27.54,True,1,3856,-78.52,-266319.54,302773.12,36453.58
10603,1970-06-04,77.36,-1.16,-1.48,108.37,-28.62,True,1,3857,-77.36,-266396.9,298377.52,31980.62
10604,1970-06-05,76.17,-1.19,-1.54,108.37,-29.71,True,1,3858,-76.17,-266473.07,293863.86,27390.79
10605,1970-06-08,76.29,0.12,0.16,108.37,-29.6,True,1,3859,-76.29,-266549.36,294403.11,27853.75
10606,1970-06-09,76.25,-0.04,-0.05,108.37,-29.64,True,1,3860,-76.25,-266625.61,294325.0,27699.39
10607,1970-06-10,75.48,-0.77,-1.01,108.37,-30.35,True,1,3861,-75.48,-266701.09,291428.28,24727.19
10608,1970-06-11,74.45,-1.03,-1.36,108.37,-31.3,True,1,3862,-74.45,-266775.54,287525.9,20750.36
10609,1970-06-12,73.88,-0.57,-0.77,108.37,-31.83,True,1,3863,-73.88,-266849.42,285398.44,18549.02
10610,1970-06-15,74.58,0.7,0.95,108.37,-31.18,True,1,3864,-74.58,-266924.0,288177.12,21253.12
10611,1970-06-16,76.15,1.57,2.1,108.37,-29.73,True,1,3865,-76.15,-267000.15,294319.75,27319.6
10612,1970-06-17,76.0,-0.15,-0.2,108.37,-29.87,True,1,3866,-76.0,-267076.15,293816.0,26739.85
10613,1970-06-18,76.51,0.51,0.67,108.37,-29.4,True,1,3867,-76.51,-267152.66,295864.17,28711.51
10614,1970-06-19,77.05,0.54,0.71,108.37,-28.9,True,1,3868,-77.05,-267229.71,298029.4,30799.69
10615,1970-06-22,76.64,-0.41,-0.53,108.37,-29.28,True,1,3869,-76.64,-267306.35,296520.16,29213.81
10616,1970-06-23,74.76,-1.88,-2.45,108.37,-31.01,True,1,3870,-74.76,-267381.11,289321.2,21940.09
10617,1970-06-24,73.97,-0.79,-1.06,108.37,-31.74,True,1,3871,-73.97,-267455.08,286337.87,18882.79
10618,1970-06-25,74.02,0.05,0.07,108.37,-31.7,True,1,3872,-74.02,-267529.1,286605.44,19076.34
10619,1970-06-26,73.47,-0.55,-0.74,108.37,-32.2,True,1,3873,-73.47,-267602.57,284549.31,16946.74
10620,1970-06-29,72.89,-0.58,-0.79,108.37,-32.74,True,1,3874,-72.89,-267675.46,282375.86,14700.4
10621,1970-06-30,72.72,-0.17,-0.23,108.37,-32.9,True,1,3875,-72.72,-267748.18,281790.0,14041.82
10622,1970-07-01,72.94,0.22,0.3,108.37,-32.69,True,1,3876,-72.94,-267821.12,282715.44,14894.32
10623,1970-07-02,72.92,-0.02,-0.03,108.37,-32.71,True,1,3877,-72.92,-267894.04,282710.84,14816.8
10624,1970-07-06,71.78,-1.14,-1.56,108.37,-33.76,True,1,3878,-71.78,-267965.82,278362.84,10397.02
10625,1970-07-07,71.23,-0.55,-0.77,108.37,-34.27,True,1,3879,-71.23,-268037.05,276301.17,8264.12
10626,1970-07-08,73.0,1.77,2.48,108.37,-32.64,True,1,3880,-73.0,-268110.05,283240.0,15129.95
10627,1970-07-09,74.06,1.06,1.45,108.37,-31.66,True,1,3881,-74.06,-268184.11,287426.86,19242.75
10628,1970-07-10,74.45,0.39,0.53,108.37,-31.3,True,1,3882,-74.45,-268258.56,289014.9,20756.34
10629,1970-07-13,74.55,0.1,0.13,108.37,-31.21,True,1,3883,-74.55,-268333.11,289477.65,21144.54
10630,1970-07-14,74.42,-0.13,-0.17,108.37,-31.33,True,1,3884,-74.42,-268407.53,289047.28,20639.75
10631,1970-07-15,75.23,0.81,1.09,108.37,-30.58,True,1,3885,-75.23,-268482.76,292268.55,23785.79
10632,1970-07-16,76.34,1.11,1.48,108.37,-29.56,True,1,3886,-76.34,-268559.1,296657.24,28098.14
10633,1970-07-17,77.69,1.35,1.77,108.37,-28.31,True,1,3887,-77.69,-268636.79,301981.03,33344.24
10634,1970-07-20,77.79,0.1,0.13,108.37,-28.22,True,1,3888,-77.79,-268714.58,302447.52,33732.94
10635,1970-07-21,76.98,-0.81,-1.04,108.37,-28.97,True,1,3889,-76.98,-268791.56,299375.22,30583.66
10636,1970-07-22,77.03,0.05,0.06,108.37,-28.92,True,1,3890,-77.03,-268868.59,299646.7,30778.11
10637,1970-07-23,78.0,0.97,1.26,108.37,-28.02,True,1,3891,-78.0,-268946.59,303498.0,34551.41
10638,1970-07-24,77.82,-0.18,-0.23,108.37,-28.19,True,1,3892,-77.82,-269024.41,302875.44,33851.03
10639,1970-07-27,77.65,-0.17,-0.22,108.37,-28.35,True,1,3893,-77.65,-269102.06,302291.45,33189.39
10640,1970-07-28,77.77,0.12,0.16,108.37,-28.24,True,1,3894,-77.77,-269179.83,302836.38,33656.55
10641,1970-07-29,78.04,0.27,0.35,108.37,-27.99,True,1,3895,-78.04,-269257.87,303965.8,34707.93
10642,1970-07-30,78.07,0.03,0.04,108.37,-27.96,True,1,3896,-78.07,-269335.94,304160.72,34824.78
10643,1970-07-31,78.05,-0.02,-0.03,108.37,-27.98,True,1,3897,-78.05,-269413.99,304160.85,34746.86
10644,1970-08-03,77.02,-1.03,-1.32,108.37,-28.93,True,1,3898,-77.02,-269491.01,300223.96,30732.95
10645,1970-08-04,77.19,0.17,0.22,108.37,-28.77,True,1,3899,-77.19,-269568.2,300963.81,31395.61
10646,1970-08-05,77.18,-0.01,-0.01,108.37,-28.78,True,1,3900,-77.18,-269645.38,301002.0,31356.62
10647,1970-08-06,77.08,-0.1,-0.13,108.37,-28.87,True,1,3901,-77.08,-269722.46,300689.08,30966.62
10648,1970-08-07,77.28,0.2,0.26,108.37,-28.69,True,1,3902,-77.28,-269799.74,301546.56,31746.82
10649,1970-08-10,76.2,-1.08,-1.4,108.37,-29.68,True,1,3903,-76.2,-269875.94,297408.6,27532.66
10650,1970-08-11,75.82,-0.38,-0.5,108.37,-30.04,True,1,3904,-75.82,-269951.76,296001.28,26049.52
10651,1970-08-12,75.42,-0.4,-0.53,108.37,-30.4,True,1,3905,-75.42,-270027.18,294515.1,24487.92
10652,1970-08-13,74.76,-0.66,-0.88,108.37,-31.01,True,1,3906,-74.76,-270101.94,292012.56,21910.62
10653,1970-08-14,75.18,0.42,0.56,108.37,-30.63,True,1,3907,-75.18,-270177.12,293728.26,23551.14
10654,1970-08-17,75.33,0.15,0.2,108.37,-30.49,True,1,3908,-75.33,-270252.45,294389.64,24137.19
10655,1970-08-18,76.2,0.87,1.16,108.37,-29.68,True,1,3909,-76.2,-270328.65,297865.8,27537.15
10656,1970-08-19,76.96,0.76,1.0,108.37,-28.98,True,1,3910,-76.96,-270405.61,300913.6,30507.99
10657,1970-08-20,77.84,0.88,1.14,108.37,-28.17,True,1,3911,-77.84,-270483.45,304432.24,33948.79
10658,1970-08-21,79.24,1.4,1.8,108.37,-26.88,True,1,3912,-79.24,-270562.69,309986.88,39424.19
10659,1970-08-24,80.99,1.75,2.21,108.37,-25.26,True,1,3913,-80.99,-270643.68,316913.87,46270.19
10660,1970-08-25,81.12,0.13,0.16,108.37,-25.14,True,1,3914,-81.12,-270724.8,317503.68,46778.88
10661,1970-08-26,81.21,0.09,0.11,108.37,-25.06,True,1,3915,-81.21,-270806.01,317937.15,47131.14
10662,1970-08-27,81.08,-0.13,-0.16,108.37,-25.18,True,1,3916,-81.08,-270887.09,317509.28,46622.19
10663,1970-08-28,81.86,0.78,0.96,108.37,-24.46,True,1,3917,-81.86,-270968.95,320645.62,49676.67
10664,1970-08-31,81.52,-0.34,-0.42,108.37,-24.78,True,1,3918,-81.52,-271050.47,319395.36,48344.89
10665,1970-09-01,80.95,-0.57,-0.7,108.37,-25.3,True,1,3919,-80.95,-271131.42,317243.05,46111.63
10666,1970-09-02,80.96,0.01,0.01,108.37,-25.29,True,1,3920,-80.96,-271212.38,317363.2,46150.82
10667,1970-09-03,82.09,1.13,1.4,108.37,-24.25,True,1,3921,-82.09,-271294.47,321874.89,50580.42
10668,1970-09-04,82.83,0.74,0.9,108.37,-23.57,True,1,3922,-82.83,-271377.3,324859.26,53481.96
10669,1970-09-08,83.04,0.21,0.25,108.37,-23.37,True,1,3923,-83.04,-271460.34,325765.92,54305.58
10670,1970-09-09,82.79,-0.25,-0.3,108.37,-23.6,True,1,3924,-82.79,-271543.13,324867.96,53324.83
10671,1970-09-10,82.3,-0.49,-0.59,108.37,-24.06,True,1,3925,-82.3,-271625.43,323027.5,51402.07
10672,1970-09-11,82.52,0.22,0.27,108.37,-23.85,True,1,3926,-82.52,-271707.95,323973.52,52265.57
10673,1970-09-14,82.07,-0.45,-0.55,108.37,-24.27,True,1,3927,-82.07,-271790.02,322288.89,50498.87
10674,1970-09-15,81.36,-0.71,-0.86,108.37,-24.92,True,1,3928,-81.36,-271871.38,319582.08,47710.7
10675,1970-09-16,81.79,0.43,0.53,108.37,-24.53,True,1,3929,-81.79,-271953.17,321352.91,49399.74
10676,1970-09-17,82.29,0.5,0.61,108.37,-24.07,True,1,3930,-82.29,-272035.46,323399.7,51364.24
10677,1970-09-18,82.62,0.33,0.4,108.37,-23.76,True,1,3931,-82.62,-272118.08,324779.22,52661.14
10678,1970-09-21,81.91,-0.71,-0.86,108.37,-24.42,True,1,3932,-81.91,-272199.99,322070.12,49870.13
10679,1970-09-22,81.86,-0.05,-0.06,108.37,-24.46,True,1,3933,-81.86,-272281.85,321955.38,49673.53
10680,1970-09-23,81.91,0.05,0.06,108.37,-24.42,True,1,3934,-81.91,-272363.76,322233.94,49870.18
10681,1970-09-24,81.66,-0.25,-0.3,108.37,-24.65,True,1,3935,-81.66,-272445.42,321332.1,48886.68
10682,1970-09-25,82.83,1.17,1.43,108.37,-23.57,True,1,3936,-82.83,-272528.25,326018.88,53490.63
10683,1970-09-28,83.91,1.08,1.3,108.37,-22.57,True,1,3937,-83.91,-272612.16,330353.67,57741.51
10684,1970-09-29,83.86,-0.05,-0.06,108.37,-22.62,True,1,3938,-83.86,-272696.02,330240.68,57544.66
10685,1970-09-30,84.3,0.44,0.52,108.37,-22.21,True,1,3939,-84.3,-272780.32,332057.7,59277.38
10686,1970-10-01,84.32,0.02,0.02,108.37,-22.19,True,1,3940,-84.32,-272864.64,332220.8,59356.16
10687,1970-10-02,85.16,0.84,1.0,108.37,-21.42,True,1,3941,-85.16,-272949.8,335615.56,62665.76
10688,1970-10-05,86.47,1.31,1.54,108.37,-20.21,True,1,3942,-86.47,-273036.27,340864.74,67828.47
10689,1970-10-06,86.85,0.38,0.44,108.37,-19.86,True,1,3943,-86.85,-273123.12,342449.55,69326.43
10690,1970-10-07,86.89,0.04,0.05,108.37,-19.82,True,1,3944,-86.89,-273210.01,342694.16,69484.15
10691,1970-10-08,85.95,-0.94,-1.08,108.37,-20.69,True,1,3945,-85.95,-273295.96,339072.75,65776.79
10692,1970-10-09,85.08,-0.87,-1.01,108.37,-21.49,True,1,3946,-85.08,-273381.04,335725.68,62344.64
10693,1970-10-12,84.17,-0.91,-1.07,108.37,-22.33,True,1,3947,-84.17,-273465.21,332218.99,58753.78
10694,1970-10-13,84.06,-0.11,-0.13,108.37,-22.43,True,1,3948,-84.06,-273549.27,331868.88,58319.61
10695,1970-10-14,84.19,0.13,0.16,108.37,-22.31,True,1,3949,-84.19,-273633.46,332466.31,58832.85
10696,1970-10-15,84.65,0.46,0.55,108.37,-21.89,True,1,3950,-84.65,-273718.11,334367.5,60649.39
10697,1970-10-16,84.28,-0.37,-0.44,108.37,-22.23,True,1,3951,-84.28,-273802.39,332990.28,59187.89
10698,1970-10-19,83.15,-1.13,-1.34,108.37,-23.27,True,1,3952,-83.15,-273885.54,328608.8,54723.26
10699,1970-10-20,83.64,0.49,0.59,108.37,-22.82,True,1,3953,-83.64,-273969.18,330628.92,56659.74
10700,1970-10-21,83.66,0.02,0.02,108.37,-22.8,True,1,3954,-83.66,-274052.84,330791.64,56738.8
10701,1970-10-22,83.38,-0.28,-0.34,108.37,-23.06,True,1,3955,-83.38,-274136.22,329767.9,55631.68
10702,1970-10-23,83.77,0.39,0.47,108.37,-22.7,True,1,3956,-83.77,-274219.99,331394.12,57174.13
10703,1970-10-26,83.31,-0.46,-0.55,108.37,-23.12,True,1,3957,-83.31,-274303.3,329657.67,55354.37
10704,1970-10-27,83.12,-0.19,-0.23,108.37,-23.3,True,1,3958,-83.12,-274386.42,328988.96,54602.54
10705,1970-10-28,83.43,0.31,0.37,108.37,-23.01,True,1,3959,-83.43,-274469.85,330299.37,55829.52
10706,1970-10-29,83.36,-0.07,-0.08,108.37,-23.08,True,1,3960,-83.36,-274553.21,330105.6,55552.39
10707,1970-10-30,83.25,-0.11,-0.13,108.37,-23.18,True,1,3961,-83.25,-274636.46,329753.25,55116.79
10708,1970-11-02,83.51,0.26,0.31,108.37,-22.94,True,1,3962,-83.51,-274719.97,330866.62,56146.65
10709,1970-11-03,84.22,0.71,0.85,108.37,-22.28,True,1,3963,-84.22,-274804.19,333763.86,58959.67
10710,1970-11-04,84.39,0.17,0.2,108.37,-22.13,True,1,3964,-84.39,-274888.58,334521.96,59633.38
10711,1970-11-05,84.1,-0.29,-0.34,108.37,-22.4,True,1,3965,-84.1,-274972.68,333456.5,58483.82
10712,1970-11-06,84.22,0.12,0.14,108.37,-22.28,True,1,3966,-84.22,-275056.9,334016.52,58959.62
10713,1970-11-09,84.67,0.45,0.53,108.37,-21.87,True,1,3967,-84.67,-275141.57,335885.89,60744.32
10714,1970-11-10,84.79,0.12,0.14,108.37,-21.76,True,1,3968,-84.79,-275226.36,336446.72,61220.36
10715,1970-11-11,85.03,0.24,0.28,108.37,-21.54,True,1,3969,-85.03,-275311.39,337484.07,62172.68
10716,1970-11-12,84.15,-0.88,-1.03,108.37,-22.35,True,1,3970,-84.15,-275395.54,334075.5,58679.96
10717,1970-11-13,83.37,-0.78,-0.93,108.37,-23.07,True,1,3971,-83.37,-275478.91,331062.27,55583.36
10718,1970-11-16,83.24,-0.13,-0.16,108.37,-23.19,True,1,3972,-83.24,-275562.15,330629.28,55067.13
10719,1970-11-17,83.47,0.23,0.28,108.37,-22.98,True,1,3973,-83.47,-275645.62,331626.31,55980.69
10720,1970-11-18,82.79,-0.68,-0.82,108.37,-23.6,True,1,3974,-82.79,-275728.41,329007.46,53279.05
10721,1970-11-19,82.91,0.12,0.14,108.37,-23.49,True,1,3975,-82.91,-275811.32,329567.25,53755.93
10722,1970-11-20,83.72,0.81,0.98,108.37,-22.75,True,1,3976,-83.72,-275895.04,332870.72,56975.68
10723,1970-11-23,84.24,0.52,0.62,108.37,-22.27,True,1,3977,-84.24,-275979.28,335022.48,59043.2
10724,1970-11-24,84.78,0.54,0.64,108.37,-21.77,True,1,3978,-84.78,-276064.06,337254.84,61190.78
10725,1970-11-25,85.09,0.31,0.37,108.37,-21.48,True,1,3979,-85.09,-276149.15,338573.11,62423.96
10726,1970-11-27,85.93,0.84,0.99,108.37,-20.71,True,1,3980,-85.93,-276235.08,342001.4,65766.32
10727,1970-11-30,87.2,1.27,1.48,108.37,-19.54,True,1,3981,-87.2,-276322.28,347143.2,70820.92
10728,1970-12-01,87.47,0.27,0.31,108.37,-19.29,True,1,3982,-87.47,-276409.75,348305.54,71895.79
10729,1970-12-02,88.48,1.01,1.16,108.37,-18.35,True,1,3983,-88.48,-276498.23,352415.84,75917.61
10730,1970-12-03,88.9,0.42,0.48,108.37,-17.97,True,1,3984,-88.9,-276587.13,354177.6,77590.47
10731,1970-12-04,89.46,0.56,0.63,108.37,-17.45,True,1,3985,-89.46,-276676.59,356498.1,79821.51
10732,1970-12-07,89.94,0.48,0.54,108.37,-17.01,True,1,3986,-89.94,-276766.53,358500.84,81734.31
10733,1970-12-08,89.47,-0.47,-0.52,108.37,-17.44,True,1,3987,-89.47,-276856.0,356716.89,79860.89
10734,1970-12-09,89.54,0.07,0.08,108.37,-17.38,True,1,3988,-89.54,-276945.54,357085.52,80139.98
10735,1970-12-10,89.92,0.38,0.42,108.37,-17.02,True,1,3989,-89.92,-277035.46,358690.88,81655.42
10736,1970-12-11,90.26,0.34,0.38,108.37,-16.71,True,1,3990,-90.26,-277125.72,360137.4,83011.68
10737,1970-12-14,89.8,-0.46,-0.51,108.37,-17.14,True,1,3991,-89.8,-277215.52,358391.8,81176.28
10738,1970-12-15,89.66,-0.14,-0.16,108.37,-17.26,True,1,3992,-89.66,-277305.18,357922.72,80617.54
10739,1970-12-16,89.72,0.06,0.07,108.37,-17.21,True,1,3993,-89.72,-277394.9,358251.96,80857.06
10740,1970-12-17,90.04,0.32,0.36,108.37,-16.91,True,1,3994,-90.04,-277484.94,359619.76,82134.82
10741,1970-12-18,90.22,0.18,0.2,108.37,-16.75,True,1,3995,-90.22,-277575.16,360428.9,82853.74
10742,1970-12-21,89.94,-0.28,-0.31,108.37,-17.01,True,1,3996,-89.94,-277665.1,359400.24,81735.14
10743,1970-12-22,90.04,0.1,0.11,108.37,-16.91,True,1,3997,-90.04,-277755.14,359889.88,82134.74
10744,1970-12-23,90.1,0.06,0.07,108.37,-16.86,True,1,3998,-90.1,-277845.24,360219.8,82374.56
10745,1970-12-24,90.61,0.51,0.57,108.37,-16.39,True,1,3999,-90.61,-277935.85,362349.39,84413.54
10746,1970-12-28,91.09,0.48,0.53,108.37,-15.94,True,1,4000,-91.09,-278026.94,364360.0,86333.06
10747,1970-12-29,92.08,0.99,1.09,108.37,-15.03,True,1,4001,-92.08,-278119.02,368412.08,90293.06
10748,1970-12-30,92.27,0.19,0.21,108.37,-14.86,True,1,4002,-92.27,-278211.29,369264.54,91053.25
10749,1970-12-31,92.15,-0.12,-0.13,108.37,-14.97,True,1,4003,-92.15,-278303.44,368876.45,90573.01
10750,1971-01-04,91.15,-1.0,-1.08,108.37,-15.89,True,1,4004,-91.15,-278394.59,364964.6,86570.01
10751,1971-01-05,91.8,0.65,0.71,108.37,-15.29,True,1,4005,-91.8,-278486.39,367659.0,89172.61
10752,1971-01-06,92.35,0.55,0.6,108.37,-14.78,True,1,4006,-92.35,-278578.74,369954.1,91375.36
10753,1971-01-07,92.38,0.03,0.03,108.37,-14.76,True,1,4007,-92.38,-278671.12,370166.66,91495.54
10754,1971-01-08,92.19,-0.19,-0.21,108.37,-14.93,True,1,4008,-92.19,-278763.31,369497.52,90734.21
10755,1971-01-11,91.98,-0.21,-0.23,108.37,-15.12,True,1,4009,-91.98,-278855.29,368747.82,89892.53
10756,1971-01-12,92.72,0.74,0.8,108.37,-14.44,True,1,4010,-92.72,-278948.01,371807.2,92859.19
10757,1971-01-13,92.56,-0.16,-0.17,108.37,-14.59,True,1,4011,-92.56,-279040.57,371258.16,92217.59
10758,1971-01-14,92.8,0.24,0.26,108.37,-14.37,True,1,4012,-92.8,-279133.37,372313.6,93180.23
10759,1971-01-15,93.03,0.23,0.25,108.37,-14.16,True,1,4013,-93.03,-279226.4,373329.39,94102.99
10760,1971-01-18,93.41,0.38,0.41,108.37,-13.8,True,1,4014,-93.41,-279319.81,374947.74,95627.93
10761,1971-01-19,93.76,0.35,0.38,108.37,-13.48,True,1,4015,-93.76,-279413.57,376446.4,97032.83
10762,1971-01-20,93.78,0.02,0.02,108.37,-13.46,True,1,4016,-93.78,-279507.35,376620.48,97113.13
10763,1971-01-21,94.19,0.41,0.44,108.37,-13.08,True,1,4017,-94.19,-279601.54,378361.23,98759.69
10764,1971-01-22,94.88,0.69,0.73,108.37,-12.45,True,1,4018,-94.88,-279696.42,381227.84,101531.42
10765,1971-01-25,95.28,0.4,0.42,108.37,-12.08,True,1,4019,-95.28,-279791.7,382930.32,103138.62
10766,1971-01-26,95.59,0.31,0.32,108.37,-11.79,True,1,4020,-95.59,-279887.29,384271.8,104384.51
10767,1971-01-27,94.89,-0.7,-0.73,108.37,-12.44,True,1,4021,-94.89,-279982.18,381552.69,101570.51
10768,1971-01-28,95.21,0.32,0.34,108.37,-12.14,True,1,4022,-95.21,-280077.39,382934.62,102857.23
10769,1971-01-29,95.88,0.67,0.7,108.37,-11.52,True,1,4023,-95.88,-280173.27,385725.24,105551.97
10770,1971-02-01,96.42,0.54,0.56,108.37,-11.03,True,1,4024,-96.42,-280269.69,387994.08,107724.39
10771,1971-02-02,96.43,0.01,0.01,108.37,-11.02,True,1,4025,-96.43,-280366.12,388130.75,107764.63
10772,1971-02-03,96.63,0.2,0.21,108.37,-10.83,True,1,4026,-96.63,-280462.75,389032.38,108569.63
10773,1971-02-04,96.62,-0.01,-0.01,108.37,-10.84,True,1,4027,-96.62,-280559.37,389088.74,108529.37
10774,1971-02-05,96.93,0.31,0.32,108.37,-10.56,True,1,4028,-96.93,-280656.3,390434.04,109777.74
10775,1971-02-08,97.45,0.52,0.54,108.37,-10.08,True,1,4029,-97.45,-280753.75,392626.05,111872.3
10776,1971-02-09,97.51,0.06,0.06,108.37,-10.02,True,1,4030,-97.51,-280851.26,392965.3,112114.04
10777,1971-02-10,97.39,-0.12,-0.12,108.37,-10.13,True,1,4031,-97.39,-280948.65,392579.09,111630.44
10778,1971-02-11,97.91,0.52,0.53,108.37,-9.65,True,1,4032,-97.91,-281046.56,394773.12,113726.56
10779,1971-02-12,98.43,0.52,0.53,108.37,-9.17,True,1,4033,-98.43,-281144.99,396968.19,115823.2
10780,1971-02-16,98.66,0.23,0.23,108.37,-8.96,True,1,4034,-98.66,-281243.65,397994.44,116750.79
10781,1971-02-17,98.2,-0.46,-0.47,108.37,-9.38,True,1,4035,-98.2,-281341.85,396237.0,114895.15
10782,1971-02-18,97.56,-0.64,-0.65,108.37,-9.98,True,1,4036,-97.56,-281439.41,393752.16,112312.75
10783,1971-02-19,96.74,-0.82,-0.84,108.37,-10.73,True,1,4037,-96.74,-281536.15,390539.38,109003.23
10784,1971-02-22,95.72,-1.02,-1.05,108.37,-11.67,True,1,4038,-95.72,-281631.87,386517.36,104885.49
10785,1971-02-23,96.09,0.37,0.39,108.37,-11.33,True,1,4039,-96.09,-281727.96,388107.51,106379.55
10786,1971-02-24,96.73,0.64,0.67,108.37,-10.74,True,1,4040,-96.73,-281824.69,390789.2,108964.51
10787,1971-02-25,96.96,0.23,0.24,108.37,-10.53,True,1,4041,-96.96,-281921.65,391815.36,109893.71
10788,1971-02-26,96.75,-0.21,-0.22,108.37,-10.72,True,1,4042,-96.75,-282018.4,391063.5,109045.1
10789,1971-03-01,97.0,0.25,0.26,108.37,-10.49,True,1,4043,-97.0,-282115.4,392171.0,110055.6
10790,1971-03-02,96.98,-0.02,-0.02,108.37,-10.51,True,1,4044,-96.98,-282212.38,392187.12,109974.74
10791,1971-03-03,96.95,-0.03,-0.03,108.37,-10.54,True,1,4045,-96.95,-282309.33,392162.75,109853.42
10792,1971-03-04,97.92,0.97,1.0,108.37,-9.64,True,1,4046,-97.92,-282407.25,396184.32,113777.07
10793,1971-03-05,98.96,1.04,1.06,108.37,-8.68,True,1,4047,-98.96,-282506.21,400491.12,117984.91
10794,1971-03-08,99.38,0.42,0.42,108.37,-8.3,True,1,4048,-99.38,-282605.59,402290.24,119684.65
10795,1971-03-09,99.46,0.08,0.08,108.37,-8.22,True,1,4049,-99.46,-282705.05,402713.54,120008.49
10796,1971-03-10,99.3,-0.16,-0.16,108.37,-8.37,True,1,4050,-99.3,-282804.35,402165.0,119360.65
10797,1971-03-11,99.39,0.09,0.09,108.37,-8.29,True,1,4051,-99.39,-282903.74,402628.89,119725.15
10798,1971-03-12,99.57,0.18,0.18,108.37,-8.12,True,1,4052,-99.57,-283003.31,403457.64,120454.33
10799,1971-03-15,100.71,1.14,1.14,108.37,-7.07,True,1,4053,-100.71,-283104.02,408177.63,125073.61
10800,1971-03-16,101.21,0.5,0.5,108.37,-6.61,True,1,4054,-101.21,-283205.23,410305.34,127100.11
10801,1971-03-17,101.12,-0.09,-0.09,108.37,-6.69,True,1,4055,-101.12,-283306.35,410041.6,126735.25
10802,1971-03-18,101.19,0.07,0.07,108.37,-6.62,True,1,4056,-101.19,-283407.54,410426.64,127019.1
10803,1971-03-19,101.01,-0.18,-0.18,108.37,-6.79,True,1,4057,-101.01,-283508.55,409797.57,126289.02
10804,1971-03-22,100.62,-0.39,-0.39,108.37,-7.15,True,1,4058,-100.62,-283609.17,408315.96,124706.79
10805,1971-03-23,100.28,-0.34,-0.34,108.37,-7.46,True,1,4059,-100.28,-283709.45,407036.52,123327.07
10806,1971-03-24,99.62,-0.66,-0.66,108.37,-8.07,True,1,4060,-99.62,-283809.07,404457.2,120648.13
10807,1971-03-25,99.61,-0.01,-0.01,108.37,-8.08,True,1,4061,-99.61,-283908.68,404516.21,120607.53
10808,1971-03-26,99.95,0.34,0.34,108.37,-7.77,True,1,4062,-99.95,-284008.63,405996.9,121988.27
10809,1971-03-29,100.03,0.08,0.08,108.37,-7.7,True,1,4063,-100.03,-284108.66,406421.89,122313.23
10810,1971-03-30,100.26,0.23,0.23,108.37,-7.48,True,1,4064,-100.26,-284208.92,407456.64,123247.72
10811,1971-03-31,100.31,0.05,0.05,108.37,-7.44,True,1,4065,-100.31,-284309.23,407760.15,123450.92
10812,1971-04-01,100.39,0.08,0.08,108.37,-7.36,True,1,4066,-100.39,-284409.62,408185.74,123776.12
10813,1971-04-02,100.56,0.17,0.17,108.37,-7.21,True,1,4067,-100.56,-284510.18,408977.52,124467.34
10814,1971-04-05,100.79,0.23,0.23,108.37,-7.0,True,1,4068,-100.79,-284610.97,410013.72,125402.75
10815,1971-04-06,101.51,0.72,0.71,108.37,-6.33,True,1,4069,-101.51,-284712.48,413044.19,128331.71
10816,1971-04-07,101.98,0.47,0.46,108.37,-5.9,True,1,4070,-101.98,-284814.46,415058.6,130244.14
10817,1971-04-08,102.1,0.12,0.12,108.37,-5.79,True,1,4071,-102.1,-284916.56,415649.1,130732.54
10818,1971-04-12,102.88,0.78,0.76,108.37,-5.07,True,1,4072,-102.88,-285019.44,418927.36,133907.92
10819,1971-04-13,102.98,0.1,0.1,108.37,-4.97,True,1,4073,-102.98,-285122.42,419437.54,134315.12
10820,1971-04-14,103.37,0.39,0.38,108.37,-4.61,True,1,4074,-103.37,-285225.79,421129.38,135903.59
10821,1971-04-15,103.52,0.15,0.14,108.37,-4.47,True,1,4075,-103.52,-285329.31,421844.0,136514.69
10822,1971-04-16,103.49,-0.03,-0.03,108.37,-4.5,True,1,4076,-103.49,-285432.8,421825.24,136392.44
10823,1971-04-19,104.01,0.52,0.5,108.37,-4.02,True,1,4077,-104.01,-285536.81,424048.77,138511.96
10824,1971-04-20,103.61,-0.4,-0.38,108.37,-4.39,True,1,4078,-103.61,-285640.42,422521.58,136881.16
10825,1971-04-21,103.36,-0.25,-0.24,108.37,-4.62,True,1,4079,-103.36,-285743.78,421605.44,135861.66
10826,1971-04-22,103.56,0.2,0.19,108.37,-4.44,True,1,4080,-103.56,-285847.34,422524.8,136677.46
10827,1971-04-23,104.05,0.49,0.47,108.37,-3.99,True,1,4081,-104.05,-285951.39,424628.05,138676.66
10828,1971-04-26,103.94,-0.11,-0.11,108.37,-4.09,True,1,4082,-103.94,-286055.33,424283.08,138227.75
10829,1971-04-27,104.59,0.65,0.62,108.37,-3.49,True,1,4083,-104.59,-286159.92,427040.97,140881.05
10830,1971-04-28,104.77,0.18,0.17,108.37,-3.32,True,1,4084,-104.77,-286264.69,427880.68,141615.99
10831,1971-04-29,104.63,-0.14,-0.13,108.37,-3.45,True,1,4085,-104.63,-286369.32,427413.55,141044.23
10832,1971-04-30,103.95,-0.68,-0.65,108.37,-4.08,True,1,4086,-103.95,-286473.27,424739.7,138266.43
10833,1971-05-03,103.29,-0.66,-0.64,108.37,-4.69,True,1,4087,-103.29,-286576.56,422146.23,135569.67
10834,1971-05-04,103.79,0.5,0.48,108.37,-4.23,True,1,4088,-103.79,-286680.35,424293.52,137613.17
10835,1971-05-05,103.78,-0.01,-0.01,108.37,-4.24,True,1,4089,-103.78,-286784.13,424356.42,137572.29
10836,1971-05-06,103.23,-0.55,-0.53,108.37,-4.74,True,1,4090,-103.23,-286887.36,422210.7,135323.34
10837,1971-05-07,102.87,-0.36,-0.35,108.37,-5.08,True,1,4091,-102.87,-286990.23,420841.17,133850.94
10838,1971-05-10,102.36,-0.51,-0.5,108.37,-5.55,True,1,4092,-102.36,-287092.59,418857.12,131764.53
10839,1971-05-11,102.62,0.26,0.25,108.37,-5.31,True,1,4093,-102.62,-287195.21,420023.66,132828.45
10840,1971-05-12,102.9,0.28,0.27,108.37,-5.05,True,1,4094,-102.9,-287298.11,421272.6,133974.49
10841,1971-05-13,102.69,-0.21,-0.2,108.37,-5.24,True,1,4095,-102.69,-287400.8,420515.55,133114.75
10842,1971-05-14,102.21,-0.48,-0.47,108.37,-5.68,True,1,4096,-102.21,-287503.01,418652.16,131149.15
10843,1971-05-17,100.69,-1.52,-1.49,108.37,-7.09,True,1,4097,-100.69,-287603.7,412526.93,124923.23
10844,1971-05-18,100.83,0.14,0.14,108.37,-6.96,True,1,4098,-100.83,-287704.53,413201.34,125496.81
10845,1971-05-19,101.07,0.24,0.24,108.37,-6.74,True,1,4099,-101.07,-287805.6,414285.93,126480.33
10846,1971-05-20,101.31,0.24,0.24,108.37,-6.52,True,1,4100,-101.31,-287906.91,415371.0,127464.09
10847,1971-05-21,100.99,-0.32,-0.32,108.37,-6.81,True,1,4101,-100.99,-288007.9,414159.99,126152.09
10848,1971-05-24,100.13,-0.86,-0.85,108.37,-7.6,True,1,4102,-100.13,-288108.03,410733.26,122625.23
10849,1971-05-25,99.47,-0.66,-0.66,108.37,-8.21,True,1,4103,-99.47,-288207.5,408125.41,119917.91
10850,1971-05-26,99.59,0.12,0.12,108.37,-8.1,True,1,4104,-99.59,-288307.09,408717.36,120410.27
10851,1971-05-27,99.4,-0.19,-0.19,108.37,-8.28,True,1,4105,-99.4,-288406.49,408037.0,119630.51
10852,1971-05-28,99.63,0.23,0.23,108.37,-8.06,True,1,4106,-99.63,-288506.12,409080.78,120574.66
10853,1971-06-01,100.2,0.57,0.57,108.37,-7.54,True,1,4107,-100.2,-288606.32,411521.4,122915.08
10854,1971-06-02,100.96,0.76,0.76,108.37,-6.84,True,1,4108,-100.96,-288707.28,414743.68,126036.4
10855,1971-06-03,101.01,0.05,0.05,108.37,-6.79,True,1,4109,-101.01,-288808.29,415050.09,126241.8
10856,1971-06-04,101.3,0.29,0.29,108.37,-6.52,True,1,4110,-101.3,-288909.59,416343.0,127433.41
10857,1971-06-07,101.09,-0.21,-0.21,108.37,-6.72,True,1,4111,-101.09,-289010.68,415580.99,126570.31
10858,1971-06-08,100.32,-0.77,-0.76,108.37,-7.43,True,1,4112,-100.32,-289111.0,412515.84,123404.84
10859,1971-06-09,100.29,-0.03,-0.03,108.37,-7.46,True,1,4113,-100.29,-289211.29,412492.77,123281.48
10860,1971-06-10,100.64,0.35,0.35,108.37,-7.13,True,1,4114,-100.64,-289311.93,414032.96,124721.03
10861,1971-06-11,101.07,0.43,0.43,108.37,-6.74,True,1,4115,-101.07,-289413.0,415903.05,126490.05
10862,1971-06-14,100.22,-0.85,-0.84,108.37,-7.52,True,1,4116,-100.22,-289513.22,412505.52,122992.3
10863,1971-06-15,100.32,0.1,0.1,108.37,-7.43,True,1,4117,-100.32,-289613.54,413017.44,123403.9
10864,1971-06-16,100.52,0.2,0.2,108.37,-7.24,True,1,4118,-100.52,-289714.06,413941.36,124227.3
10865,1971-06-17,100.5,-0.02,-0.02,108.37,-7.26,True,1,4119,-100.5,-289814.56,413959.5,124144.94
10866,1971-06-18,98.97,-1.53,-1.52,108.37,-8.67,True,1,4120,-98.97,-289913.53,407756.4,117842.87
10867,1971-06-21,97.87,-1.1,-1.11,108.37,-9.69,True,1,4121,-97.87,-290011.4,403322.27,113310.87
10868,1971-06-22,97.59,-0.28,-0.29,108.37,-9.95,True,1,4122,-97.59,-290108.99,402265.98,112156.99
10869,1971-06-23,98.41,0.82,0.84,108.37,-9.19,True,1,4123,-98.41,-290207.4,405744.43,115537.03
10870,1971-06-24,98.13,-0.28,-0.28,108.37,-9.45,True,1,4124,-98.13,-290305.53,404688.12,114382.59
10871,1971-06-25,97.99,-0.14,-0.14,108.37,-9.58,True,1,4125,-97.99,-290403.52,404208.75,113805.23
10872,1971-06-28,97.74,-0.25,-0.26,108.37,-9.81,True,1,4126,-97.74,-290501.26,403275.24,112773.98
10873,1971-06-29,98.82,1.08,1.1,108.37,-8.81,True,1,4127,-98.82,-290600.08,407830.14,117230.06
10874,1971-06-30,98.7,-0.12,-0.12,108.37,-8.92,True,1,4128,-98.7,-290698.78,407433.6,116734.82
10875,1971-07-01,99.78,1.08,1.09,108.37,-7.93,True,1,4129,-99.78,-290798.56,411991.62,121193.06
10876,1971-07-02,99.78,0.0,0.0,108.37,-7.93,True,1,4130,-99.78,-290898.34,412091.4,121193.06
10877,1971-07-06,99.76,-0.02,-0.02,108.37,-7.94,True,1,4131,-99.76,-290998.1,412108.56,121110.46
10878,1971-07-07,100.04,0.28,0.28,108.37,-7.69,True,1,4132,-100.04,-291098.14,413365.28,122267.14
10879,1971-07-08,100.34,0.3,0.3,108.37,-7.41,True,1,4133,-100.34,-291198.48,414705.22,123506.74
10880,1971-07-09,100.69,0.35,0.35,108.37,-7.09,True,1,4134,-100.69,-291299.17,416252.46,124953.29
10881,1971-07-12,100.82,0.13,0.13,108.37,-6.97,True,1,4135,-100.82,-291399.99,416890.7,125490.71
10882,1971-07-13,99.5,-1.32,-1.31,108.37,-8.18,True,1,4136,-99.5,-291499.49,411532.0,120032.51
10883,1971-07-14,99.22,-0.28,-0.28,108.37,-8.44,True,1,4137,-99.22,-291598.71,410473.14,118874.43
10884,1971-07-15,99.28,0.06,0.06,108.37,-8.39,True,1,4138,-99.28,-291697.99,410820.64,119122.65
10885,1971-07-16,99.11,-0.17,-0.17,108.37,-8.54,True,1,4139,-99.11,-291797.1,410216.29,118419.19
10886,1971-07-19,98.93,-0.18,-0.18,108.37,-8.71,True,1,4140,-98.93,-291896.03,409570.2,117674.17
10887,1971-07-20,99.32,0.39,0.39,108.37,-8.35,True,1,4141,-99.32,-291995.35,411284.12,119288.77
10888,1971-07-21,99.28,-0.04,-0.04,108.37,-8.39,True,1,4142,-99.28,-292094.63,411217.76,119123.13
10889,1971-07-22,99.11,-0.17,-0.17,108.37,-8.54,True,1,4143,-99.11,-292193.74,410612.73,118418.99
10890,1971-07-23,98.94,-0.17,-0.17,108.37,-8.7,True,1,4144,-98.94,-292292.68,410007.36,117714.68
10891,1971-07-26,98.14,-0.8,-0.81,108.37,-9.44,True,1,4145,-98.14,-292390.82,406790.3,114399.48
10892,1971-07-27,97.78,-0.36,-0.37,108.37,-9.77,True,1,4146,-97.78,-292488.6,405395.88,112907.28
10893,1971-07-28,97.07,-0.71,-0.73,108.37,-10.43,True,1,4147,-97.07,-292585.67,402549.29,109963.62
10894,1971-07-29,96.02,-1.05,-1.08,108.37,-11.4,True,1,4148,-96.02,-292681.69,398290.96,105609.27
10895,1971-07-30,95.58,-0.44,-0.46,108.37,-11.8,True,1,4149,-95.58,-292777.27,396561.42,103784.15
10896,1971-08-02,95.96,0.38,0.4,108.37,-11.45,True,1,4150,-95.96,-292873.23,398234.0,105360.77
10897,1971-08-03,94.51,-1.45,-1.51,108.37,-12.79,True,1,4151,-94.51,-292967.74,392311.01,99343.27
10898,1971-08-04,93.89,-0.62,-0.66,108.37,-13.36,True,1,4152,-93.89,-293061.63,389831.28,96769.65
10899,1971-08-05,94.09,0.2,0.21,108.37,-13.18,True,1,4153,-94.09,-293155.72,390755.77,97600.05
10900,1971-08-06,94.25,0.16,0.17,108.37,-13.03,True,1,4154,-94.25,-293249.97,391514.5,98264.53
10901,1971-08-09,93.53,-0.72,-0.76,108.37,-13.69,True,1,4155,-93.53,-293343.5,388617.15,95273.65
10902,1971-08-10,93.54,0.01,0.01,108.37,-13.68,True,1,4156,-93.54,-293437.04,388752.24,95315.2
10903,1971-08-11,94.66,1.12,1.2,108.37,-12.65,True,1,4157,-94.66,-293531.7,393501.62,99969.92
10904,1971-08-12,96.0,1.34,1.42,108.37,-11.42,True,1,4158,-96.0,-293627.7,399168.0,105540.3
10905,1971-08-13,95.69,-0.31,-0.32,108.37,-11.7,True,1,4159,-95.69,-293723.39,397974.71,104251.32
10906,1971-08-16,98.76,3.07,3.21,108.37,-8.87,True,1,4160,-98.76,-293822.15,410841.6,117019.45
10907,1971-08-17,99.99,1.23,1.25,108.37,-7.73,True,1,4161,-99.99,-293922.14,416058.39,122136.25
10908,1971-08-18,98.6,-1.39,-1.39,108.37,-9.02,True,1,4162,-98.6,-294020.74,410373.2,116352.46
10909,1971-08-19,98.16,-0.44,-0.45,108.37,-9.42,True,1,4163,-98.16,-294118.9,408640.08,114521.18
10910,1971-08-20,98.33,0.17,0.17,108.37,-9.26,True,1,4164,-98.33,-294217.23,409446.12,115228.89
10911,1971-08-23,99.25,0.92,0.94,108.37,-8.42,True,1,4165,-99.25,-294316.48,413376.25,119059.77
10912,1971-08-24,100.4,1.15,1.16,108.37,-7.35,True,1,4166,-100.4,-294416.88,418266.4,123849.52
10913,1971-08-25,100.41,0.01,0.01,108.37,-7.34,True,1,4167,-100.41,-294517.29,418408.47,123891.18
10914,1971-08-26,100.24,-0.17,-0.17,108.37,-7.5,True,1,4168,-100.24,-294617.53,417800.32,123182.79
10915,1971-08-27,100.48,0.24,0.24,108.37,-7.28,True,1,4169,-100.48,-294718.01,418901.12,124183.11
10916,1971-08-30,99.52,-0.96,-0.96,108.37,-8.17,True,1,4170,-99.52,-294817.53,414998.4,120180.87
10917,1971-08-31,99.03,-0.49,-0.49,108.37,-8.62,True,1,4171,-99.03,-294916.56,413054.13,118137.57
10918,1971-09-01,99.07,0.04,0.04,108.37,-8.58,True,1,4172,-99.07,-295015.63,413320.04,118304.41
10919,1971-09-02,99.29,0.22,0.22,108.37,-8.38,True,1,4173,-99.29,-295114.92,414337.17,119222.25
10920,1971-09-03,100.69,1.4,1.41,108.37,-7.09,True,1,4174,-100.69,-295215.61,420280.06,125064.45
10921,1971-09-07,101.15,0.46,0.46,108.37,-6.66,True,1,4175,-101.15,-295316.76,422301.25,126984.49
10922,1971-09-08,101.34,0.19,0.19,108.37,-6.49,True,1,4176,-101.34,-295418.1,423195.84,127777.74
10923,1971-09-09,100.8,-0.54,-0.53,108.37,-6.98,True,1,4177,-100.8,-295518.9,421041.6,125522.7
10924,1971-09-10,100.42,-0.38,-0.38,108.37,-7.34,True,1,4178,-100.42,-295619.32,419554.76,123935.44
10925,1971-09-13,100.07,-0.35,-0.35,108.37,-7.66,True,1,4179,-100.07,-295719.39,418192.53,122473.14
10926,1971-09-14,99.34,-0.73,-0.73,108.37,-8.33,True,1,4180,-99.34,-295818.73,415241.2,119422.47
10927,1971-09-15,99.77,0.43,0.43,108.37,-7.94,True,1,4181,-99.77,-295918.5,417138.37,121219.87
10928,1971-09-16,99.66,-0.11,-0.11,108.37,-8.04,True,1,4182,-99.66,-296018.16,416778.12,120759.96
10929,1971-09-17,99.96,0.3,0.3,108.37,-7.76,True,1,4183,-99.96,-296118.12,418132.68,122014.56
10930,1971-09-20,99.68,-0.28,-0.28,108.37,-8.02,True,1,4184,-99.68,-296217.8,417061.12,120843.32
10931,1971-09-21,99.34,-0.34,-0.34,108.37,-8.33,True,1,4185,-99.34,-296317.14,415737.9,119420.76
10932,1971-09-22,98.47,-0.87,-0.88,108.37,-9.14,True,1,4186,-98.47,-296415.61,412195.42,115779.81
10933,1971-09-23,98.38,-0.09,-0.09,108.37,-9.22,True,1,4187,-98.38,-296513.99,411917.06,115403.07
10934,1971-09-24,98.15,-0.23,-0.23,108.37,-9.43,True,1,4188,-98.15,-296612.14,411052.2,114440.06
10935,1971-09-27,97.62,-0.53,-0.54,108.37,-9.92,True,1,4189,-97.62,-296709.76,408930.18,112220.42
10936,1971-09-28,97.88,0.26,0.27,108.37,-9.68,True,1,4190,-97.88,-296807.64,410117.2,113309.56
10937,1971-09-29,97.9,0.02,0.02,108.37,-9.66,True,1,4191,-97.9,-296905.54,410298.9,113393.36
10938,1971-09-30,98.34,0.44,0.45,108.37,-9.26,True,1,4192,-98.34,-297003.88,412241.28,115237.4
10939,1971-10-01,98.93,0.59,0.6,108.37,-8.71,True,1,4193,-98.93,-297102.81,414813.49,117710.68
10940,1971-10-04,99.21,0.28,0.28,108.37,-8.45,True,1,4194,-99.21,-297202.02,416086.74,118884.72
10941,1971-10-05,99.11,-0.1,-0.1,108.37,-8.54,True,1,4195,-99.11,-297301.13,415766.45,118465.32
10942,1971-10-06,99.82,0.71,0.72,108.37,-7.89,True,1,4196,-99.82,-297400.95,418844.72,121443.77
10943,1971-10-07,100.02,0.2,0.2,108.37,-7.7,True,1,4197,-100.02,-297500.97,419783.94,122282.97
10944,1971-10-08,99.36,-0.66,-0.66,108.37,-8.31,True,1,4198,-99.36,-297600.33,417113.28,119512.95
10945,1971-10-11,99.21,-0.15,-0.15,108.37,-8.45,True,1,4199,-99.21,-297699.54,416582.79,118883.25
10946,1971-10-12,99.57,0.36,0.36,108.37,-8.12,True,1,4200,-99.57,-297799.11,418194.0,120394.89
10947,1971-10-13,99.03,-0.54,-0.54,108.37,-8.62,True,1,4201,-99.03,-297898.14,416025.03,118126.89
10948,1971-10-14,98.13,-0.9,-0.91,108.37,-9.45,True,1,4202,-98.13,-297996.27,412342.26,114345.99
10949,1971-10-15,97.79,-0.34,-0.35,108.37,-9.76,True,1,4203,-97.79,-298094.06,411011.37,112917.31
10950,1971-10-18,97.35,-0.44,-0.45,108.37,-10.17,True,1,4204,-97.35,-298191.41,409259.4,111067.99
10951,1971-10-19,97.0,-0.35,-0.36,108.37,-10.49,True,1,4205,-97.0,-298288.41,407885.0,109596.59
10952,1971-10-20,95.65,-1.35,-1.39,108.37,-11.74,True,1,4206,-95.65,-298384.06,402303.9,103919.84
10953,1971-10-21,95.6,-0.05,-0.05,108.37,-11.78,True,1,4207,-95.6,-298479.66,402189.2,103709.54
10954,1971-10-22,95.57,-0.03,-0.03,108.37,-11.81,True,1,4208,-95.57,-298575.23,402158.56,103583.33
10955,1971-10-25,95.1,-0.47,-0.49,108.37,-12.24,True,1,4209,-95.1,-298670.33,400275.9,101605.57
10956,1971-10-26,94.74,-0.36,-0.38,108.37,-12.58,True,1,4210,-94.74,-298765.07,398855.4,100090.33
10957,1971-10-27,93.79,-0.95,-1.0,108.37,-13.45,True,1,4211,-93.79,-298858.86,394949.69,96090.83
10958,1971-10-28,93.96,0.17,0.18,108.37,-13.3,True,1,4212,-93.96,-298952.82,395759.52,96806.7
10959,1971-10-29,94.23,0.27,0.29,108.37,-13.05,True,1,4213,-94.23,-299047.05,396990.99,97943.94
10960,1971-11-01,92.8,-1.43,-1.52,108.37,-14.37,True,1,4214,-92.8,-299139.85,391059.2,91919.35
10961,1971-11-02,93.18,0.38,0.41,108.37,-14.02,True,1,4215,-93.18,-299233.03,392753.7,93520.67
10962,1971-11-03,94.91,1.73,1.86,108.37,-12.42,True,1,4216,-94.91,-299327.94,400140.56,100812.62
10963,1971-11-04,94.79,-0.12,-0.13,108.37,-12.53,True,1,4217,-94.79,-299422.73,399729.43,100306.7
10964,1971-11-05,94.46,-0.33,-0.35,108.37,-12.84,True,1,4218,-94.46,-299517.19,398432.28,98915.09
10965,1971-11-08,94.39,-0.07,-0.07,108.37,-12.9,True,1,4219,-94.39,-299611.58,398231.41,98619.83
10966,1971-11-09,94.46,0.07,0.07,108.37,-12.84,True,1,4220,-94.46,-299706.04,398621.2,98915.16
10967,1971-11-10,93.41,-1.05,-1.11,108.37,-13.8,True,1,4221,-93.41,-299799.45,394283.61,94484.16
10968,1971-11-11,92.12,-1.29,-1.38,108.37,-15.0,True,1,4222,-92.12,-299891.57,388930.64,89039.07
10969,1971-11-12,92.12,0.0,0.0,108.37,-15.0,True,1,4223,-92.12,-299983.69,389022.76,89039.07
10970,1971-11-15,91.81,-0.31,-0.34,108.37,-15.28,True,1,4224,-91.81,-300075.5,387805.44,87729.94
10971,1971-11-16,92.71,0.9,0.98,108.37,-14.45,True,1,4225,-92.71,-300168.21,391699.75,91531.54
10972,1971-11-17,92.85,0.14,0.15,108.37,-14.32,True,1,4226,-92.85,-300261.06,392384.1,92123.04
10973,1971-11-18,92.13,-0.72,-0.78,108.37,-14.99,True,1,4227,-92.13,-300353.19,389433.51,89080.32
10974,1971-11-19,91.61,-0.52,-0.56,108.37,-15.47,True,1,4228,-91.61,-300444.8,387327.08,86882.28
10975,1971-11-22,90.79,-0.82,-0.9,108.37,-16.22,True,1,4229,-90.79,-300535.59,383950.91,83415.32
10976,1971-11-23,90.16,-0.63,-0.69,108.37,-16.8,True,1,4230,-90.16,-300625.75,381376.8,80751.05
10977,1971-11-24,90.33,0.17,0.19,108.37,-16.65,True,1,4231,-90.33,-300716.08,382186.23,81470.15
10978,1971-11-26,91.94,1.61,1.78,108.37,-15.16,True,1,4232,-91.94,-300808.02,389090.08,88282.06
10979,1971-11-29,93.41,1.47,1.6,108.37,-13.8,True,1,4233,-93.41,-300901.43,395404.53,94503.1
10980,1971-11-30,93.99,0.58,0.62,108.37,-13.27,True,1,4234,-93.99,-300995.42,397953.66,96958.24
10981,1971-12-01,95.44,1.45,1.54,108.37,-11.93,True,1,4235,-95.44,-301090.86,404188.4,103097.54
10982,1971-12-02,95.84,0.4,0.42,108.37,-11.56,True,1,4236,-95.84,-301186.7,405978.24,104791.54
10983,1971-12-03,97.06,1.22,1.27,108.37,-10.44,True,1,4237,-97.06,-301283.76,411243.22,109959.46
10984,1971-12-06,96.51,-0.55,-0.57,108.37,-10.94,True,1,4238,-96.51,-301380.27,409009.38,107629.11
10985,1971-12-07,96.87,0.36,0.37,108.37,-10.61,True,1,4239,-96.87,-301477.14,410631.93,109154.79
10986,1971-12-08,96.92,0.05,0.05,108.37,-10.57,True,1,4240,-96.92,-301574.06,410940.8,109366.74
10987,1971-12-09,96.96,0.04,0.04,108.37,-10.53,True,1,4241,-96.96,-301671.02,411207.36,109536.34
10988,1971-12-10,97.69,0.73,0.75,108.37,-9.86,True,1,4242,-97.69,-301768.71,414400.98,112632.27
10989,1971-12-13,97.97,0.28,0.29,108.37,-9.6,True,1,4243,-97.97,-301866.68,415686.71,113820.03
10990,1971-12-14,97.67,-0.3,-0.31,108.37,-9.87,True,1,4244,-97.67,-301964.35,414511.48,112547.13
10991,1971-12-15,98.54,0.87,0.89,108.37,-9.07,True,1,4245,-98.54,-302062.89,418302.3,116239.41
10992,1971-12-16,99.74,1.2,1.22,108.37,-7.96,True,1,4246,-99.74,-302162.63,423496.04,121333.41
10993,1971-12-17,100.26,0.52,0.52,108.37,-7.48,True,1,4247,-100.26,-302262.89,425804.22,123541.33
10994,1971-12-20,101.55,1.29,1.29,108.37,-6.29,True,1,4248,-101.55,-302364.44,431384.4,129019.96
10995,1971-12-21,101.8,0.25,0.25,108.37,-6.06,True,1,4249,-101.8,-302466.24,432548.2,130081.96
10996,1971-12-22,101.18,-0.62,-0.61,108.37,-6.64,True,1,4250,-101.18,-302567.42,430015.0,127447.58
10997,1971-12-23,100.74,-0.44,-0.44,108.37,-7.04,True,1,4251,-100.74,-302668.16,428245.74,125577.58
10998,1971-12-27,100.95,0.21,0.21,108.37,-6.85,True,1,4252,-100.95,-302769.11,429239.4,126470.29
10999,1971-12-28,101.95,1.0,0.99,108.37,-5.92,True,1,4253,-101.95,-302871.06,433593.35,130722.29
11000,1971-12-29,102.21,0.26,0.26,108.37,-5.68,True,1,4254,-102.21,-302973.27,434801.34,131828.07
11001,1971-12-30,101.78,-0.43,-0.42,108.37,-6.08,True,1,4255,-101.78,-303075.05,433073.9,129998.85
11002,1971-12-31,102.09,0.31,0.3,108.37,-5.8,True,1,4256,-102.09,-303177.14,434495.04,131317.9
11003,1972-01-03,101.67,-0.42,-0.41,108.37,-6.18,True,1,4257,-101.67,-303278.81,432809.19,129530.38
11004,1972-01-04,102.09,0.42,0.41,108.37,-5.8,True,1,4258,-102.09,-303380.9,434699.22,131318.32
11005,1972-01-05,103.06,0.97,0.95,108.37,-4.9,True,1,4259,-103.06,-303483.96,438932.54,135448.58
11006,1972-01-06,103.51,0.45,0.44,108.37,-4.49,True,1,4260,-103.51,-303587.47,440952.6,137365.13
11007,1972-01-07,103.47,-0.04,-0.04,108.37,-4.52,True,1,4261,-103.47,-303690.94,440885.67,137194.73
11008,1972-01-10,103.32,-0.15,-0.14,108.37,-4.66,True,1,4262,-103.32,-303794.26,440349.84,136555.58
11009,1972-01-11,103.65,0.33,0.32,108.37,-4.36,True,1,4263,-103.65,-303897.91,441859.95,137962.04
11010,1972-01-12,103.59,-0.06,-0.06,108.37,-4.41,True,1,4264,-103.59,-304001.5,441707.76,137706.26
11011,1972-01-13,102.99,-0.6,-0.58,108.37,-4.96,True,1,4265,-102.99,-304104.49,439252.35,135147.86
11012,1972-01-14,103.39,0.4,0.39,108.37,-4.6,True,1,4266,-103.39,-304207.88,441061.74,136853.86
11013,1972-01-17,103.7,0.31,0.3,108.37,-4.31,True,1,4267,-103.7,-304311.58,442487.9,138176.32
11014,1972-01-18,104.05,0.35,0.34,108.37,-3.99,True,1,4268,-104.05,-304415.63,444085.4,139669.77
11015,1972-01-19,103.88,-0.17,-0.16,108.37,-4.14,True,1,4269,-103.88,-304519.51,443463.72,138944.21
11016,1972-01-20,103.88,0.0,0.0,108.37,-4.14,True,1,4270,-103.88,-304623.39,443567.6,138944.21
11017,1972-01-21,103.65,-0.23,-0.22,108.37,-4.36,True,1,4271,-103.65,-304727.04,442689.15,137962.11
11018,1972-01-24,102.57,-1.08,-1.04,108.37,-5.35,True,1,4272,-102.57,-304829.61,438179.04,133349.43
11019,1972-01-25,102.7,0.13,0.13,108.37,-5.23,True,1,4273,-102.7,-304932.31,438837.1,133904.79
11020,1972-01-26,102.5,-0.2,-0.2,108.37,-5.42,True,1,4274,-102.5,-305034.81,438085.0,133050.19
11021,1972-01-27,103.5,1.0,0.98,108.37,-4.49,True,1,4275,-103.5,-305138.31,442462.5,137324.19
11022,1972-01-28,104.16,0.66,0.64,108.37,-3.88,True,1,4276,-104.16,-305242.47,445388.16,140145.69
11023,1972-01-31,103.94,-0.22,-0.21,108.37,-4.09,True,1,4277,-103.94,-305346.41,444551.38,139204.97
11024,1972-02-01,104.01,0.07,0.07,108.37,-4.02,True,1,4278,-104.01,-305450.42,444954.78,139504.36
11025,1972-02-02,104.68,0.67,0.64,108.37,-3.4,True,1,4279,-104.68,-305555.1,447925.72,142370.62
11026,1972-02-03,104.64,-0.04,-0.04,108.37,-3.44,True,1,4280,-104.64,-305659.74,447859.2,142199.46
11027,1972-02-04,104.86,0.22,0.21,108.37,-3.24,True,1,4281,-104.86,-305764.6,448905.66,143141.06
11028,1972-02-07,104.54,-0.32,-0.3,108.37,-3.53,True,1,4282,-104.54,-305869.14,447640.28,141771.14
11029,1972-02-08,104.74,0.2,0.19,108.37,-3.35,True,1,4283,-104.74,-305973.88,448601.42,142627.54
11030,1972-02-09,105.55,0.81,0.77,108.37,-2.6,True,1,4284,-105.55,-306079.43,452176.2,146096.77
11031,1972-02-10,105.59,0.04,0.04,108.37,-2.56,True,1,4285,-105.59,-306185.02,452453.15,146268.13
11032,1972-02-11,105.08,-0.51,-0.48,108.37,-3.04,True,1,4286,-105.08,-306290.1,450372.88,144082.78
11033,1972-02-14,104.59,-0.49,-0.47,108.37,-3.49,True,1,4287,-104.59,-306394.69,448377.33,141982.64
11034,1972-02-15,105.03,0.44,0.42,108.37,-3.08,True,1,4288,-105.03,-306499.72,450368.64,143868.92
11035,1972-02-16,105.62,0.59,0.56,108.37,-2.54,True,1,4289,-105.62,-306605.34,453004.18,146398.84
11036,1972-02-17,105.59,-0.03,-0.03,108.37,-2.56,True,1,4290,-105.59,-306710.93,452981.1,146270.17
11037,1972-02-18,105.28,-0.31,-0.29,108.37,-2.85,True,1,4291,-105.28,-306816.21,451756.48,144940.27
11038,1972-02-22,105.29,0.01,0.01,108.37,-2.84,True,1,4292,-105.29,-306921.5,451904.68,144983.18
11039,1972-02-23,105.38,0.09,0.08,108.37,-2.76,True,1,4293,-105.38,-307026.88,452396.34,145369.46
11040,1972-02-24,105.45,0.07,0.07,108.37,-2.69,True,1,4294,-105.45,-307132.33,452802.3,145669.97
11041,1972-02-25,106.18,0.73,0.69,108.37,-2.02,True,1,4295,-106.18,-307238.51,456043.1,148804.59
11042,1972-02-28,106.19,0.01,0.01,108.37,-2.01,True,1,4296,-106.19,-307344.7,456192.24,148847.54
11043,1972-02-29,106.57,0.38,0.36,108.37,-1.66,True,1,4297,-106.57,-307451.27,457931.29,150480.02
11044,1972-03-01,107.35,0.78,0.73,108.37,-0.94,True,1,4298,-107.35,-307558.62,461390.3,153831.68
11045,1972-03-02,107.32,-0.03,-0.03,108.37,-0.97,True,1,4299,-107.32,-307665.94,461368.68,153702.74
11046,1972-03-03,107.94,0.62,0.58,108.37,-0.4,True,1,4300,-107.94,-307773.88,464142.0,156368.12
11047,1972-03-06,108.77,0.83,0.77,108.77,0.0,True,1,4301,-108.77,-307882.65,467819.77,159937.12
11048,1972-03-07,108.87,0.1,0.09,108.87,0.0,True,1,4302,-108.87,-307991.52,468358.74,160367.22
11049,1972-03-08,108.96,0.09,0.08,108.96,0.0,True,1,4303,-108.96,-308100.48,468854.88,160754.4
11050,1972-03-09,108.94,-0.02,-0.02,108.96,-0.02,True,1,4304,-108.94,-308209.42,468877.76,160668.34
11051,1972-03-10,108.38,-0.56,-0.51,108.96,-0.53,True,1,4305,-108.38,-308317.8,466575.9,158258.1
11052,1972-03-13,107.33,-1.05,-0.97,108.96,-1.5,True,1,4306,-107.33,-308425.13,462162.98,153737.85
11053,1972-03-14,107.61,0.28,0.26,108.96,-1.24,True,1,4307,-107.61,-308532.74,463476.27,154943.53
11054,1972-03-15,107.75,0.14,0.13,108.96,-1.11,True,1,4308,-107.75,-308640.49,464187.0,155546.51
11055,1972-03-16,107.5,-0.25,-0.23,108.96,-1.34,True,1,4309,-107.5,-308747.99,463217.5,154469.51
11056,1972-03-17,107.92,0.42,0.39,108.96,-0.95,True,1,4310,-107.92,-308855.91,465135.2,156279.29
11057,1972-03-20,107.59,-0.33,-0.31,108.96,-1.26,True,1,4311,-107.59,-308963.5,463820.49,154856.99
11058,1972-03-21,106.69,-0.9,-0.84,108.96,-2.08,True,1,4312,-106.69,-309070.19,460047.28,150977.09
11059,1972-03-22,106.84,0.15,0.14,108.96,-1.95,True,1,4313,-106.84,-309177.03,460800.92,151623.89
11060,1972-03-23,107.75,0.91,0.85,108.96,-1.11,True,1,4314,-107.75,-309284.78,464833.5,155548.72
11061,1972-03-24,107.52,-0.23,-0.21,108.96,-1.32,True,1,4315,-107.52,-309392.3,463948.8,154556.5
11062,1972-03-27,107.3,-0.22,-0.2,108.96,-1.52,True,1,4316,-107.3,-309499.6,463106.8,153607.2
11063,1972-03-28,107.17,-0.13,-0.12,108.96,-1.64,True,1,4317,-107.17,-309606.77,462652.89,153046.12
11064,1972-03-29,106.49,-0.68,-0.64,108.96,-2.27,True,1,4318,-106.49,-309713.26,459823.82,150110.56
11065,1972-03-30,107.2,0.71,0.67,108.96,-1.62,True,1,4319,-107.2,-309820.46,462996.8,153176.34
11066,1972-04-03,107.48,0.28,0.26,108.96,-1.36,True,1,4320,-107.48,-309927.94,464313.6,154385.66
11067,1972-04-04,108.12,0.64,0.6,108.96,-0.77,True,1,4321,-108.12,-310036.06,467186.52,157150.46
11068,1972-04-05,109.0,0.88,0.81,109.0,0.0,True,1,4322,-109.0,-310145.06,471098.0,160952.94
11069,1972-04-06,109.53,0.53,0.49,109.53,0.0,True,1,4323,-109.53,-310254.59,473498.19,163243.6
11070,1972-04-07,109.62,0.09,0.08,109.62,0.0,True,1,4324,-109.62,-310364.21,473996.88,163632.67
11071,1972-04-10,109.45,-0.17,-0.16,109.62,-0.16,True,1,4325,-109.45,-310473.66,473371.25,162897.59
11072,1972-04-11,109.76,0.31,0.28,109.76,0.0,True,1,4326,-109.76,-310583.42,474821.76,164238.34
11073,1972-04-12,110.18,0.42,0.38,110.18,0.0,True,1,4327,-110.18,-310693.6,476748.86,166055.26
11074,1972-04-13,109.91,-0.27,-0.24,110.18,-0.24,True,1,4328,-109.91,-310803.51,475690.48,164886.97
11075,1972-04-14,109.84,-0.07,-0.06,110.18,-0.31,True,1,4329,-109.84,-310913.35,475497.36,164584.01
11076,1972-04-17,109.51,-0.33,-0.3,110.18,-0.61,True,1,4330,-109.51,-311022.86,474178.3,163155.44
11077,1972-04-18,109.77,0.26,0.24,110.18,-0.37,True,1,4331,-109.77,-311132.63,475413.87,164281.24
11078,1972-04-19,109.2,-0.57,-0.52,110.18,-0.89,True,1,4332,-109.2,-311241.83,473054.4,161812.57
11079,1972-04-20,109.04,-0.16,-0.15,110.18,-1.03,True,1,4333,-109.04,-311350.87,472470.32,161119.45
11080,1972-04-21,108.89,-0.15,-0.14,110.18,-1.17,True,1,4334,-108.89,-311459.76,471929.26,160469.5
11081,1972-04-24,108.19,-0.7,-0.64,110.18,-1.81,True,1,4335,-108.19,-311567.95,469003.65,157435.7
11082,1972-04-25,107.12,-1.07,-0.99,110.18,-2.78,True,1,4336,-107.12,-311675.07,464472.32,152797.25
11083,1972-04-26,106.89,-0.23,-0.22,110.18,-2.99,True,1,4337,-106.89,-311781.96,463581.93,151799.97
11084,1972-04-27,107.05,0.16,0.15,110.18,-2.84,True,1,4338,-107.05,-311889.01,464382.9,152493.89
11085,1972-04-28,107.67,0.62,0.58,110.18,-2.28,True,1,4339,-107.67,-311996.68,467180.13,155183.45
11086,1972-05-01,106.69,-0.98,-0.91,110.18,-3.17,True,1,4340,-106.69,-312103.37,463034.6,150931.23
11087,1972-05-02,106.08,-0.61,-0.57,110.18,-3.72,True,1,4341,-106.08,-312209.45,460493.28,148283.83
11088,1972-05-03,105.99,-0.09,-0.08,110.18,-3.8,True,1,4342,-105.99,-312315.44,460208.58,147893.14
11089,1972-05-04,106.25,0.26,0.24,110.18,-3.57,True,1,4343,-106.25,-312421.69,461443.75,149022.06
11090,1972-05-05,106.63,0.38,0.36,110.18,-3.22,True,1,4344,-106.63,-312528.32,463200.72,150672.4
11091,1972-05-08,106.14,-0.49,-0.46,110.18,-3.67,True,1,4345,-106.14,-312634.46,461178.3,148543.84
11092,1972-05-09,104.74,-1.4,-1.32,110.18,-4.94,True,1,4346,-104.74,-312739.2,455200.04,142460.84
11093,1972-05-10,105.42,0.68,0.65,110.18,-4.32,True,1,4347,-105.42,-312844.62,458260.74,145416.12
11094,1972-05-11,105.77,0.35,0.33,110.18,-4.0,True,1,4348,-105.77,-312950.39,459887.96,146937.57
11095,1972-05-12,106.38,0.61,0.58,110.18,-3.45,True,1,4349,-106.38,-313056.77,462646.62,149589.85
11096,1972-05-15,106.86,0.48,0.45,110.18,-3.01,True,1,4350,-106.86,-313163.63,464841.0,151677.37
11097,1972-05-16,106.66,-0.2,-0.19,110.18,-3.2,True,1,4351,-106.66,-313270.29,464077.66,150807.37
11098,1972-05-17,106.89,0.23,0.22,110.18,-2.99,True,1,4352,-106.89,-313377.18,465185.28,151808.1
11099,1972-05-18,107.94,1.05,0.98,110.18,-2.03,True,1,4353,-107.94,-313485.12,469862.82,156377.7
11100,1972-05-19,108.98,1.04,0.96,110.18,-1.09,True,1,4354,-108.98,-313594.1,474498.92,160904.82
11101,1972-05-22,109.69,0.71,0.65,110.18,-0.44,True,1,4355,-109.69,-313703.79,477699.95,163996.16
11102,1972-05-23,109.78,0.09,0.08,110.18,-0.36,True,1,4356,-109.78,-313813.57,478201.68,164388.11
11103,1972-05-24,110.31,0.53,0.48,110.31,0.0,True,1,4357,-110.31,-313923.88,480620.67,166696.79
11104,1972-05-25,110.46,0.15,0.14,110.46,0.0,True,1,4358,-110.46,-314034.34,481384.68,167350.34
11105,1972-05-26,110.66,0.2,0.18,110.66,0.0,True,1,4359,-110.66,-314145.0,482366.94,168221.94
11106,1972-05-30,110.35,-0.31,-0.28,110.66,-0.28,True,1,4360,-110.35,-314255.35,481126.0,166870.65
11107,1972-05-31,109.53,-0.82,-0.74,110.66,-1.02,True,1,4361,-109.53,-314364.88,477660.33,163295.45
11108,1972-06-01,109.69,0.16,0.15,110.66,-0.88,True,1,4362,-109.69,-314474.57,478467.78,163993.21
11109,1972-06-02,109.73,0.04,0.04,110.66,-0.84,True,1,4363,-109.73,-314584.3,478751.99,164167.69
11110,1972-06-05,108.82,-0.91,-0.83,110.66,-1.66,True,1,4364,-108.82,-314693.12,474890.48,160197.36
11111,1972-06-06,108.21,-0.61,-0.56,110.66,-2.21,True,1,4365,-108.21,-314801.33,472336.65,157535.32
11112,1972-06-07,107.65,-0.56,-0.52,110.66,-2.72,True,1,4366,-107.65,-314908.98,469999.9,155090.92
11113,1972-06-08,107.28,-0.37,-0.34,110.66,-3.05,True,1,4367,-107.28,-315016.26,468491.76,153475.5
11114,1972-06-09,106.86,-0.42,-0.39,110.66,-3.43,True,1,4368,-106.86,-315123.12,466764.48,151641.36
11115,1972-06-12,107.01,0.15,0.14,110.66,-3.3,True,1,4369,-107.01,-315230.13,467526.69,152296.56
11116,1972-06-13,107.55,0.54,0.5,110.66,-2.81,True,1,4370,-107.55,-315337.68,469993.5,154655.82
11117,1972-06-14,108.39,0.84,0.78,110.66,-2.05,True,1,4371,-108.39,-315446.07,473772.69,158326.62
11118,1972-06-15,108.44,0.05,0.05,110.66,-2.01,True,1,4372,-108.44,-315554.51,474099.68,158545.17
11119,1972-06-16,108.36,-0.08,-0.07,110.66,-2.08,True,1,4373,-108.36,-315662.87,473858.28,158195.41
11120,1972-06-19,108.11,-0.25,-0.23,110.66,-2.3,True,1,4374,-108.11,-315770.98,472873.14,157102.16
11121,1972-06-20,108.56,0.45,0.42,110.66,-1.9,True,1,4375,-108.56,-315879.54,474950.0,159070.46
11122,1972-06-21,108.79,0.23,0.21,110.66,-1.69,True,1,4376,-108.79,-315988.33,476065.04,160076.71
11123,1972-06-22,108.68,-0.11,-0.1,110.66,-1.79,True,1,4377,-108.68,-316097.01,475692.36,159595.35
11124,1972-06-23,108.27,-0.41,-0.38,110.66,-2.16,True,1,4378,-108.27,-316205.28,474006.06,157800.78
11125,1972-06-26,107.48,-0.79,-0.73,110.66,-2.87,True,1,4379,-107.48,-316312.76,470654.92,154342.16
11126,1972-06-27,107.37,-0.11,-0.1,110.66,-2.97,True,1,4380,-107.37,-316420.13,470280.6,153860.47
11127,1972-06-28,107.02,-0.35,-0.33,110.66,-3.29,True,1,4381,-107.02,-316527.15,468854.62,152327.47
11128,1972-06-29,106.82,-0.2,-0.19,110.66,-3.47,True,1,4382,-106.82,-316633.97,468085.24,151451.27
11129,1972-06-30,107.14,0.32,0.3,110.66,-3.18,True,1,4383,-107.14,-316741.11,469594.62,152853.51
11130,1972-07-03,107.49,0.35,0.33,110.66,-2.86,True,1,4384,-107.49,-316848.6,471236.16,154387.56
11131,1972-07-05,108.1,0.61,0.57,110.66,-2.31,True,1,4385,-108.1,-316956.7,474018.5,157061.8
11132,1972-07-06,109.04,0.94,0.87,110.66,-1.46,True,1,4386,-109.04,-317065.74,478249.44,161183.7
11133,1972-07-07,108.69,-0.35,-0.32,110.66,-1.78,True,1,4387,-108.69,-317174.43,476823.03,159648.6
11134,1972-07-10,108.11,-0.58,-0.53,110.66,-2.3,True,1,4388,-108.11,-317282.54,474386.68,157104.14
11135,1972-07-11,107.32,-0.79,-0.73,110.66,-3.02,True,1,4389,-107.32,-317389.86,471027.48,153637.62
11136,1972-07-12,106.89,-0.43,-0.4,110.66,-3.41,True,1,4390,-106.89,-317496.75,469247.1,151750.35
11137,1972-07-13,106.28,-0.61,-0.57,110.66,-3.96,True,1,4391,-106.28,-317603.03,466675.48,149072.45
11138,1972-07-14,106.8,0.52,0.49,110.66,-3.49,True,1,4392,-106.8,-317709.83,469065.6,151355.77
11139,1972-07-17,105.88,-0.92,-0.86,110.66,-4.32,True,1,4393,-105.88,-317815.71,465130.84,147315.13
11140,1972-07-18,105.83,-0.05,-0.05,110.66,-4.36,True,1,4394,-105.83,-317921.54,465017.02,147095.48
11141,1972-07-19,106.14,0.31,0.29,110.66,-4.08,True,1,4395,-106.14,-318027.68,466485.3,148457.62
11142,1972-07-20,105.81,-0.33,-0.31,110.66,-4.38,True,1,4396,-105.81,-318133.49,465140.76,147007.27
11143,1972-07-21,106.66,0.85,0.8,110.66,-3.62,True,1,4397,-106.66,-318240.15,468984.02,150743.87
11144,1972-07-24,107.92,1.26,1.18,110.66,-2.48,True,1,4398,-107.92,-318348.07,474632.16,156284.09
11145,1972-07-25,107.6,-0.32,-0.3,110.66,-2.76,True,1,4399,-107.6,-318455.67,473332.4,154876.73
11146,1972-07-26,107.53,-0.07,-0.06,110.66,-2.83,True,1,4400,-107.53,-318563.2,473132.0,154568.8
11147,1972-07-27,107.28,-0.25,-0.23,110.66,-3.05,True,1,4401,-107.28,-318670.48,472139.28,153468.8
11148,1972-07-28,107.38,0.1,0.09,110.66,-2.96,True,1,4402,-107.38,-318777.86,472686.76,153908.9
11149,1972-07-31,107.39,0.01,0.01,110.66,-2.96,True,1,4403,-107.39,-318885.25,472838.17,153952.92
11150,1972-08-01,108.4,1.01,0.94,110.66,-2.04,True,1,4404,-108.4,-318993.65,477393.6,158399.95
11151,1972-08-02,109.29,0.89,0.82,110.66,-1.24,True,1,4405,-109.29,-319102.94,481422.45,162319.51
11152,1972-08-03,110.14,0.85,0.78,110.66,-0.47,True,1,4406,-110.14,-319213.08,485276.84,166063.76
11153,1972-08-04,110.43,0.29,0.26,110.66,-0.21,True,1,4407,-110.43,-319323.51,486665.01,167341.5
11154,1972-08-07,110.61,0.18,0.16,110.66,-0.04,True,1,4408,-110.61,-319434.12,487568.88,168134.76
11155,1972-08-08,110.69,0.08,0.07,110.69,0.0,True,1,4409,-110.69,-319544.81,488032.21,168487.4
11156,1972-08-09,110.86,0.17,0.15,110.86,0.0,True,1,4410,-110.86,-319655.67,488892.6,169236.93
11157,1972-08-10,111.05,0.19,0.17,111.05,0.0,True,1,4411,-111.05,-319766.72,489841.55,170074.83
11158,1972-08-11,111.95,0.9,0.81,111.95,0.0,True,1,4412,-111.95,-319878.67,493923.4,174044.73
11159,1972-08-14,112.55,0.6,0.54,112.55,0.0,True,1,4413,-112.55,-319991.22,496683.15,176691.93
11160,1972-08-15,112.06,-0.49,-0.44,112.55,-0.44,True,1,4414,-112.06,-320103.28,494632.84,174529.56
11161,1972-08-16,111.66,-0.4,-0.36,112.55,-0.79,True,1,4415,-111.66,-320214.94,492978.9,172763.96
11162,1972-08-17,111.34,-0.32,-0.29,112.55,-1.08,True,1,4416,-111.34,-320326.28,491677.44,171351.16
11163,1972-08-18,111.76,0.42,0.38,112.55,-0.7,True,1,4417,-111.76,-320438.04,493643.92,173205.88
11164,1972-08-21,111.72,-0.04,-0.04,112.55,-0.74,True,1,4418,-111.72,-320549.76,493578.96,173029.2
11165,1972-08-22,112.41,0.69,0.62,112.55,-0.12,True,1,4419,-112.41,-320662.17,496739.79,176077.62
11166,1972-08-23,112.26,-0.15,-0.13,112.55,-0.26,True,1,4420,-112.26,-320774.43,496189.2,175414.77
11167,1972-08-24,111.02,-1.24,-1.1,112.55,-1.36,True,1,4421,-111.02,-320885.45,490819.42,169933.97
11168,1972-08-25,110.67,-0.35,-0.32,112.55,-1.67,True,1,4422,-110.67,-320996.12,489382.74,168386.62
11169,1972-08-28,110.23,-0.44,-0.4,112.55,-2.06,True,1,4423,-110.23,-321106.35,487547.29,166440.94
11170,1972-08-29,110.41,0.18,0.16,112.55,-1.9,True,1,4424,-110.41,-321216.76,488453.84,167237.08
11171,1972-08-30,110.57,0.16,0.14,112.55,-1.76,True,1,4425,-110.57,-321327.33,489272.25,167944.92
11172,1972-08-31,111.09,0.52,0.47,112.55,-1.3,True,1,4426,-111.09,-321438.42,491684.34,170245.92
11173,1972-09-01,111.51,0.42,0.38,112.55,-0.92,True,1,4427,-111.51,-321549.93,493654.77,172104.84
11174,1972-09-05,111.23,-0.28,-0.25,112.55,-1.17,True,1,4428,-111.23,-321661.16,492526.44,170865.28
11175,1972-09-06,110.55,-0.68,-0.61,112.55,-1.78,True,1,4429,-110.55,-321771.71,489625.95,167854.24
11176,1972-09-07,110.29,-0.26,-0.24,112.55,-2.01,True,1,4430,-110.29,-321882.0,488584.7,166702.7
11177,1972-09-08,110.15,-0.14,-0.13,112.55,-2.13,True,1,4431,-110.15,-321992.15,488074.65,166082.5
11178,1972-09-11,109.51,-0.64,-0.58,112.55,-2.7,True,1,4432,-109.51,-322101.66,485348.32,163246.66
11179,1972-09-12,108.47,-1.04,-0.95,112.55,-3.62,True,1,4433,-108.47,-322210.13,480847.51,158637.38
11180,1972-09-13,108.9,0.43,0.4,112.55,-3.24,True,1,4434,-108.9,-322319.03,482862.6,160543.57
11181,1972-09-14,108.93,0.03,0.03,112.55,-3.22,True,1,4435,-108.93,-322427.96,483104.55,160676.59
11182,1972-09-15,108.81,-0.12,-0.11,112.55,-3.32,True,1,4436,-108.81,-322536.77,482681.16,160144.39
11183,1972-09-18,108.61,-0.2,-0.18,112.55,-3.5,True,1,4437,-108.61,-322645.38,481902.57,159257.19
11184,1972-09-19,108.55,-0.06,-0.06,112.55,-3.55,True,1,4438,-108.55,-322753.93,481744.9,158990.97
11185,1972-09-20,108.6,0.05,0.05,112.55,-3.51,True,1,4439,-108.6,-322862.53,482075.4,159212.87
11186,1972-09-21,108.43,-0.17,-0.16,112.55,-3.66,True,1,4440,-108.43,-322970.96,481429.2,158458.24
11187,1972-09-22,108.52,0.09,0.08,112.55,-3.58,True,1,4441,-108.52,-323079.48,481937.32,158857.84
11188,1972-09-25,108.05,-0.47,-0.43,112.55,-4.0,True,1,4442,-108.05,-323187.53,479958.1,156770.57
11189,1972-09-26,108.12,0.07,0.06,112.55,-3.94,True,1,4443,-108.12,-323295.65,480377.16,157081.51
11190,1972-09-27,109.66,1.54,1.42,112.55,-2.57,True,1,4444,-109.66,-323405.31,487329.04,163923.73
11191,1972-09-28,110.35,0.69,0.63,112.55,-1.96,True,1,4445,-110.35,-323515.66,490505.75,166990.09
11192,1972-09-29,110.55,0.2,0.18,112.55,-1.78,True,1,4446,-110.55,-323626.21,491505.3,167879.09
11193,1972-10-02,110.16,-0.39,-0.35,112.55,-2.12,True,1,4447,-110.16,-323736.37,489881.52,166145.15
11194,1972-10-03,110.3,0.14,0.13,112.55,-2.0,True,1,4448,-110.3,-323846.67,490614.4,166767.73
11195,1972-10-04,110.09,-0.21,-0.19,112.55,-2.19,True,1,4449,-110.09,-323956.76,489790.41,165833.65
11196,1972-10-05,108.89,-1.2,-1.09,112.55,-3.25,True,1,4450,-108.89,-324065.65,484560.5,160494.85
11197,1972-10-06,109.62,0.73,0.67,112.55,-2.6,True,1,4451,-109.62,-324175.27,487918.62,163743.35
11198,1972-10-09,109.9,0.28,0.26,112.55,-2.36,True,1,4452,-109.9,-324285.17,489274.8,164989.63
11199,1972-10-10,109.99,0.09,0.08,112.55,-2.28,True,1,4453,-109.99,-324395.16,489785.47,165390.31
11200,1972-10-11,109.5,-0.49,-0.44,112.55,-2.71,True,1,4454,-109.5,-324504.66,487713.0,163208.34
11201,1972-10-12,108.6,-0.9,-0.82,112.55,-3.51,True,1,4455,-108.6,-324613.26,483813.0,159199.74
11202,1972-10-13,107.92,-0.68,-0.63,112.55,-4.11,True,1,4456,-107.92,-324721.18,480891.52,156170.34
11203,1972-10-16,106.77,-1.15,-1.07,112.55,-5.14,True,1,4457,-106.77,-324827.95,475873.89,151045.94
11204,1972-10-17,107.5,0.73,0.68,112.55,-4.49,True,1,4458,-107.5,-324935.45,479235.0,154299.55
11205,1972-10-18,108.19,0.69,0.64,112.55,-3.87,True,1,4459,-108.19,-325043.64,482419.21,157375.57
11206,1972-10-19,108.05,-0.14,-0.13,112.55,-4.0,True,1,4460,-108.05,-325151.69,481903.0,156751.31
11207,1972-10-20,109.24,1.19,1.1,112.55,-2.94,True,1,4461,-109.24,-325260.93,487319.64,162058.71
11208,1972-10-23,110.35,1.11,1.02,112.55,-1.96,True,1,4462,-110.35,-325371.28,492381.7,167010.42
11209,1972-10-24,110.81,0.46,0.42,112.55,-1.55,True,1,4463,-110.81,-325482.09,494545.03,169062.94
11210,1972-10-25,110.72,-0.09,-0.08,112.55,-1.63,True,1,4464,-110.72,-325592.81,494254.08,168661.27
11211,1972-10-26,110.99,0.27,0.24,112.55,-1.39,True,1,4465,-110.99,-325703.8,495570.35,169866.55
11212,1972-10-27,110.62,-0.37,-0.33,112.55,-1.72,True,1,4466,-110.62,-325814.42,494028.92,168214.5
11213,1972-10-30,110.59,-0.03,-0.03,112.55,-1.74,True,1,4467,-110.59,-325925.01,494005.53,168080.52
11214,1972-10-31,111.58,0.99,0.9,112.55,-0.86,True,1,4468,-111.58,-326036.59,498539.44,172502.85
11215,1972-11-01,112.67,1.09,0.98,112.67,0.0,True,1,4469,-112.67,-326149.26,503522.23,177372.97
11216,1972-11-02,113.23,0.56,0.5,113.23,0.0,True,1,4470,-113.23,-326262.49,506138.1,179875.61
11217,1972-11-03,114.22,0.99,0.87,114.22,0.0,True,1,4471,-114.22,-326376.71,510677.62,184300.91
11218,1972-11-06,113.98,-0.24,-0.21,114.22,-0.21,True,1,4472,-113.98,-326490.69,509718.56,183227.87
11219,1972-11-08,113.35,-0.63,-0.55,114.22,-0.76,True,1,4473,-113.35,-326604.04,507014.55,180410.51
11220,1972-11-09,113.5,0.15,0.13,114.22,-0.63,True,1,4474,-113.5,-326717.54,507799.0,181081.46
11221,1972-11-10,113.73,0.23,0.2,114.22,-0.43,True,1,4475,-113.73,-326831.27,508941.75,182110.48
11222,1972-11-13,113.9,0.17,0.15,114.22,-0.28,True,1,4476,-113.9,-326945.17,509816.4,182871.23
11223,1972-11-14,114.95,1.05,0.92,114.95,0.0,True,1,4477,-114.95,-327060.12,514631.15,187571.03
11224,1972-11-15,114.5,-0.45,-0.39,114.95,-0.39,True,1,4478,-114.5,-327174.62,512731.0,185556.38
11225,1972-11-16,115.13,0.63,0.55,115.13,0.0,True,1,4479,-115.13,-327289.75,515667.27,188377.52
11226,1972-11-17,115.49,0.36,0.31,115.49,0.0,True,1,4480,-115.49,-327405.24,517395.2,189989.96
11227,1972-11-20,115.53,0.04,0.04,115.53,0.0,True,1,4481,-115.53,-327520.77,517689.93,190169.16
11228,1972-11-21,116.21,0.68,0.59,116.21,0.0,True,1,4482,-116.21,-327636.98,520853.22,193216.24
11229,1972-11-22,116.9,0.69,0.59,116.9,0.0,True,1,4483,-116.9,-327753.88,524062.7,196308.82
11230,1972-11-24,117.27,0.37,0.32,117.27,0.0,True,1,4484,-117.27,-327871.15,525838.68,197967.53
11231,1972-11-27,116.72,-0.55,-0.47,117.27,-0.47,True,1,4485,-116.72,-327987.87,523489.2,195501.33
11232,1972-11-28,116.47,-0.25,-0.21,117.27,-0.68,True,1,4486,-116.47,-328104.34,522484.42,194380.08
11233,1972-11-29,116.52,0.05,0.04,117.27,-0.64,True,1,4487,-116.52,-328220.86,522825.24,194604.38
11234,1972-11-30,116.67,0.15,0.13,117.27,-0.51,True,1,4488,-116.67,-328337.53,523614.96,195277.43
11235,1972-12-01,117.38,0.71,0.61,117.38,0.0,True,1,4489,-117.38,-328454.91,526918.82,198463.91
11236,1972-12-04,117.77,0.39,0.33,117.77,0.0,True,1,4490,-117.77,-328572.68,528787.3,200214.62
11237,1972-12-05,117.58,-0.19,-0.16,117.77,-0.16,True,1,4491,-117.58,-328690.26,528051.78,199361.52
11238,1972-12-06,118.01,0.43,0.37,118.01,0.0,True,1,4492,-118.01,-328808.27,530100.92,201292.65
11239,1972-12-07,118.6,0.59,0.5,118.6,0.0,True,1,4493,-118.6,-328926.87,532869.8,203942.93
11240,1972-12-08,118.86,0.26,0.22,118.86,0.0,True,1,4494,-118.86,-329045.73,534156.84,205111.11
11241,1972-12-11,119.12,0.26,0.22,119.12,0.0,True,1,4495,-119.12,-329164.85,535444.4,206279.55
11242,1972-12-12,118.66,-0.46,-0.39,119.12,-0.39,True,1,4496,-118.66,-329283.51,533495.36,204211.85
11243,1972-12-13,118.56,-0.1,-0.08,119.12,-0.47,True,1,4497,-118.56,-329402.07,533164.32,203762.25
11244,1972-12-14,118.24,-0.32,-0.27,119.12,-0.74,True,1,4498,-118.24,-329520.31,531843.52,202323.21
11245,1972-12-15,118.26,0.02,0.02,119.12,-0.72,True,1,4499,-118.26,-329638.57,532051.74,202413.17
11246,1972-12-18,116.9,-1.36,-1.15,119.12,-1.86,True,1,4500,-116.9,-329755.47,526050.0,196294.53
11247,1972-12-19,116.34,-0.56,-0.48,119.12,-2.33,True,1,4501,-116.34,-329871.81,523646.34,193774.53
11248,1972-12-20,115.95,-0.39,-0.34,119.12,-2.66,True,1,4502,-115.95,-329987.76,522006.9,192019.14
11249,1972-12-21,115.11,-0.84,-0.72,119.12,-3.37,True,1,4503,-115.11,-330102.87,518340.33,188237.46
11250,1972-12-22,115.83,0.72,0.62,119.12,-2.76,True,1,4504,-115.83,-330218.7,521698.32,191479.62
11251,1972-12-26,116.3,0.47,0.41,119.12,-2.37,True,1,4505,-116.3,-330335.0,523931.5,193596.5
11252,1972-12-27,116.93,0.63,0.54,119.12,-1.84,True,1,4506,-116.93,-330451.93,526886.58,196434.65
11253,1972-12-29,118.05,1.12,0.96,119.12,-0.9,True,1,4507,-118.05,-330569.98,532051.35,201481.37
11254,1973-01-02,119.1,1.05,0.89,119.12,-0.02,True,1,4508,-119.1,-330689.08,536902.8,206213.72
11255,1973-01-03,119.57,0.47,0.4,119.57,0.0,True,1,4509,-119.57,-330808.65,539141.13,208332.48
11256,1973-01-04,119.4,-0.17,-0.14,119.57,-0.14,True,1,4510,-119.4,-330928.05,538494.0,207565.95
11257,1973-01-05,119.87,0.47,0.39,119.87,0.0,True,1,4511,-119.87,-331047.92,540733.57,209685.65
11258,1973-01-08,119.85,-0.02,-0.02,119.87,-0.02,True,1,4512,-119.85,-331167.77,540763.2,209595.43
11259,1973-01-09,119.73,-0.12,-0.1,119.87,-0.12,True,1,4513,-119.73,-331287.5,540341.49,209053.99
11260,1973-01-10,119.43,-0.3,-0.25,119.87,-0.37,True,1,4514,-119.43,-331406.93,539107.02,207700.09
11261,1973-01-11,120.24,0.81,0.68,120.24,0.0,True,1,4515,-120.24,-331527.17,542883.6,211356.43
11262,1973-01-12,119.3,-0.94,-0.78,120.24,-0.78,True,1,4516,-119.3,-331646.47,538758.8,207112.33
11263,1973-01-15,118.44,-0.86,-0.72,120.24,-1.5,True,1,4517,-118.44,-331764.91,534993.48,203228.57
11264,1973-01-16,118.14,-0.3,-0.25,120.24,-1.75,True,1,4518,-118.14,-331883.05,533756.52,201873.47
11265,1973-01-17,118.68,0.54,0.46,120.24,-1.3,True,1,4519,-118.68,-332001.73,536314.92,204313.19
11266,1973-01-18,118.85,0.17,0.14,120.24,-1.16,True,1,4520,-118.85,-332120.58,537202.0,205081.42
11267,1973-01-19,118.78,-0.07,-0.06,120.24,-1.21,True,1,4521,-118.78,-332239.36,537004.38,204765.02
11268,1973-01-22,118.21,-0.57,-0.48,120.24,-1.69,True,1,4522,-118.21,-332357.57,534545.62,202188.05
11269,1973-01-23,118.22,0.01,0.01,120.24,-1.68,True,1,4523,-118.22,-332475.79,534709.06,202233.27
11270,1973-01-24,116.73,-1.49,-1.26,120.24,-2.92,True,1,4524,-116.73,-332592.52,528086.52,195494.0
11271,1973-01-26,116.45,-0.28,-0.24,120.24,-3.15,True,1,4525,-116.45,-332708.97,526936.25,194227.28
11272,1973-01-29,116.01,-0.44,-0.38,120.24,-3.52,True,1,4526,-116.01,-332824.98,525061.26,192236.28
11273,1973-01-30,115.83,-0.18,-0.16,120.24,-3.67,True,1,4527,-115.83,-332940.81,524362.41,191421.6
11274,1973-01-31,116.03,0.2,0.17,120.24,-3.5,True,1,4528,-116.03,-333056.84,525383.84,192327.0
11275,1973-02-01,114.76,-1.27,-1.1,120.24,-4.56,True,1,4529,-114.76,-333171.6,519748.04,186576.44
11276,1973-02-02,114.35,-0.41,-0.36,120.24,-4.9,True,1,4530,-114.35,-333285.95,518005.5,184719.55
11277,1973-02-05,114.23,-0.12,-0.1,120.24,-5.0,True,1,4531,-114.23,-333400.18,517576.13,184175.95
11278,1973-02-06,114.45,0.22,0.19,120.24,-4.82,True,1,4532,-114.45,-333514.63,518687.4,185172.77
11279,1973-02-07,113.66,-0.79,-0.69,120.24,-5.47,True,1,4533,-113.66,-333628.29,515220.78,181592.49
11280,1973-02-08,113.16,-0.5,-0.44,120.24,-5.89,True,1,4534,-113.16,-333741.45,513067.44,179325.99
11281,1973-02-09,114.68,1.52,1.34,120.24,-4.62,True,1,4535,-114.68,-333856.13,520073.8,186217.67
11282,1973-02-12,116.06,1.38,1.2,120.24,-3.48,True,1,4536,-116.06,-333972.19,526448.16,192475.97
11283,1973-02-13,116.78,0.72,0.62,120.24,-2.88,True,1,4537,-116.78,-334088.97,529830.86,195741.89
11284,1973-02-14,115.1,-1.68,-1.44,120.24,-4.28,True,1,4538,-115.1,-334204.07,522323.8,188119.73
11285,1973-02-15,114.45,-0.65,-0.56,120.24,-4.82,True,1,4539,-114.45,-334318.52,519488.55,185170.03
11286,1973-02-16,114.98,0.53,0.46,120.24,-4.38,True,1,4540,-114.98,-334433.5,522009.2,187575.7
11287,1973-02-20,115.4,0.42,0.36,120.24,-4.03,True,1,4541,-115.4,-334548.9,524031.4,189482.5
11288,1973-02-21,114.69,-0.71,-0.62,120.24,-4.62,True,1,4542,-114.69,-334663.59,520921.98,186258.39
11289,1973-02-22,114.44,-0.25,-0.22,120.24,-4.82,True,1,4543,-114.44,-334778.03,519900.92,185122.89
11290,1973-02-23,113.16,-1.28,-1.12,120.24,-5.89,True,1,4544,-113.16,-334891.19,514199.04,179307.85
11291,1973-02-26,112.19,-0.97,-0.86,120.24,-6.7,True,1,4545,-112.19,-335003.38,509903.55,174900.17
11292,1973-02-27,110.9,-1.29,-1.15,120.24,-7.77,True,1,4546,-110.9,-335114.28,504151.4,169037.12
11293,1973-02-28,111.68,0.78,0.7,120.24,-7.12,True,1,4547,-111.68,-335225.96,507808.96,172583.0
11294,1973-03-01,111.05,-0.63,-0.56,120.24,-7.64,True,1,4548,-111.05,-335337.01,505055.4,169718.39
11295,1973-03-02,112.28,1.23,1.11,120.24,-6.62,True,1,4549,-112.28,-335449.29,510761.72,175312.43
11296,1973-03-05,112.68,0.4,0.36,120.24,-6.29,True,1,4550,-112.68,-335561.97,512694.0,177132.03
11297,1973-03-06,114.1,1.42,1.26,120.24,-5.11,True,1,4551,-114.1,-335676.07,519269.1,183593.03
11298,1973-03-07,114.45,0.35,0.31,120.24,-4.82,True,1,4552,-114.45,-335790.52,520976.4,185185.88
11299,1973-03-08,114.23,-0.22,-0.19,120.24,-5.0,True,1,4553,-114.23,-335904.75,520089.19,184184.44
11300,1973-03-09,113.79,-0.44,-0.38,120.24,-5.36,True,1,4554,-113.79,-336018.54,518199.66,182181.12
11301,1973-03-12,113.86,0.07,0.06,120.24,-5.31,True,1,4555,-113.86,-336132.4,518632.3,182499.9
11302,1973-03-13,114.48,0.62,0.55,120.24,-4.79,True,1,4556,-114.48,-336246.88,521570.88,185324.0
11303,1973-03-14,114.98,0.5,0.44,120.24,-4.38,True,1,4557,-114.98,-336361.86,523963.86,187602.0
11304,1973-03-15,114.12,-0.86,-0.75,120.24,-5.09,True,1,4558,-114.12,-336475.98,520158.96,183682.98
11305,1973-03-16,113.54,-0.58,-0.51,120.24,-5.57,True,1,4559,-113.54,-336589.52,517628.86,181039.34
11306,1973-03-19,112.17,-1.37,-1.21,120.24,-6.71,True,1,4560,-112.17,-336701.69,511495.2,174793.51
11307,1973-03-20,111.95,-0.22,-0.2,120.24,-6.9,True,1,4561,-111.95,-336813.64,510603.95,173790.31
11308,1973-03-21,110.49,-1.46,-1.3,120.24,-8.11,True,1,4562,-110.49,-336924.13,504055.38,167131.25
11309,1973-03-22,108.84,-1.65,-1.49,120.24,-9.48,True,1,4563,-108.84,-337032.97,496636.92,159603.95
11310,1973-03-23,108.88,0.04,0.04,120.24,-9.45,True,1,4564,-108.88,-337141.85,496928.32,159786.47
11311,1973-03-26,109.84,0.96,0.88,120.24,-8.65,True,1,4565,-109.84,-337251.69,501419.6,164167.91
11312,1973-03-27,111.56,1.72,1.57,120.24,-7.22,True,1,4566,-111.56,-337363.25,509382.96,172019.71
11313,1973-03-28,111.62,0.06,0.05,120.24,-7.17,True,1,4567,-111.62,-337474.87,509768.54,172293.67
11314,1973-03-29,112.71,1.09,0.98,120.24,-6.26,True,1,4568,-112.71,-337587.58,514859.28,177271.7
11315,1973-03-30,111.52,-1.19,-1.06,120.24,-7.25,True,1,4569,-111.52,-337699.1,509534.88,171835.78
11316,1973-04-02,110.18,-1.34,-1.2,120.24,-8.37,True,1,4570,-110.18,-337809.28,503522.6,165713.32
11317,1973-04-03,109.24,-0.94,-0.85,120.24,-9.15,True,1,4571,-109.24,-337918.52,499336.04,161417.52
11318,1973-04-04,108.77,-0.47,-0.43,120.24,-9.54,True,1,4572,-108.77,-338027.29,497296.44,159269.15
11319,1973-04-05,108.52,-0.25,-0.23,120.24,-9.75,True,1,4573,-108.52,-338135.81,496261.96,158126.15
11320,1973-04-06,109.28,0.76,0.7,120.24,-9.12,True,1,4574,-109.28,-338245.09,499846.72,161601.63
11321,1973-04-09,110.86,1.58,1.45,120.24,-7.8,True,1,4575,-110.86,-338355.95,507184.5,168828.55
11322,1973-04-10,112.21,1.35,1.22,120.24,-6.68,True,1,4576,-112.21,-338468.16,513472.96,175004.8
11323,1973-04-11,112.68,0.47,0.42,120.24,-6.29,True,1,4577,-112.68,-338580.84,515736.36,177155.52
11324,1973-04-12,112.58,-0.1,-0.09,120.24,-6.37,True,1,4578,-112.58,-338693.42,515391.24,176697.82
11325,1973-04-13,112.08,-0.5,-0.44,120.24,-6.79,True,1,4579,-112.08,-338805.5,513214.32,174408.82
11326,1973-04-16,111.44,-0.64,-0.57,120.24,-7.32,True,1,4580,-111.44,-338916.94,510395.2,171478.26
11327,1973-04-17,110.94,-0.5,-0.45,120.24,-7.74,True,1,4581,-110.94,-339027.88,508216.14,169188.26
11328,1973-04-18,111.54,0.6,0.54,120.24,-7.24,True,1,4582,-111.54,-339139.42,511076.28,171936.86
11329,1973-04-19,112.17,0.63,0.56,120.24,-6.71,True,1,4583,-112.17,-339251.59,514075.11,174823.52
11330,1973-04-23,111.57,-0.6,-0.54,120.24,-7.21,True,1,4584,-111.57,-339363.16,511436.88,172073.72
11331,1973-04-24,109.99,-1.58,-1.42,120.24,-8.52,True,1,4585,-109.99,-339473.15,504304.15,164831.0
11332,1973-04-25,108.34,-1.65,-1.5,120.24,-9.9,True,1,4586,-108.34,-339581.49,496847.24,157265.75
11333,1973-04-26,108.89,0.55,0.51,120.24,-9.44,True,1,4587,-108.89,-339690.38,499478.43,159788.05
11334,1973-04-27,107.23,-1.66,-1.52,120.24,-10.82,True,1,4588,-107.23,-339797.61,491971.24,152173.63
11335,1973-04-30,106.97,-0.26,-0.24,120.24,-11.04,True,1,4589,-106.97,-339904.58,490885.33,150980.75
11336,1973-05-01,107.1,0.13,0.12,120.24,-10.93,True,1,4590,-107.1,-340011.68,491589.0,151577.32
11337,1973-05-02,108.43,1.33,1.24,120.24,-9.82,True,1,4591,-108.43,-340120.11,497802.13,157682.02
11338,1973-05-03,110.22,1.79,1.65,120.24,-8.33,True,1,4592,-110.22,-340230.33,506130.24,165899.91
11339,1973-05-04,111.0,0.78,0.71,120.24,-7.68,True,1,4593,-111.0,-340341.33,509823.0,169481.67
11340,1973-05-07,110.53,-0.47,-0.42,120.24,-8.08,True,1,4594,-110.53,-340451.86,507774.82,167322.96
11341,1973-05-08,111.25,0.72,0.65,120.24,-7.48,True,1,4595,-111.25,-340563.11,511193.75,170630.64
11342,1973-05-09,110.44,-0.81,-0.73,120.24,-8.15,True,1,4596,-110.44,-340673.55,507582.24,166908.69
11343,1973-05-10,109.54,-0.9,-0.82,120.24,-8.9,True,1,4597,-109.54,-340783.09,503555.38,162772.29
11344,1973-05-11,108.17,-1.37,-1.25,120.24,-10.04,True,1,4598,-108.17,-340891.26,497365.66,156474.4
11345,1973-05-14,105.9,-2.27,-2.1,120.24,-11.93,True,1,4599,-105.9,-340997.16,487034.1,146036.94
11346,1973-05-15,106.57,0.67,0.63,120.24,-11.37,True,1,4600,-106.57,-341103.73,490222.0,149118.27
11347,1973-05-16,106.43,-0.14,-0.13,120.24,-11.48,True,1,4601,-106.43,-341210.16,489684.43,148474.27
11348,1973-05-17,105.56,-0.87,-0.82,120.24,-12.21,True,1,4602,-105.56,-341315.72,485787.12,144471.4
11349,1973-05-18,103.86,-1.7,-1.61,120.24,-13.62,True,1,4603,-103.86,-341419.58,478067.58,136648.0
11350,1973-05-21,102.73,-1.13,-1.09,120.24,-14.56,True,1,4604,-102.73,-341522.31,472968.92,131446.61
11351,1973-05-22,103.58,0.85,0.83,120.24,-13.86,True,1,4605,-103.58,-341625.89,476985.9,135360.01
11352,1973-05-23,104.07,0.49,0.47,120.24,-13.45,True,1,4606,-104.07,-341729.96,479346.42,137616.46
11353,1973-05-24,107.14,3.07,2.95,120.24,-10.9,True,1,4607,-107.14,-341837.1,493593.98,151756.88
11354,1973-05-25,107.94,0.8,0.75,120.24,-10.23,True,1,4608,-107.94,-341945.04,497387.52,155442.48
11355,1973-05-29,107.51,-0.43,-0.4,120.24,-10.59,True,1,4609,-107.51,-342052.55,495513.59,153461.04
11356,1973-05-30,105.91,-1.6,-1.49,120.24,-11.92,True,1,4610,-105.91,-342158.46,488245.1,146086.64
11357,1973-05-31,104.95,-0.96,-0.91,120.24,-12.72,True,1,4611,-104.95,-342263.41,483924.45,141661.04
11358,1973-06-01,103.93,-1.02,-0.97,120.24,-13.56,True,1,4612,-103.93,-342367.34,479325.16,136957.82
11359,1973-06-04,102.97,-0.96,-0.92,120.24,-14.36,True,1,4613,-102.97,-342470.31,475000.61,132530.3
11360,1973-06-05,104.62,1.65,1.6,120.24,-12.99,True,1,4614,-104.62,-342574.93,482716.68,140141.75
11361,1973-06-06,104.31,-0.31,-0.3,120.24,-13.25,True,1,4615,-104.31,-342679.24,481390.65,138711.41
11362,1973-06-07,105.84,1.53,1.47,120.24,-11.98,True,1,4616,-105.84,-342785.08,488557.44,145772.36
11363,1973-06-08,107.03,1.19,1.12,120.24,-10.99,True,1,4617,-107.03,-342892.11,494157.51,151265.4
11364,1973-06-11,106.7,-0.33,-0.31,120.24,-11.26,True,1,4618,-106.7,-342998.81,492740.6,149741.79
11365,1973-06-12,108.29,1.59,1.49,120.24,-9.94,True,1,4619,-108.29,-343107.1,500191.51,157084.41
11366,1973-06-13,107.6,-0.69,-0.64,120.24,-10.51,True,1,4620,-107.6,-343214.7,497112.0,153897.3
11367,1973-06-14,106.4,-1.2,-1.12,120.24,-11.51,True,1,4621,-106.4,-343321.1,491674.4,148353.3
11368,1973-06-15,105.1,-1.3,-1.22,120.24,-12.59,True,1,4622,-105.1,-343426.2,485772.2,142346.0
11369,1973-06-18,103.6,-1.5,-1.43,120.24,-13.84,True,1,4623,-103.6,-343529.8,478942.8,135413.0
11370,1973-06-19,103.99,0.39,0.38,120.24,-13.52,True,1,4624,-103.99,-343633.79,480849.76,137215.97
11371,1973-06-20,104.44,0.45,0.43,120.24,-13.14,True,1,4625,-104.44,-343738.23,483035.0,139296.77
11372,1973-06-21,103.21,-1.23,-1.18,120.24,-14.16,True,1,4626,-103.21,-343841.44,477449.46,133608.02
11373,1973-06-22,103.7,0.49,0.48,120.24,-13.76,True,1,4627,-103.7,-343945.14,479819.9,135874.76
11374,1973-06-25,102.25,-1.45,-1.4,120.24,-14.96,True,1,4628,-102.25,-344047.39,473213.0,129165.61
11375,1973-06-26,103.3,1.05,1.03,120.24,-14.09,True,1,4629,-103.3,-344150.69,478175.7,134025.01
11376,1973-06-27,103.62,0.32,0.31,120.24,-13.82,True,1,4630,-103.62,-344254.31,479760.6,135506.29
11377,1973-06-28,104.69,1.07,1.03,120.24,-12.93,True,1,4631,-104.69,-344359.0,484819.39,140460.39
11378,1973-06-29,104.26,-0.43,-0.41,120.24,-13.29,True,1,4632,-104.26,-344463.26,482932.32,138469.06
11379,1973-07-02,102.9,-1.36,-1.3,120.24,-14.42,True,1,4633,-102.9,-344566.16,476735.7,132169.54
11380,1973-07-03,101.87,-1.03,-1.0,120.24,-15.28,True,1,4634,-101.87,-344668.03,472065.58,127397.55
11381,1973-07-05,101.78,-0.09,-0.09,120.24,-15.35,True,1,4635,-101.78,-344769.81,471750.3,126980.49
11382,1973-07-06,101.28,-0.5,-0.49,120.24,-15.77,True,1,4636,-101.28,-344871.09,469534.08,124662.99
11383,1973-07-09,102.14,0.86,0.85,120.24,-15.05,True,1,4637,-102.14,-344973.23,473623.18,128649.95
11384,1973-07-10,103.52,1.38,1.35,120.24,-13.91,True,1,4638,-103.52,-345076.75,480125.76,135049.01
11385,1973-07-11,105.8,2.28,2.2,120.24,-12.01,True,1,4639,-105.8,-345182.55,490806.2,145623.65
11386,1973-07-12,105.5,-0.3,-0.28,120.24,-12.26,True,1,4640,-105.5,-345288.05,489520.0,144231.95
11387,1973-07-13,104.09,-1.41,-1.34,120.24,-13.43,True,1,4641,-104.09,-345392.14,483081.69,137689.55
11388,1973-07-16,105.67,1.58,1.52,120.24,-12.12,True,1,4642,-105.67,-345497.81,490520.14,145022.33
11389,1973-07-17,105.72,0.05,0.05,120.24,-12.08,True,1,4643,-105.72,-345603.53,490857.96,145254.43
11390,1973-07-18,106.35,0.63,0.6,120.24,-11.55,True,1,4644,-106.35,-345709.88,493889.4,148179.52
11391,1973-07-19,106.55,0.2,0.19,120.24,-11.39,True,1,4645,-106.55,-345816.43,494924.75,149108.32
11392,1973-07-20,107.14,0.59,0.55,120.24,-10.9,True,1,4646,-107.14,-345923.57,497772.44,151848.87
11393,1973-07-23,107.52,0.38,0.36,120.24,-10.58,True,1,4647,-107.52,-346031.09,499645.44,153614.35
11394,1973-07-24,108.14,0.62,0.58,120.24,-10.06,True,1,4648,-108.14,-346139.23,502634.72,156495.49
11395,1973-07-25,109.64,1.5,1.39,120.24,-8.82,True,1,4649,-109.64,-346248.87,509716.36,163467.49
11396,1973-07-26,109.85,0.21,0.19,120.24,-8.64,True,1,4650,-109.85,-346358.72,510802.5,164443.78
11397,1973-07-27,109.59,-0.26,-0.24,120.24,-8.86,True,1,4651,-109.59,-346468.31,509703.09,163234.78
11398,1973-07-30,109.25,-0.34,-0.31,120.24,-9.14,True,1,4652,-109.25,-346577.56,508231.0,161653.44
11399,1973-07-31,108.22,-1.03,-0.94,120.24,-10.0,True,1,4653,-108.22,-346685.78,503547.66,156861.88
11400,1973-08-01,106.83,-1.39,-1.28,120.24,-11.15,True,1,4654,-106.83,-346792.61,497186.82,150394.21
11401,1973-08-02,106.67,-0.16,-0.15,120.24,-11.29,True,1,4655,-106.67,-346899.28,496548.85,149649.57
11402,1973-08-03,106.49,-0.18,-0.17,120.24,-11.44,True,1,4656,-106.49,-347005.77,495817.44,148811.67
11403,1973-08-06,106.73,0.24,0.22,120.24,-11.24,True,1,4657,-106.73,-347112.5,497041.61,149929.11
11404,1973-08-07,106.55,-0.18,-0.17,120.24,-11.39,True,1,4658,-106.55,-347219.05,496309.9,149090.85
11405,1973-08-08,105.55,-1.0,-0.94,120.24,-12.22,True,1,4659,-105.55,-347324.6,491757.45,144432.85
11406,1973-08-09,105.61,0.06,0.06,120.24,-12.17,True,1,4660,-105.61,-347430.21,492142.6,144712.39
11407,1973-08-10,104.77,-0.84,-0.8,120.24,-12.87,True,1,4661,-104.77,-347534.98,488332.97,140797.99
11408,1973-08-13,103.71,-1.06,-1.01,120.24,-13.75,True,1,4662,-103.71,-347638.69,483496.02,135857.33
11409,1973-08-14,102.71,-1.0,-0.96,120.24,-14.58,True,1,4663,-102.71,-347741.4,478936.73,131195.33
11410,1973-08-15,103.01,0.3,0.29,120.24,-14.33,True,1,4664,-103.01,-347844.41,480438.64,132594.23
11411,1973-08-16,102.29,-0.72,-0.7,120.24,-14.93,True,1,4665,-102.29,-347946.7,477182.85,129236.15
11412,1973-08-17,102.31,0.02,0.02,120.24,-14.91,True,1,4666,-102.31,-348049.01,477378.46,129329.45
11413,1973-08-20,101.61,-0.7,-0.68,120.24,-15.49,True,1,4667,-101.61,-348150.62,474213.87,126063.25
11414,1973-08-21,100.89,-0.72,-0.71,120.24,-16.09,True,1,4668,-100.89,-348251.51,470954.52,122703.01
11415,1973-08-22,100.53,-0.36,-0.36,120.24,-16.39,True,1,4669,-100.53,-348352.04,469374.57,121022.53
11416,1973-08-23,101.91,1.38,1.37,120.24,-15.24,True,1,4670,-101.91,-348453.95,475919.7,127465.75
11417,1973-08-24,101.62,-0.29,-0.28,120.24,-15.49,True,1,4671,-101.62,-348555.57,474667.02,126111.45
11418,1973-08-27,102.42,0.8,0.79,120.24,-14.82,True,1,4672,-102.42,-348657.99,478506.24,129848.25
11419,1973-08-28,103.02,0.6,0.59,120.24,-14.32,True,1,4673,-103.02,-348761.01,481412.46,132651.45
11420,1973-08-29,104.03,1.01,0.98,120.24,-13.48,True,1,4674,-104.03,-348865.04,486236.22,137371.18
11421,1973-08-30,103.88,-0.15,-0.14,120.24,-13.61,True,1,4675,-103.88,-348968.92,485639.0,136670.08
11422,1973-08-31,104.25,0.37,0.36,120.24,-13.3,True,1,4676,-104.25,-349073.17,487473.0,138399.83
11423,1973-09-04,104.51,0.26,0.25,120.24,-13.08,True,1,4677,-104.51,-349177.68,488793.27,139615.59
11424,1973-09-05,104.64,0.13,0.12,120.24,-12.97,True,1,4678,-104.64,-349282.32,489505.92,140223.6
11425,1973-09-06,105.15,0.51,0.49,120.24,-12.55,True,1,4679,-105.15,-349387.47,491996.85,142609.38
11426,1973-09-07,104.76,-0.39,-0.37,120.24,-12.87,True,1,4680,-104.76,-349492.23,490276.8,140784.57
11427,1973-09-10,103.85,-0.91,-0.87,120.24,-13.63,True,1,4681,-103.85,-349596.08,486121.85,136525.77
11428,1973-09-11,103.22,-0.63,-0.61,120.24,-14.16,True,1,4682,-103.22,-349699.3,483276.04,133576.74
11429,1973-09-12,103.06,-0.16,-0.16,120.24,-14.29,True,1,4683,-103.06,-349802.36,482629.98,132827.62
11430,1973-09-13,103.36,0.3,0.29,120.24,-14.04,True,1,4684,-103.36,-349905.72,484138.24,134232.52
11431,1973-09-14,104.44,1.08,1.04,120.24,-13.14,True,1,4685,-104.44,-350010.16,489301.4,139291.24
11432,1973-09-17,104.15,-0.29,-0.28,120.24,-13.38,True,1,4686,-104.15,-350114.31,488046.9,137932.59
11433,1973-09-18,103.77,-0.38,-0.36,120.24,-13.7,True,1,4687,-103.77,-350218.08,486369.99,136151.91
11434,1973-09-19,105.88,2.11,2.03,120.24,-11.94,True,1,4688,-105.88,-350323.96,496365.44,146041.48
11435,1973-09-20,106.76,0.88,0.83,120.24,-11.21,True,1,4689,-106.76,-350430.72,500597.64,150166.92
11436,1973-09-21,107.2,0.44,0.41,120.24,-10.84,True,1,4690,-107.2,-350537.92,502768.0,152230.08
11437,1973-09-24,107.36,0.16,0.15,120.24,-10.71,True,1,4691,-107.36,-350645.28,503625.76,152980.48
11438,1973-09-25,108.05,0.69,0.64,120.24,-10.14,True,1,4692,-108.05,-350753.33,506970.6,156217.27
11439,1973-09-26,108.83,0.78,0.72,120.24,-9.49,True,1,4693,-108.83,-350862.16,510739.19,159877.03
11440,1973-09-27,109.08,0.25,0.23,120.24,-9.28,True,1,4694,-109.08,-350971.24,512021.52,161050.28
11441,1973-09-28,108.43,-0.65,-0.6,120.24,-9.82,True,1,4695,-108.43,-351079.67,509078.85,157999.18
11442,1973-10-01,108.21,-0.22,-0.2,120.24,-10.01,True,1,4696,-108.21,-351187.88,508154.16,156966.28
11443,1973-10-02,108.79,0.58,0.54,120.24,-9.52,True,1,4697,-108.79,-351296.67,510986.63,159689.96
11444,1973-10-03,108.78,-0.01,-0.01,120.24,-9.53,True,1,4698,-108.78,-351405.45,511048.44,159642.99
11445,1973-10-04,108.41,-0.37,-0.34,120.24,-9.84,True,1,4699,-108.41,-351513.86,509418.59,157904.73
11446,1973-10-05,109.85,1.44,1.33,120.24,-8.64,True,1,4700,-109.85,-351623.71,516295.0,164671.29
11447,1973-10-08,110.23,0.38,0.35,120.24,-8.32,True,1,4701,-110.23,-351733.94,518191.23,166457.29
11448,1973-10-09,110.13,-0.1,-0.09,120.24,-8.41,True,1,4702,-110.13,-351844.07,517831.26,165987.19
11449,1973-10-10,109.22,-0.91,-0.83,120.24,-9.16,True,1,4703,-109.22,-351953.29,513661.66,161708.37
11450,1973-10-11,111.09,1.87,1.71,120.24,-7.61,True,1,4704,-111.09,-352064.38,522567.36,170502.98
11451,1973-10-12,111.44,0.35,0.32,120.24,-7.32,True,1,4705,-111.44,-352175.82,524325.2,172149.38
11452,1973-10-15,110.05,-1.39,-1.25,120.24,-8.48,True,1,4706,-110.05,-352285.87,517895.3,165609.43
11453,1973-10-16,110.19,0.14,0.13,120.24,-8.36,True,1,4707,-110.19,-352396.06,518664.33,166268.27
11454,1973-10-17,109.97,-0.22,-0.2,120.24,-8.54,True,1,4708,-109.97,-352506.03,517738.76,165232.73
11455,1973-10-18,110.01,0.04,0.04,120.24,-8.51,True,1,4709,-110.01,-352616.04,518037.09,165421.05
11456,1973-10-19,110.22,0.21,0.19,120.24,-8.33,True,1,4710,-110.22,-352726.26,519136.2,166409.94
11457,1973-10-22,109.16,-1.06,-0.96,120.24,-9.22,True,1,4711,-109.16,-352835.42,514252.76,161417.34
11458,1973-10-23,109.75,0.59,0.54,120.24,-8.72,True,1,4712,-109.75,-352945.17,517142.0,164196.83
11459,1973-10-24,110.27,0.52,0.47,120.24,-8.29,True,1,4713,-110.27,-353055.44,519702.51,166647.07
11460,1973-10-25,110.5,0.23,0.21,120.24,-8.1,True,1,4714,-110.5,-353165.94,520897.0,167731.06
11461,1973-10-26,111.38,0.88,0.8,120.24,-7.37,True,1,4715,-111.38,-353277.32,525156.7,171879.38
11462,1973-10-29,111.15,-0.23,-0.21,120.24,-7.56,True,1,4716,-111.15,-353388.47,524183.4,170794.93
11463,1973-10-30,109.33,-1.82,-1.64,120.24,-9.07,True,1,4717,-109.33,-353497.8,515709.61,162211.81
11464,1973-10-31,108.29,-1.04,-0.95,120.24,-9.94,True,1,4718,-108.29,-353606.09,510912.22,157306.13
11465,1973-11-01,107.69,-0.6,-0.55,120.24,-10.44,True,1,4719,-107.69,-353713.78,508189.11,154475.33
11466,1973-11-02,107.07,-0.62,-0.58,120.24,-10.95,True,1,4720,-107.07,-353820.85,505370.4,151549.55
11467,1973-11-05,105.52,-1.55,-1.45,120.24,-12.24,True,1,4721,-105.52,-353926.37,498159.92,144233.55
11468,1973-11-06,104.96,-0.56,-0.53,120.24,-12.71,True,1,4722,-104.96,-354031.33,495621.12,141589.79
11469,1973-11-07,105.8,0.84,0.8,120.24,-12.01,True,1,4723,-105.8,-354137.13,499693.4,145556.27
11470,1973-11-08,107.02,1.22,1.15,120.24,-11.0,True,1,4724,-107.02,-354244.15,505562.48,151318.33
11471,1973-11-09,105.3,-1.72,-1.61,120.24,-12.42,True,1,4725,-105.3,-354349.45,497542.5,143193.05
11472,1973-11-12,104.44,-0.86,-0.82,120.24,-13.14,True,1,4726,-104.44,-354453.89,493583.44,139129.55
11473,1973-11-13,104.36,-0.08,-0.08,120.24,-13.21,True,1,4727,-104.36,-354558.25,493309.72,138751.47
11474,1973-11-14,102.45,-1.91,-1.83,120.24,-14.8,True,1,4728,-102.45,-354660.7,484383.6,129722.9
11475,1973-11-15,102.43,-0.02,-0.02,120.24,-14.81,True,1,4729,-102.43,-354763.13,484391.47,129628.34
11476,1973-11-16,103.88,1.45,1.42,120.24,-13.61,True,1,4730,-103.88,-354867.01,491352.4,136485.39
11477,1973-11-19,100.71,-3.17,-3.05,120.24,-16.24,True,1,4731,-100.71,-354967.72,476459.01,121491.29
11478,1973-11-20,98.66,-2.05,-2.04,120.24,-17.95,True,1,4732,-98.66,-355066.38,466859.12,111792.74
11479,1973-11-21,99.76,1.1,1.12,120.24,-17.03,True,1,4733,-99.76,-355166.14,472164.08,116997.94
11480,1973-11-23,99.44,-0.32,-0.32,120.24,-17.3,True,1,4734,-99.44,-355265.58,470748.96,115483.38
11481,1973-11-26,96.58,-2.86,-2.88,120.24,-19.68,True,1,4735,-96.58,-355362.16,457306.3,101944.14
11482,1973-11-27,95.7,-0.88,-0.91,120.24,-20.41,True,1,4736,-95.7,-355457.86,453235.2,97777.34
11483,1973-11-28,97.65,1.95,2.04,120.24,-18.79,True,1,4737,-97.65,-355555.51,462568.05,107012.54
11484,1973-11-29,97.31,-0.34,-0.35,120.24,-19.07,True,1,4738,-97.31,-355652.82,461054.78,105401.96
11485,1973-11-30,95.96,-1.35,-1.39,120.24,-20.19,True,1,4739,-95.96,-355748.78,454754.44,99005.66
11486,1973-12-03,93.9,-2.06,-2.15,120.24,-21.91,True,1,4740,-93.9,-355842.68,445086.0,89243.32
11487,1973-12-04,93.59,-0.31,-0.33,120.24,-22.16,True,1,4741,-93.59,-355936.27,443710.19,87773.92
11488,1973-12-05,92.16,-1.43,-1.53,120.24,-23.35,True,1,4742,-92.16,-356028.43,437022.72,80994.29
11489,1973-12-06,94.42,2.26,2.45,120.24,-21.47,True,1,4743,-94.42,-356122.85,447834.06,91711.21
11490,1973-12-07,96.51,2.09,2.21,120.24,-19.74,True,1,4744,-96.51,-356219.36,457843.44,101624.08
11491,1973-12-10,97.95,1.44,1.49,120.24,-18.54,True,1,4745,-97.95,-356317.31,464772.75,108455.44
11492,1973-12-11,96.04,-1.91,-1.95,120.24,-20.13,True,1,4746,-96.04,-356413.35,455805.84,99392.49
11493,1973-12-12,93.57,-2.47,-2.57,120.24,-22.18,True,1,4747,-93.57,-356506.92,444176.79,87669.87
11494,1973-12-13,92.38,-1.19,-1.27,120.24,-23.17,True,1,4748,-92.38,-356599.3,438620.24,82020.94
11495,1973-12-14,93.29,0.91,0.98,120.24,-22.41,True,1,4749,-93.29,-356692.59,443034.21,86341.62
11496,1973-12-17,92.75,-0.54,-0.58,120.24,-22.86,True,1,4750,-92.75,-356785.34,440562.5,83777.16
11497,1973-12-18,94.74,1.99,2.15,120.24,-21.21,True,1,4751,-94.74,-356880.08,450109.74,93229.66
11498,1973-12-19,94.82,0.08,0.08,120.24,-21.14,True,1,4752,-94.82,-356974.9,450584.64,93609.74
11499,1973-12-20,94.55,-0.27,-0.28,120.24,-21.37,True,1,4753,-94.55,-357069.45,449396.15,92326.7
11500,1973-12-21,93.54,-1.01,-1.07,120.24,-22.21,True,1,4754,-93.54,-357162.99,444689.16,87526.17
11501,1973-12-24,92.9,-0.64,-0.68,120.24,-22.74,True,1,4755,-92.9,-357255.89,441739.5,84483.61
11502,1973-12-26,95.74,2.84,3.06,120.24,-20.38,True,1,4756,-95.74,-357351.63,455339.44,97987.81
11503,1973-12-27,97.74,2.0,2.09,120.24,-18.71,True,1,4757,-97.74,-357449.37,464949.18,107499.81
11504,1973-12-28,97.54,-0.2,-0.2,120.24,-18.88,True,1,4758,-97.54,-357546.91,464095.32,106548.41
11505,1973-12-31,97.55,0.01,0.01,120.24,-18.87,True,1,4759,-97.55,-357644.46,464240.45,106595.99
11506,1974-01-02,97.68,0.13,0.13,120.24,-18.76,True,1,4760,-97.68,-357742.14,464956.8,107214.66
11507,1974-01-03,99.8,2.12,2.17,120.24,-17.0,True,1,4761,-99.8,-357841.94,475147.8,117305.86
11508,1974-01-04,98.9,-0.9,-0.9,120.24,-17.75,True,1,4762,-98.9,-357940.84,470961.8,113020.96
11509,1974-01-07,98.07,-0.83,-0.84,120.24,-18.44,True,1,4763,-98.07,-358038.91,467107.41,109068.5
11510,1974-01-08,96.12,-1.95,-1.99,120.24,-20.06,True,1,4764,-96.12,-358135.03,457915.68,99780.65
11511,1974-01-09,93.42,-2.7,-2.81,120.24,-22.3,True,1,4765,-93.42,-358228.45,445146.3,86917.85
11512,1974-01-10,92.39,-1.03,-1.1,120.24,-23.16,True,1,4766,-92.39,-358320.84,440330.74,82009.9
11513,1974-01-11,93.66,1.27,1.38,120.24,-22.11,True,1,4767,-93.66,-358414.5,446477.22,88062.72
11514,1974-01-14,93.42,-0.24,-0.26,120.24,-22.3,True,1,4768,-93.42,-358507.92,445426.56,86918.64
11515,1974-01-15,94.23,0.81,0.87,120.24,-21.63,True,1,4769,-94.23,-358602.15,449382.87,90780.72
11516,1974-01-16,95.67,1.44,1.53,120.24,-20.43,True,1,4770,-95.67,-358697.82,456345.9,97648.08
11517,1974-01-17,97.3,1.63,1.7,120.24,-19.08,True,1,4771,-97.3,-358795.12,464218.3,105423.18
11518,1974-01-18,95.56,-1.74,-1.79,120.24,-20.53,True,1,4772,-95.56,-358890.68,456012.32,97121.64
11519,1974-01-21,95.4,-0.16,-0.17,120.24,-20.66,True,1,4773,-95.4,-358986.08,455344.2,96358.12
11520,1974-01-22,96.55,1.15,1.2,120.24,-19.7,True,1,4774,-96.55,-359082.63,460929.7,101847.07
11521,1974-01-23,97.07,0.52,0.54,120.24,-19.27,True,1,4775,-97.07,-359179.7,463509.25,104329.55
11522,1974-01-24,96.82,-0.25,-0.26,120.24,-19.48,True,1,4776,-96.82,-359276.52,462412.32,103135.8
11523,1974-01-25,96.63,-0.19,-0.2,120.24,-19.64,True,1,4777,-96.63,-359373.15,461601.51,102228.36
11524,1974-01-28,96.09,-0.54,-0.56,120.24,-20.08,True,1,4778,-96.09,-359469.24,459118.02,99648.78
11525,1974-01-29,96.01,-0.08,-0.08,120.24,-20.15,True,1,4779,-96.01,-359565.25,458831.79,99266.54
11526,1974-01-30,97.06,1.05,1.09,120.24,-19.28,True,1,4780,-97.06,-359662.31,463946.8,104284.49
11527,1974-01-31,96.57,-0.49,-0.5,120.24,-19.69,True,1,4781,-96.57,-359758.88,461701.17,101942.29
11528,1974-02-01,95.32,-1.25,-1.29,120.24,-20.72,True,1,4782,-95.32,-359854.2,455820.24,95966.04
11529,1974-02-04,93.29,-2.03,-2.13,120.24,-22.41,True,1,4783,-93.29,-359947.49,446206.07,86258.58
11530,1974-02-05,93.0,-0.29,-0.31,120.24,-22.66,True,1,4784,-93.0,-360040.49,444912.0,84871.51
11531,1974-02-06,93.26,0.26,0.28,120.24,-22.44,True,1,4785,-93.26,-360133.75,446249.1,86115.35
11532,1974-02-07,93.3,0.04,0.04,120.24,-22.4,True,1,4786,-93.3,-360227.05,446533.8,86306.75
11533,1974-02-08,92.33,-0.97,-1.04,120.24,-23.21,True,1,4787,-92.33,-360319.38,441983.71,81664.33
11534,1974-02-11,90.66,-1.67,-1.81,120.24,-24.6,True,1,4788,-90.66,-360410.04,434080.08,73670.04
11535,1974-02-12,90.94,0.28,0.31,120.24,-24.37,True,1,4789,-90.94,-360500.98,435511.66,75010.68
11536,1974-02-13,90.98,0.04,0.04,120.24,-24.34,True,1,4790,-90.98,-360591.96,435794.2,75202.24
11537,1974-02-14,90.95,-0.03,-0.03,120.24,-24.36,True,1,4791,-90.95,-360682.91,435741.45,75058.54
11538,1974-02-15,92.27,1.32,1.45,120.24,-23.26,True,1,4792,-92.27,-360775.18,442157.84,81382.66
11539,1974-02-19,92.12,-0.15,-0.16,120.24,-23.39,True,1,4793,-92.12,-360867.3,441531.16,80663.86
11540,1974-02-20,93.44,1.32,1.43,120.24,-22.29,True,1,4794,-93.44,-360960.74,447951.36,86990.62
11541,1974-02-21,94.71,1.27,1.36,120.24,-21.23,True,1,4795,-94.71,-361055.45,454134.45,93079.0
11542,1974-02-22,95.39,0.68,0.72,120.24,-20.67,True,1,4796,-95.39,-361150.84,457490.44,96339.6
11543,1974-02-25,95.03,-0.36,-0.38,120.24,-20.97,True,1,4797,-95.03,-361245.87,455858.91,94613.04
11544,1974-02-26,96.0,0.97,1.02,120.24,-20.16,True,1,4798,-96.0,-361341.87,460608.0,99266.13
11545,1974-02-27,96.4,0.4,0.42,120.24,-19.83,True,1,4799,-96.4,-361438.27,462623.6,101185.33
11546,1974-02-28,96.22,-0.18,-0.19,120.24,-19.98,True,1,4800,-96.22,-361534.49,461856.0,100321.51
11547,1974-03-01,95.53,-0.69,-0.72,120.24,-20.55,True,1,4801,-95.53,-361630.02,458639.53,97009.51
11548,1974-03-04,95.53,0.0,0.0,120.24,-20.55,True,1,4802,-95.53,-361725.55,458735.06,97009.51
11549,1974-03-05,97.32,1.79,1.87,120.24,-19.06,True,1,4803,-97.32,-361822.87,467427.96,105605.09
11550,1974-03-06,97.98,0.66,0.68,120.24,-18.51,True,1,4804,-97.98,-361920.85,470695.92,108775.07
11551,1974-03-07,96.94,-1.04,-1.06,120.24,-19.38,True,1,4805,-96.94,-362017.79,465796.7,103778.91
11552,1974-03-08,97.78,0.84,0.87,120.24,-18.68,True,1,4806,-97.78,-362115.57,469930.68,107815.11
11553,1974-03-11,98.88,1.1,1.12,120.24,-17.76,True,1,4807,-98.88,-362214.45,475316.16,113101.71
11554,1974-03-12,99.15,0.27,0.27,120.24,-17.54,True,1,4808,-99.15,-362313.6,476713.2,114399.6
11555,1974-03-13,99.74,0.59,0.6,120.24,-17.05,True,1,4809,-99.74,-362413.34,479649.66,117236.32
11556,1974-03-14,99.65,-0.09,-0.09,120.24,-17.12,True,1,4810,-99.65,-362512.99,479316.5,116803.51
11557,1974-03-15,99.28,-0.37,-0.37,120.24,-17.43,True,1,4811,-99.28,-362612.27,477636.08,115023.81
11558,1974-03-18,98.05,-1.23,-1.24,120.24,-18.45,True,1,4812,-98.05,-362710.32,471816.6,109106.28
11559,1974-03-19,97.23,-0.82,-0.84,120.24,-19.14,True,1,4813,-97.23,-362807.55,467967.99,105160.44
11560,1974-03-20,97.57,0.34,0.35,120.24,-18.85,True,1,4814,-97.57,-362905.12,469701.98,106796.86
11561,1974-03-21,97.34,-0.23,-0.24,120.24,-19.05,True,1,4815,-97.34,-363002.46,468692.1,105689.64
11562,1974-03-22,97.27,-0.07,-0.07,120.24,-19.1,True,1,4816,-97.27,-363099.73,468452.32,105352.59
11563,1974-03-25,97.64,0.37,0.38,120.24,-18.8,True,1,4817,-97.64,-363197.37,470331.88,107134.51
11564,1974-03-26,97.95,0.31,0.32,120.24,-18.54,True,1,4818,-97.95,-363295.32,471923.1,108627.78
11565,1974-03-27,96.59,-1.36,-1.39,120.24,-19.67,True,1,4819,-96.59,-363391.91,465467.21,102075.3
11566,1974-03-28,94.82,-1.77,-1.83,120.24,-21.14,True,1,4820,-94.82,-363486.73,457032.4,93545.67
11567,1974-03-29,93.98,-0.84,-0.89,120.24,-21.84,True,1,4821,-93.98,-363580.71,453077.58,89496.87
11568,1974-04-01,93.25,-0.73,-0.78,120.24,-22.45,True,1,4822,-93.25,-363673.96,449651.5,85977.54
11569,1974-04-02,93.35,0.1,0.11,120.24,-22.36,True,1,4823,-93.35,-363767.31,450227.05,86459.74
11570,1974-04-03,94.33,0.98,1.05,120.24,-21.55,True,1,4824,-94.33,-363861.64,455047.92,91186.28
11571,1974-04-04,94.33,0.0,0.0,120.24,-21.55,True,1,4825,-94.33,-363955.97,455142.25,91186.28
11572,1974-04-05,93.01,-1.32,-1.4,120.24,-22.65,True,1,4826,-93.01,-364048.98,448866.26,84817.28
11573,1974-04-08,92.03,-0.98,-1.05,120.24,-23.46,True,1,4827,-92.03,-364141.01,444228.81,80087.8
11574,1974-04-09,92.61,0.58,0.63,120.24,-22.98,True,1,4828,-92.61,-364233.62,447121.08,82887.46
11575,1974-04-10,92.4,-0.21,-0.23,120.24,-23.15,True,1,4829,-92.4,-364326.02,446199.6,81873.58
11576,1974-04-11,92.12,-0.28,-0.3,120.24,-23.39,True,1,4830,-92.12,-364418.14,444939.6,80521.46
11577,1974-04-15,92.05,-0.07,-0.08,120.24,-23.44,True,1,4831,-92.05,-364510.19,444693.55,80183.36
11578,1974-04-16,93.66,1.61,1.75,120.24,-22.11,True,1,4832,-93.66,-364603.85,452565.12,87961.27
11579,1974-04-17,94.36,0.7,0.75,120.24,-21.52,True,1,4833,-94.36,-364698.21,456041.88,91343.67
11580,1974-04-18,94.78,0.42,0.44,120.24,-21.17,True,1,4834,-94.78,-364792.99,458166.52,93373.53
11581,1974-04-19,93.75,-1.03,-1.09,120.24,-22.03,True,1,4835,-93.75,-364886.74,453281.25,88394.51
11582,1974-04-22,93.38,-0.37,-0.4,120.24,-22.34,True,1,4836,-93.38,-364980.12,451585.68,86605.56
11583,1974-04-23,91.81,-1.57,-1.68,120.24,-23.64,True,1,4837,-91.81,-365071.93,444084.97,79013.04
11584,1974-04-24,90.3,-1.51,-1.64,120.24,-24.9,True,1,4838,-90.3,-365162.23,436871.4,71709.17
11585,1974-04-25,89.57,-0.73,-0.81,120.24,-25.51,True,1,4839,-89.57,-365251.8,433429.23,68177.43
11586,1974-04-26,90.18,0.61,0.68,120.24,-25.0,True,1,4840,-90.18,-365341.98,436471.2,71129.22
11587,1974-04-29,90.0,-0.18,-0.2,120.24,-25.15,True,1,4841,-90.0,-365431.98,435690.0,70258.02
11588,1974-04-30,90.31,0.31,0.34,120.24,-24.89,True,1,4842,-90.31,-365522.29,437281.02,71758.73
11589,1974-05-01,92.22,1.91,2.12,120.24,-23.3,True,1,4843,-92.22,-365614.51,446621.46,81006.95
11590,1974-05-02,92.09,-0.13,-0.14,120.24,-23.41,True,1,4844,-92.09,-365706.6,446083.96,80377.36
11591,1974-05-03,91.29,-0.8,-0.87,120.24,-24.08,True,1,4845,-91.29,-365797.89,442300.05,76502.16
11592,1974-05-06,91.12,-0.17,-0.19,120.24,-24.22,True,1,4846,-91.12,-365889.01,441567.52,75678.51
11593,1974-05-07,91.46,0.34,0.37,120.24,-23.94,True,1,4847,-91.46,-365980.47,443306.62,77326.15
11594,1974-05-08,91.64,0.18,0.2,120.24,-23.79,True,1,4848,-91.64,-366072.11,444270.72,78198.61
11595,1974-05-09,92.96,1.32,1.44,120.24,-22.69,True,1,4849,-92.96,-366165.07,450763.04,84597.97
11596,1974-05-10,91.47,-1.49,-1.6,120.24,-23.93,True,1,4850,-91.47,-366256.54,443629.5,77372.96
11597,1974-05-13,90.66,-0.81,-0.89,120.24,-24.6,True,1,4851,-90.66,-366347.2,439791.66,73444.46
11598,1974-05-14,90.69,0.03,0.03,120.24,-24.58,True,1,4852,-90.69,-366437.89,440027.88,73589.99
11599,1974-05-15,90.45,-0.24,-0.26,120.24,-24.78,True,1,4853,-90.45,-366528.34,438953.85,72425.51
11600,1974-05-16,89.72,-0.73,-0.81,120.24,-25.38,True,1,4854,-89.72,-366618.06,435500.88,68882.82
11601,1974-05-17,88.21,-1.51,-1.68,120.24,-26.64,True,1,4855,-88.21,-366706.27,428259.55,61553.28
11602,1974-05-20,87.86,-0.35,-0.4,120.24,-26.93,True,1,4856,-87.86,-366794.13,426648.16,59854.03
11603,1974-05-21,87.91,0.05,0.06,120.24,-26.89,True,1,4857,-87.91,-366882.04,426978.87,60096.83
11604,1974-05-22,87.09,-0.82,-0.93,120.24,-27.57,True,1,4858,-87.09,-366969.13,423083.22,56114.09
11605,1974-05-23,87.29,0.2,0.23,120.24,-27.4,True,1,4859,-87.29,-367056.42,424142.11,57085.69
11606,1974-05-24,88.58,1.29,1.48,120.24,-26.33,True,1,4860,-88.58,-367145.0,430498.8,63353.8
11607,1974-05-28,88.37,-0.21,-0.24,120.24,-26.5,True,1,4861,-88.37,-367233.37,429566.57,62333.2
11608,1974-05-29,86.89,-1.48,-1.68,120.24,-27.74,True,1,4862,-86.89,-367320.26,422459.18,55138.92
11609,1974-05-30,87.43,0.54,0.62,120.24,-27.29,True,1,4863,-87.43,-367407.69,425172.09,57764.4
11610,1974-05-31,87.28,-0.15,-0.17,120.24,-27.41,True,1,4864,-87.28,-367494.97,424529.92,57034.95
11611,1974-06-03,89.1,1.82,2.08,120.24,-25.9,True,1,4865,-89.1,-367584.07,433471.5,65887.43
11612,1974-06-04,90.14,1.04,1.17,120.24,-25.03,True,1,4866,-90.14,-367674.21,438621.24,70947.03
11613,1974-06-05,90.31,0.17,0.19,120.24,-24.89,True,1,4867,-90.31,-367764.52,439538.77,71774.25
11614,1974-06-06,91.96,1.65,1.83,120.24,-23.52,True,1,4868,-91.96,-367856.48,447661.28,79804.8
11615,1974-06-07,92.55,0.59,0.64,120.24,-23.03,True,1,4869,-92.55,-367949.03,450625.95,82676.92
11616,1974-06-10,93.1,0.55,0.59,120.24,-22.57,True,1,4870,-93.1,-368042.13,453397.0,85354.87
11617,1974-06-11,92.28,-0.82,-0.88,120.24,-23.25,True,1,4871,-92.28,-368134.41,449495.88,81361.47
11618,1974-06-12,92.06,-0.22,-0.24,120.24,-23.44,True,1,4872,-92.06,-368226.47,448516.32,80289.85
11619,1974-06-13,92.34,0.28,0.3,120.24,-23.2,True,1,4873,-92.34,-368318.81,449972.82,81654.01
11620,1974-06-14,91.3,-1.04,-1.13,120.24,-24.07,True,1,4874,-91.3,-368410.11,444996.2,76586.09
11621,1974-06-17,90.04,-1.26,-1.38,120.24,-25.12,True,1,4875,-90.04,-368500.15,438945.0,70444.85
11622,1974-06-18,89.45,-0.59,-0.66,120.24,-25.61,True,1,4876,-89.45,-368589.6,436158.2,67568.6
11623,1974-06-19,88.84,-0.61,-0.68,120.24,-26.11,True,1,4877,-88.84,-368678.44,433272.68,64594.24
11624,1974-06-20,88.21,-0.63,-0.71,120.24,-26.64,True,1,4878,-88.21,-368766.65,430288.38,61521.73
11625,1974-06-21,87.46,-0.75,-0.85,120.24,-27.26,True,1,4879,-87.46,-368854.11,426717.34,57863.23
11626,1974-06-24,87.69,0.23,0.26,120.24,-27.07,True,1,4880,-87.69,-368941.8,427927.2,58985.4
11627,1974-06-25,88.98,1.29,1.47,120.24,-26.0,True,1,4881,-88.98,-369030.78,434311.38,65280.6
11628,1974-06-26,87.61,-1.37,-1.54,120.24,-27.14,True,1,4882,-87.61,-369118.39,427712.02,58593.63
11629,1974-06-27,86.31,-1.3,-1.48,120.24,-28.22,True,1,4883,-86.31,-369204.7,421451.73,52247.03
11630,1974-06-28,86.0,-0.31,-0.36,120.24,-28.48,True,1,4884,-86.0,-369290.7,420024.0,50733.3
11631,1974-07-01,86.02,0.02,0.02,120.24,-28.46,True,1,4885,-86.02,-369376.72,420207.7,50830.98
11632,1974-07-02,84.3,-1.72,-2.0,120.24,-29.89,True,1,4886,-84.3,-369461.02,411889.8,42428.78
11633,1974-07-03,84.25,-0.05,-0.06,120.24,-29.93,True,1,4887,-84.25,-369545.27,411729.75,42184.48
11634,1974-07-05,83.66,-0.59,-0.7,120.24,-30.42,True,1,4888,-83.66,-369628.93,408930.08,39301.15
11635,1974-07-08,81.09,-2.57,-3.07,120.24,-32.56,True,1,4889,-81.09,-369710.02,396449.01,26738.99
11636,1974-07-09,81.48,0.39,0.48,120.24,-32.24,True,1,4890,-81.48,-369791.5,398437.2,28645.7
11637,1974-07-10,79.99,-1.49,-1.83,120.24,-33.48,True,1,4891,-79.99,-369871.49,391231.09,21359.6
11638,1974-07-11,79.89,-0.1,-0.12,120.24,-33.56,True,1,4892,-79.89,-369951.38,390821.88,20870.5
11639,1974-07-12,83.15,3.26,4.08,120.24,-30.85,True,1,4893,-83.15,-370034.53,406852.95,36818.42
11640,1974-07-15,83.78,0.63,0.76,120.24,-30.32,True,1,4894,-83.78,-370118.31,410019.32,39901.01
11641,1974-07-16,82.81,-0.97,-1.16,120.24,-31.13,True,1,4895,-82.81,-370201.12,405354.95,35153.83
11642,1974-07-17,83.7,0.89,1.08,120.24,-30.39,True,1,4896,-83.7,-370284.82,409795.2,39510.38
11643,1974-07-18,83.78,0.08,0.1,120.24,-30.32,True,1,4897,-83.78,-370368.6,410270.66,39902.06
11644,1974-07-19,83.54,-0.24,-0.29,120.24,-30.52,True,1,4898,-83.54,-370452.14,409178.92,38726.78
11645,1974-07-22,83.81,0.27,0.32,120.24,-30.3,True,1,4899,-83.81,-370535.95,410585.19,40049.24
11646,1974-07-23,84.65,0.84,1.0,120.24,-29.6,True,1,4900,-84.65,-370620.6,414785.0,44164.4
11647,1974-07-24,84.99,0.34,0.4,120.24,-29.32,True,1,4901,-84.99,-370705.59,416535.99,45830.4
11648,1974-07-25,83.98,-1.01,-1.19,120.24,-30.16,True,1,4902,-83.98,-370789.57,411669.96,40880.39
11649,1974-07-26,82.4,-1.58,-1.88,120.24,-31.47,True,1,4903,-82.4,-370871.97,404007.2,33135.23
11650,1974-07-29,80.94,-1.46,-1.77,120.24,-32.68,True,1,4904,-80.94,-370952.91,396929.76,25976.85
11651,1974-07-30,80.5,-0.44,-0.54,120.24,-33.05,True,1,4905,-80.5,-371033.41,394852.5,23819.09
11652,1974-07-31,79.31,-1.19,-1.48,120.24,-34.04,True,1,4906,-79.31,-371112.72,389094.86,17982.14
11653,1974-08-01,78.75,-0.56,-0.71,120.24,-34.51,True,1,4907,-78.75,-371191.47,386426.25,15234.78
11654,1974-08-02,78.59,-0.16,-0.2,120.24,-34.64,True,1,4908,-78.59,-371270.06,385719.72,14449.66
11655,1974-08-05,79.29,0.7,0.89,120.24,-34.06,True,1,4909,-79.29,-371349.35,389234.61,17885.26
11656,1974-08-06,80.52,1.23,1.55,120.24,-33.03,True,1,4910,-80.52,-371429.87,395353.2,23923.33
11657,1974-08-07,82.65,2.13,2.64,120.24,-31.26,True,1,4911,-82.65,-371512.52,405894.15,34381.63
11658,1974-08-08,81.57,-1.08,-1.31,120.24,-32.16,True,1,4912,-81.57,-371594.09,400671.84,29077.75
11659,1974-08-09,80.86,-0.71,-0.87,120.24,-32.75,True,1,4913,-80.86,-371674.95,397265.18,25590.23
11660,1974-08-12,79.75,-1.11,-1.37,120.24,-33.67,True,1,4914,-79.75,-371754.7,391891.5,20136.8
11661,1974-08-13,78.49,-1.26,-1.58,120.24,-34.72,True,1,4915,-78.49,-371833.19,385778.35,13945.16
11662,1974-08-14,76.73,-1.76,-2.24,120.24,-36.19,True,1,4916,-76.73,-371909.92,377204.68,5294.76
11663,1974-08-15,76.3,-0.43,-0.56,120.24,-36.54,True,1,4917,-76.3,-371986.22,375167.1,3180.88
11664,1974-08-16,75.67,-0.63,-0.83,120.24,-37.07,True,1,4918,-75.67,-372061.89,372145.06,83.17
11665,1974-08-19,74.57,-1.1,-1.45,120.24,-37.98,True,1,4919,-74.57,-372136.46,366809.83,-5326.63
11666,1974-08-20,74.95,0.38,0.51,120.24,-37.67,True,1,4920,-74.95,-372211.41,368754.0,-3457.41
11667,1974-08-21,73.51,-1.44,-1.92,120.24,-38.86,True,1,4921,-73.51,-372284.92,361742.71,-10542.21
11668,1974-08-22,72.8,-0.71,-0.97,120.24,-39.45,True,1,4922,-72.8,-372357.72,358321.6,-14036.12
11669,1974-08-23,71.55,-1.25,-1.72,120.24,-40.49,True,1,4923,-71.55,-372429.27,352240.65,-20188.62
11670,1974-08-26,72.16,0.61,0.85,120.24,-39.99,True,1,4924,-72.16,-372501.43,355315.84,-17185.59
11671,1974-08-27,70.94,-1.22,-1.69,120.24,-41.0,True,1,4925,-70.94,-372572.37,349379.5,-23192.87
11672,1974-08-28,70.76,-0.18,-0.25,120.24,-41.15,True,1,4926,-70.76,-372643.13,348563.76,-24079.37
11673,1974-08-29,69.99,-0.77,-1.09,120.24,-41.79,True,1,4927,-69.99,-372713.12,344840.73,-27872.39
11674,1974-08-30,72.15,2.16,3.09,120.24,-39.99,True,1,4928,-72.15,-372785.27,355555.2,-17230.07
11675,1974-09-03,70.52,-1.63,-2.26,120.24,-41.35,True,1,4929,-70.52,-372855.79,347593.08,-25262.71
11676,1974-09-04,68.69,-1.83,-2.6,120.24,-42.87,True,1,4930,-68.69,-372924.48,338641.7,-34282.78
11677,1974-09-05,70.87,2.18,3.17,120.24,-41.06,True,1,4931,-70.87,-372995.35,349459.97,-23535.38
11678,1974-09-06,71.42,0.55,0.78,120.24,-40.6,True,1,4932,-71.42,-373066.77,352243.44,-20823.33
11679,1974-09-09,69.72,-1.7,-2.38,120.24,-42.02,True,1,4933,-69.72,-373136.49,343928.76,-29207.73
11680,1974-09-10,69.24,-0.48,-0.69,120.24,-42.42,True,1,4934,-69.24,-373205.73,341630.16,-31575.57
11681,1974-09-11,68.55,-0.69,-1.0,120.24,-42.99,True,1,4935,-68.55,-373274.28,338294.25,-34980.03
11682,1974-09-12,66.71,-1.84,-2.68,120.24,-44.52,True,1,4936,-66.71,-373340.99,329280.56,-44060.43
11683,1974-09-13,65.2,-1.51,-2.26,120.24,-45.78,True,1,4937,-65.2,-373406.19,321892.4,-51513.79
11684,1974-09-16,66.26,1.06,1.63,120.24,-44.89,True,1,4938,-66.26,-373472.45,327191.88,-46280.57
11685,1974-09-17,67.38,1.12,1.69,120.24,-43.96,True,1,4939,-67.38,-373539.83,332789.82,-40750.01
11686,1974-09-18,67.72,0.34,0.5,120.24,-43.68,True,1,4940,-67.72,-373607.55,334536.8,-39070.75
11687,1974-09-19,70.09,2.37,3.5,120.24,-41.71,True,1,4941,-70.09,-373677.64,346314.69,-27362.95
11688,1974-09-20,70.14,0.05,0.07,120.24,-41.67,True,1,4942,-70.14,-373747.78,346631.88,-27115.9
11689,1974-09-23,69.42,-0.72,-1.03,120.24,-42.26,True,1,4943,-69.42,-373817.2,343143.06,-30674.14
11690,1974-09-24,68.02,-1.4,-2.02,120.24,-43.43,True,1,4944,-68.02,-373885.22,336290.88,-37594.34
11691,1974-09-25,67.57,-0.45,-0.66,120.24,-43.8,True,1,4945,-67.57,-373952.79,334133.65,-39819.14
11692,1974-09-26,66.46,-1.11,-1.64,120.24,-44.73,True,1,4946,-66.46,-374019.25,328711.16,-45308.09
11693,1974-09-27,64.94,-1.52,-2.29,120.24,-45.99,True,1,4947,-64.94,-374084.19,321258.18,-52826.01
11694,1974-09-30,63.54,-1.4,-2.16,120.24,-47.16,True,1,4948,-63.54,-374147.73,314395.92,-59751.81
11695,1974-10-01,63.39,-0.15,-0.24,120.24,-47.28,True,1,4949,-63.39,-374211.12,313717.11,-60494.01
11696,1974-10-02,63.38,-0.01,-0.02,120.24,-47.29,True,1,4950,-63.38,-374274.5,313731.0,-60543.5
11697,1974-10-03,62.28,-1.1,-1.74,120.24,-48.2,True,1,4951,-62.28,-374336.78,308348.28,-65988.5
11698,1974-10-04,62.34,0.06,0.1,120.24,-48.15,True,1,4952,-62.34,-374399.12,308707.68,-65691.44
11699,1974-10-07,64.95,2.61,4.19,120.24,-45.98,True,1,4953,-64.95,-374464.07,321697.35,-52766.72
11700,1974-10-08,64.84,-0.11,-0.17,120.24,-46.08,True,1,4954,-64.84,-374528.91,321217.36,-53311.55
11701,1974-10-09,67.82,2.98,4.6,120.24,-43.6,True,1,4955,-67.82,-374596.73,336048.1,-38548.63
11702,1974-10-10,69.79,1.97,2.9,120.24,-41.96,True,1,4956,-69.79,-374666.52,345879.24,-28787.28
11703,1974-10-11,71.14,1.35,1.93,120.24,-40.84,True,1,4957,-71.14,-374737.66,352640.98,-22096.68
11704,1974-10-14,72.74,1.6,2.25,120.24,-39.5,True,1,4958,-72.74,-374810.4,360644.92,-14165.48
11705,1974-10-15,71.44,-1.3,-1.79,120.24,-40.58,True,1,4959,-71.44,-374881.84,354270.96,-20610.88
11706,1974-10-16,70.33,-1.11,-1.55,120.24,-41.51,True,1,4960,-70.33,-374952.17,348836.8,-26115.37
11707,1974-10-17,71.17,0.84,1.19,120.24,-40.81,True,1,4961,-71.17,-375023.34,353074.37,-21948.97
11708,1974-10-18,72.28,1.11,1.56,120.24,-39.89,True,1,4962,-72.28,-375095.62,358653.36,-16442.26
11709,1974-10-21,73.5,1.22,1.69,120.24,-38.87,True,1,4963,-73.5,-375169.12,364780.5,-10388.62
11710,1974-10-22,73.13,-0.37,-0.5,120.24,-39.18,True,1,4964,-73.13,-375242.25,363017.32,-12224.93
11711,1974-10-23,71.03,-2.1,-2.87,120.24,-40.93,True,1,4965,-71.03,-375313.28,352663.95,-22649.33
11712,1974-10-24,70.22,-0.81,-1.14,120.24,-41.6,True,1,4966,-70.22,-375383.5,348712.52,-26670.98
11713,1974-10-25,70.12,-0.1,-0.14,120.24,-41.68,True,1,4967,-70.12,-375453.62,348286.04,-27167.58
11714,1974-10-28,70.09,-0.03,-0.04,120.24,-41.71,True,1,4968,-70.09,-375523.71,348207.12,-27316.59
11715,1974-10-29,72.83,2.74,3.91,120.24,-39.43,True,1,4969,-72.83,-375596.54,361892.27,-13704.27
11716,1974-10-30,74.31,1.48,2.03,120.24,-38.2,True,1,4970,-74.31,-375670.85,369320.7,-6350.15
11717,1974-10-31,73.9,-0.41,-0.55,120.24,-38.54,True,1,4971,-73.9,-375744.75,367356.9,-8387.85
11718,1974-11-01,73.88,-0.02,-0.03,120.24,-38.56,True,1,4972,-73.88,-375818.63,367331.36,-8487.27
11719,1974-11-04,73.08,-0.8,-1.08,120.24,-39.22,True,1,4973,-73.08,-375891.71,363426.84,-12464.87
11720,1974-11-05,75.11,2.03,2.78,120.24,-37.53,True,1,4974,-75.11,-375966.82,373597.14,-2369.68
11721,1974-11-06,74.75,-0.36,-0.48,120.24,-37.83,True,1,4975,-74.75,-376041.57,371881.25,-4160.32
11722,1974-11-07,75.21,0.46,0.62,120.24,-37.45,True,1,4976,-75.21,-376116.78,374244.96,-1871.82
11723,1974-11-08,74.91,-0.3,-0.4,120.24,-37.7,True,1,4977,-74.91,-376191.69,372827.07,-3364.62
11724,1974-11-11,75.15,0.24,0.32,120.24,-37.5,True,1,4978,-75.15,-376266.84,374096.7,-2170.14
11725,1974-11-12,73.67,-1.48,-1.97,120.24,-38.73,True,1,4979,-73.67,-376340.51,366802.93,-9537.58
11726,1974-11-13,73.35,-0.32,-0.43,120.24,-39.0,True,1,4980,-73.35,-376413.86,365283.0,-11130.86
11727,1974-11-14,73.06,-0.29,-0.4,120.24,-39.24,True,1,4981,-73.06,-376486.92,363911.86,-12575.06
11728,1974-11-15,71.91,-1.15,-1.57,120.24,-40.2,True,1,4982,-71.91,-376558.83,358255.62,-18303.21
11729,1974-11-18,69.27,-2.64,-3.67,120.24,-42.39,True,1,4983,-69.27,-376628.1,345172.41,-31455.69
11730,1974-11-19,68.2,-1.07,-1.54,120.24,-43.28,True,1,4984,-68.2,-376696.3,339908.8,-36787.5
11731,1974-11-20,67.9,-0.3,-0.44,120.24,-43.53,True,1,4985,-67.9,-376764.2,338481.5,-38282.7
11732,1974-11-21,68.18,0.28,0.41,120.24,-43.3,True,1,4986,-68.18,-376832.38,339945.48,-36886.9
11733,1974-11-22,68.9,0.72,1.06,120.24,-42.7,True,1,4987,-68.9,-376901.28,343604.3,-33296.98
11734,1974-11-25,68.83,-0.07,-0.1,120.24,-42.76,True,1,4988,-68.83,-376970.11,343324.04,-33646.07
11735,1974-11-26,69.47,0.64,0.93,120.24,-42.22,True,1,4989,-69.47,-377039.58,346585.83,-30453.75
11736,1974-11-27,69.94,0.47,0.68,120.24,-41.83,True,1,4990,-69.94,-377109.52,349000.6,-28108.92
11737,1974-11-29,69.97,0.03,0.04,120.24,-41.81,True,1,4991,-69.97,-377179.49,349220.27,-27959.22
11738,1974-12-02,68.11,-1.86,-2.66,120.24,-43.36,True,1,4992,-68.11,-377247.6,340005.12,-37242.48
11739,1974-12-03,67.17,-0.94,-1.38,120.24,-44.14,True,1,4993,-67.17,-377314.77,335379.81,-41934.96
11740,1974-12-04,67.41,0.24,0.36,120.24,-43.94,True,1,4994,-67.41,-377382.18,336645.54,-40736.64
11741,1974-12-05,66.13,-1.28,-1.9,120.24,-45.0,True,1,4995,-66.13,-377448.31,330319.35,-47128.96
11742,1974-12-06,65.01,-1.12,-1.69,120.24,-45.93,True,1,4996,-65.01,-377513.32,324789.96,-52723.36
11743,1974-12-09,65.6,0.59,0.91,120.24,-45.44,True,1,4997,-65.6,-377578.92,327803.2,-49775.72
11744,1974-12-10,67.28,1.68,2.56,120.24,-44.04,True,1,4998,-67.28,-377646.2,336265.44,-41380.76
11745,1974-12-11,67.67,0.39,0.58,120.24,-43.72,True,1,4999,-67.67,-377713.87,338282.33,-39431.54
11746,1974-12-12,67.45,-0.22,-0.32,120.24,-43.9,True,1,5000,-67.45,-377781.32,337250.0,-40531.32
11747,1974-12-13,67.07,-0.38,-0.56,120.24,-44.22,True,1,5001,-67.07,-377848.39,335417.07,-42431.32
11748,1974-12-16,66.46,-0.61,-0.91,120.24,-44.73,True,1,5002,-66.46,-377914.85,332432.92,-45481.93
11749,1974-12-17,67.58,1.12,1.68,120.24,-43.8,True,1,5003,-67.58,-377982.43,338102.74,-39879.69
11750,1974-12-18,67.9,0.32,0.47,120.24,-43.53,True,1,5004,-67.9,-378050.33,339771.6,-38278.73
11751,1974-12-19,67.65,-0.25,-0.37,120.24,-43.74,True,1,5005,-67.65,-378117.98,338588.25,-39529.73
11752,1974-12-20,66.91,-0.74,-1.09,120.24,-44.35,True,1,5006,-66.91,-378184.89,334951.46,-43233.43
11753,1974-12-23,65.96,-0.95,-1.42,120.24,-45.14,True,1,5007,-65.96,-378250.85,330261.72,-47989.13
11754,1974-12-24,66.88,0.92,1.4,120.24,-44.38,True,1,5008,-66.88,-378317.73,334935.04,-43382.69
11755,1974-12-26,67.44,0.56,0.84,120.24,-43.91,True,1,5009,-67.44,-378385.17,337806.96,-40578.21
11756,1974-12-27,67.14,-0.3,-0.44,120.24,-44.16,True,1,5010,-67.14,-378452.31,336371.4,-42080.91
11757,1974-12-30,67.16,0.02,0.03,120.24,-44.14,True,1,5011,-67.16,-378519.47,336538.76,-41980.71
11758,1974-12-31,68.56,1.4,2.08,120.24,-42.98,True,1,5012,-68.56,-378588.03,343622.72,-34965.31
11759,1975-01-02,70.23,1.67,2.44,120.24,-41.59,True,1,5013,-70.23,-378658.26,352062.99,-26595.27
11760,1975-01-03,70.71,0.48,0.68,120.24,-41.19,True,1,5014,-70.71,-378728.97,354539.94,-24189.03
11761,1975-01-06,71.07,0.36,0.51,120.24,-40.89,True,1,5015,-71.07,-378800.04,356416.05,-22383.99
11762,1975-01-07,71.02,-0.05,-0.07,120.24,-40.94,True,1,5016,-71.02,-378871.06,356236.32,-22634.74
11763,1975-01-08,70.04,-0.98,-1.38,120.24,-41.75,True,1,5017,-70.04,-378941.1,351390.68,-27550.42
11764,1975-01-09,71.17,1.13,1.61,120.24,-40.81,True,1,5018,-71.17,-379012.27,357131.06,-21881.21
11765,1975-01-10,72.61,1.44,2.02,120.24,-39.61,True,1,5019,-72.61,-379084.88,364429.59,-14655.29
11766,1975-01-13,72.31,-0.3,-0.41,120.24,-39.86,True,1,5020,-72.31,-379157.19,362996.2,-16160.99
11767,1975-01-14,71.68,-0.63,-0.87,120.24,-40.39,True,1,5021,-71.68,-379228.87,359905.28,-19323.59
11768,1975-01-15,72.14,0.46,0.64,120.24,-40.0,True,1,5022,-72.14,-379301.01,362287.08,-17013.93
11769,1975-01-16,72.05,-0.09,-0.12,120.24,-40.08,True,1,5023,-72.05,-379373.06,361907.15,-17465.91
11770,1975-01-17,70.96,-1.09,-1.51,120.24,-40.98,True,1,5024,-70.96,-379444.02,356503.04,-22940.98
11771,1975-01-20,71.08,0.12,0.17,120.24,-40.88,True,1,5025,-71.08,-379515.1,357177.0,-22338.1
11772,1975-01-21,70.7,-0.38,-0.54,120.24,-41.2,True,1,5026,-70.7,-379585.8,355338.2,-24247.6
11773,1975-01-22,71.74,1.04,1.47,120.24,-40.34,True,1,5027,-71.74,-379657.54,360636.98,-19020.56
11774,1975-01-23,72.07,0.33,0.46,120.24,-40.06,True,1,5028,-72.07,-379729.61,362367.96,-17361.65
11775,1975-01-24,72.98,0.91,1.26,120.24,-39.3,True,1,5029,-72.98,-379802.59,367016.42,-12786.17
11776,1975-01-27,75.37,2.39,3.28,120.24,-37.32,True,1,5030,-75.37,-379877.96,379111.1,-766.86
11777,1975-01-28,76.03,0.66,0.88,120.24,-36.77,True,1,5031,-76.03,-379953.99,382506.93,2552.94
11778,1975-01-29,77.26,1.23,1.62,120.24,-35.74,True,1,5032,-77.26,-380031.25,388772.32,8741.07
11779,1975-01-30,76.21,-1.05,-1.36,120.24,-36.62,True,1,5033,-76.21,-380107.46,383564.93,3457.47
11780,1975-01-31,76.98,0.77,1.01,120.24,-35.98,True,1,5034,-76.98,-380184.44,387517.32,7332.88
11781,1975-02-03,77.82,0.84,1.09,120.24,-35.28,True,1,5035,-77.82,-380262.26,391823.7,11561.44
11782,1975-02-04,77.61,-0.21,-0.27,120.24,-35.45,True,1,5036,-77.61,-380339.87,390843.96,10504.09
11783,1975-02-05,78.95,1.34,1.73,120.24,-34.34,True,1,5037,-78.95,-380418.82,397671.15,17252.33
11784,1975-02-06,78.56,-0.39,-0.49,120.24,-34.66,True,1,5038,-78.56,-380497.38,395785.28,15287.9
11785,1975-02-07,78.63,0.07,0.09,120.24,-34.61,True,1,5039,-78.63,-380576.01,396216.57,15640.56
11786,1975-02-10,78.36,-0.27,-0.34,120.24,-34.83,True,1,5040,-78.36,-380654.37,394934.4,14280.03
11787,1975-02-11,78.58,0.22,0.28,120.24,-34.65,True,1,5041,-78.58,-380732.95,396121.78,15388.83
11788,1975-02-12,79.92,1.34,1.7,120.24,-33.53,True,1,5042,-79.92,-380812.87,402956.64,22143.77
11789,1975-02-13,81.01,1.09,1.36,120.24,-32.63,True,1,5043,-81.01,-380893.88,408533.43,27639.55
11790,1975-02-14,81.5,0.49,0.6,120.24,-32.22,True,1,5044,-81.5,-380975.38,411086.0,30110.62
11791,1975-02-18,80.93,-0.57,-0.7,120.24,-32.69,True,1,5045,-80.93,-381056.31,408291.85,27235.54
11792,1975-02-19,81.44,0.51,0.63,120.24,-32.27,True,1,5046,-81.44,-381137.75,410946.24,29808.49
11793,1975-02-20,82.21,0.77,0.94,120.24,-31.63,True,1,5047,-82.21,-381219.96,414913.87,33693.91
11794,1975-02-21,82.62,0.41,0.5,120.24,-31.29,True,1,5048,-82.62,-381302.58,417065.76,35763.18
11795,1975-02-24,81.44,-1.18,-1.43,120.24,-32.27,True,1,5049,-81.44,-381384.02,411190.56,29806.54
11796,1975-02-25,79.53,-1.91,-2.35,120.24,-33.86,True,1,5050,-79.53,-381463.55,401626.5,20162.95
11797,1975-02-26,80.37,0.84,1.06,120.24,-33.16,True,1,5051,-80.37,-381543.92,405948.87,24404.95
11798,1975-02-27,80.77,0.4,0.5,120.24,-32.83,True,1,5052,-80.77,-381624.69,408050.04,26425.35
11799,1975-02-28,81.59,0.82,1.01,120.24,-32.14,True,1,5053,-81.59,-381706.28,412274.27,30567.99
11800,1975-03-03,83.03,1.44,1.76,120.24,-30.95,True,1,5054,-83.03,-381789.31,419633.62,37844.31
11801,1975-03-04,83.56,0.53,0.64,120.24,-30.51,True,1,5055,-83.56,-381872.87,422395.8,40522.93
11802,1975-03-05,83.9,0.34,0.41,120.24,-30.22,True,1,5056,-83.9,-381956.77,424198.4,42241.63
11803,1975-03-06,83.69,-0.21,-0.25,120.24,-30.4,True,1,5057,-83.69,-382040.46,423220.33,41179.87
11804,1975-03-07,84.3,0.61,0.73,120.24,-29.89,True,1,5058,-84.3,-382124.76,426389.4,44264.64
11805,1975-03-10,84.95,0.65,0.77,120.24,-29.35,True,1,5059,-84.95,-382209.71,429762.05,47552.34
11806,1975-03-11,84.36,-0.59,-0.7,120.24,-29.84,True,1,5060,-84.36,-382294.07,426861.6,44567.53
11807,1975-03-12,83.59,-0.77,-0.91,120.24,-30.48,True,1,5061,-83.59,-382377.66,423048.99,40671.33
11808,1975-03-13,83.74,0.15,0.18,120.24,-30.36,True,1,5062,-83.74,-382461.4,423891.88,41430.48
11809,1975-03-14,84.76,1.02,1.22,120.24,-29.51,True,1,5063,-84.76,-382546.16,429139.88,46593.72
11810,1975-03-17,86.01,1.25,1.48,120.24,-28.47,True,1,5064,-86.01,-382632.17,435554.64,52922.47
11811,1975-03-18,85.13,-0.88,-1.02,120.24,-29.2,True,1,5065,-85.13,-382717.3,431183.45,48466.15
11812,1975-03-19,84.34,-0.79,-0.93,120.24,-29.86,True,1,5066,-84.34,-382801.64,427266.44,44464.8
11813,1975-03-20,83.61,-0.73,-0.87,120.24,-30.46,True,1,5067,-83.61,-382885.25,423651.87,40766.62
11814,1975-03-21,83.39,-0.22,-0.26,120.24,-30.65,True,1,5068,-83.39,-382968.64,422620.52,39651.88
11815,1975-03-24,81.42,-1.97,-2.36,120.24,-32.28,True,1,5069,-81.42,-383050.06,412717.98,29667.92
11816,1975-03-25,82.06,0.64,0.79,120.24,-31.75,True,1,5070,-82.06,-383132.12,416044.2,32912.08
11817,1975-03-26,83.59,1.53,1.86,120.24,-30.48,True,1,5071,-83.59,-383215.71,423884.89,40669.18
11818,1975-03-27,83.85,0.26,0.31,120.24,-30.26,True,1,5072,-83.85,-383299.56,425287.2,41987.64
11819,1975-03-31,83.36,-0.49,-0.58,120.24,-30.67,True,1,5073,-83.36,-383382.92,422885.28,39502.36
11820,1975-04-01,82.64,-0.72,-0.86,120.24,-31.27,True,1,5074,-82.64,-383465.56,419315.36,35849.8
11821,1975-04-02,82.43,-0.21,-0.25,120.24,-31.44,True,1,5075,-82.43,-383547.99,418332.25,34784.26
11822,1975-04-03,81.51,-0.92,-1.12,120.24,-32.21,True,1,5076,-81.51,-383629.5,413744.76,30115.26
11823,1975-04-04,80.88,-0.63,-0.77,120.24,-32.74,True,1,5077,-80.88,-383710.38,410627.76,26917.38
11824,1975-04-07,80.35,-0.53,-0.66,120.24,-33.17,True,1,5078,-80.35,-383790.73,408017.3,24226.57
11825,1975-04-08,80.99,0.64,0.8,120.24,-32.64,True,1,5079,-80.99,-383871.72,411348.21,27476.49
11826,1975-04-09,82.84,1.85,2.28,120.24,-31.1,True,1,5080,-82.84,-383954.56,420827.2,36872.64
11827,1975-04-10,83.77,0.93,1.12,120.24,-30.33,True,1,5081,-83.77,-384038.33,425635.37,41597.04
11828,1975-04-11,84.18,0.41,0.49,120.24,-29.99,True,1,5082,-84.18,-384122.51,427802.76,43680.25
11829,1975-04-14,85.6,1.42,1.69,120.24,-28.81,True,1,5083,-85.6,-384208.11,435104.8,50896.69
11830,1975-04-15,86.3,0.7,0.82,120.24,-28.23,True,1,5084,-86.3,-384294.41,438749.2,54454.79
11831,1975-04-16,86.6,0.3,0.35,120.24,-27.98,True,1,5085,-86.6,-384381.01,440361.0,55979.99
11832,1975-04-17,87.25,0.65,0.75,120.24,-27.44,True,1,5086,-87.25,-384468.26,443753.5,59285.24
11833,1975-04-18,86.3,-0.95,-1.09,120.24,-28.23,True,1,5087,-86.3,-384554.56,439008.1,54453.54
11834,1975-04-21,87.23,0.93,1.08,120.24,-27.45,True,1,5088,-87.23,-384641.79,443826.24,59184.45
11835,1975-04-22,87.09,-0.14,-0.16,120.24,-27.57,True,1,5089,-87.09,-384728.88,443201.01,58472.13
11836,1975-04-23,86.12,-0.97,-1.11,120.24,-28.38,True,1,5090,-86.12,-384815.0,438350.8,53535.8
11837,1975-04-24,86.04,-0.08,-0.09,120.24,-28.44,True,1,5091,-86.04,-384901.04,438029.64,53128.6
11838,1975-04-25,86.62,0.58,0.67,120.24,-27.96,True,1,5092,-86.62,-384987.66,441069.04,56081.38
11839,1975-04-28,86.23,-0.39,-0.45,120.24,-28.28,True,1,5093,-86.23,-385073.89,439169.39,54095.5
11840,1975-04-29,85.64,-0.59,-0.68,120.24,-28.78,True,1,5094,-85.64,-385159.53,436250.16,51090.63
11841,1975-04-30,87.3,1.66,1.94,120.24,-27.4,True,1,5095,-87.3,-385246.83,444793.5,59546.67
11842,1975-05-01,88.1,0.8,0.92,120.24,-26.73,True,1,5096,-88.1,-385334.93,448957.6,63622.67
11843,1975-05-02,89.22,1.12,1.27,120.24,-25.8,True,1,5097,-89.22,-385424.15,454754.34,69330.19
11844,1975-05-05,90.08,0.86,0.96,120.24,-25.08,True,1,5098,-90.08,-385514.23,459227.84,73713.61
11845,1975-05-06,88.64,-1.44,-1.6,120.24,-26.28,True,1,5099,-88.64,-385602.87,451975.36,66372.49
11846,1975-05-07,89.08,0.44,0.5,120.24,-25.92,True,1,5100,-89.08,-385691.95,454308.0,68616.05
11847,1975-05-08,89.56,0.48,0.54,120.24,-25.52,True,1,5101,-89.56,-385781.51,456845.56,71064.05
11848,1975-05-09,90.53,0.97,1.08,120.24,-24.71,True,1,5102,-90.53,-385872.04,461884.06,76012.02
11849,1975-05-12,90.61,0.08,0.09,120.24,-24.64,True,1,5103,-90.61,-385962.65,462382.83,76420.18
11850,1975-05-13,91.58,0.97,1.07,120.24,-23.84,True,1,5104,-91.58,-386054.23,467424.32,81370.09
11851,1975-05-14,92.27,0.69,0.75,120.24,-23.26,True,1,5105,-92.27,-386146.5,471038.35,84891.85
11852,1975-05-15,91.41,-0.86,-0.93,120.24,-23.98,True,1,5106,-91.41,-386237.91,466739.46,80501.55
11853,1975-05-16,90.43,-0.98,-1.07,120.24,-24.79,True,1,5107,-90.43,-386328.34,461826.01,75497.67
11854,1975-05-19,90.53,0.1,0.11,120.24,-24.71,True,1,5108,-90.53,-386418.87,462427.24,76008.37
11855,1975-05-20,90.07,-0.46,-0.51,120.24,-25.09,True,1,5109,-90.07,-386508.94,460167.63,73658.69
11856,1975-05-21,89.06,-1.01,-1.12,120.24,-25.93,True,1,5110,-89.06,-386598.0,455096.6,68498.6
11857,1975-05-22,89.39,0.33,0.37,120.24,-25.66,True,1,5111,-89.39,-386687.39,456872.29,70184.9
11858,1975-05-23,90.58,1.19,1.33,120.24,-24.67,True,1,5112,-90.58,-386777.97,463044.96,76266.99
11859,1975-05-27,90.34,-0.24,-0.26,120.24,-24.87,True,1,5113,-90.34,-386868.31,461908.42,75040.11
11860,1975-05-28,89.71,-0.63,-0.7,120.24,-25.39,True,1,5114,-89.71,-386958.02,458776.94,71818.92
11861,1975-05-29,89.68,-0.03,-0.03,120.24,-25.42,True,1,5115,-89.68,-387047.7,458713.2,71665.5
11862,1975-05-30,91.15,1.47,1.64,120.24,-24.19,True,1,5116,-91.15,-387138.85,466323.4,79184.55
11863,1975-06-02,92.58,1.43,1.57,120.24,-23.0,True,1,5117,-92.58,-387231.43,473731.86,86500.43
11864,1975-06-03,92.89,0.31,0.34,120.24,-22.75,True,1,5118,-92.89,-387324.32,475411.02,88086.7
11865,1975-06-04,92.6,-0.29,-0.31,120.24,-22.99,True,1,5119,-92.6,-387416.92,474019.4,86602.48
11866,1975-06-05,92.69,0.09,0.1,120.24,-22.91,True,1,5120,-92.69,-387509.61,474572.8,87063.19
11867,1975-06-06,92.48,-0.21,-0.23,120.24,-23.09,True,1,5121,-92.48,-387602.09,473590.08,85987.99
11868,1975-06-09,91.21,-1.27,-1.37,120.24,-24.14,True,1,5122,-91.21,-387693.3,467177.62,79484.32
11869,1975-06-10,90.44,-0.77,-0.84,120.24,-24.78,True,1,5123,-90.44,-387783.74,463324.12,75540.38
11870,1975-06-11,90.55,0.11,0.12,120.24,-24.69,True,1,5124,-90.55,-387874.29,463978.2,76103.91
11871,1975-06-12,90.08,-0.47,-0.52,120.24,-25.08,True,1,5125,-90.08,-387964.37,461660.0,73695.63
11872,1975-06-13,90.52,0.44,0.49,120.24,-24.72,True,1,5126,-90.52,-388054.89,464005.52,75950.63
11873,1975-06-16,91.46,0.94,1.04,120.24,-23.94,True,1,5127,-91.46,-388146.35,468915.42,80769.07
11874,1975-06-17,90.58,-0.88,-0.96,120.24,-24.67,True,1,5128,-90.58,-388236.93,464494.24,76257.31
11875,1975-06-18,90.39,-0.19,-0.21,120.24,-24.82,True,1,5129,-90.39,-388327.32,463610.31,75282.99
11876,1975-06-19,92.02,1.63,1.8,120.24,-23.47,True,1,5130,-92.02,-388419.34,472062.6,83643.26
11877,1975-06-20,92.61,0.59,0.64,120.24,-22.98,True,1,5131,-92.61,-388511.95,475181.91,86669.96
11878,1975-06-23,93.62,1.01,1.09,120.24,-22.14,True,1,5132,-93.62,-388605.57,480457.84,91852.27
11879,1975-06-24,94.19,0.57,0.61,120.24,-21.66,True,1,5133,-94.19,-388699.76,483477.27,94777.51
11880,1975-06-25,94.62,0.43,0.46,120.24,-21.31,True,1,5134,-94.62,-388794.38,485779.08,96984.7
11881,1975-06-26,94.81,0.19,0.2,120.24,-21.15,True,1,5135,-94.81,-388889.19,486849.35,97960.16
11882,1975-06-27,94.81,0.0,0.0,120.24,-21.15,True,1,5136,-94.81,-388984.0,486944.16,97960.16
11883,1975-06-30,95.19,0.38,0.4,120.24,-20.83,True,1,5137,-95.19,-389079.19,488991.03,99911.84
11884,1975-07-01,94.85,-0.34,-0.36,120.24,-21.12,True,1,5138,-94.85,-389174.04,487339.3,98165.26
11885,1975-07-02,94.18,-0.67,-0.71,120.24,-21.67,True,1,5139,-94.18,-389268.22,483991.02,94722.8
11886,1975-07-03,94.36,0.18,0.19,120.24,-21.52,True,1,5140,-94.36,-389362.58,485010.4,95647.82
11887,1975-07-07,93.54,-0.82,-0.87,120.24,-22.21,True,1,5141,-93.54,-389456.12,480889.14,91433.02
11888,1975-07-08,93.39,-0.15,-0.16,120.24,-22.33,True,1,5142,-93.39,-389549.51,480211.38,90661.87
11889,1975-07-09,94.8,1.41,1.51,120.24,-21.16,True,1,5143,-94.8,-389644.31,487556.4,97912.09
11890,1975-07-10,94.81,0.01,0.01,120.24,-21.15,True,1,5144,-94.81,-389739.12,487702.64,97963.52
11891,1975-07-11,94.66,-0.15,-0.16,120.24,-21.27,True,1,5145,-94.66,-389833.78,487025.7,97191.92
11892,1975-07-14,95.19,0.53,0.56,120.24,-20.83,True,1,5146,-95.19,-389928.97,489847.74,99918.77
11893,1975-07-15,95.61,0.42,0.44,120.24,-20.48,True,1,5147,-95.61,-390024.58,492104.67,102080.09
11894,1975-07-16,94.61,-1.0,-1.05,120.24,-21.32,True,1,5148,-94.61,-390119.19,487052.28,96933.09
11895,1975-07-17,93.63,-0.98,-1.04,120.24,-22.13,True,1,5149,-93.63,-390212.82,482100.87,91888.05
11896,1975-07-18,93.2,-0.43,-0.46,120.24,-22.49,True,1,5150,-93.2,-390306.02,479980.0,89673.98
11897,1975-07-21,92.44,-0.76,-0.82,120.24,-23.12,True,1,5151,-92.44,-390398.46,476158.44,85759.98
11898,1975-07-22,91.45,-0.99,-1.07,120.24,-23.94,True,1,5152,-91.45,-390489.91,471150.4,80660.49
11899,1975-07-23,90.18,-1.27,-1.39,120.24,-25.0,True,1,5153,-90.18,-390580.09,464697.54,74117.45
11900,1975-07-24,90.07,-0.11,-0.12,120.24,-25.09,True,1,5154,-90.07,-390670.16,464220.78,73550.62
11901,1975-07-25,89.29,-0.78,-0.87,120.24,-25.74,True,1,5155,-89.29,-390759.45,460289.95,69530.5
11902,1975-07-28,88.69,-0.6,-0.67,120.24,-26.24,True,1,5156,-88.69,-390848.14,457285.64,66437.5
11903,1975-07-29,88.19,-0.5,-0.56,120.24,-26.66,True,1,5157,-88.19,-390936.33,454795.83,63859.5
11904,1975-07-30,88.83,0.64,0.73,120.24,-26.12,True,1,5158,-88.83,-391025.16,458185.14,67159.98
11905,1975-07-31,88.75,-0.08,-0.09,120.24,-26.19,True,1,5159,-88.75,-391113.91,457861.25,66747.34
11906,1975-08-01,87.99,-0.76,-0.86,120.24,-26.82,True,1,5160,-87.99,-391201.9,454028.4,62826.5
11907,1975-08-04,87.15,-0.84,-0.96,120.24,-27.52,True,1,5161,-87.15,-391289.05,449781.15,58492.1
11908,1975-08-05,86.23,-0.92,-1.06,120.24,-28.28,True,1,5162,-86.23,-391375.28,445119.26,53743.98
11909,1975-08-06,86.25,0.02,0.02,120.24,-28.27,True,1,5163,-86.25,-391461.53,445308.75,53847.22
11910,1975-08-07,86.3,0.05,0.06,120.24,-28.23,True,1,5164,-86.3,-391547.83,445653.2,54105.37
11911,1975-08-08,86.02,-0.28,-0.32,120.24,-28.46,True,1,5165,-86.02,-391633.85,444293.3,52659.45
11912,1975-08-11,86.55,0.53,0.62,120.24,-28.02,True,1,5166,-86.55,-391720.4,447117.3,55396.9
11913,1975-08-12,87.12,0.57,0.66,120.24,-27.54,True,1,5167,-87.12,-391807.52,450149.04,58341.52
11914,1975-08-13,85.97,-1.15,-1.32,120.24,-28.5,True,1,5168,-85.97,-391893.49,444292.96,52399.47
11915,1975-08-14,85.6,-0.37,-0.43,120.24,-28.81,True,1,5169,-85.6,-391979.09,442466.4,50487.31
11916,1975-08-15,86.36,0.76,0.89,120.24,-28.18,True,1,5170,-86.36,-392065.45,446481.2,54415.75
11917,1975-08-18,86.2,-0.16,-0.18,120.24,-28.31,True,1,5171,-86.2,-392151.65,445740.2,53588.55
11918,1975-08-19,84.95,-1.25,-1.45,120.24,-29.35,True,1,5172,-84.95,-392236.6,439361.4,47124.8
11919,1975-08-20,83.22,-1.73,-2.04,120.24,-30.79,True,1,5173,-83.22,-392319.82,430497.06,38177.24
11920,1975-08-21,83.07,-0.15,-0.18,120.24,-30.91,True,1,5174,-83.07,-392402.89,429804.18,37401.29
11921,1975-08-22,84.28,1.21,1.46,120.24,-29.91,True,1,5175,-84.28,-392487.17,436149.0,43661.83
11922,1975-08-25,85.06,0.78,0.92,120.24,-29.26,True,1,5176,-85.06,-392572.23,440270.56,47698.33
11923,1975-08-26,83.96,-1.1,-1.29,120.24,-30.17,True,1,5177,-83.96,-392656.19,434660.92,42004.73
11924,1975-08-27,84.43,0.47,0.56,120.24,-29.78,True,1,5178,-84.43,-392740.62,437178.54,44437.92
11925,1975-08-28,86.4,1.97,2.33,120.24,-28.14,True,1,5179,-86.4,-392827.02,447465.6,54638.58
11926,1975-08-29,86.88,0.48,0.56,120.24,-27.74,True,1,5180,-86.88,-392913.9,450038.4,57124.5
11927,1975-09-02,85.48,-1.4,-1.61,120.24,-28.91,True,1,5181,-85.48,-392999.38,442871.88,49872.5
11928,1975-09-03,86.03,0.55,0.64,120.24,-28.45,True,1,5182,-86.03,-393085.41,445807.46,52722.05
11929,1975-09-04,86.2,0.17,0.2,120.24,-28.31,True,1,5183,-86.2,-393171.61,446774.6,53602.99
11930,1975-09-05,85.62,-0.58,-0.67,120.24,-28.79,True,1,5184,-85.62,-393257.23,443854.08,50596.85
11931,1975-09-08,85.89,0.27,0.32,120.24,-28.57,True,1,5185,-85.89,-393343.12,445339.65,51996.53
11932,1975-09-09,84.6,-1.29,-1.5,120.24,-29.64,True,1,5186,-84.6,-393427.72,438735.6,45307.88
11933,1975-09-10,83.79,-0.81,-0.96,120.24,-30.31,True,1,5187,-83.79,-393511.51,434618.73,41107.22
11934,1975-09-11,83.45,-0.34,-0.41,120.24,-30.6,True,1,5188,-83.45,-393594.96,432938.6,39343.64
11935,1975-09-12,83.3,-0.15,-0.18,120.24,-30.72,True,1,5189,-83.3,-393678.26,432243.7,38565.44
11936,1975-09-15,82.88,-0.42,-0.5,120.24,-31.07,True,1,5190,-82.88,-393761.14,430147.2,36386.06
11937,1975-09-16,82.09,-0.79,-0.95,120.24,-31.73,True,1,5191,-82.09,-393843.23,426129.19,32285.96
11938,1975-09-17,82.37,0.28,0.34,120.24,-31.5,True,1,5192,-82.37,-393925.6,427665.04,33739.44
11939,1975-09-18,84.06,1.69,2.05,120.24,-30.09,True,1,5193,-84.06,-394009.66,436523.58,42513.92
11940,1975-09-19,85.88,1.82,2.16,120.24,-28.58,True,1,5194,-85.88,-394095.54,446060.72,51965.18
11941,1975-09-22,85.07,-0.81,-0.94,120.24,-29.25,True,1,5195,-85.07,-394180.61,441938.65,47758.04
11942,1975-09-23,84.94,-0.13,-0.15,120.24,-29.36,True,1,5196,-84.94,-394265.55,441348.24,47082.69
11943,1975-09-24,85.74,0.8,0.94,120.24,-28.69,True,1,5197,-85.74,-394351.29,445590.78,51239.49
11944,1975-09-25,85.64,-0.1,-0.12,120.24,-28.78,True,1,5198,-85.64,-394436.93,445156.72,50719.79
11945,1975-09-26,86.19,0.55,0.64,120.24,-28.32,True,1,5199,-86.19,-394523.12,448101.81,53578.69
11946,1975-09-29,85.03,-1.16,-1.35,120.24,-29.28,True,1,5200,-85.03,-394608.15,442156.0,47547.85
11947,1975-09-30,83.87,-1.16,-1.36,120.24,-30.25,True,1,5201,-83.87,-394692.02,436207.87,41515.85
11948,1975-10-01,82.93,-0.94,-1.12,120.24,-31.03,True,1,5202,-82.93,-394774.95,431401.86,36626.91
11949,1975-10-02,83.82,0.89,1.07,120.24,-30.29,True,1,5203,-83.82,-394858.77,436115.46,41256.69
11950,1975-10-03,85.95,2.13,2.54,120.24,-28.52,True,1,5204,-85.95,-394944.72,447283.8,52339.08
11951,1975-10-06,86.88,0.93,1.08,120.24,-27.74,True,1,5205,-86.88,-395031.6,452210.4,57178.8
11952,1975-10-07,86.77,-0.11,-0.13,120.24,-27.84,True,1,5206,-86.77,-395118.37,451724.62,56606.25
11953,1975-10-08,87.94,1.17,1.35,120.24,-26.86,True,1,5207,-87.94,-395206.31,457903.58,62697.27
11954,1975-10-09,88.37,0.43,0.49,120.24,-26.5,True,1,5208,-88.37,-395294.68,460230.96,64936.28
11955,1975-10-10,88.21,-0.16,-0.18,120.24,-26.64,True,1,5209,-88.21,-395382.89,459485.89,64103.0
11956,1975-10-13,89.46,1.25,1.42,120.24,-25.6,True,1,5210,-89.46,-395472.35,466086.6,70614.25
11957,1975-10-14,89.28,-0.18,-0.2,120.24,-25.75,True,1,5211,-89.28,-395561.63,465238.08,69676.45
11958,1975-10-15,89.23,-0.05,-0.06,120.24,-25.79,True,1,5212,-89.23,-395650.86,465066.76,69415.9
11959,1975-10-16,89.37,0.14,0.16,120.24,-25.67,True,1,5213,-89.37,-395740.23,465885.81,70145.58
11960,1975-10-17,88.86,-0.51,-0.57,120.24,-26.1,True,1,5214,-88.86,-395829.09,463316.04,67486.95
11961,1975-10-20,89.82,0.96,1.08,120.24,-25.3,True,1,5215,-89.82,-395918.91,468411.3,72492.39
11962,1975-10-21,90.56,0.74,0.82,120.24,-24.68,True,1,5216,-90.56,-396009.47,472360.96,76351.49
11963,1975-10-22,90.71,0.15,0.17,120.24,-24.56,True,1,5217,-90.71,-396100.18,473234.07,77133.89
11964,1975-10-23,91.24,0.53,0.58,120.24,-24.12,True,1,5218,-91.24,-396191.42,476090.32,79898.9
11965,1975-10-24,89.83,-1.41,-1.54,120.24,-25.29,True,1,5219,-89.83,-396281.25,468822.77,72541.52
11966,1975-10-27,89.73,-0.1,-0.11,120.24,-25.37,True,1,5220,-89.73,-396370.98,468390.6,72019.62
11967,1975-10-28,90.51,0.78,0.87,120.24,-24.73,True,1,5221,-90.51,-396461.49,472552.71,76091.22
11968,1975-10-29,89.39,-1.12,-1.24,120.24,-25.66,True,1,5222,-89.39,-396550.88,466794.58,70243.7
11969,1975-10-30,89.31,-0.08,-0.09,120.24,-25.72,True,1,5223,-89.31,-396640.19,466466.13,69825.94
11970,1975-10-31,89.04,-0.27,-0.3,120.24,-25.95,True,1,5224,-89.04,-396729.23,465144.96,68415.73
11971,1975-11-03,88.09,-0.95,-1.07,120.24,-26.74,True,1,5225,-88.09,-396817.32,460270.25,63452.93
11972,1975-11-04,88.51,0.42,0.48,120.24,-26.39,True,1,5226,-88.51,-396905.83,462553.26,65647.43
11973,1975-11-05,89.15,0.64,0.72,120.24,-25.86,True,1,5227,-89.15,-396994.98,465987.05,68992.07
11974,1975-11-06,89.55,0.4,0.45,120.24,-25.52,True,1,5228,-89.55,-397084.53,468167.4,71082.87
11975,1975-11-07,89.33,-0.22,-0.25,120.24,-25.71,True,1,5229,-89.33,-397173.86,467106.57,69932.71
11976,1975-11-10,89.34,0.01,0.01,120.24,-25.7,True,1,5230,-89.34,-397263.2,467248.2,69985.0
11977,1975-11-11,89.87,0.53,0.59,120.24,-25.26,True,1,5231,-89.87,-397353.07,470109.97,72756.9
11978,1975-11-12,91.19,1.32,1.47,120.24,-24.16,True,1,5232,-91.19,-397444.26,477106.08,79661.82
11979,1975-11-13,91.04,-0.15,-0.16,120.24,-24.28,True,1,5233,-91.04,-397535.3,476412.32,78877.02
11980,1975-11-14,90.97,-0.07,-0.08,120.24,-24.34,True,1,5234,-90.97,-397626.27,476136.98,78510.71
11981,1975-11-17,91.46,0.49,0.54,120.24,-23.94,True,1,5235,-91.46,-397717.73,478793.1,81075.37
11982,1975-11-18,91.0,-0.46,-0.5,120.24,-24.32,True,1,5236,-91.0,-397808.73,476476.0,78667.27
11983,1975-11-19,89.98,-1.02,-1.12,120.24,-25.17,True,1,5237,-89.98,-397898.71,471225.26,73326.55
11984,1975-11-20,89.64,-0.34,-0.38,120.24,-25.45,True,1,5238,-89.64,-397988.35,469534.32,71545.97
11985,1975-11-21,89.53,-0.11,-0.12,120.24,-25.54,True,1,5239,-89.53,-398077.88,469047.67,70969.79
11986,1975-11-24,89.7,0.17,0.19,120.24,-25.4,True,1,5240,-89.7,-398167.58,470028.0,71860.42
11987,1975-11-25,90.71,1.01,1.13,120.24,-24.56,True,1,5241,-90.71,-398258.29,475411.11,77152.82
11988,1975-11-26,90.94,0.23,0.25,120.24,-24.37,True,1,5242,-90.94,-398349.23,476707.48,78358.25
11989,1975-11-28,91.24,0.3,0.33,120.24,-24.12,True,1,5243,-91.24,-398440.47,478371.32,79930.85
11990,1975-12-01,90.67,-0.57,-0.62,120.24,-24.59,True,1,5244,-90.67,-398531.14,475473.48,76942.34
11991,1975-12-02,89.33,-1.34,-1.48,120.24,-25.71,True,1,5245,-89.33,-398620.47,468535.85,69915.38
11992,1975-12-03,87.6,-1.73,-1.94,120.24,-27.15,True,1,5246,-87.6,-398708.07,459549.6,60841.53
11993,1975-12-04,87.84,0.24,0.27,120.24,-26.95,True,1,5247,-87.84,-398795.91,460896.48,62100.57
11994,1975-12-05,86.82,-1.02,-1.16,120.24,-27.79,True,1,5248,-86.82,-398882.73,455631.36,56748.63
11995,1975-12-08,87.07,0.25,0.29,120.24,-27.59,True,1,5249,-87.07,-398969.8,457030.43,58060.63
11996,1975-12-09,87.3,0.23,0.26,120.24,-27.4,True,1,5250,-87.3,-399057.1,458325.0,59267.9
11997,1975-12-10,88.08,0.78,0.89,120.24,-26.75,True,1,5251,-88.08,-399145.18,462508.08,63362.9
11998,1975-12-11,87.8,-0.28,-0.32,120.24,-26.98,True,1,5252,-87.8,-399232.98,461125.6,61892.62
11999,1975-12-12,87.83,0.03,0.03,120.24,-26.95,True,1,5253,-87.83,-399320.81,461370.99,62050.18
12000,1975-12-15,88.09,0.26,0.3,120.24,-26.74,True,1,5254,-88.09,-399408.9,462824.86,63415.96
12001,1975-12-16,88.93,0.84,0.95,120.24,-26.04,True,1,5255,-88.93,-399497.83,467327.15,67829.32
12002,1975-12-17,89.15,0.22,0.25,120.24,-25.86,True,1,5256,-89.15,-399586.98,468572.4,68985.42
12003,1975-12-18,89.43,0.28,0.31,120.24,-25.62,True,1,5257,-89.43,-399676.41,470133.51,70457.1
12004,1975-12-19,88.8,-0.63,-0.7,120.24,-26.15,True,1,5258,-88.8,-399765.21,466910.4,67145.19
12005,1975-12-22,88.14,-0.66,-0.74,120.24,-26.7,True,1,5259,-88.14,-399853.35,463528.26,63674.91
12006,1975-12-23,88.73,0.59,0.67,120.24,-26.21,True,1,5260,-88.73,-399942.08,466719.8,66777.72
12007,1975-12-24,89.46,0.73,0.82,120.24,-25.6,True,1,5261,-89.46,-400031.54,470649.06,70617.52
12008,1975-12-26,90.25,0.79,0.88,120.24,-24.94,True,1,5262,-90.25,-400121.79,474895.5,74773.71
12009,1975-12-29,90.13,-0.12,-0.13,120.24,-25.04,True,1,5263,-90.13,-400211.92,474354.19,74142.27
12010,1975-12-30,89.77,-0.36,-0.4,120.24,-25.34,True,1,5264,-89.77,-400301.69,472549.28,72247.59
12011,1975-12-31,90.19,0.42,0.47,120.24,-24.99,True,1,5265,-90.19,-400391.88,474850.35,74458.47
12012,1976-01-02,90.9,0.71,0.79,120.24,-24.4,True,1,5266,-90.9,-400482.78,478679.4,78196.62
12013,1976-01-05,92.58,1.68,1.85,120.24,-23.0,True,1,5267,-92.58,-400575.36,487618.86,87043.5
12014,1976-01-06,93.53,0.95,1.03,120.24,-22.21,True,1,5268,-93.53,-400668.89,492716.04,92047.15
12015,1976-01-07,93.95,0.42,0.45,120.24,-21.86,True,1,5269,-93.95,-400762.84,495022.55,94259.71
12016,1976-01-08,94.58,0.63,0.67,120.24,-21.34,True,1,5270,-94.58,-400857.42,498436.6,97579.18
12017,1976-01-09,94.95,0.37,0.39,120.24,-21.03,True,1,5271,-94.95,-400952.37,500481.45,99529.08
12018,1976-01-12,96.33,1.38,1.45,120.24,-19.89,True,1,5272,-96.33,-401048.7,507851.76,106803.06
12019,1976-01-13,95.57,-0.76,-0.79,120.24,-20.52,True,1,5273,-95.57,-401144.27,503940.61,102796.34
12020,1976-01-14,97.13,1.56,1.63,120.24,-19.22,True,1,5274,-97.13,-401241.4,512263.62,111022.22
12021,1976-01-15,96.61,-0.52,-0.54,120.24,-19.65,True,1,5275,-96.61,-401338.01,509617.75,108279.74
12022,1976-01-16,97.0,0.39,0.4,120.24,-19.33,True,1,5276,-97.0,-401435.01,511772.0,110336.99
12023,1976-01-19,98.32,1.32,1.36,120.24,-18.23,True,1,5277,-98.32,-401533.33,518834.64,117301.31
12024,1976-01-20,98.86,0.54,0.55,120.24,-17.78,True,1,5278,-98.86,-401632.19,521783.08,120150.89
12025,1976-01-21,98.24,-0.62,-0.63,120.24,-18.3,True,1,5279,-98.24,-401730.43,518608.96,116878.53
12026,1976-01-22,98.04,-0.2,-0.2,120.24,-18.46,True,1,5280,-98.04,-401828.47,517651.2,115822.73
12027,1976-01-23,99.21,1.17,1.19,120.24,-17.49,True,1,5281,-99.21,-401927.68,523928.01,122000.33
12028,1976-01-26,99.68,0.47,0.47,120.24,-17.1,True,1,5282,-99.68,-402027.36,526509.76,124482.4
12029,1976-01-27,99.07,-0.61,-0.61,120.24,-17.61,True,1,5283,-99.07,-402126.43,523386.81,121260.38
12030,1976-01-28,98.53,-0.54,-0.55,120.24,-18.06,True,1,5284,-98.53,-402224.96,520632.52,118407.56
12031,1976-01-29,100.11,1.58,1.6,120.24,-16.74,True,1,5285,-100.11,-402325.07,529081.35,126756.28
12032,1976-01-30,100.86,0.75,0.75,120.24,-16.12,True,1,5286,-100.86,-402425.93,533145.96,130720.03
12033,1976-02-02,100.87,0.01,0.01,120.24,-16.11,True,1,5287,-100.87,-402526.8,533299.69,130772.89
12034,1976-02-03,101.18,0.31,0.31,120.24,-15.85,True,1,5288,-101.18,-402627.98,535039.84,132411.86
12035,1976-02-04,101.91,0.73,0.72,120.24,-15.24,True,1,5289,-101.91,-402729.89,539001.99,136272.1
12036,1976-02-05,100.39,-1.52,-1.49,120.24,-16.51,True,1,5290,-100.39,-402830.28,531063.1,128232.82
12037,1976-02-06,99.46,-0.93,-0.93,120.24,-17.28,True,1,5291,-99.46,-402929.74,526242.86,123313.12
12038,1976-02-09,99.62,0.16,0.16,120.24,-17.15,True,1,5292,-99.62,-403029.36,527189.04,124159.68
12039,1976-02-10,100.47,0.85,0.85,120.24,-16.44,True,1,5293,-100.47,-403129.83,531787.71,128657.88
12040,1976-02-11,100.77,0.3,0.3,120.24,-16.19,True,1,5294,-100.77,-403230.6,533476.38,130245.78
12041,1976-02-12,100.25,-0.52,-0.52,120.24,-16.62,True,1,5295,-100.25,-403330.85,530823.75,127492.9
12042,1976-02-13,99.67,-0.58,-0.58,120.24,-17.11,True,1,5296,-99.67,-403430.52,527852.32,124421.8
12043,1976-02-17,99.05,-0.62,-0.62,120.24,-17.62,True,1,5297,-99.05,-403529.57,524667.85,121138.28
12044,1976-02-18,99.85,0.8,0.81,120.24,-16.96,True,1,5298,-99.85,-403629.42,529005.3,125375.88
12045,1976-02-19,101.41,1.56,1.56,120.24,-15.66,True,1,5299,-101.41,-403730.83,537371.59,133640.76
12046,1976-02-20,102.1,0.69,0.68,120.24,-15.09,True,1,5300,-102.1,-403832.93,541130.0,137297.07
12047,1976-02-23,101.61,-0.49,-0.48,120.24,-15.49,True,1,5301,-101.61,-403934.54,538634.61,134700.07
12048,1976-02-24,102.03,0.42,0.41,120.24,-15.14,True,1,5302,-102.03,-404036.57,540963.06,136926.49
12049,1976-02-25,101.69,-0.34,-0.33,120.24,-15.43,True,1,5303,-101.69,-404138.26,539262.07,135123.81
12050,1976-02-26,100.11,-1.58,-1.55,120.24,-16.74,True,1,5304,-100.11,-404238.37,530983.44,126745.07
12051,1976-02-27,99.71,-0.4,-0.4,120.24,-17.07,True,1,5305,-99.71,-404338.08,528961.55,124623.47
12052,1976-03-01,100.02,0.31,0.31,120.24,-16.82,True,1,5306,-100.02,-404438.1,530706.12,126268.02
12053,1976-03-02,100.58,0.56,0.56,120.24,-16.35,True,1,5307,-100.58,-404538.68,533778.06,129239.38
12054,1976-03-03,99.98,-0.6,-0.6,120.24,-16.85,True,1,5308,-99.98,-404638.66,530693.84,126055.18
12055,1976-03-04,98.92,-1.06,-1.06,120.24,-17.73,True,1,5309,-98.92,-404737.58,525166.28,120428.7
12056,1976-03-05,99.11,0.19,0.19,120.24,-17.57,True,1,5310,-99.11,-404836.69,526274.1,121437.41
12057,1976-03-08,100.19,1.08,1.09,120.24,-16.68,True,1,5311,-100.19,-404936.88,532109.09,127172.21
12058,1976-03-09,100.58,0.39,0.39,120.24,-16.35,True,1,5312,-100.58,-405037.46,534280.96,129243.5
12059,1976-03-10,100.94,0.36,0.36,120.24,-16.05,True,1,5313,-100.94,-405138.4,536294.22,131155.82
12060,1976-03-11,101.89,0.95,0.94,120.24,-15.26,True,1,5314,-101.89,-405240.29,541443.46,136203.17
12061,1976-03-12,100.86,-1.03,-1.01,120.24,-16.12,True,1,5315,-100.86,-405341.15,536070.9,130729.75
12062,1976-03-15,99.8,-1.06,-1.05,120.24,-17.0,True,1,5316,-99.8,-405440.95,530536.8,125095.85
12063,1976-03-16,100.92,1.12,1.12,120.24,-16.07,True,1,5317,-100.92,-405541.87,536591.64,131049.77
12064,1976-03-17,100.86,-0.06,-0.06,120.24,-16.12,True,1,5318,-100.86,-405642.73,536373.48,130730.75
12065,1976-03-18,100.45,-0.41,-0.41,120.24,-16.46,True,1,5319,-100.45,-405743.18,534293.55,128550.37
12066,1976-03-19,100.58,0.13,0.13,120.24,-16.35,True,1,5320,-100.58,-405843.76,535085.6,129241.84
12067,1976-03-22,100.71,0.13,0.13,120.24,-16.24,True,1,5321,-100.71,-405944.47,535877.91,129933.44
12068,1976-03-23,102.24,1.53,1.52,120.24,-14.97,True,1,5322,-102.24,-406046.71,544121.28,138074.57
12069,1976-03-24,103.42,1.18,1.15,120.24,-13.99,True,1,5323,-103.42,-406150.13,550504.66,144354.53
12070,1976-03-25,102.85,-0.57,-0.55,120.24,-14.46,True,1,5324,-102.85,-406252.98,547573.4,141320.42
12071,1976-03-26,102.85,0.0,0.0,120.24,-14.46,True,1,5325,-102.85,-406355.83,547676.25,141320.42
12072,1976-03-29,102.41,-0.44,-0.43,120.24,-14.83,True,1,5326,-102.41,-406458.24,545435.66,138977.42
12073,1976-03-30,102.01,-0.4,-0.39,120.24,-15.16,True,1,5327,-102.01,-406560.25,543407.27,136847.02
12074,1976-03-31,102.77,0.76,0.74,120.24,-14.53,True,1,5328,-102.77,-406663.02,547558.56,140895.54
12075,1976-04-01,102.24,-0.53,-0.52,120.24,-14.97,True,1,5329,-102.24,-406765.26,544836.96,138071.7
12076,1976-04-02,102.25,0.01,0.01,120.24,-14.96,True,1,5330,-102.25,-406867.51,544992.5,138124.99
12077,1976-04-05,103.51,1.26,1.23,120.24,-13.91,True,1,5331,-103.51,-406971.02,551811.81,144840.79
12078,1976-04-06,103.36,-0.15,-0.14,120.24,-14.04,True,1,5332,-103.36,-407074.38,551115.52,144041.14
12079,1976-04-07,102.21,-1.15,-1.11,120.24,-15.0,True,1,5333,-102.21,-407176.59,545085.93,137909.34
12080,1976-04-08,101.28,-0.93,-0.91,120.24,-15.77,True,1,5334,-101.28,-407277.87,540227.52,132949.65
12081,1976-04-09,100.35,-0.93,-0.92,120.24,-16.54,True,1,5335,-100.35,-407378.22,535367.25,127989.03
12082,1976-04-12,100.2,-0.15,-0.15,120.24,-16.67,True,1,5336,-100.2,-407478.42,534667.2,127188.78
12083,1976-04-13,101.05,0.85,0.85,120.24,-15.96,True,1,5337,-101.05,-407579.47,539303.85,131724.38
12084,1976-04-14,100.31,-0.74,-0.73,120.24,-16.58,True,1,5338,-100.31,-407679.78,535454.78,127775.0
12085,1976-04-15,100.67,0.36,0.36,120.24,-16.28,True,1,5339,-100.67,-407780.45,537477.13,129696.68
12086,1976-04-19,101.44,0.77,0.76,120.24,-15.64,True,1,5340,-101.44,-407881.89,541689.6,133807.71
12087,1976-04-20,102.87,1.43,1.41,120.24,-14.45,True,1,5341,-102.87,-407984.76,549428.67,141443.91
12088,1976-04-21,103.32,0.45,0.44,120.24,-14.07,True,1,5342,-103.32,-408088.08,551935.44,143847.36
12089,1976-04-22,102.98,-0.34,-0.33,120.24,-14.36,True,1,5343,-102.98,-408191.06,550222.14,142031.08
12090,1976-04-23,102.29,-0.69,-0.67,120.24,-14.93,True,1,5344,-102.29,-408293.35,546637.76,138344.41
12091,1976-04-26,102.43,0.14,0.14,120.24,-14.81,True,1,5345,-102.43,-408395.78,547488.35,139092.57
12092,1976-04-27,101.86,-0.57,-0.56,120.24,-15.29,True,1,5346,-101.86,-408497.64,544543.56,136045.92
12093,1976-04-28,102.13,0.27,0.26,120.24,-15.06,True,1,5347,-102.13,-408599.77,546089.11,137489.34
12094,1976-04-29,102.13,0.0,0.0,120.24,-15.06,True,1,5348,-102.13,-408701.9,546191.24,137489.34
12095,1976-04-30,101.64,-0.49,-0.48,120.24,-15.47,True,1,5349,-101.64,-408803.54,543672.36,134868.82
12096,1976-05-03,100.92,-0.72,-0.71,120.24,-16.07,True,1,5350,-100.92,-408904.46,539922.0,131017.54
12097,1976-05-04,101.46,0.54,0.54,120.24,-15.62,True,1,5351,-101.46,-409005.92,542912.46,133906.54
12098,1976-05-05,100.88,-0.58,-0.57,120.24,-16.1,True,1,5352,-100.88,-409106.8,539909.76,130802.96
12099,1976-05-06,101.16,0.28,0.28,120.24,-15.87,True,1,5353,-101.16,-409207.96,541509.48,132301.52
12100,1976-05-07,101.88,0.72,0.71,120.24,-15.27,True,1,5354,-101.88,-409309.84,545465.52,136155.68
12101,1976-05-10,103.1,1.22,1.2,120.24,-14.26,True,1,5355,-103.1,-409412.94,552100.5,142687.56
12102,1976-05-11,102.95,-0.15,-0.14,120.24,-14.38,True,1,5356,-102.95,-409515.89,551400.2,141884.31
12103,1976-05-12,102.77,-0.18,-0.18,120.24,-14.53,True,1,5357,-102.77,-409618.66,550538.89,140920.23
12104,1976-05-13,102.16,-0.61,-0.59,120.24,-15.04,True,1,5358,-102.16,-409720.82,547373.28,137652.46
12105,1976-05-14,101.34,-0.82,-0.8,120.24,-15.72,True,1,5359,-101.34,-409822.16,543081.06,133258.9
12106,1976-05-17,101.09,-0.25,-0.25,120.24,-15.93,True,1,5360,-101.09,-409923.25,541842.4,131919.15
12107,1976-05-18,101.26,0.17,0.17,120.24,-15.78,True,1,5361,-101.26,-410024.51,542854.86,132830.35
12108,1976-05-19,101.18,-0.08,-0.08,120.24,-15.85,True,1,5362,-101.18,-410125.69,542527.16,132401.47
12109,1976-05-20,102.0,0.82,0.81,120.24,-15.17,True,1,5363,-102.0,-410227.69,547026.0,136798.31
12110,1976-05-21,101.26,-0.74,-0.72,120.24,-15.78,True,1,5364,-101.26,-410328.95,543158.64,132829.69
12111,1976-05-24,99.44,-1.82,-1.8,120.24,-17.3,True,1,5365,-99.44,-410428.39,533495.6,123067.21
12112,1976-05-25,99.49,0.05,0.05,120.24,-17.26,True,1,5366,-99.49,-410527.88,533863.34,123335.46
12113,1976-05-26,99.34,-0.15,-0.15,120.24,-17.38,True,1,5367,-99.34,-410627.22,533157.78,122530.56
12114,1976-05-27,99.38,0.04,0.04,120.24,-17.35,True,1,5368,-99.38,-410726.6,533471.84,122745.24
12115,1976-05-28,100.18,0.8,0.8,120.24,-16.68,True,1,5369,-100.18,-410826.78,537866.42,127039.64
12116,1976-06-01,99.85,-0.33,-0.33,120.24,-16.96,True,1,5370,-99.85,-410926.63,536194.5,125267.87
12117,1976-06-02,100.22,0.37,0.37,120.24,-16.65,True,1,5371,-100.22,-411026.85,538281.62,127254.77
12118,1976-06-03,100.13,-0.09,-0.09,120.24,-16.73,True,1,5372,-100.13,-411126.98,537898.36,126771.38
12119,1976-06-04,99.15,-0.98,-0.98,120.24,-17.54,True,1,5373,-99.15,-411226.13,532732.95,121506.82
12120,1976-06-07,98.63,-0.52,-0.52,120.24,-17.97,True,1,5374,-98.63,-411324.76,530037.62,118712.86
12121,1976-06-08,98.8,0.17,0.17,120.24,-17.83,True,1,5375,-98.8,-411423.56,531050.0,119626.44
12122,1976-06-09,98.74,-0.06,-0.06,120.24,-17.88,True,1,5376,-98.74,-411522.3,530826.24,119303.94
12123,1976-06-10,99.56,0.82,0.83,120.24,-17.2,True,1,5377,-99.56,-411621.86,535334.12,123712.26
12124,1976-06-11,100.92,1.36,1.37,120.24,-16.07,True,1,5378,-100.92,-411722.78,542747.76,131024.98
12125,1976-06-14,101.95,1.03,1.02,120.24,-15.21,True,1,5379,-101.95,-411824.73,548389.05,136564.32
12126,1976-06-15,101.46,-0.49,-0.48,120.24,-15.62,True,1,5380,-101.46,-411926.19,545854.8,133928.61
12127,1976-06-16,102.01,0.55,0.54,120.24,-15.16,True,1,5381,-102.01,-412028.2,548915.81,136887.61
12128,1976-06-17,103.61,1.6,1.57,120.24,-13.83,True,1,5382,-103.61,-412131.81,557629.02,145497.21
12129,1976-06-18,103.76,0.15,0.14,120.24,-13.71,True,1,5383,-103.76,-412235.57,558540.08,146304.51
12130,1976-06-21,104.28,0.52,0.5,120.24,-13.27,True,1,5384,-104.28,-412339.85,561443.52,149103.67
12131,1976-06-22,103.47,-0.81,-0.78,120.24,-13.95,True,1,5385,-103.47,-412443.32,557185.95,144742.63
12132,1976-06-23,103.25,-0.22,-0.21,120.24,-14.13,True,1,5386,-103.25,-412546.57,556104.5,143557.93
12133,1976-06-24,103.79,0.54,0.52,120.24,-13.68,True,1,5387,-103.79,-412650.36,559116.73,146466.37
12134,1976-06-25,103.72,-0.07,-0.07,120.24,-13.74,True,1,5388,-103.72,-412754.08,558843.36,146089.28
12135,1976-06-28,103.43,-0.29,-0.28,120.24,-13.98,True,1,5389,-103.43,-412857.51,557384.27,144526.76
12136,1976-06-29,103.86,0.43,0.42,120.24,-13.62,True,1,5390,-103.86,-412961.37,559805.4,146844.03
12137,1976-06-30,104.28,0.42,0.4,120.24,-13.27,True,1,5391,-104.28,-413065.65,562173.48,149107.83
12138,1976-07-01,103.59,-0.69,-0.66,120.24,-13.85,True,1,5392,-103.59,-413169.24,558557.28,145388.04
12139,1976-07-02,104.11,0.52,0.5,120.24,-13.42,True,1,5393,-104.11,-413273.35,561465.23,148191.88
12140,1976-07-06,103.54,-0.57,-0.55,120.24,-13.89,True,1,5394,-103.54,-413376.89,558494.76,145117.87
12141,1976-07-07,103.83,0.29,0.28,120.24,-13.65,True,1,5395,-103.83,-413480.72,560162.85,146682.13
12142,1976-07-08,103.98,0.15,0.14,120.24,-13.52,True,1,5396,-103.98,-413584.7,561076.08,147491.38
12143,1976-07-09,104.98,1.0,0.96,120.24,-12.69,True,1,5397,-104.98,-413689.68,566577.06,152887.38
12144,1976-07-12,105.9,0.92,0.88,120.24,-11.93,True,1,5398,-105.9,-413795.58,571648.2,157852.62
12145,1976-07-13,105.67,-0.23,-0.22,120.24,-12.12,True,1,5399,-105.67,-413901.25,570512.33,156611.08
12146,1976-07-14,105.95,0.28,0.26,120.24,-11.88,True,1,5400,-105.95,-414007.2,572130.0,158122.8
12147,1976-07-15,105.2,-0.75,-0.71,120.24,-12.51,True,1,5401,-105.2,-414112.4,568185.2,154072.8
12148,1976-07-16,104.68,-0.52,-0.49,120.24,-12.94,True,1,5402,-104.68,-414217.08,565481.36,151264.28
12149,1976-07-19,104.29,-0.39,-0.37,120.24,-13.26,True,1,5403,-104.29,-414321.37,563478.87,149157.5
12150,1976-07-20,103.72,-0.57,-0.55,120.24,-13.74,True,1,5404,-103.72,-414425.09,560502.88,146077.79
12151,1976-07-21,103.82,0.1,0.1,120.24,-13.66,True,1,5405,-103.82,-414528.91,561147.1,146618.19
12152,1976-07-22,103.93,0.11,0.11,120.24,-13.56,True,1,5406,-103.93,-414632.84,561845.58,147212.74
12153,1976-07-23,104.06,0.13,0.12,120.24,-13.46,True,1,5407,-104.06,-414736.9,562652.42,147915.52
12154,1976-07-26,104.07,0.01,0.01,120.24,-13.45,True,1,5408,-104.07,-414840.97,562810.56,147969.59
12155,1976-07-27,103.48,-0.59,-0.57,120.24,-13.94,True,1,5409,-103.48,-414944.45,559723.32,144778.87
12156,1976-07-28,103.05,-0.43,-0.42,120.24,-14.3,True,1,5410,-103.05,-415047.5,557500.5,142453.0
12157,1976-07-29,102.93,-0.12,-0.12,120.24,-14.4,True,1,5411,-102.93,-415150.43,556954.23,141803.8
12158,1976-07-30,103.44,0.51,0.5,120.24,-13.97,True,1,5412,-103.44,-415253.87,559817.28,144563.41
12159,1976-08-02,103.19,-0.25,-0.24,120.24,-14.18,True,1,5413,-103.19,-415357.06,558567.47,143210.41
12160,1976-08-03,104.14,0.95,0.92,120.24,-13.39,True,1,5414,-104.14,-415461.2,563813.96,148352.76
12161,1976-08-04,104.43,0.29,0.28,120.24,-13.15,True,1,5415,-104.43,-415565.63,565488.45,149922.82
12162,1976-08-05,103.85,-0.58,-0.56,120.24,-13.63,True,1,5416,-103.85,-415669.48,562451.6,146782.12
12163,1976-08-06,103.79,-0.06,-0.06,120.24,-13.68,True,1,5417,-103.79,-415773.27,562230.43,146457.16
12164,1976-08-09,103.49,-0.3,-0.29,120.24,-13.93,True,1,5418,-103.49,-415876.76,560708.82,144832.06
12165,1976-08-10,104.41,0.92,0.89,120.24,-13.16,True,1,5419,-104.41,-415981.17,565797.79,149816.62
12166,1976-08-11,104.06,-0.35,-0.34,120.24,-13.46,True,1,5420,-104.06,-416085.23,564005.2,147919.97
12167,1976-08-12,104.22,0.16,0.15,120.24,-13.32,True,1,5421,-104.22,-416189.45,564976.62,148787.17
12168,1976-08-13,104.25,0.03,0.03,120.24,-13.3,True,1,5422,-104.25,-416293.7,565243.5,148949.8
12169,1976-08-16,104.43,0.18,0.17,120.24,-13.15,True,1,5423,-104.43,-416398.13,566323.89,149925.76
12170,1976-08-17,104.8,0.37,0.35,120.24,-12.84,True,1,5424,-104.8,-416502.93,568435.2,151932.27
12171,1976-08-18,104.56,-0.24,-0.23,120.24,-13.04,True,1,5425,-104.56,-416607.49,567238.0,150630.51
12172,1976-08-19,103.39,-1.17,-1.12,120.24,-14.01,True,1,5426,-103.39,-416710.88,560994.14,144283.26
12173,1976-08-20,102.37,-1.02,-0.99,120.24,-14.86,True,1,5427,-102.37,-416813.25,555561.99,138748.74
12174,1976-08-23,101.96,-0.41,-0.4,120.24,-15.2,True,1,5428,-101.96,-416915.21,553438.88,136523.67
12175,1976-08-24,101.27,-0.69,-0.68,120.24,-15.78,True,1,5429,-101.27,-417016.48,549794.83,132778.35
12176,1976-08-25,102.03,0.76,0.75,120.24,-15.14,True,1,5430,-102.03,-417118.51,554022.9,136904.39
12177,1976-08-26,101.32,-0.71,-0.7,120.24,-15.74,True,1,5431,-101.32,-417219.83,550268.92,133049.09
12178,1976-08-27,101.48,0.16,0.16,120.24,-15.6,True,1,5432,-101.48,-417321.31,551239.36,133918.05
12179,1976-08-30,102.07,0.59,0.58,120.24,-15.11,True,1,5433,-102.07,-417423.38,554546.31,137122.93
12180,1976-08-31,102.91,0.84,0.82,120.24,-14.41,True,1,5434,-102.91,-417526.29,559212.94,141686.65
12181,1976-09-01,104.06,1.15,1.12,120.24,-13.46,True,1,5435,-104.06,-417630.35,565566.1,147935.75
12182,1976-09-02,103.92,-0.14,-0.14,120.24,-13.57,True,1,5436,-103.92,-417734.27,564909.12,147174.85
12183,1976-09-03,104.3,0.38,0.37,120.24,-13.26,True,1,5437,-104.3,-417838.57,567079.1,149240.53
12184,1976-09-07,105.03,0.73,0.7,120.24,-12.65,True,1,5438,-105.03,-417943.6,571153.14,153209.54
12185,1976-09-08,104.94,-0.09,-0.09,120.24,-12.72,True,1,5439,-104.94,-418048.54,570768.66,152720.12
12186,1976-09-09,104.4,-0.54,-0.52,120.24,-13.17,True,1,5440,-104.4,-418152.94,567936.0,149783.06
12187,1976-09-10,104.65,0.25,0.24,120.24,-12.97,True,1,5441,-104.65,-418257.59,569400.65,151143.06
12188,1976-09-13,104.29,-0.36,-0.34,120.24,-13.26,True,1,5442,-104.29,-418361.88,567546.18,149184.3
12189,1976-09-14,103.94,-0.35,-0.34,120.24,-13.56,True,1,5443,-103.94,-418465.82,565745.42,147279.6
12190,1976-09-15,104.25,0.31,0.3,120.24,-13.3,True,1,5444,-104.25,-418570.07,567537.0,148966.93
12191,1976-09-16,105.34,1.09,1.05,120.24,-12.39,True,1,5445,-105.34,-418675.41,573576.3,154900.89
12192,1976-09-17,106.27,0.93,0.88,120.24,-11.62,True,1,5446,-106.27,-418781.68,578746.42,159964.74
12193,1976-09-20,106.32,0.05,0.05,120.24,-11.58,True,1,5447,-106.32,-418888.0,579125.04,160237.04
12194,1976-09-21,107.83,1.51,1.42,120.24,-10.32,True,1,5448,-107.83,-418995.83,587457.84,168462.01
12195,1976-09-22,107.46,-0.37,-0.34,120.24,-10.63,True,1,5449,-107.46,-419103.29,585549.54,166446.25
12196,1976-09-23,106.92,-0.54,-0.5,120.24,-11.08,True,1,5450,-106.92,-419210.21,582714.0,163503.79
12197,1976-09-24,106.8,-0.12,-0.11,120.24,-11.18,True,1,5451,-106.8,-419317.01,582166.8,162849.79
12198,1976-09-27,107.27,0.47,0.44,120.24,-10.79,True,1,5452,-107.27,-419424.28,584836.04,165411.76
12199,1976-09-28,105.92,-1.35,-1.26,120.24,-11.91,True,1,5453,-105.92,-419530.2,577581.76,158051.56
12200,1976-09-29,105.37,-0.55,-0.52,120.24,-12.37,True,1,5454,-105.37,-419635.57,574687.98,155052.41
12201,1976-09-30,105.24,-0.13,-0.12,120.24,-12.48,True,1,5455,-105.24,-419740.81,574084.2,154343.39
12202,1976-10-01,104.17,-1.07,-1.02,120.24,-13.36,True,1,5456,-104.17,-419844.98,568351.52,148506.54
12203,1976-10-04,104.03,-0.14,-0.13,120.24,-13.48,True,1,5457,-104.03,-419949.01,567691.71,147742.7
12204,1976-10-05,103.23,-0.8,-0.77,120.24,-14.15,True,1,5458,-103.23,-420052.24,563429.34,143377.1
12205,1976-10-06,102.97,-0.26,-0.25,120.24,-14.36,True,1,5459,-102.97,-420155.21,562113.23,141958.02
12206,1976-10-07,103.54,0.57,0.55,120.24,-13.89,True,1,5460,-103.54,-420258.75,565328.4,145069.65
12207,1976-10-08,102.56,-0.98,-0.95,120.24,-14.7,True,1,5461,-102.56,-420361.31,560080.16,139718.85
12208,1976-10-11,101.64,-0.92,-0.9,120.24,-15.47,True,1,5462,-101.64,-420462.95,555157.68,134694.73
12209,1976-10-12,100.81,-0.83,-0.82,120.24,-16.16,True,1,5463,-100.81,-420563.76,550725.03,130161.27
12210,1976-10-13,102.12,1.31,1.3,120.24,-15.07,True,1,5464,-102.12,-420665.88,557983.68,137317.8
12211,1976-10-14,100.85,-1.27,-1.24,120.24,-16.13,True,1,5465,-100.85,-420766.73,551145.25,130378.52
12212,1976-10-15,100.88,0.03,0.03,120.24,-16.1,True,1,5466,-100.88,-420867.61,551410.08,130542.47
12213,1976-10-18,101.47,0.59,0.58,120.24,-15.61,True,1,5467,-101.47,-420969.08,554736.49,133767.41
12214,1976-10-19,101.45,-0.02,-0.02,120.24,-15.63,True,1,5468,-101.45,-421070.53,554728.6,133658.07
12215,1976-10-20,101.74,0.29,0.29,120.24,-15.39,True,1,5469,-101.74,-421172.27,556416.06,135243.79
12216,1976-10-21,100.77,-0.97,-0.95,120.24,-16.19,True,1,5470,-100.77,-421273.04,551211.9,129938.86
12217,1976-10-22,99.96,-0.81,-0.8,120.24,-16.87,True,1,5471,-99.96,-421373.0,546881.16,125508.16
12218,1976-10-25,100.07,0.11,0.11,120.24,-16.77,True,1,5472,-100.07,-421473.07,547583.04,126109.97
12219,1976-10-26,101.06,0.99,0.99,120.24,-15.95,True,1,5473,-101.06,-421574.13,553101.38,131527.25
12220,1976-10-27,101.76,0.7,0.69,120.24,-15.37,True,1,5474,-101.76,-421675.89,557034.24,135358.35
12221,1976-10-28,101.61,-0.15,-0.15,120.24,-15.49,True,1,5475,-101.61,-421777.5,556314.75,134537.25
12222,1976-10-29,102.9,1.29,1.27,120.24,-14.42,True,1,5476,-102.9,-421880.4,563480.4,141600.0
12223,1976-11-01,103.1,0.2,0.19,120.24,-14.26,True,1,5477,-103.1,-421983.5,564678.7,142695.2
12224,1976-11-03,101.92,-1.18,-1.14,120.24,-15.24,True,1,5478,-101.92,-422085.42,558317.76,136232.34
12225,1976-11-04,102.41,0.49,0.48,120.24,-14.83,True,1,5479,-102.41,-422187.83,561104.39,138916.56
12226,1976-11-05,100.82,-1.59,-1.55,120.24,-16.15,True,1,5480,-100.82,-422288.65,552493.6,130204.95
12227,1976-11-08,99.6,-1.22,-1.21,120.24,-17.17,True,1,5481,-99.6,-422388.25,545907.6,123519.35
12228,1976-11-09,99.32,-0.28,-0.28,120.24,-17.4,True,1,5482,-99.32,-422487.57,544472.24,121984.67
12229,1976-11-10,98.81,-0.51,-0.51,120.24,-17.82,True,1,5483,-98.81,-422586.38,541775.23,119188.85
12230,1976-11-11,99.64,0.83,0.84,120.24,-17.13,True,1,5484,-99.64,-422686.02,546425.76,123739.74
12231,1976-11-12,99.24,-0.4,-0.4,120.24,-17.46,True,1,5485,-99.24,-422785.26,544331.4,121546.14
12232,1976-11-15,99.9,0.66,0.66,120.24,-16.92,True,1,5486,-99.9,-422885.16,548051.4,125166.24
12233,1976-11-16,100.04,0.14,0.14,120.24,-16.8,True,1,5487,-100.04,-422985.2,548919.48,125934.28
12234,1976-11-17,100.61,0.57,0.57,120.24,-16.33,True,1,5488,-100.61,-423085.81,552147.68,129061.87
12235,1976-11-18,101.89,1.28,1.27,120.24,-15.26,True,1,5489,-101.89,-423187.7,559274.21,136086.51
12236,1976-11-19,101.92,0.03,0.03,120.24,-15.24,True,1,5490,-101.92,-423289.62,559540.8,136251.18
12237,1976-11-22,102.59,0.67,0.66,120.24,-14.68,True,1,5491,-102.59,-423392.21,563321.69,139929.48
12238,1976-11-23,101.96,-0.63,-0.61,120.24,-15.2,True,1,5492,-101.96,-423494.17,559964.32,136470.15
12239,1976-11-24,102.41,0.45,0.44,120.24,-14.83,True,1,5493,-102.41,-423596.58,562538.13,138941.55
12240,1976-11-26,103.15,0.74,0.72,120.24,-14.21,True,1,5494,-103.15,-423699.73,566706.1,143006.37
12241,1976-11-29,102.44,-0.71,-0.69,120.24,-14.8,True,1,5495,-102.44,-423802.17,562907.8,139105.63
12242,1976-11-30,102.1,-0.34,-0.33,120.24,-15.09,True,1,5496,-102.1,-423904.27,561141.6,137237.33
12243,1976-12-01,102.49,0.39,0.38,120.24,-14.76,True,1,5497,-102.49,-424006.76,563387.53,139380.77
12244,1976-12-02,102.12,-0.37,-0.36,120.24,-15.07,True,1,5498,-102.12,-424108.88,561455.76,137346.88
12245,1976-12-03,102.76,0.64,0.63,120.24,-14.54,True,1,5499,-102.76,-424211.64,565077.24,140865.6
12246,1976-12-06,103.56,0.8,0.78,120.24,-13.87,True,1,5500,-103.56,-424315.2,569580.0,145264.8
12247,1976-12-07,103.49,-0.07,-0.07,120.24,-13.93,True,1,5501,-103.49,-424418.69,569298.49,144879.8
12248,1976-12-08,104.08,0.59,0.57,120.24,-13.44,True,1,5502,-104.08,-424522.77,572648.16,148125.39
12249,1976-12-09,104.51,0.43,0.41,120.24,-13.08,True,1,5503,-104.51,-424627.28,575118.53,150491.25
12250,1976-12-10,104.7,0.19,0.18,120.24,-12.92,True,1,5504,-104.7,-424731.98,576268.8,151536.82
12251,1976-12-13,104.63,-0.07,-0.07,120.24,-12.98,True,1,5505,-104.63,-424836.61,575988.15,151151.54
12252,1976-12-14,105.07,0.44,0.42,120.24,-12.62,True,1,5506,-105.07,-424941.68,578515.42,153573.74
12253,1976-12-15,105.14,0.07,0.07,120.24,-12.56,True,1,5507,-105.14,-425046.82,579005.98,153959.16
12254,1976-12-16,104.8,-0.34,-0.32,120.24,-12.84,True,1,5508,-104.8,-425151.62,577238.4,152086.78
12255,1976-12-17,104.26,-0.54,-0.52,120.24,-13.29,True,1,5509,-104.26,-425255.88,574368.34,149112.46
12256,1976-12-20,103.65,-0.61,-0.58,120.24,-13.8,True,1,5510,-103.65,-425359.53,571111.5,145751.97
12257,1976-12-21,104.22,0.57,0.55,120.24,-13.32,True,1,5511,-104.22,-425463.75,574356.42,148892.67
12258,1976-12-22,104.71,0.49,0.47,120.24,-12.92,True,1,5512,-104.71,-425568.46,577161.52,151593.06
12259,1976-12-23,104.84,0.13,0.12,120.24,-12.81,True,1,5513,-104.84,-425673.3,577982.92,152309.62
12260,1976-12-27,106.06,1.22,1.16,120.24,-11.79,True,1,5514,-106.06,-425779.36,584814.84,159035.48
12261,1976-12-28,106.77,0.71,0.67,120.24,-11.2,True,1,5515,-106.77,-425886.13,588836.55,162950.42
12262,1976-12-29,106.34,-0.43,-0.4,120.24,-11.56,True,1,5516,-106.34,-425992.47,586571.44,160578.97
12263,1976-12-30,106.88,0.54,0.51,120.24,-11.11,True,1,5517,-106.88,-426099.35,589656.96,163557.61
12264,1976-12-31,107.46,0.58,0.54,120.24,-10.63,True,1,5518,-107.46,-426206.81,592964.28,166757.47
12265,1977-01-03,107.0,-0.46,-0.43,120.24,-11.01,True,1,5519,-107.0,-426313.81,590533.0,164219.19
12266,1977-01-04,105.7,-1.3,-1.22,120.24,-12.09,True,1,5520,-105.7,-426419.51,583464.0,157044.49
12267,1977-01-05,104.76,-0.94,-0.89,120.24,-12.87,True,1,5521,-104.76,-426524.27,578379.96,151855.69
12268,1977-01-06,105.02,0.26,0.25,120.24,-12.66,True,1,5522,-105.02,-426629.29,579920.44,153291.15
12269,1977-01-07,105.01,-0.01,-0.01,120.24,-12.67,True,1,5523,-105.01,-426734.3,579970.23,153235.93
12270,1977-01-10,105.2,0.19,0.18,120.24,-12.51,True,1,5524,-105.2,-426839.5,581124.8,154285.3
12271,1977-01-11,104.12,-1.08,-1.03,120.24,-13.41,True,1,5525,-104.12,-426943.62,575263.0,148319.38
12272,1977-01-12,103.4,-0.72,-0.69,120.24,-14.0,True,1,5526,-103.4,-427047.02,571388.4,144341.38
12273,1977-01-13,104.2,0.8,0.77,120.24,-13.34,True,1,5527,-104.2,-427151.22,575913.4,148762.18
12274,1977-01-14,104.01,-0.19,-0.18,120.24,-13.5,True,1,5528,-104.01,-427255.23,574967.28,147712.05
12275,1977-01-17,103.73,-0.28,-0.27,120.24,-13.73,True,1,5529,-103.73,-427358.96,573523.17,146164.21
12276,1977-01-18,103.32,-0.41,-0.4,120.24,-14.07,True,1,5530,-103.32,-427462.28,571359.6,143897.32
12277,1977-01-19,103.85,0.53,0.51,120.24,-13.63,True,1,5531,-103.85,-427566.13,574394.35,146828.22
12278,1977-01-20,102.97,-0.88,-0.85,120.24,-14.36,True,1,5532,-102.97,-427669.1,569630.04,141960.94
12279,1977-01-21,103.32,0.35,0.34,120.24,-14.07,True,1,5533,-103.32,-427772.42,571669.56,143897.14
12280,1977-01-24,103.25,-0.07,-0.07,120.24,-14.13,True,1,5534,-103.25,-427875.67,571385.5,143509.83
12281,1977-01-25,103.13,-0.12,-0.12,120.24,-14.23,True,1,5535,-103.13,-427978.8,570824.55,142845.75
12282,1977-01-26,102.34,-0.79,-0.77,120.24,-14.89,True,1,5536,-102.34,-428081.14,566554.24,138473.1
12283,1977-01-27,101.79,-0.55,-0.54,120.24,-15.34,True,1,5537,-101.79,-428182.93,563611.23,135428.3
12284,1977-01-28,101.93,0.14,0.14,120.24,-15.23,True,1,5538,-101.93,-428284.86,564488.34,136203.48
12285,1977-01-31,102.03,0.1,0.1,120.24,-15.14,True,1,5539,-102.03,-428386.89,565144.17,136757.28
12286,1977-02-01,102.54,0.51,0.5,120.24,-14.72,True,1,5540,-102.54,-428489.43,568071.6,139582.17
12287,1977-02-02,102.36,-0.18,-0.18,120.24,-14.87,True,1,5541,-102.36,-428591.79,567176.76,138584.97
12288,1977-02-03,101.85,-0.51,-0.5,120.24,-15.29,True,1,5542,-101.85,-428693.64,564452.7,135759.06
12289,1977-02-04,101.88,0.03,0.03,120.24,-15.27,True,1,5543,-101.88,-428795.52,564720.84,135925.32
12290,1977-02-07,101.89,0.01,0.01,120.24,-15.26,True,1,5544,-101.89,-428897.41,564878.16,135980.75
12291,1977-02-08,101.6,-0.29,-0.28,120.24,-15.5,True,1,5545,-101.6,-428999.01,563372.0,134372.99
12292,1977-02-09,100.73,-0.87,-0.86,120.24,-16.23,True,1,5546,-100.73,-429099.74,558648.58,129548.84
12293,1977-02-10,100.82,0.09,0.09,120.24,-16.15,True,1,5547,-100.82,-429200.56,559248.54,130047.98
12294,1977-02-11,100.22,-0.6,-0.6,120.24,-16.65,True,1,5548,-100.22,-429300.78,556020.56,126719.78
12295,1977-02-14,100.74,0.52,0.52,120.24,-16.22,True,1,5549,-100.74,-429401.52,559006.26,129604.74
12296,1977-02-15,101.04,0.3,0.3,120.24,-15.97,True,1,5550,-101.04,-429502.56,560772.0,131269.44
12297,1977-02-16,101.5,0.46,0.46,120.24,-15.58,True,1,5551,-101.5,-429604.06,563426.5,133822.44
12298,1977-02-17,100.92,-0.58,-0.57,120.24,-16.07,True,1,5552,-100.92,-429704.98,560307.84,130602.86
12299,1977-02-18,100.49,-0.43,-0.43,120.24,-16.42,True,1,5553,-100.49,-429805.47,558020.97,128215.5
12300,1977-02-22,100.49,0.0,0.0,120.24,-16.42,True,1,5554,-100.49,-429905.96,558121.46,128215.5
12301,1977-02-23,100.19,-0.3,-0.3,120.24,-16.68,True,1,5555,-100.19,-430006.15,556555.45,126549.3
12302,1977-02-24,99.6,-0.59,-0.59,120.24,-17.17,True,1,5556,-99.6,-430105.75,553377.6,123271.85
12303,1977-02-25,99.48,-0.12,-0.12,120.24,-17.26,True,1,5557,-99.48,-430205.23,552810.36,122605.13
12304,1977-02-28,99.82,0.34,0.34,120.24,-16.98,True,1,5558,-99.82,-430305.05,554799.56,124494.51
12305,1977-03-01,100.66,0.84,0.84,120.24,-16.28,True,1,5559,-100.66,-430405.71,559568.94,129163.23
12306,1977-03-02,100.39,-0.27,-0.27,120.24,-16.51,True,1,5560,-100.39,-430506.1,558168.4,127662.3
12307,1977-03-03,100.88,0.49,0.49,120.24,-16.1,True,1,5561,-100.88,-430606.98,560993.68,130386.7
12308,1977-03-04,101.2,0.32,0.32,120.24,-15.84,True,1,5562,-101.2,-430708.18,562874.4,132166.22
12309,1977-03-07,101.25,0.05,0.05,120.24,-15.79,True,1,5563,-101.25,-430809.43,563253.75,132444.32
12310,1977-03-08,100.87,-0.38,-0.38,120.24,-16.11,True,1,5564,-100.87,-430910.3,561240.68,130330.38
12311,1977-03-09,100.1,-0.77,-0.76,120.24,-16.75,True,1,5565,-100.1,-431010.4,557056.5,126046.1
12312,1977-03-10,100.67,0.57,0.57,120.24,-16.28,True,1,5566,-100.67,-431111.07,560329.22,129218.15
12313,1977-03-11,100.65,-0.02,-0.02,120.24,-16.29,True,1,5567,-100.65,-431211.72,560318.55,129106.83
12314,1977-03-14,101.42,0.77,0.76,120.24,-15.65,True,1,5568,-101.42,-431313.14,564706.56,133393.42
12315,1977-03-15,101.98,0.56,0.55,120.24,-15.19,True,1,5569,-101.98,-431415.12,567926.62,136511.5
12316,1977-03-16,102.17,0.19,0.19,120.24,-15.03,True,1,5570,-102.17,-431517.29,569086.9,137569.61
12317,1977-03-17,102.08,-0.09,-0.09,120.24,-15.1,True,1,5571,-102.08,-431619.37,568687.68,137068.31
12318,1977-03-18,101.86,-0.22,-0.22,120.24,-15.29,True,1,5572,-101.86,-431721.23,567563.92,135842.69
12319,1977-03-21,101.31,-0.55,-0.54,120.24,-15.74,True,1,5573,-101.31,-431822.54,564600.63,132778.09
12320,1977-03-22,101.0,-0.31,-0.31,120.24,-16.0,True,1,5574,-101.0,-431923.54,562974.0,131050.46
12321,1977-03-23,100.2,-0.8,-0.79,120.24,-16.67,True,1,5575,-100.2,-432023.74,558615.0,126591.26
12322,1977-03-24,99.7,-0.5,-0.5,120.24,-17.08,True,1,5576,-99.7,-432123.44,555927.2,123803.76
12323,1977-03-25,99.06,-0.64,-0.64,120.24,-17.61,True,1,5577,-99.06,-432222.5,552457.62,120235.12
12324,1977-03-28,99.0,-0.06,-0.06,120.24,-17.66,True,1,5578,-99.0,-432321.5,552222.0,119900.5
12325,1977-03-29,99.69,0.69,0.7,120.24,-17.09,True,1,5579,-99.69,-432421.19,556170.51,123749.32
12326,1977-03-30,98.54,-1.15,-1.15,120.24,-18.05,True,1,5580,-98.54,-432519.73,549853.2,117333.47
12327,1977-03-31,98.42,-0.12,-0.12,120.24,-18.15,True,1,5581,-98.42,-432618.15,549282.02,116663.87
12328,1977-04-01,99.21,0.79,0.8,120.24,-17.49,True,1,5582,-99.21,-432717.36,553790.22,121072.86
12329,1977-04-04,98.23,-0.98,-0.99,120.24,-18.3,True,1,5583,-98.23,-432815.59,548418.09,115602.5
12330,1977-04-05,98.01,-0.22,-0.22,120.24,-18.49,True,1,5584,-98.01,-432913.6,547287.84,114374.24
12331,1977-04-06,97.91,-0.1,-0.1,120.24,-18.57,True,1,5585,-97.91,-433011.51,546827.35,113815.84
12332,1977-04-07,98.35,0.44,0.45,120.24,-18.2,True,1,5586,-98.35,-433109.86,549383.1,116273.24
12333,1977-04-11,98.88,0.53,0.54,120.24,-17.76,True,1,5587,-98.88,-433208.74,552442.56,119233.82
12334,1977-04-12,100.15,1.27,1.28,120.24,-16.71,True,1,5588,-100.15,-433308.89,559638.2,126329.31
12335,1977-04-13,100.16,0.01,0.01,120.24,-16.7,True,1,5589,-100.16,-433409.05,559794.24,126385.19
12336,1977-04-14,101.0,0.84,0.84,120.24,-16.0,True,1,5590,-101.0,-433510.05,564590.0,131079.95
12337,1977-04-15,101.04,0.04,0.04,120.24,-15.97,True,1,5591,-101.04,-433611.09,564914.64,131303.55
12338,1977-04-18,100.54,-0.5,-0.5,120.24,-16.38,True,1,5592,-100.54,-433711.63,562219.68,128508.05
12339,1977-04-19,100.07,-0.47,-0.47,120.24,-16.77,True,1,5593,-100.07,-433811.7,559691.51,125879.81
12340,1977-04-20,100.4,0.33,0.33,120.24,-16.5,True,1,5594,-100.4,-433912.1,561637.6,127725.5
12341,1977-04-21,99.75,-0.65,-0.65,120.24,-17.04,True,1,5595,-99.75,-434011.85,558101.25,124089.4
12342,1977-04-22,98.44,-1.31,-1.31,120.24,-18.13,True,1,5596,-98.44,-434110.29,550870.24,116759.95
12343,1977-04-25,97.15,-1.29,-1.31,120.24,-19.2,True,1,5597,-97.15,-434207.44,543748.55,109541.11
12344,1977-04-26,97.11,-0.04,-0.04,120.24,-19.24,True,1,5598,-97.11,-434304.55,543621.78,109317.23
12345,1977-04-27,97.96,0.85,0.88,120.24,-18.53,True,1,5599,-97.96,-434402.51,548478.04,114075.53
12346,1977-04-28,98.2,0.24,0.24,120.24,-18.33,True,1,5600,-98.2,-434500.71,549920.0,115419.29
12347,1977-04-29,98.44,0.24,0.24,120.24,-18.13,True,1,5601,-98.44,-434599.15,551362.44,116763.29
12348,1977-05-02,98.93,0.49,0.5,120.24,-17.72,True,1,5602,-98.93,-434698.08,554205.86,119507.78
12349,1977-05-03,99.43,0.5,0.5,120.24,-17.31,True,1,5603,-99.43,-434797.51,557106.29,122308.78
12350,1977-05-04,99.96,0.53,0.53,120.24,-16.87,True,1,5604,-99.96,-434897.47,560175.84,125278.37
12351,1977-05-05,100.11,0.15,0.15,120.24,-16.74,True,1,5605,-100.11,-434997.58,561116.55,126118.97
12352,1977-05-06,99.49,-0.62,-0.62,120.24,-17.26,True,1,5606,-99.49,-435097.07,557740.94,122643.87
12353,1977-05-09,99.18,-0.31,-0.31,120.24,-17.52,True,1,5607,-99.18,-435196.25,556102.26,120906.01
12354,1977-05-10,99.47,0.29,0.29,120.24,-17.27,True,1,5608,-99.47,-435295.72,557827.76,122532.04
12355,1977-05-11,98.78,-0.69,-0.69,120.24,-17.85,True,1,5609,-98.78,-435394.5,554057.02,118662.52
12356,1977-05-12,98.73,-0.05,-0.05,120.24,-17.89,True,1,5610,-98.73,-435493.23,553875.3,118382.07
12357,1977-05-13,99.03,0.3,0.3,120.24,-17.64,True,1,5611,-99.03,-435592.26,555657.33,120065.07
12358,1977-05-16,99.47,0.44,0.44,120.24,-17.27,True,1,5612,-99.47,-435691.73,558225.64,122533.91
12359,1977-05-17,99.77,0.3,0.3,120.24,-17.02,True,1,5613,-99.77,-435791.5,560009.01,124217.51
12360,1977-05-18,100.3,0.53,0.53,120.24,-16.58,True,1,5614,-100.3,-435891.8,563084.2,127192.4
12361,1977-05-19,99.88,-0.42,-0.42,120.24,-16.93,True,1,5615,-99.88,-435991.68,560826.2,124834.52
12362,1977-05-20,99.45,-0.43,-0.43,120.24,-17.29,True,1,5616,-99.45,-436091.13,558511.2,122420.07
12363,1977-05-23,98.15,-1.3,-1.31,120.24,-18.37,True,1,5617,-98.15,-436189.28,551308.55,115119.27
12364,1977-05-24,97.67,-0.48,-0.49,120.24,-18.77,True,1,5618,-97.67,-436286.95,548710.06,112423.11
12365,1977-05-25,96.77,-0.9,-0.92,120.24,-19.52,True,1,5619,-96.77,-436383.72,543750.63,107366.91
12366,1977-05-26,97.01,0.24,0.25,120.24,-19.32,True,1,5620,-97.01,-436480.73,545196.2,108715.47
12367,1977-05-27,96.27,-0.74,-0.76,120.24,-19.93,True,1,5621,-96.27,-436577.0,541133.67,104556.67
12368,1977-05-31,96.12,-0.15,-0.16,120.24,-20.06,True,1,5622,-96.12,-436673.12,540386.64,103713.52
12369,1977-06-01,96.93,0.81,0.84,120.24,-19.39,True,1,5623,-96.93,-436770.05,545037.39,108267.34
12370,1977-06-02,96.74,-0.19,-0.2,120.24,-19.54,True,1,5624,-96.74,-436866.79,544065.76,107198.97
12371,1977-06-03,97.69,0.95,0.98,120.24,-18.75,True,1,5625,-97.69,-436964.48,549506.25,112541.77
12372,1977-06-06,97.23,-0.46,-0.47,120.24,-19.14,True,1,5626,-97.23,-437061.71,547015.98,109954.27
12373,1977-06-07,97.73,0.5,0.51,120.24,-18.72,True,1,5627,-97.73,-437159.44,549926.71,112767.27
12374,1977-06-08,98.2,0.47,0.48,120.24,-18.33,True,1,5628,-98.2,-437257.64,552669.6,115411.96
12375,1977-06-09,98.14,-0.06,-0.06,120.24,-18.38,True,1,5629,-98.14,-437355.78,552430.06,115074.28
12376,1977-06-10,98.46,0.32,0.33,120.24,-18.11,True,1,5630,-98.46,-437454.24,554329.8,116875.56
12377,1977-06-13,98.74,0.28,0.28,120.24,-17.88,True,1,5631,-98.74,-437552.98,556004.94,118451.96
12378,1977-06-14,99.86,1.12,1.13,120.24,-16.95,True,1,5632,-99.86,-437652.84,562411.52,124758.68
12379,1977-06-15,99.61,-0.25,-0.25,120.24,-17.16,True,1,5633,-99.61,-437752.45,561103.13,123350.68
12380,1977-06-16,99.85,0.24,0.24,120.24,-16.96,True,1,5634,-99.85,-437852.3,562554.9,124702.6
12381,1977-06-17,99.97,0.12,0.12,120.24,-16.86,True,1,5635,-99.97,-437952.27,563330.95,125378.68
12382,1977-06-20,100.42,0.45,0.45,120.24,-16.48,True,1,5636,-100.42,-438052.69,565967.12,127914.43
12383,1977-06-21,100.74,0.32,0.32,120.24,-16.22,True,1,5637,-100.74,-438153.43,567871.38,129717.95
12384,1977-06-22,100.46,-0.28,-0.28,120.24,-16.45,True,1,5638,-100.46,-438253.89,566393.48,128139.59
12385,1977-06-23,100.62,0.16,0.16,120.24,-16.32,True,1,5639,-100.62,-438354.51,567396.18,129041.67
12386,1977-06-24,101.19,0.57,0.57,120.24,-15.84,True,1,5640,-101.19,-438455.7,570711.6,132255.9
12387,1977-06-27,100.98,-0.21,-0.21,120.24,-16.02,True,1,5641,-100.98,-438556.68,569628.18,131071.5
12388,1977-06-28,100.14,-0.84,-0.83,120.24,-16.72,True,1,5642,-100.14,-438656.82,564989.88,126333.06
12389,1977-06-29,100.11,-0.03,-0.03,120.24,-16.74,True,1,5643,-100.11,-438756.93,564920.73,126163.8
12390,1977-06-30,100.48,0.37,0.37,120.24,-16.43,True,1,5644,-100.48,-438857.41,567109.12,128251.71
12391,1977-07-01,100.1,-0.38,-0.38,120.24,-16.75,True,1,5645,-100.1,-438957.51,565064.5,126106.99
12392,1977-07-05,100.09,-0.01,-0.01,120.24,-16.76,True,1,5646,-100.09,-439057.6,565108.14,126050.54
12393,1977-07-06,99.58,-0.51,-0.51,120.24,-17.18,True,1,5647,-99.58,-439157.18,562328.26,123171.08
12394,1977-07-07,99.93,0.35,0.35,120.24,-16.89,True,1,5648,-99.93,-439257.11,564404.64,125147.53
12395,1977-07-08,99.79,-0.14,-0.14,120.24,-17.01,True,1,5649,-99.79,-439356.9,563713.71,124356.81
12396,1977-07-11,99.55,-0.24,-0.24,120.24,-17.21,True,1,5650,-99.55,-439456.45,562457.5,123001.05
12397,1977-07-12,99.45,-0.1,-0.1,120.24,-17.29,True,1,5651,-99.45,-439555.9,561991.95,122436.05
12398,1977-07-13,99.59,0.14,0.14,120.24,-17.17,True,1,5652,-99.59,-439655.49,562882.68,123227.19
12399,1977-07-15,100.18,0.59,0.59,120.24,-16.68,True,1,5653,-100.18,-439755.67,566317.54,126561.87
12400,1977-07-18,100.95,0.77,0.77,120.24,-16.04,True,1,5654,-100.95,-439856.62,570771.3,130914.68
12401,1977-07-19,101.79,0.84,0.83,120.24,-15.34,True,1,5655,-101.79,-439958.41,575622.45,135664.04
12402,1977-07-20,101.73,-0.06,-0.06,120.24,-15.39,True,1,5656,-101.73,-440060.14,575384.88,135324.74
12403,1977-07-21,101.59,-0.14,-0.14,120.24,-15.51,True,1,5657,-101.59,-440161.73,574694.63,134532.9
12404,1977-07-22,101.67,0.08,0.08,120.24,-15.44,True,1,5658,-101.67,-440263.4,575248.86,134985.46
12405,1977-07-25,100.85,-0.82,-0.81,120.24,-16.13,True,1,5659,-100.85,-440364.25,570710.15,130345.9
12406,1977-07-26,100.27,-0.58,-0.57,120.24,-16.61,True,1,5660,-100.27,-440464.52,567528.2,127063.68
12407,1977-07-27,98.64,-1.63,-1.63,120.24,-17.96,True,1,5661,-98.64,-440563.16,558401.04,117837.88
12408,1977-07-28,98.79,0.15,0.15,120.24,-17.84,True,1,5662,-98.79,-440661.95,559348.98,118687.03
12409,1977-07-29,98.85,0.06,0.06,120.24,-17.79,True,1,5663,-98.85,-440760.8,559787.55,119026.75
12410,1977-08-01,99.12,0.27,0.27,120.24,-17.57,True,1,5664,-99.12,-440859.92,561415.68,120555.76
12411,1977-08-02,98.5,-0.62,-0.63,120.24,-18.08,True,1,5665,-98.5,-440958.42,558002.5,117044.08
12412,1977-08-03,98.37,-0.13,-0.13,120.24,-18.19,True,1,5666,-98.37,-441056.79,557364.42,116307.63
12413,1977-08-04,98.74,0.37,0.38,120.24,-17.88,True,1,5667,-98.74,-441155.53,559559.58,118404.05
12414,1977-08-05,98.76,0.02,0.02,120.24,-17.86,True,1,5668,-98.76,-441254.29,559771.68,118517.39
12415,1977-08-08,97.99,-0.77,-0.78,120.24,-18.5,True,1,5669,-97.99,-441352.28,555505.31,114153.03
12416,1977-08-09,98.05,0.06,0.06,120.24,-18.45,True,1,5670,-98.05,-441450.33,555943.5,114493.17
12417,1977-08-10,98.92,0.87,0.89,120.24,-17.73,True,1,5671,-98.92,-441549.25,560975.32,119426.07
12418,1977-08-11,98.16,-0.76,-0.77,120.24,-18.36,True,1,5672,-98.16,-441647.41,556763.52,115116.11
12419,1977-08-12,97.88,-0.28,-0.28,120.24,-18.6,True,1,5673,-97.88,-441745.29,555273.24,113527.95
12420,1977-08-15,98.18,0.3,0.31,120.24,-18.35,True,1,5674,-98.18,-441843.47,557073.32,115229.85
12421,1977-08-16,97.73,-0.45,-0.46,120.24,-18.72,True,1,5675,-97.73,-441941.2,554617.75,112676.55
12422,1977-08-17,97.74,0.01,0.01,120.24,-18.71,True,1,5676,-97.74,-442038.94,554772.24,112733.3
12423,1977-08-18,97.68,-0.06,-0.06,120.24,-18.76,True,1,5677,-97.68,-442136.62,554529.36,112392.74
12424,1977-08-19,97.51,-0.17,-0.17,120.24,-18.9,True,1,5678,-97.51,-442234.13,553661.78,111427.65
12425,1977-08-22,97.79,0.28,0.29,120.24,-18.67,True,1,5679,-97.79,-442331.92,555349.41,113017.49
12426,1977-08-23,97.62,-0.17,-0.17,120.24,-18.81,True,1,5680,-97.62,-442429.54,554481.6,112052.06
12427,1977-08-24,97.23,-0.39,-0.4,120.24,-19.14,True,1,5681,-97.23,-442526.77,552363.63,109836.86
12428,1977-08-25,96.15,-1.08,-1.11,120.24,-20.04,True,1,5682,-96.15,-442622.92,546324.3,103701.38
12429,1977-08-26,96.06,-0.09,-0.09,120.24,-20.11,True,1,5683,-96.06,-442718.98,545908.98,103190.0
12430,1977-08-29,96.92,0.86,0.9,120.24,-19.4,True,1,5684,-96.92,-442815.9,550893.28,108077.38
12431,1977-08-30,96.38,-0.54,-0.56,120.24,-19.84,True,1,5685,-96.38,-442912.28,547920.3,105008.02
12432,1977-08-31,96.77,0.39,0.4,120.24,-19.52,True,1,5686,-96.77,-443009.05,550234.22,107225.17
12433,1977-09-01,96.83,0.06,0.06,120.24,-19.47,True,1,5687,-96.83,-443105.88,550672.21,107566.33
12434,1977-09-02,97.45,0.62,0.64,120.24,-18.95,True,1,5688,-97.45,-443203.33,554295.6,111092.27
12435,1977-09-06,97.71,0.26,0.27,120.24,-18.74,True,1,5689,-97.71,-443301.04,555872.19,112571.15
12436,1977-09-07,98.01,0.3,0.31,120.24,-18.49,True,1,5690,-98.01,-443399.05,557676.9,114277.85
12437,1977-09-08,97.28,-0.73,-0.74,120.24,-19.1,True,1,5691,-97.28,-443496.33,553620.48,110124.15
12438,1977-09-09,96.37,-0.91,-0.94,120.24,-19.85,True,1,5692,-96.37,-443592.7,548538.04,104945.34
12439,1977-09-12,96.03,-0.34,-0.35,120.24,-20.14,True,1,5693,-96.03,-443688.73,546698.79,103010.06
12440,1977-09-13,96.09,0.06,0.06,120.24,-20.08,True,1,5694,-96.09,-443784.82,547136.46,103351.64
12441,1977-09-14,96.55,0.46,0.48,120.24,-19.7,True,1,5695,-96.55,-443881.37,549852.25,105970.88
12442,1977-09-15,96.8,0.25,0.26,120.24,-19.49,True,1,5696,-96.8,-443978.17,551372.8,107394.63
12443,1977-09-16,96.48,-0.32,-0.33,120.24,-19.76,True,1,5697,-96.48,-444074.65,549646.56,105571.91
12444,1977-09-19,95.85,-0.63,-0.65,120.24,-20.28,True,1,5698,-95.85,-444170.5,546153.3,101982.8
12445,1977-09-20,95.89,0.04,0.04,120.24,-20.25,True,1,5699,-95.89,-444266.39,546477.11,102210.72
12446,1977-09-21,95.1,-0.79,-0.82,120.24,-20.91,True,1,5700,-95.1,-444361.49,542070.0,97708.51
12447,1977-09-22,95.09,-0.01,-0.01,120.24,-20.92,True,1,5701,-95.09,-444456.58,542108.09,97651.51
12448,1977-09-23,95.04,-0.05,-0.05,120.24,-20.96,True,1,5702,-95.04,-444551.62,541918.08,97366.46
12449,1977-09-26,95.38,0.34,0.36,120.24,-20.68,True,1,5703,-95.38,-444647.0,543952.14,99305.14
12450,1977-09-27,95.24,-0.14,-0.15,120.24,-20.79,True,1,5704,-95.24,-444742.24,543248.96,98506.72
12451,1977-09-28,95.31,0.07,0.07,120.24,-20.73,True,1,5705,-95.31,-444837.55,543743.55,98906.0
12452,1977-09-29,95.85,0.54,0.57,120.24,-20.28,True,1,5706,-95.85,-444933.4,546920.1,101986.7
12453,1977-09-30,96.53,0.68,0.71,120.24,-19.72,True,1,5707,-96.53,-445029.93,550896.71,105866.78
12454,1977-10-03,96.74,0.21,0.22,120.24,-19.54,True,1,5708,-96.74,-445126.67,552191.92,107065.25
12455,1977-10-04,96.03,-0.71,-0.73,120.24,-20.14,True,1,5709,-96.03,-445222.7,548235.27,103012.57
12456,1977-10-05,95.68,-0.35,-0.36,120.24,-20.43,True,1,5710,-95.68,-445318.38,546332.8,101014.42
12457,1977-10-06,96.05,0.37,0.39,120.24,-20.12,True,1,5711,-96.05,-445414.43,548541.55,103127.12
12458,1977-10-07,95.97,-0.08,-0.08,120.24,-20.18,True,1,5712,-95.97,-445510.4,548180.64,102670.24
12459,1977-10-10,95.75,-0.22,-0.23,120.24,-20.37,True,1,5713,-95.75,-445606.15,547019.75,101413.6
12460,1977-10-11,94.93,-0.82,-0.86,120.24,-21.05,True,1,5714,-94.93,-445701.08,542430.02,96728.94
12461,1977-10-12,94.04,-0.89,-0.94,120.24,-21.79,True,1,5715,-94.04,-445795.12,537438.6,91643.48
12462,1977-10-13,93.46,-0.58,-0.62,120.24,-22.27,True,1,5716,-93.46,-445888.58,534217.36,88328.78
12463,1977-10-14,93.56,0.1,0.11,120.24,-22.19,True,1,5717,-93.56,-445982.14,534882.52,88900.38
12464,1977-10-17,93.47,-0.09,-0.1,120.24,-22.26,True,1,5718,-93.47,-446075.61,534461.46,88385.85
12465,1977-10-18,93.46,-0.01,-0.01,120.24,-22.27,True,1,5719,-93.46,-446169.07,534497.74,88328.67
12466,1977-10-19,92.38,-1.08,-1.16,120.24,-23.17,True,1,5720,-92.38,-446261.45,528413.6,82152.15
12467,1977-10-20,92.67,0.29,0.31,120.24,-22.93,True,1,5721,-92.67,-446354.12,530165.07,83810.95
12468,1977-10-21,92.32,-0.35,-0.38,120.24,-23.22,True,1,5722,-92.32,-446446.44,528255.04,81808.6
12469,1977-10-24,91.63,-0.69,-0.75,120.24,-23.79,True,1,5723,-91.63,-446538.07,524398.49,77860.42
12470,1977-10-25,91.0,-0.63,-0.69,120.24,-24.32,True,1,5724,-91.0,-446629.07,520884.0,74254.93
12471,1977-10-26,92.1,1.1,1.21,120.24,-23.4,True,1,5725,-92.1,-446721.17,527272.5,80551.33
12472,1977-10-27,92.34,0.24,0.26,120.24,-23.2,True,1,5726,-92.34,-446813.51,528738.84,81925.33
12473,1977-10-28,92.61,0.27,0.29,120.24,-22.98,True,1,5727,-92.61,-446906.12,530377.47,83471.35
12474,1977-10-31,92.34,-0.27,-0.29,120.24,-23.2,True,1,5728,-92.34,-446998.46,528923.52,81925.06
12475,1977-11-01,91.35,-0.99,-1.07,120.24,-24.03,True,1,5729,-91.35,-447089.81,523344.15,76254.34
12476,1977-11-02,90.71,-0.64,-0.7,120.24,-24.56,True,1,5730,-90.71,-447180.52,519768.3,72587.78
12477,1977-11-03,90.76,0.05,0.06,120.24,-24.52,True,1,5731,-90.76,-447271.28,520145.56,72874.28
12478,1977-11-04,91.58,0.82,0.9,120.24,-23.84,True,1,5732,-91.58,-447362.86,524936.56,77573.7
12479,1977-11-07,92.29,0.71,0.78,120.24,-23.24,True,1,5733,-92.29,-447455.15,529098.57,81643.42
12480,1977-11-08,92.46,0.17,0.18,120.24,-23.1,True,1,5734,-92.46,-447547.61,530165.64,82618.03
12481,1977-11-09,92.98,0.52,0.56,120.24,-22.67,True,1,5735,-92.98,-447640.59,533240.3,85599.71
12482,1977-11-10,94.71,1.73,1.86,120.24,-21.23,True,1,5736,-94.71,-447735.3,543256.56,95521.26
12483,1977-11-11,95.98,1.27,1.34,120.24,-20.18,True,1,5737,-95.98,-447831.28,550637.26,102805.98
12484,1977-11-14,95.32,-0.66,-0.69,120.24,-20.72,True,1,5738,-95.32,-447926.6,546946.16,99019.56
12485,1977-11-15,95.93,0.61,0.64,120.24,-20.22,True,1,5739,-95.93,-448022.53,550542.27,102519.74
12486,1977-11-16,95.45,-0.48,-0.5,120.24,-20.62,True,1,5740,-95.45,-448117.98,547883.0,99765.02
12487,1977-11-17,95.16,-0.29,-0.3,120.24,-20.86,True,1,5741,-95.16,-448213.14,546313.56,98100.42
12488,1977-11-18,95.33,0.17,0.18,120.24,-20.72,True,1,5742,-95.33,-448308.47,547384.86,99076.39
12489,1977-11-21,95.25,-0.08,-0.08,120.24,-20.78,True,1,5743,-95.25,-448403.72,547020.75,98617.03
12490,1977-11-22,96.09,0.84,0.88,120.24,-20.08,True,1,5744,-96.09,-448499.81,551940.96,103441.15
12491,1977-11-23,96.49,0.4,0.42,120.24,-19.75,True,1,5745,-96.49,-448596.3,554335.05,105738.75
12492,1977-11-25,96.69,0.2,0.21,120.24,-19.59,True,1,5746,-96.69,-448692.99,555580.74,106887.75
12493,1977-11-28,96.04,-0.65,-0.67,120.24,-20.13,True,1,5747,-96.04,-448789.03,551941.88,103152.85
12494,1977-11-29,94.55,-1.49,-1.55,120.24,-21.37,True,1,5748,-94.55,-448883.58,543473.4,94589.82
12495,1977-11-30,94.83,0.28,0.3,120.24,-21.13,True,1,5749,-94.83,-448978.41,545177.67,96199.26
12496,1977-12-01,94.69,-0.14,-0.15,120.24,-21.25,True,1,5750,-94.69,-449073.1,544467.5,95394.4
12497,1977-12-02,94.67,-0.02,-0.02,120.24,-21.27,True,1,5751,-94.67,-449167.77,544447.17,95279.4
12498,1977-12-05,94.27,-0.4,-0.42,120.24,-21.6,True,1,5752,-94.27,-449262.04,542241.04,92979.0
12499,1977-12-06,92.83,-1.44,-1.53,120.24,-22.8,True,1,5753,-92.83,-449354.87,534050.99,84696.12
12500,1977-12-07,92.78,-0.05,-0.05,120.24,-22.84,True,1,5754,-92.78,-449447.65,533856.12,84408.47
12501,1977-12-08,92.96,0.18,0.19,120.24,-22.69,True,1,5755,-92.96,-449540.61,534984.8,85444.19
12502,1977-12-09,93.65,0.69,0.74,120.24,-22.11,True,1,5756,-93.65,-449634.26,539049.4,89415.14
12503,1977-12-12,93.63,-0.02,-0.02,120.24,-22.13,True,1,5757,-93.63,-449727.89,539027.91,89300.02
12504,1977-12-13,93.56,-0.07,-0.08,120.24,-22.19,True,1,5758,-93.56,-449821.45,538718.48,88897.03
12505,1977-12-14,94.03,0.47,0.5,120.24,-21.8,True,1,5759,-94.03,-449915.48,541518.77,91603.29
12506,1977-12-15,93.55,-0.48,-0.51,120.24,-22.2,True,1,5760,-93.55,-450009.03,538848.0,88838.97
12507,1977-12-16,93.4,-0.15,-0.16,120.24,-22.32,True,1,5761,-93.4,-450102.43,538077.4,87974.97
12508,1977-12-19,92.69,-0.71,-0.76,120.24,-22.91,True,1,5762,-92.69,-450195.12,534079.78,83884.66
12509,1977-12-20,92.5,-0.19,-0.2,120.24,-23.07,True,1,5763,-92.5,-450287.62,533077.5,82789.88
12510,1977-12-21,93.05,0.55,0.6,120.24,-22.61,True,1,5764,-93.05,-450380.67,536340.2,85959.53
12511,1977-12-22,93.8,0.75,0.81,120.24,-21.99,True,1,5765,-93.8,-450474.47,540757.0,90282.53
12512,1977-12-23,94.69,0.89,0.95,120.24,-21.25,True,1,5766,-94.69,-450569.16,545982.54,95413.38
12513,1977-12-27,94.69,0.0,0.0,120.24,-21.25,True,1,5767,-94.69,-450663.85,546077.23,95413.38
12514,1977-12-28,94.75,0.06,0.06,120.24,-21.2,True,1,5768,-94.75,-450758.6,546518.0,95759.4
12515,1977-12-29,94.94,0.19,0.2,120.24,-21.04,True,1,5769,-94.94,-450853.54,547708.86,96855.32
12516,1977-12-30,95.1,0.16,0.17,120.24,-20.91,True,1,5770,-95.1,-450948.64,548727.0,97778.36
12517,1978-01-03,93.82,-1.28,-1.35,120.24,-21.97,True,1,5771,-93.82,-451042.46,541435.22,90392.76
12518,1978-01-04,93.52,-0.3,-0.32,120.24,-22.22,True,1,5772,-93.52,-451135.98,539797.44,88661.46
12519,1978-01-05,92.74,-0.78,-0.83,120.24,-22.87,True,1,5773,-92.74,-451228.72,535388.02,84159.3
12520,1978-01-06,91.62,-1.12,-1.21,120.24,-23.8,True,1,5774,-91.62,-451320.34,529013.88,77693.54
12521,1978-01-09,90.64,-0.98,-1.07,120.24,-24.62,True,1,5775,-90.64,-451410.98,523446.0,72035.02
12522,1978-01-10,90.17,-0.47,-0.52,120.24,-25.01,True,1,5776,-90.17,-451501.15,520821.92,69320.77
12523,1978-01-11,89.74,-0.43,-0.48,120.24,-25.37,True,1,5777,-89.74,-451590.89,518427.98,66837.09
12524,1978-01-12,89.82,0.08,0.09,120.24,-25.3,True,1,5778,-89.82,-451680.71,518979.96,67299.25
12525,1978-01-13,89.69,-0.13,-0.14,120.24,-25.41,True,1,5779,-89.69,-451770.4,518318.51,66548.11
12526,1978-01-16,89.43,-0.26,-0.29,120.24,-25.62,True,1,5780,-89.43,-451859.83,516905.4,65045.57
12527,1978-01-17,89.88,0.45,0.5,120.24,-25.25,True,1,5781,-89.88,-451949.71,519596.28,67646.57
12528,1978-01-18,90.56,0.68,0.76,120.24,-24.68,True,1,5782,-90.56,-452040.27,523617.92,71577.65
12529,1978-01-19,90.09,-0.47,-0.52,120.24,-25.08,True,1,5783,-90.09,-452130.36,520990.47,68860.11
12530,1978-01-20,89.89,-0.2,-0.22,120.24,-25.24,True,1,5784,-89.89,-452220.25,519923.76,67703.51
12531,1978-01-23,89.24,-0.65,-0.72,120.24,-25.78,True,1,5785,-89.24,-452309.49,516253.4,63943.91
12532,1978-01-24,89.25,0.01,0.01,120.24,-25.77,True,1,5786,-89.25,-452398.74,516400.5,64001.76
12533,1978-01-25,89.39,0.14,0.16,120.24,-25.66,True,1,5787,-89.39,-452488.13,517299.93,64811.8
12534,1978-01-26,88.58,-0.81,-0.91,120.24,-26.33,True,1,5788,-88.58,-452576.71,512701.04,60124.33
12535,1978-01-27,88.58,0.0,0.0,120.24,-26.33,True,1,5789,-88.58,-452665.29,512789.62,60124.33
12536,1978-01-30,89.34,0.76,0.86,120.24,-25.7,True,1,5790,-89.34,-452754.63,517278.6,64523.97
12537,1978-01-31,89.25,-0.09,-0.1,120.24,-25.77,True,1,5791,-89.25,-452843.88,516846.75,64002.87
12538,1978-02-01,89.93,0.68,0.76,120.24,-25.21,True,1,5792,-89.93,-452933.81,520874.56,67940.75
12539,1978-02-02,90.13,0.2,0.22,120.24,-25.04,True,1,5793,-90.13,-453023.94,522123.09,69099.15
12540,1978-02-03,89.62,-0.51,-0.57,120.24,-25.47,True,1,5794,-89.62,-453113.56,519258.28,66144.72
12541,1978-02-06,89.5,-0.12,-0.13,120.24,-25.57,True,1,5795,-89.5,-453203.06,518652.5,65449.44
12542,1978-02-07,90.33,0.83,0.93,120.24,-24.88,True,1,5796,-90.33,-453293.39,523552.68,70259.29
12543,1978-02-08,90.83,0.5,0.55,120.24,-24.46,True,1,5797,-90.83,-453384.22,526541.51,73157.29
12544,1978-02-09,90.3,-0.53,-0.58,120.24,-24.9,True,1,5798,-90.3,-453474.52,523559.4,70084.88
12545,1978-02-10,90.08,-0.22,-0.24,120.24,-25.08,True,1,5799,-90.08,-453564.6,522373.92,68809.32
12546,1978-02-13,89.86,-0.22,-0.24,120.24,-25.27,True,1,5800,-89.86,-453654.46,521188.0,67533.54
12547,1978-02-14,89.04,-0.82,-0.91,120.24,-25.95,True,1,5801,-89.04,-453743.5,516521.04,62777.54
12548,1978-02-15,88.83,-0.21,-0.24,120.24,-26.12,True,1,5802,-88.83,-453832.33,515391.66,61559.33
12549,1978-02-16,88.08,-0.75,-0.84,120.24,-26.75,True,1,5803,-88.08,-453920.41,511128.24,57207.83
12550,1978-02-17,87.96,-0.12,-0.14,120.24,-26.85,True,1,5804,-87.96,-454008.37,510519.84,56511.47
12551,1978-02-21,87.59,-0.37,-0.42,120.24,-27.15,True,1,5805,-87.59,-454095.96,508459.95,54363.99
12552,1978-02-22,87.56,-0.03,-0.03,120.24,-27.18,True,1,5806,-87.56,-454183.52,508373.36,54189.84
12553,1978-02-23,87.64,0.08,0.09,120.24,-27.11,True,1,5807,-87.64,-454271.16,508925.48,54654.32
12554,1978-02-24,88.49,0.85,0.97,120.24,-26.41,True,1,5808,-88.49,-454359.65,513949.92,59590.27
12555,1978-02-27,87.72,-0.77,-0.87,120.24,-27.05,True,1,5809,-87.72,-454447.37,509565.48,55118.11
12556,1978-02-28,87.04,-0.68,-0.78,120.24,-27.61,True,1,5810,-87.04,-454534.41,505702.4,51167.99
12557,1978-03-01,87.19,0.15,0.17,120.24,-27.49,True,1,5811,-87.19,-454621.6,506661.09,52039.49
12558,1978-03-02,87.32,0.13,0.15,120.24,-27.38,True,1,5812,-87.32,-454708.92,507503.84,52794.92
12559,1978-03-03,87.45,0.13,0.15,120.24,-27.27,True,1,5813,-87.45,-454796.37,508346.85,53550.48
12560,1978-03-06,86.9,-0.55,-0.63,120.24,-27.73,True,1,5814,-86.9,-454883.27,505236.6,50353.33
12561,1978-03-07,87.36,0.46,0.53,120.24,-27.34,True,1,5815,-87.36,-454970.63,507998.4,53027.77
12562,1978-03-08,87.84,0.48,0.55,120.24,-26.95,True,1,5816,-87.84,-455058.47,510877.44,55818.97
12563,1978-03-09,87.89,0.05,0.06,120.24,-26.9,True,1,5817,-87.89,-455146.36,511256.13,56109.77
12564,1978-03-10,88.88,0.99,1.13,120.24,-26.08,True,1,5818,-88.88,-455235.24,517103.84,61868.6
12565,1978-03-13,88.95,0.07,0.08,120.24,-26.02,True,1,5819,-88.95,-455324.19,517600.05,62275.86
12566,1978-03-14,89.35,0.4,0.45,120.24,-25.69,True,1,5820,-89.35,-455413.54,520017.0,64603.46
12567,1978-03-15,89.12,-0.23,-0.26,120.24,-25.88,True,1,5821,-89.12,-455502.66,518767.52,63264.86
12568,1978-03-16,89.51,0.39,0.44,120.24,-25.56,True,1,5822,-89.51,-455592.17,521127.22,65535.05
12569,1978-03-17,90.2,0.69,0.77,120.24,-24.98,True,1,5823,-90.2,-455682.37,525234.6,69552.23
12570,1978-03-20,90.82,0.62,0.69,120.24,-24.47,True,1,5824,-90.82,-455773.19,528935.68,73162.49
12571,1978-03-21,89.79,-1.03,-1.13,120.24,-25.32,True,1,5825,-89.79,-455862.98,523026.75,67163.77
12572,1978-03-22,89.47,-0.32,-0.36,120.24,-25.59,True,1,5826,-89.47,-455952.45,521252.22,65299.77
12573,1978-03-23,89.36,-0.11,-0.12,120.24,-25.68,True,1,5827,-89.36,-456041.81,520700.72,64658.91
12574,1978-03-27,88.87,-0.49,-0.55,120.24,-26.09,True,1,5828,-88.87,-456130.68,517934.36,61803.68
12575,1978-03-28,89.5,0.63,0.71,120.24,-25.57,True,1,5829,-89.5,-456220.18,521695.5,65475.32
12576,1978-03-29,89.64,0.14,0.16,120.24,-25.45,True,1,5830,-89.64,-456309.82,522601.2,66291.38
12577,1978-03-30,89.41,-0.23,-0.26,120.24,-25.64,True,1,5831,-89.41,-456399.23,521349.71,64950.48
12578,1978-03-31,89.21,-0.2,-0.22,120.24,-25.81,True,1,5832,-89.21,-456488.44,520272.72,63784.28
12579,1978-04-03,88.46,-0.75,-0.84,120.24,-26.43,True,1,5833,-88.46,-456576.9,515987.18,59410.28
12580,1978-04-04,88.86,0.4,0.45,120.24,-26.1,True,1,5834,-88.86,-456665.76,518409.24,61743.48
12581,1978-04-05,89.64,0.78,0.88,120.24,-25.45,True,1,5835,-89.64,-456755.4,523049.4,66294.0
12582,1978-04-06,89.79,0.15,0.17,120.24,-25.32,True,1,5836,-89.79,-456845.19,524014.44,67169.25
12583,1978-04-07,90.17,0.38,0.42,120.24,-25.01,True,1,5837,-90.17,-456935.36,526322.29,69386.93
12584,1978-04-10,90.49,0.32,0.36,120.24,-24.74,True,1,5838,-90.49,-457025.85,528280.62,71254.77
12585,1978-04-11,90.25,-0.24,-0.26,120.24,-24.94,True,1,5839,-90.25,-457116.1,526969.75,69853.65
12586,1978-04-12,90.11,-0.14,-0.16,120.24,-25.06,True,1,5840,-90.11,-457206.21,526242.4,69036.19
12587,1978-04-13,90.98,0.87,0.96,120.24,-24.34,True,1,5841,-90.98,-457297.19,531414.18,74116.99
12588,1978-04-14,92.92,1.94,2.13,120.24,-22.72,True,1,5842,-92.92,-457390.11,542838.64,85448.53
12589,1978-04-17,94.45,1.53,1.65,120.24,-21.45,True,1,5843,-94.45,-457484.56,551871.35,94386.79
12590,1978-04-18,93.43,-1.02,-1.08,120.24,-22.3,True,1,5844,-93.43,-457577.99,546004.92,88426.93
12591,1978-04-19,93.86,0.43,0.46,120.24,-21.94,True,1,5845,-93.86,-457671.85,548611.7,90939.85
12592,1978-04-20,94.54,0.68,0.72,120.24,-21.37,True,1,5846,-94.54,-457766.39,552680.84,94914.45
12593,1978-04-21,94.34,-0.2,-0.21,120.24,-21.54,True,1,5847,-94.34,-457860.73,551605.98,93745.25
12594,1978-04-24,95.77,1.43,1.52,120.24,-20.35,True,1,5848,-95.77,-457956.5,560062.96,102106.46
12595,1978-04-25,96.64,0.87,0.91,120.24,-19.63,True,1,5849,-96.64,-458053.14,565247.36,107194.22
12596,1978-04-26,96.82,0.18,0.19,120.24,-19.48,True,1,5850,-96.82,-458149.96,566397.0,108247.04
12597,1978-04-27,95.86,-0.96,-0.99,120.24,-20.28,True,1,5851,-95.86,-458245.82,560876.86,102631.04
12598,1978-04-28,96.83,0.97,1.01,120.24,-19.47,True,1,5852,-96.83,-458342.65,566649.16,108306.51
12599,1978-05-01,97.67,0.84,0.87,120.24,-18.77,True,1,5853,-97.67,-458440.32,571662.51,113222.19
12600,1978-05-02,97.25,-0.42,-0.43,120.24,-19.12,True,1,5854,-97.25,-458537.57,569301.5,110763.93
12601,1978-05-03,96.26,-0.99,-1.02,120.24,-19.94,True,1,5855,-96.26,-458633.83,563602.3,104968.47
12602,1978-05-04,95.93,-0.33,-0.34,120.24,-20.22,True,1,5856,-95.93,-458729.76,561766.08,103036.32
12603,1978-05-05,96.53,0.6,0.62,120.24,-19.72,True,1,5857,-96.53,-458826.29,565376.21,106549.92
12604,1978-05-08,96.19,-0.34,-0.35,120.24,-20.0,True,1,5858,-96.19,-458922.48,563481.02,104558.54
12605,1978-05-09,95.9,-0.29,-0.3,120.24,-20.24,True,1,5859,-95.9,-459018.38,561878.1,102859.72
12606,1978-05-10,95.92,0.02,0.02,120.24,-20.23,True,1,5860,-95.92,-459114.3,562091.2,102976.9
12607,1978-05-11,97.2,1.28,1.33,120.24,-19.16,True,1,5861,-97.2,-459211.5,569689.2,110477.7
12608,1978-05-12,98.07,0.87,0.9,120.24,-18.44,True,1,5862,-98.07,-459309.57,574886.34,115576.77
12609,1978-05-15,98.76,0.69,0.7,120.24,-17.86,True,1,5863,-98.76,-459408.33,579029.88,119621.55
12610,1978-05-16,99.35,0.59,0.6,120.24,-17.37,True,1,5864,-99.35,-459507.68,582588.4,123080.72
12611,1978-05-17,99.6,0.25,0.25,120.24,-17.17,True,1,5865,-99.6,-459607.28,584154.0,124546.72
12612,1978-05-18,98.62,-0.98,-0.98,120.24,-17.98,True,1,5866,-98.62,-459705.9,578504.92,118799.02
12613,1978-05-19,98.12,-0.5,-0.51,120.24,-18.4,True,1,5867,-98.12,-459804.02,575670.04,115866.02
12614,1978-05-22,99.09,0.97,0.99,120.24,-17.59,True,1,5868,-99.09,-459903.11,581460.12,121557.01
12615,1978-05-23,98.05,-1.04,-1.05,120.24,-18.45,True,1,5869,-98.05,-460001.16,575455.45,115454.29
12616,1978-05-24,97.08,-0.97,-0.99,120.24,-19.26,True,1,5870,-97.08,-460098.24,569859.6,109761.36
12617,1978-05-25,96.8,-0.28,-0.29,120.24,-19.49,True,1,5871,-96.8,-460195.04,568312.8,108117.76
12618,1978-05-26,96.58,-0.22,-0.23,120.24,-19.68,True,1,5872,-96.58,-460291.62,567117.76,106826.14
12619,1978-05-30,96.86,0.28,0.29,120.24,-19.44,True,1,5873,-96.86,-460388.48,568858.78,108470.3
12620,1978-05-31,97.24,0.38,0.39,120.24,-19.13,True,1,5874,-97.24,-460485.72,571187.76,110702.04
12621,1978-06-01,97.35,0.11,0.11,120.24,-19.04,True,1,5875,-97.35,-460583.07,571931.25,111348.18
12622,1978-06-02,98.14,0.79,0.81,120.24,-18.38,True,1,5876,-98.14,-460681.21,576670.64,115989.43
12623,1978-06-05,99.95,1.81,1.84,120.24,-16.88,True,1,5877,-99.95,-460781.16,587406.15,126624.99
12624,1978-06-06,100.32,0.37,0.37,120.24,-16.57,True,1,5878,-100.32,-460881.48,589680.96,128799.48
12625,1978-06-07,100.12,-0.2,-0.2,120.24,-16.73,True,1,5879,-100.12,-460981.6,588605.48,127623.88
12626,1978-06-08,100.21,0.09,0.09,120.24,-16.66,True,1,5880,-100.21,-461081.81,589234.8,128152.99
12627,1978-06-09,99.93,-0.28,-0.28,120.24,-16.89,True,1,5881,-99.93,-461181.74,587688.33,126506.59
12628,1978-06-12,99.55,-0.38,-0.38,120.24,-17.21,True,1,5882,-99.55,-461281.29,585553.1,124271.81
12629,1978-06-13,99.57,0.02,0.02,120.24,-17.19,True,1,5883,-99.57,-461380.86,585770.31,124389.45
12630,1978-06-14,99.48,-0.09,-0.09,120.24,-17.26,True,1,5884,-99.48,-461480.34,585340.32,123859.98
12631,1978-06-15,98.34,-1.14,-1.15,120.24,-18.21,True,1,5885,-98.34,-461578.68,578730.9,117152.22
12632,1978-06-16,97.42,-0.92,-0.94,120.24,-18.98,True,1,5886,-97.42,-461676.1,573414.12,111738.02
12633,1978-06-19,97.49,0.07,0.07,120.24,-18.92,True,1,5887,-97.49,-461773.59,573923.63,112150.04
12634,1978-06-20,96.51,-0.98,-1.0,120.24,-19.74,True,1,5888,-96.51,-461870.1,568250.88,106380.78
12635,1978-06-21,96.01,-0.5,-0.52,120.24,-20.15,True,1,5889,-96.01,-461966.11,565402.89,103436.78
12636,1978-06-22,96.24,0.23,0.24,120.24,-19.96,True,1,5890,-96.24,-462062.35,566853.6,104791.25
12637,1978-06-23,95.85,-0.39,-0.4,120.24,-20.28,True,1,5891,-95.85,-462158.2,564652.35,102494.15
12638,1978-06-26,94.6,-1.25,-1.3,120.24,-21.32,True,1,5892,-94.6,-462252.8,557383.2,95130.4
12639,1978-06-27,94.98,0.38,0.4,120.24,-21.01,True,1,5893,-94.98,-462347.78,559717.14,97369.36
12640,1978-06-28,95.4,0.42,0.44,120.24,-20.66,True,1,5894,-95.4,-462443.18,562287.6,99844.42
12641,1978-06-29,95.57,0.17,0.18,120.24,-20.52,True,1,5895,-95.57,-462538.75,563385.15,100846.4
12642,1978-06-30,95.53,-0.04,-0.04,120.24,-20.55,True,1,5896,-95.53,-462634.28,563244.88,100610.6
12643,1978-07-03,95.09,-0.44,-0.46,120.24,-20.92,True,1,5897,-95.09,-462729.37,560745.73,98016.36
12644,1978-07-05,94.27,-0.82,-0.86,120.24,-21.6,True,1,5898,-94.27,-462823.64,556004.46,93180.82
12645,1978-07-06,94.32,0.05,0.05,120.24,-21.56,True,1,5899,-94.32,-462917.96,556393.68,93475.72
12646,1978-07-07,94.89,0.57,0.6,120.24,-21.08,True,1,5900,-94.89,-463012.85,559851.0,96838.15
12647,1978-07-10,95.27,0.38,0.4,120.24,-20.77,True,1,5901,-95.27,-463108.12,562188.27,99080.15
12648,1978-07-11,95.93,0.66,0.69,120.24,-20.22,True,1,5902,-95.93,-463204.05,566178.86,102974.81
12649,1978-07-12,96.24,0.31,0.32,120.24,-19.96,True,1,5903,-96.24,-463300.29,568104.72,104804.43
12650,1978-07-13,96.25,0.01,0.01,120.24,-19.95,True,1,5904,-96.25,-463396.54,568260.0,104863.46
12651,1978-07-14,97.58,1.33,1.38,120.24,-18.85,True,1,5905,-97.58,-463494.12,576209.9,112715.78
12652,1978-07-17,97.78,0.2,0.2,120.24,-18.68,True,1,5906,-97.78,-463591.9,577488.68,113896.78
12653,1978-07-18,96.87,-0.91,-0.93,120.24,-19.44,True,1,5907,-96.87,-463688.77,572211.09,108522.32
12654,1978-07-19,98.12,1.25,1.29,120.24,-18.4,True,1,5908,-98.12,-463786.89,579692.96,115906.07
12655,1978-07-20,98.03,-0.09,-0.09,120.24,-18.47,True,1,5909,-98.03,-463884.92,579259.27,115374.35
12656,1978-07-21,97.75,-0.28,-0.29,120.24,-18.7,True,1,5910,-97.75,-463982.67,577702.5,113719.83
12657,1978-07-24,97.72,-0.03,-0.03,120.24,-18.73,True,1,5911,-97.72,-464080.39,577622.92,113542.53
12658,1978-07-25,98.44,0.72,0.74,120.24,-18.13,True,1,5912,-98.44,-464178.83,581977.28,117798.45
12659,1978-07-26,99.08,0.64,0.65,120.24,-17.6,True,1,5913,-99.08,-464277.91,585860.04,121582.13
12660,1978-07-27,99.54,0.46,0.46,120.24,-17.22,True,1,5914,-99.54,-464377.45,588679.56,124302.11
12661,1978-07-28,100.0,0.46,0.46,120.24,-16.83,True,1,5915,-100.0,-464477.45,591500.0,127022.55
12662,1978-07-31,100.68,0.68,0.68,120.24,-16.27,True,1,5916,-100.68,-464578.13,595622.88,131044.75
12663,1978-08-01,100.66,-0.02,-0.02,120.24,-16.28,True,1,5917,-100.66,-464678.79,595605.22,130926.43
12664,1978-08-02,102.92,2.26,2.24,120.24,-14.4,True,1,5918,-102.92,-464781.71,609080.56,144298.85
12665,1978-08-03,103.51,0.59,0.57,120.24,-13.91,True,1,5919,-103.51,-464885.22,612675.69,147790.47
12666,1978-08-04,103.92,0.41,0.4,120.24,-13.57,True,1,5920,-103.92,-464989.14,615206.4,150217.26
12667,1978-08-07,103.55,-0.37,-0.36,120.24,-13.88,True,1,5921,-103.55,-465092.69,613119.55,148026.86
12668,1978-08-08,104.01,0.46,0.44,120.24,-13.5,True,1,5922,-104.01,-465196.7,615947.22,150750.52
12669,1978-08-09,104.5,0.49,0.47,120.24,-13.09,True,1,5923,-104.5,-465301.2,618953.5,153652.3
12670,1978-08-10,103.66,-0.84,-0.8,120.24,-13.79,True,1,5924,-103.66,-465404.86,614081.84,148676.98
12671,1978-08-11,103.96,0.3,0.29,120.24,-13.54,True,1,5925,-103.96,-465508.82,615963.0,150454.18
12672,1978-08-14,103.97,0.01,0.01,120.24,-13.53,True,1,5926,-103.97,-465612.79,616126.22,150513.43
12673,1978-08-15,103.85,-0.12,-0.12,120.24,-13.63,True,1,5927,-103.85,-465716.64,615518.95,149802.31
12674,1978-08-16,104.65,0.8,0.77,120.24,-12.97,True,1,5928,-104.65,-465821.29,620365.2,154543.91
12675,1978-08-17,105.08,0.43,0.41,120.24,-12.61,True,1,5929,-105.08,-465926.37,623019.32,157092.95
12676,1978-08-18,104.73,-0.35,-0.33,120.24,-12.9,True,1,5930,-104.73,-466031.1,621048.9,155017.8
12677,1978-08-21,103.89,-0.84,-0.8,120.24,-13.6,True,1,5931,-103.89,-466134.99,616171.59,150036.6
12678,1978-08-22,104.31,0.42,0.4,120.24,-13.25,True,1,5932,-104.31,-466239.3,618766.92,152527.62
12679,1978-08-23,104.91,0.6,0.57,120.24,-12.75,True,1,5933,-104.91,-466344.21,622431.03,156086.82
12680,1978-08-24,105.08,0.17,0.16,120.24,-12.61,True,1,5934,-105.08,-466449.29,623544.72,157095.43
12681,1978-08-25,104.9,-0.18,-0.17,120.24,-12.76,True,1,5935,-104.9,-466554.19,622581.5,156027.31
12682,1978-08-28,103.96,-0.94,-0.9,120.24,-13.54,True,1,5936,-103.96,-466658.15,617106.56,150448.41
12683,1978-08-29,103.39,-0.57,-0.55,120.24,-14.01,True,1,5937,-103.39,-466761.54,613826.43,147064.89
12684,1978-08-30,103.5,0.11,0.11,120.24,-13.92,True,1,5938,-103.5,-466865.04,614583.0,147717.96
12685,1978-08-31,103.29,-0.21,-0.2,120.24,-14.1,True,1,5939,-103.29,-466968.33,613439.31,146470.98
12686,1978-09-01,103.68,0.39,0.38,120.24,-13.77,True,1,5940,-103.68,-467072.01,615859.2,148787.19
12687,1978-09-05,104.49,0.81,0.78,120.24,-13.1,True,1,5941,-104.49,-467176.5,620775.09,153598.59
12688,1978-09-06,105.38,0.89,0.85,120.24,-12.36,True,1,5942,-105.38,-467281.88,626167.96,158886.08
12689,1978-09-07,105.42,0.04,0.04,120.24,-12.32,True,1,5943,-105.42,-467387.3,626511.06,159123.76
12690,1978-09-08,106.79,1.37,1.3,120.24,-11.19,True,1,5944,-106.79,-467494.09,634759.76,167265.67
12691,1978-09-11,106.98,0.19,0.18,120.24,-11.03,True,1,5945,-106.98,-467601.07,635996.1,168395.03
12692,1978-09-12,106.99,0.01,0.01,120.24,-11.02,True,1,5946,-106.99,-467708.06,636162.54,168454.48
12693,1978-09-13,106.34,-0.65,-0.61,120.24,-11.56,True,1,5947,-106.34,-467814.4,632403.98,164589.58
12694,1978-09-14,105.1,-1.24,-1.17,120.24,-12.59,True,1,5948,-105.1,-467919.5,625134.8,157215.3
12695,1978-09-15,104.12,-0.98,-0.93,120.24,-13.41,True,1,5949,-104.12,-468023.62,619409.88,151386.26
12696,1978-09-18,103.21,-0.91,-0.87,120.24,-14.16,True,1,5950,-103.21,-468126.83,614099.5,145972.67
12697,1978-09-19,102.53,-0.68,-0.66,120.24,-14.73,True,1,5951,-102.53,-468229.36,610156.03,141926.67
12698,1978-09-20,101.73,-0.8,-0.78,120.24,-15.39,True,1,5952,-101.73,-468331.09,605496.96,137165.87
12699,1978-09-21,101.9,0.17,0.17,120.24,-15.25,True,1,5953,-101.9,-468432.99,606610.7,138177.71
12700,1978-09-22,101.84,-0.06,-0.06,120.24,-15.3,True,1,5954,-101.84,-468534.83,606355.36,137820.53
12701,1978-09-25,101.86,0.02,0.02,120.24,-15.29,True,1,5955,-101.86,-468636.69,606576.3,137939.61
12702,1978-09-26,102.62,0.76,0.75,120.24,-14.65,True,1,5956,-102.62,-468739.31,611204.72,142465.41
12703,1978-09-27,101.66,-0.96,-0.94,120.24,-15.45,True,1,5957,-101.66,-468840.97,605588.62,136747.65
12704,1978-09-28,101.96,0.3,0.3,120.24,-15.2,True,1,5958,-101.96,-468942.93,607477.68,138534.75
12705,1978-09-29,102.54,0.58,0.57,120.24,-14.72,True,1,5959,-102.54,-469045.47,611035.86,141990.39
12706,1978-10-02,102.96,0.42,0.41,120.24,-14.37,True,1,5960,-102.96,-469148.43,613641.6,144493.17
12707,1978-10-03,102.6,-0.36,-0.35,120.24,-14.67,True,1,5961,-102.6,-469251.03,611598.6,142347.57
12708,1978-10-04,103.06,0.46,0.45,120.24,-14.29,True,1,5962,-103.06,-469354.09,614443.72,145089.63
12709,1978-10-05,103.27,0.21,0.2,120.24,-14.11,True,1,5963,-103.27,-469457.36,615799.01,146341.65
12710,1978-10-06,103.52,0.25,0.24,120.24,-13.91,True,1,5964,-103.52,-469560.88,617393.28,147832.4
12711,1978-10-09,104.59,1.07,1.03,120.24,-13.02,True,1,5965,-104.59,-469665.47,623879.35,154213.88
12712,1978-10-10,104.46,-0.13,-0.12,120.24,-13.12,True,1,5966,-104.46,-469769.93,623208.36,153438.43
12713,1978-10-11,105.39,0.93,0.89,120.24,-12.35,True,1,5967,-105.39,-469875.32,628862.13,158986.81
12714,1978-10-12,104.88,-0.51,-0.48,120.24,-12.77,True,1,5968,-104.88,-469980.2,625923.84,155943.64
12715,1978-10-13,104.66,-0.22,-0.21,120.24,-12.96,True,1,5969,-104.66,-470084.86,624715.54,154630.68
12716,1978-10-16,102.61,-2.05,-1.96,120.24,-14.66,True,1,5970,-102.61,-470187.47,612581.7,142394.23
12717,1978-10-17,101.26,-1.35,-1.32,120.24,-15.78,True,1,5971,-101.26,-470288.73,604623.46,134334.73
12718,1978-10-18,100.49,-0.77,-0.76,120.24,-16.42,True,1,5972,-100.49,-470389.22,600126.28,129737.06
12719,1978-10-19,99.33,-1.16,-1.15,120.24,-17.39,True,1,5973,-99.33,-470488.55,593298.09,122809.54
12720,1978-10-20,97.95,-1.38,-1.39,120.24,-18.54,True,1,5974,-97.95,-470586.5,585153.3,114566.8
12721,1978-10-23,98.18,0.23,0.24,120.24,-18.35,True,1,5975,-98.18,-470684.68,586625.5,115940.82
12722,1978-10-24,97.49,-0.69,-0.7,120.24,-18.92,True,1,5976,-97.49,-470782.17,582600.24,111818.07
12723,1978-10-25,97.31,-0.18,-0.18,120.24,-19.07,True,1,5977,-97.31,-470879.48,581621.87,110742.39
12724,1978-10-26,96.03,-1.28,-1.32,120.24,-20.14,True,1,5978,-96.03,-470975.51,574067.34,103091.83
12725,1978-10-27,94.59,-1.44,-1.5,120.24,-21.33,True,1,5979,-94.59,-471070.1,565553.61,94483.51
12726,1978-10-30,95.06,0.47,0.5,120.24,-20.94,True,1,5980,-95.06,-471165.16,568458.8,97293.64
12727,1978-10-31,93.15,-1.91,-2.01,120.24,-22.53,True,1,5981,-93.15,-471258.31,557130.15,85871.84
12728,1978-11-01,96.85,3.7,3.97,120.24,-19.45,True,1,5982,-96.85,-471355.16,579356.7,108001.54
12729,1978-11-02,95.61,-1.24,-1.28,120.24,-20.48,True,1,5983,-95.61,-471450.77,572034.63,100583.86
12730,1978-11-03,96.18,0.57,0.6,120.24,-20.01,True,1,5984,-96.18,-471546.95,575541.12,103994.17
12731,1978-11-06,95.19,-0.99,-1.03,120.24,-20.83,True,1,5985,-95.19,-471642.14,569712.15,98070.01
12732,1978-11-07,93.85,-1.34,-1.41,120.24,-21.95,True,1,5986,-93.85,-471735.99,561786.1,90050.11
12733,1978-11-08,94.45,0.6,0.64,120.24,-21.45,True,1,5987,-94.45,-471830.44,565472.15,93641.71
12734,1978-11-09,94.42,-0.03,-0.03,120.24,-21.47,True,1,5988,-94.42,-471924.86,565386.96,93462.1
12735,1978-11-10,94.77,0.35,0.37,120.24,-21.18,True,1,5989,-94.77,-472019.63,567577.53,95557.9
12736,1978-11-13,93.13,-1.64,-1.73,120.24,-22.55,True,1,5990,-93.13,-472112.76,557848.7,85735.94
12737,1978-11-14,92.49,-0.64,-0.69,120.24,-23.08,True,1,5991,-92.49,-472205.25,554107.59,81902.34
12738,1978-11-15,92.71,0.22,0.24,120.24,-22.9,True,1,5992,-92.71,-472297.96,555518.32,83220.36
12739,1978-11-16,93.71,1.0,1.08,120.24,-22.06,True,1,5993,-93.71,-472391.67,561604.03,89212.36
12740,1978-11-17,94.42,0.71,0.76,120.24,-21.47,True,1,5994,-94.42,-472486.09,565953.48,93467.39
12741,1978-11-20,95.25,0.83,0.88,120.24,-20.78,True,1,5995,-95.25,-472581.34,571023.75,98442.41
12742,1978-11-21,95.01,-0.24,-0.25,120.24,-20.98,True,1,5996,-95.01,-472676.35,569679.96,97003.61
12743,1978-11-22,95.48,0.47,0.5,120.24,-20.59,True,1,5997,-95.48,-472771.83,572593.56,99821.73
12744,1978-11-24,95.79,0.31,0.32,120.24,-20.33,True,1,5998,-95.79,-472867.62,574548.42,101680.8
12745,1978-11-27,95.99,0.2,0.21,120.24,-20.17,True,1,5999,-95.99,-472963.61,575844.01,102880.4
12746,1978-11-28,95.15,-0.84,-0.88,120.24,-20.87,True,1,6000,-95.15,-473058.76,570900.0,97841.24
12747,1978-11-29,93.75,-1.4,-1.47,120.24,-22.03,True,1,6001,-93.75,-473152.51,562593.75,89441.24
12748,1978-11-30,94.7,0.95,1.01,120.24,-21.24,True,1,6002,-94.7,-473247.21,568389.4,95142.19
12749,1978-12-01,96.28,1.58,1.67,120.24,-19.93,True,1,6003,-96.28,-473343.49,577968.84,104625.35
12750,1978-12-04,96.15,-0.13,-0.14,120.24,-20.04,True,1,6004,-96.15,-473439.64,577284.6,103844.96
12751,1978-12-05,97.44,1.29,1.34,120.24,-18.96,True,1,6005,-97.44,-473537.08,585127.2,111590.12
12752,1978-12-06,97.49,0.05,0.05,120.24,-18.92,True,1,6006,-97.49,-473634.57,585524.94,111890.37
12753,1978-12-07,97.08,-0.41,-0.42,120.24,-19.26,True,1,6007,-97.08,-473731.65,583159.56,109427.91
12754,1978-12-08,96.63,-0.45,-0.46,120.24,-19.64,True,1,6008,-96.63,-473828.28,580553.04,106724.76
12755,1978-12-11,97.11,0.48,0.5,120.24,-19.24,True,1,6009,-97.11,-473925.39,583533.99,109608.6
12756,1978-12-12,96.59,-0.52,-0.54,120.24,-19.67,True,1,6010,-96.59,-474021.98,580505.9,106483.92
12757,1978-12-13,96.06,-0.53,-0.55,120.24,-20.11,True,1,6011,-96.06,-474118.04,577416.66,103298.62
12758,1978-12-14,96.04,-0.02,-0.02,120.24,-20.13,True,1,6012,-96.04,-474214.08,577392.48,103178.4
12759,1978-12-15,95.33,-0.71,-0.74,120.24,-20.72,True,1,6013,-95.33,-474309.41,573219.29,98909.88
12760,1978-12-18,93.44,-1.89,-1.98,120.24,-22.29,True,1,6014,-93.44,-474402.85,561948.16,87545.31
12761,1978-12-19,94.24,0.8,0.86,120.24,-21.62,True,1,6015,-94.24,-474497.09,566853.6,92356.51
12762,1978-12-20,94.68,0.44,0.47,120.24,-21.26,True,1,6016,-94.68,-474591.77,569594.88,95003.11
12763,1978-12-21,94.71,0.03,0.03,120.24,-21.23,True,1,6017,-94.71,-474686.48,569870.07,95183.59
12764,1978-12-22,96.31,1.6,1.69,120.24,-19.9,True,1,6018,-96.31,-474782.79,579593.58,104810.79
12765,1978-12-26,97.52,1.21,1.26,120.24,-18.9,True,1,6019,-97.52,-474880.31,586972.88,112092.57
12766,1978-12-27,96.66,-0.86,-0.88,120.24,-19.61,True,1,6020,-96.66,-474976.97,581893.2,106916.23
12767,1978-12-28,96.28,-0.38,-0.39,120.24,-19.93,True,1,6021,-96.28,-475073.25,579701.88,104628.63
12768,1978-12-29,96.11,-0.17,-0.18,120.24,-20.07,True,1,6022,-96.11,-475169.36,578774.42,103605.06
12769,1979-01-02,96.73,0.62,0.64,120.24,-19.55,True,1,6023,-96.73,-475266.09,582604.79,107338.7
12770,1979-01-03,97.8,1.07,1.11,120.24,-18.66,True,1,6024,-97.8,-475363.89,589147.2,113783.31
12771,1979-01-04,98.58,0.78,0.8,120.24,-18.01,True,1,6025,-98.58,-475462.47,593944.5,118482.03
12772,1979-01-05,99.13,0.55,0.56,120.24,-17.56,True,1,6026,-99.13,-475561.6,597357.38,121795.78
12773,1979-01-08,98.8,-0.33,-0.33,120.24,-17.83,True,1,6027,-98.8,-475660.4,595467.6,119807.2
12774,1979-01-09,99.33,0.53,0.54,120.24,-17.39,True,1,6028,-99.33,-475759.73,598761.24,123001.51
12775,1979-01-10,98.77,-0.56,-0.56,120.24,-17.86,True,1,6029,-98.77,-475858.5,595484.33,119625.83
12776,1979-01-11,99.1,0.33,0.33,120.24,-17.58,True,1,6030,-99.1,-475957.6,597573.0,121615.4
12777,1979-01-12,99.93,0.83,0.84,120.24,-16.89,True,1,6031,-99.93,-476057.53,602677.83,126620.3
12778,1979-01-15,100.69,0.76,0.76,120.24,-16.26,True,1,6032,-100.69,-476158.22,607362.08,131203.86
12779,1979-01-16,99.46,-1.23,-1.22,120.24,-17.28,True,1,6033,-99.46,-476257.68,600042.18,123784.5
12780,1979-01-17,99.48,0.02,0.02,120.24,-17.26,True,1,6034,-99.48,-476357.16,600262.32,123905.16
12781,1979-01-18,99.72,0.24,0.24,120.24,-17.07,True,1,6035,-99.72,-476456.88,601810.2,125353.32
12782,1979-01-19,99.75,0.03,0.03,120.24,-17.04,True,1,6036,-99.75,-476556.63,602091.0,125534.37
12783,1979-01-22,99.9,0.15,0.15,120.24,-16.92,True,1,6037,-99.9,-476656.53,603096.3,126439.77
12784,1979-01-23,100.6,0.7,0.7,120.24,-16.33,True,1,6038,-100.6,-476757.13,607422.8,130665.67
12785,1979-01-24,100.16,-0.44,-0.44,120.24,-16.7,True,1,6039,-100.16,-476857.29,604866.24,128008.95
12786,1979-01-25,101.19,1.03,1.03,120.24,-15.84,True,1,6040,-101.19,-476958.48,611187.6,134229.12
12787,1979-01-26,101.86,0.67,0.66,120.24,-15.29,True,1,6041,-101.86,-477060.34,615336.26,138275.92
12788,1979-01-29,101.55,-0.31,-0.3,120.24,-15.54,True,1,6042,-101.55,-477161.89,613565.1,136403.21
12789,1979-01-30,101.05,-0.5,-0.49,120.24,-15.96,True,1,6043,-101.05,-477262.94,610645.15,133382.21
12790,1979-01-31,99.93,-1.12,-1.11,120.24,-16.89,True,1,6044,-99.93,-477362.87,603976.92,126614.05
12791,1979-02-01,99.96,0.03,0.03,120.24,-16.87,True,1,6045,-99.96,-477462.83,604258.2,126795.37
12792,1979-02-02,99.5,-0.46,-0.46,120.24,-17.25,True,1,6046,-99.5,-477562.33,601577.0,124014.67
12793,1979-02-05,98.09,-1.41,-1.42,120.24,-18.42,True,1,6047,-98.09,-477660.42,593150.23,115489.81
12794,1979-02-06,98.05,-0.04,-0.04,120.24,-18.45,True,1,6048,-98.05,-477758.47,593006.4,115247.93
12795,1979-02-07,97.16,-0.89,-0.91,120.24,-19.2,True,1,6049,-97.16,-477855.63,587720.84,109865.21
12796,1979-02-08,97.65,0.49,0.5,120.24,-18.79,True,1,6050,-97.65,-477953.28,590782.5,112829.22
12797,1979-02-09,97.87,0.22,0.22,120.24,-18.6,True,1,6051,-97.87,-478051.15,592211.37,114160.22
12798,1979-02-12,98.2,0.33,0.34,120.24,-18.33,True,1,6052,-98.2,-478149.35,594306.4,116157.05
12799,1979-02-13,98.93,0.73,0.74,120.24,-17.72,True,1,6053,-98.93,-478248.28,598823.29,120575.01
12800,1979-02-14,98.87,-0.06,-0.06,120.24,-17.77,True,1,6054,-98.87,-478347.15,598558.98,120211.83
12801,1979-02-15,98.73,-0.14,-0.14,120.24,-17.89,True,1,6055,-98.73,-478445.88,597810.15,119364.27
12802,1979-02-16,98.67,-0.06,-0.06,120.24,-17.94,True,1,6056,-98.67,-478544.55,597545.52,119000.97
12803,1979-02-20,99.42,0.75,0.76,120.24,-17.32,True,1,6057,-99.42,-478643.97,602186.94,123542.97
12804,1979-02-21,99.07,-0.35,-0.35,120.24,-17.61,True,1,6058,-99.07,-478743.04,600166.06,121423.02
12805,1979-02-22,98.33,-0.74,-0.75,120.24,-18.22,True,1,6059,-98.33,-478841.37,595781.47,116940.1
12806,1979-02-23,97.78,-0.55,-0.56,120.24,-18.68,True,1,6060,-97.78,-478939.15,592546.8,113607.65
12807,1979-02-26,97.67,-0.11,-0.11,120.24,-18.77,True,1,6061,-97.67,-479036.82,591977.87,112941.05
12808,1979-02-27,96.13,-1.54,-1.58,120.24,-20.05,True,1,6062,-96.13,-479132.95,582740.06,103607.11
12809,1979-02-28,96.28,0.15,0.16,120.24,-19.93,True,1,6063,-96.28,-479229.23,583745.64,104516.41
12810,1979-03-01,96.9,0.62,0.64,120.24,-19.41,True,1,6064,-96.9,-479326.13,587601.6,108275.47
12811,1979-03-02,96.97,0.07,0.07,120.24,-19.35,True,1,6065,-96.97,-479423.1,588123.05,108699.95
12812,1979-03-05,98.06,1.09,1.12,120.24,-18.45,True,1,6066,-98.06,-479521.16,594831.96,115310.8
12813,1979-03-06,97.87,-0.19,-0.19,120.24,-18.6,True,1,6067,-97.87,-479619.03,593777.29,114158.26
12814,1979-03-07,98.44,0.57,0.58,120.24,-18.13,True,1,6068,-98.44,-479717.47,597333.92,117616.45
12815,1979-03-08,99.58,1.14,1.16,120.24,-17.18,True,1,6069,-99.58,-479817.05,604351.02,124533.97
12816,1979-03-09,99.54,-0.04,-0.04,120.24,-17.22,True,1,6070,-99.54,-479916.59,604207.8,124291.21
12817,1979-03-12,99.67,0.13,0.13,120.24,-17.11,True,1,6071,-99.67,-480016.26,605096.57,125080.31
12818,1979-03-13,99.84,0.17,0.17,120.24,-16.97,True,1,6072,-99.84,-480116.1,606228.48,126112.38
12819,1979-03-14,99.71,-0.13,-0.13,120.24,-17.07,True,1,6073,-99.71,-480215.81,605538.83,125323.02
12820,1979-03-15,99.86,0.15,0.15,120.24,-16.95,True,1,6074,-99.86,-480315.67,606549.64,126233.97
12821,1979-03-16,100.69,0.83,0.83,120.24,-16.26,True,1,6075,-100.69,-480416.36,611691.75,131275.39
12822,1979-03-19,101.06,0.37,0.37,120.24,-15.95,True,1,6076,-101.06,-480517.42,614040.56,133523.14
12823,1979-03-20,100.5,-0.56,-0.55,120.24,-16.42,True,1,6077,-100.5,-480617.92,610738.5,130120.58
12824,1979-03-21,101.25,0.75,0.75,120.24,-15.79,True,1,6078,-101.25,-480719.17,615397.5,134678.33
12825,1979-03-22,101.67,0.42,0.42,120.24,-15.44,True,1,6079,-101.67,-480820.84,618051.93,137231.09
12826,1979-03-23,101.6,-0.07,-0.07,120.24,-15.5,True,1,6080,-101.6,-480922.44,617728.0,136805.56
12827,1979-03-26,101.04,-0.56,-0.55,120.24,-15.97,True,1,6081,-101.04,-481023.48,614424.24,133400.76
12828,1979-03-27,102.48,1.44,1.42,120.24,-14.77,True,1,6082,-102.48,-481125.96,623283.36,142157.4
12829,1979-03-28,102.12,-0.36,-0.35,120.24,-15.07,True,1,6083,-102.12,-481228.08,621195.96,139967.88
12830,1979-03-29,102.03,-0.09,-0.09,120.24,-15.14,True,1,6084,-102.03,-481330.11,620750.52,139420.41
12831,1979-03-30,101.59,-0.44,-0.43,120.24,-15.51,True,1,6085,-101.59,-481431.7,618175.15,136743.45
12832,1979-04-02,100.9,-0.69,-0.68,120.24,-16.08,True,1,6086,-100.9,-481532.6,614077.4,132544.8
12833,1979-04-03,102.4,1.5,1.49,120.24,-14.84,True,1,6087,-102.4,-481635.0,623308.8,141673.8
12834,1979-04-04,102.65,0.25,0.24,120.24,-14.63,True,1,6088,-102.65,-481737.65,624933.2,143195.55
12835,1979-04-05,103.26,0.61,0.59,120.24,-14.12,True,1,6089,-103.26,-481840.91,628750.14,146909.23
12836,1979-04-06,103.18,-0.08,-0.08,120.24,-14.19,True,1,6090,-103.18,-481944.09,628366.2,146422.11
12837,1979-04-09,102.87,-0.31,-0.3,120.24,-14.45,True,1,6091,-102.87,-482046.96,626581.17,144534.21
12838,1979-04-10,103.34,0.47,0.46,120.24,-14.06,True,1,6092,-103.34,-482150.3,629547.28,147396.98
12839,1979-04-11,102.31,-1.03,-1.0,120.24,-14.91,True,1,6093,-102.31,-482252.61,623374.83,141122.22
12840,1979-04-12,102.0,-0.31,-0.3,120.24,-15.17,True,1,6094,-102.0,-482354.61,621588.0,139233.39
12841,1979-04-16,101.12,-0.88,-0.86,120.24,-15.9,True,1,6095,-101.12,-482455.73,616326.4,133870.67
12842,1979-04-17,101.24,0.12,0.12,120.24,-15.8,True,1,6096,-101.24,-482556.97,617159.04,134602.07
12843,1979-04-18,101.7,0.46,0.45,120.24,-15.42,True,1,6097,-101.7,-482658.67,620064.9,137406.23
12844,1979-04-19,101.28,-0.42,-0.41,120.24,-15.77,True,1,6098,-101.28,-482759.95,617605.44,134845.49
12845,1979-04-20,101.23,-0.05,-0.05,120.24,-15.81,True,1,6099,-101.23,-482861.18,617401.77,134540.59
12846,1979-04-23,101.57,0.34,0.34,120.24,-15.53,True,1,6100,-101.57,-482962.75,619577.0,136614.25
12847,1979-04-24,102.2,0.63,0.62,120.24,-15.0,True,1,6101,-102.2,-483064.95,623522.2,140457.25
12848,1979-04-25,102.5,0.3,0.29,120.24,-14.75,True,1,6102,-102.5,-483167.45,625455.0,142287.55
12849,1979-04-26,102.01,-0.49,-0.48,120.24,-15.16,True,1,6103,-102.01,-483269.46,622567.03,139297.57
12850,1979-04-27,101.8,-0.21,-0.21,120.24,-15.34,True,1,6104,-101.8,-483371.26,621387.2,138015.94
12851,1979-04-30,101.76,-0.04,-0.04,120.24,-15.37,True,1,6105,-101.76,-483473.02,621244.8,137771.78
12852,1979-05-01,101.68,-0.08,-0.08,120.24,-15.44,True,1,6106,-101.68,-483574.7,620858.08,137283.38
12853,1979-05-02,101.72,0.04,0.04,120.24,-15.4,True,1,6107,-101.72,-483676.42,621204.04,137527.62
12854,1979-05-03,101.81,0.09,0.09,120.24,-15.33,True,1,6108,-101.81,-483778.23,621855.48,138077.25
12855,1979-05-04,100.69,-1.12,-1.1,120.24,-16.26,True,1,6109,-100.69,-483878.92,615115.21,131236.29
12856,1979-05-07,99.02,-1.67,-1.66,120.24,-17.65,True,1,6110,-99.02,-483977.94,605012.2,121034.26
12857,1979-05-08,99.17,0.15,0.15,120.24,-17.52,True,1,6111,-99.17,-484077.11,606027.87,121950.76
12858,1979-05-09,99.46,0.29,0.29,120.24,-17.28,True,1,6112,-99.46,-484176.57,607899.52,123722.95
12859,1979-05-10,98.52,-0.94,-0.94,120.24,-18.06,True,1,6113,-98.52,-484275.09,602252.76,117977.67
12860,1979-05-11,98.52,0.0,0.0,120.24,-18.06,True,1,6114,-98.52,-484373.61,602351.28,117977.67
12861,1979-05-14,98.06,-0.46,-0.47,120.24,-18.45,True,1,6115,-98.06,-484471.67,599636.9,115165.23
12862,1979-05-15,98.14,0.08,0.08,120.24,-18.38,True,1,6116,-98.14,-484569.81,600224.24,115654.43
12863,1979-05-16,98.42,0.28,0.28,120.24,-18.15,True,1,6117,-98.42,-484668.23,602035.14,117366.91
12864,1979-05-17,99.94,1.52,1.54,120.24,-16.88,True,1,6118,-99.94,-484768.17,611432.92,126664.75
12865,1979-05-18,99.93,-0.01,-0.01,120.24,-16.89,True,1,6119,-99.93,-484868.1,611471.67,126603.57
12866,1979-05-21,100.14,0.21,0.21,120.24,-16.72,True,1,6120,-100.14,-484968.24,612856.8,127888.56
12867,1979-05-22,100.51,0.37,0.37,120.24,-16.41,True,1,6121,-100.51,-485068.75,615221.71,130152.96
12868,1979-05-23,99.89,-0.62,-0.62,120.24,-16.92,True,1,6122,-99.89,-485168.64,611526.58,126357.94
12869,1979-05-24,99.93,0.04,0.04,120.24,-16.89,True,1,6123,-99.93,-485268.57,611871.39,126602.82
12870,1979-05-25,100.22,0.29,0.29,120.24,-16.65,True,1,6124,-100.22,-485368.79,613747.28,128378.49
12871,1979-05-29,100.05,-0.17,-0.17,120.24,-16.79,True,1,6125,-100.05,-485468.84,612806.25,127337.41
12872,1979-05-30,99.11,-0.94,-0.94,120.24,-17.57,True,1,6126,-99.11,-485567.95,607147.86,121579.91
12873,1979-05-31,99.08,-0.03,-0.03,120.24,-17.6,True,1,6127,-99.08,-485667.03,607063.16,121396.13
12874,1979-06-01,99.17,0.09,0.09,120.24,-17.52,True,1,6128,-99.17,-485766.2,607713.76,121947.56
12875,1979-06-04,99.32,0.15,0.15,120.24,-17.4,True,1,6129,-99.32,-485865.52,608732.28,122866.76
12876,1979-06-05,100.62,1.3,1.31,120.24,-16.32,True,1,6130,-100.62,-485966.14,616800.6,130834.46
12877,1979-06-06,101.3,0.68,0.68,120.24,-15.75,True,1,6131,-101.3,-486067.44,621070.3,135002.86
12878,1979-06-07,101.79,0.49,0.48,120.24,-15.34,True,1,6132,-101.79,-486169.23,624176.28,138007.05
12879,1979-06-08,101.49,-0.3,-0.3,120.24,-15.59,True,1,6133,-101.49,-486270.72,622438.17,136167.45
12880,1979-06-11,101.91,0.42,0.41,120.24,-15.24,True,1,6134,-101.91,-486372.63,625115.94,138743.31
12881,1979-06-12,102.85,0.94,0.92,120.24,-14.46,True,1,6135,-102.85,-486475.48,630984.75,144509.27
12882,1979-06-13,102.31,-0.54,-0.52,120.24,-14.91,True,1,6136,-102.31,-486577.79,627774.16,141196.37
12883,1979-06-14,102.2,-0.11,-0.11,120.24,-15.0,True,1,6137,-102.2,-486679.99,627201.4,140521.41
12884,1979-06-15,102.09,-0.11,-0.11,120.24,-15.1,True,1,6138,-102.09,-486782.08,626628.42,139846.34
12885,1979-06-18,101.56,-0.53,-0.52,120.24,-15.54,True,1,6139,-101.56,-486883.64,623476.84,136593.2
12886,1979-06-19,101.58,0.02,0.02,120.24,-15.52,True,1,6140,-101.58,-486985.22,623701.2,136715.98
12887,1979-06-20,101.63,0.05,0.05,120.24,-15.48,True,1,6141,-101.63,-487086.85,624109.83,137022.98
12888,1979-06-21,102.09,0.46,0.45,120.24,-15.1,True,1,6142,-102.09,-487188.94,627036.78,139847.84
12889,1979-06-22,102.64,0.55,0.54,120.24,-14.64,True,1,6143,-102.64,-487291.58,630517.52,143225.94
12890,1979-06-25,102.09,-0.55,-0.54,120.24,-15.1,True,1,6144,-102.09,-487393.67,627240.96,139847.29
12891,1979-06-26,101.66,-0.43,-0.42,120.24,-15.45,True,1,6145,-101.66,-487495.33,624700.7,137205.37
12892,1979-06-27,102.27,0.61,0.6,120.24,-14.94,True,1,6146,-102.27,-487597.6,628551.42,140953.82
12893,1979-06-28,102.8,0.53,0.52,120.24,-14.5,True,1,6147,-102.8,-487700.4,631911.6,144211.2
12894,1979-06-29,102.91,0.11,0.11,120.24,-14.41,True,1,6148,-102.91,-487803.31,632690.68,144887.37
12895,1979-07-02,101.99,-0.92,-0.89,120.24,-15.18,True,1,6149,-101.99,-487905.3,627136.51,139231.21
12896,1979-07-03,102.09,0.1,0.1,120.24,-15.1,True,1,6150,-102.09,-488007.39,627853.5,139846.11
12897,1979-07-05,102.43,0.34,0.33,120.24,-14.81,True,1,6151,-102.43,-488109.82,630046.93,141937.11
12898,1979-07-06,103.62,1.19,1.16,120.24,-13.82,True,1,6152,-103.62,-488213.44,637470.24,149256.8
12899,1979-07-09,104.47,0.85,0.82,120.24,-13.12,True,1,6153,-104.47,-488317.91,642803.91,154486.0
12900,1979-07-10,104.2,-0.27,-0.26,120.24,-13.34,True,1,6154,-104.2,-488422.11,641246.8,152824.69
12901,1979-07-11,103.64,-0.56,-0.54,120.24,-13.81,True,1,6155,-103.64,-488525.75,637904.2,149378.45
12902,1979-07-12,102.69,-0.95,-0.92,120.24,-14.6,True,1,6156,-102.69,-488628.44,632159.64,143531.2
12903,1979-07-13,102.32,-0.37,-0.36,120.24,-14.9,True,1,6157,-102.32,-488730.76,629984.24,141253.48
12904,1979-07-16,102.74,0.42,0.41,120.24,-14.55,True,1,6158,-102.74,-488833.5,632672.92,143839.42
12905,1979-07-17,101.83,-0.91,-0.89,120.24,-15.31,True,1,6159,-101.83,-488935.33,627170.97,138235.64
12906,1979-07-18,101.69,-0.14,-0.14,120.24,-15.43,True,1,6160,-101.69,-489037.02,626410.4,137373.38
12907,1979-07-19,101.61,-0.08,-0.08,120.24,-15.49,True,1,6161,-101.61,-489138.63,626019.21,136880.58
12908,1979-07-20,101.82,0.21,0.21,120.24,-15.32,True,1,6162,-101.82,-489240.45,627414.84,138174.39
12909,1979-07-23,101.59,-0.23,-0.23,120.24,-15.51,True,1,6163,-101.59,-489342.04,626099.17,136757.13
12910,1979-07-24,101.97,0.38,0.37,120.24,-15.2,True,1,6164,-101.97,-489444.01,628543.08,139099.07
12911,1979-07-25,103.08,1.11,1.09,120.24,-14.27,True,1,6165,-103.08,-489547.09,635488.2,145941.11
12912,1979-07-26,103.1,0.02,0.02,120.24,-14.26,True,1,6166,-103.1,-489650.19,635714.6,146064.41
12913,1979-07-27,103.1,0.0,0.0,120.24,-14.26,True,1,6167,-103.1,-489753.29,635817.7,146064.41
12914,1979-07-30,103.15,0.05,0.05,120.24,-14.21,True,1,6168,-103.15,-489856.44,636229.2,146372.76
12915,1979-07-31,103.81,0.66,0.64,120.24,-13.66,True,1,6169,-103.81,-489960.25,640403.89,150443.64
12916,1979-08-01,104.17,0.36,0.35,120.24,-13.36,True,1,6170,-104.17,-490064.42,642728.9,152664.48
12917,1979-08-02,104.1,-0.07,-0.07,120.24,-13.42,True,1,6171,-104.1,-490168.52,642401.1,152232.58
12918,1979-08-03,104.04,-0.06,-0.06,120.24,-13.47,True,1,6172,-104.04,-490272.56,642134.88,151862.32
12919,1979-08-06,104.3,0.26,0.25,120.24,-13.26,True,1,6173,-104.3,-490376.86,643843.9,153467.04
12920,1979-08-07,105.65,1.35,1.29,120.24,-12.13,True,1,6174,-105.65,-490482.51,652283.1,161800.59
12921,1979-08-08,105.98,0.33,0.31,120.24,-11.86,True,1,6175,-105.98,-490588.49,654426.5,163838.01
12922,1979-08-09,105.49,-0.49,-0.46,120.24,-12.27,True,1,6176,-105.49,-490693.98,651506.24,160812.26
12923,1979-08-10,106.4,0.91,0.86,120.24,-11.51,True,1,6177,-106.4,-490800.38,657232.8,166432.42
12924,1979-08-13,107.42,1.02,0.96,120.24,-10.66,True,1,6178,-107.42,-490907.8,663640.76,172732.96
12925,1979-08-14,107.52,0.1,0.09,120.24,-10.58,True,1,6179,-107.52,-491015.32,664366.08,173350.76
12926,1979-08-15,108.25,0.73,0.68,120.24,-9.97,True,1,6180,-108.25,-491123.57,668985.0,177861.43
12927,1979-08-16,108.09,-0.16,-0.15,120.24,-10.1,True,1,6181,-108.09,-491231.66,668104.29,176872.63
12928,1979-08-17,108.3,0.21,0.19,120.24,-9.93,True,1,6182,-108.3,-491339.96,669510.6,178170.64
12929,1979-08-20,108.83,0.53,0.49,120.24,-9.49,True,1,6183,-108.83,-491448.79,672895.89,181447.1
12930,1979-08-21,108.91,0.08,0.07,120.24,-9.42,True,1,6184,-108.91,-491557.7,673499.44,181941.74
12931,1979-08-22,108.99,0.08,0.07,120.24,-9.36,True,1,6185,-108.99,-491666.69,674103.15,182436.46
12932,1979-08-23,108.63,-0.36,-0.33,120.24,-9.66,True,1,6186,-108.63,-491775.32,671985.18,180209.86
12933,1979-08-24,108.6,-0.03,-0.03,120.24,-9.68,True,1,6187,-108.6,-491883.92,671908.2,180024.28
12934,1979-08-27,109.14,0.54,0.5,120.24,-9.23,True,1,6188,-109.14,-491993.06,675358.32,183365.26
12935,1979-08-28,109.02,-0.12,-0.11,120.24,-9.33,True,1,6189,-109.02,-492102.08,674724.78,182622.7
12936,1979-08-29,109.02,0.0,0.0,120.24,-9.33,True,1,6190,-109.02,-492211.1,674833.8,182622.7
12937,1979-08-30,109.02,0.0,0.0,120.24,-9.33,True,1,6191,-109.02,-492320.12,674942.82,182622.7
12938,1979-08-31,109.32,0.3,0.28,120.24,-9.08,True,1,6192,-109.32,-492429.44,676909.44,184480.0
12939,1979-09-04,107.44,-1.88,-1.72,120.24,-10.64,True,1,6193,-107.44,-492536.88,665375.92,172839.04
12940,1979-09-05,106.4,-1.04,-0.97,120.24,-11.51,True,1,6194,-106.4,-492643.28,659041.6,166398.32
12941,1979-09-06,106.85,0.45,0.42,120.24,-11.14,True,1,6195,-106.85,-492750.13,661935.75,169185.62
12942,1979-09-07,107.66,0.81,0.76,120.24,-10.46,True,1,6196,-107.66,-492857.79,667061.36,174203.57
12943,1979-09-10,108.17,0.51,0.47,120.24,-10.04,True,1,6197,-108.17,-492965.96,670329.49,177363.53
12944,1979-09-11,107.51,-0.66,-0.61,120.24,-10.59,True,1,6198,-107.51,-493073.47,666346.98,173273.51
12945,1979-09-12,107.82,0.31,0.29,120.24,-10.33,True,1,6199,-107.82,-493181.29,668376.18,175194.89
12946,1979-09-13,107.85,0.03,0.03,120.24,-10.3,True,1,6200,-107.85,-493289.14,668670.0,175380.86
12947,1979-09-14,108.76,0.91,0.84,120.24,-9.55,True,1,6201,-108.76,-493397.9,674420.76,181022.86
12948,1979-09-17,108.84,0.08,0.07,120.24,-9.48,True,1,6202,-108.84,-493506.74,675025.68,181518.94
12949,1979-09-18,108.0,-0.84,-0.77,120.24,-10.18,True,1,6203,-108.0,-493614.74,669924.0,176309.26
12950,1979-09-19,108.28,0.28,0.26,120.24,-9.95,True,1,6204,-108.28,-493723.02,671769.12,178046.1
12951,1979-09-20,110.51,2.23,2.06,120.24,-8.09,True,1,6205,-110.51,-493833.53,685714.55,191881.02
12952,1979-09-21,110.47,-0.04,-0.04,120.24,-8.12,True,1,6206,-110.47,-493944.0,685576.82,191632.82
12953,1979-09-24,109.61,-0.86,-0.78,120.24,-8.84,True,1,6207,-109.61,-494053.61,680349.27,186295.66
12954,1979-09-25,109.68,0.07,0.06,120.24,-8.78,True,1,6208,-109.68,-494163.29,680893.44,186730.15
12955,1979-09-26,109.96,0.28,0.26,120.24,-8.55,True,1,6209,-109.96,-494273.25,682741.64,188468.39
12956,1979-09-27,110.21,0.25,0.23,120.24,-8.34,True,1,6210,-110.21,-494383.46,684404.1,190020.64
12957,1979-09-28,109.32,-0.89,-0.81,120.24,-9.08,True,1,6211,-109.32,-494492.78,678986.52,184493.74
12958,1979-10-01,108.56,-0.76,-0.7,120.24,-9.71,True,1,6212,-108.56,-494601.34,674374.72,179773.38
12959,1979-10-02,109.59,1.03,0.95,120.24,-8.86,True,1,6213,-109.59,-494710.93,680882.67,186171.74
12960,1979-10-03,109.59,0.0,0.0,120.24,-8.86,True,1,6214,-109.59,-494820.52,680992.26,186171.74
12961,1979-10-04,110.17,0.58,0.53,120.24,-8.38,True,1,6215,-110.17,-494930.69,684706.55,189775.86
12962,1979-10-05,111.27,1.1,1.0,120.24,-7.46,True,1,6216,-111.27,-495041.96,691654.32,196612.36
12963,1979-10-08,109.88,-1.39,-1.25,120.24,-8.62,True,1,6217,-109.88,-495151.84,683123.96,187972.12
12964,1979-10-09,106.63,-3.25,-2.96,120.24,-11.32,True,1,6218,-106.63,-495258.47,663025.34,167766.87
12965,1979-10-10,105.3,-1.33,-1.25,120.24,-12.42,True,1,6219,-105.3,-495363.77,654860.7,159496.93
12966,1979-10-11,105.05,-0.25,-0.24,120.24,-12.63,True,1,6220,-105.05,-495468.82,653411.0,157942.18
12967,1979-10-12,104.49,-0.56,-0.53,120.24,-13.1,True,1,6221,-104.49,-495573.31,650032.29,154458.98
12968,1979-10-15,103.36,-1.13,-1.08,120.24,-14.04,True,1,6222,-103.36,-495676.67,643105.92,147429.25
12969,1979-10-16,103.19,-0.17,-0.16,120.24,-14.18,True,1,6223,-103.19,-495779.86,642151.37,146371.51
12970,1979-10-17,103.39,0.2,0.19,120.24,-14.01,True,1,6224,-103.39,-495883.25,643499.36,147616.11
12971,1979-10-18,103.61,0.22,0.21,120.24,-13.83,True,1,6225,-103.61,-495986.86,644972.25,148985.39
12972,1979-10-19,101.6,-2.01,-1.94,120.24,-15.5,True,1,6226,-101.6,-496088.46,632561.6,136473.14
12973,1979-10-22,100.71,-0.89,-0.88,120.24,-16.24,True,1,6227,-100.71,-496189.17,627121.17,130932.0
12974,1979-10-23,100.28,-0.43,-0.43,120.24,-16.6,True,1,6228,-100.28,-496289.45,624543.84,128254.39
12975,1979-10-24,100.44,0.16,0.16,120.24,-16.47,True,1,6229,-100.44,-496389.89,625640.76,129250.87
12976,1979-10-25,100.0,-0.44,-0.44,120.24,-16.83,True,1,6230,-100.0,-496489.89,623000.0,126510.11
12977,1979-10-26,100.57,0.57,0.57,120.24,-16.36,True,1,6231,-100.57,-496590.46,626651.67,130061.21
12978,1979-10-29,100.71,0.14,0.14,120.24,-16.24,True,1,6232,-100.71,-496691.17,627624.72,130933.55
12979,1979-10-30,102.67,1.96,1.95,120.24,-14.61,True,1,6233,-102.67,-496793.84,639942.11,143148.27
12980,1979-10-31,101.82,-0.85,-0.83,120.24,-15.32,True,1,6234,-101.82,-496895.66,634745.88,137850.22
12981,1979-11-01,102.57,0.75,0.74,120.24,-14.7,True,1,6235,-102.57,-496998.23,639523.95,142525.72
12982,1979-11-02,102.51,-0.06,-0.06,120.24,-14.75,True,1,6236,-102.51,-497100.74,639252.36,142151.62
12983,1979-11-05,101.82,-0.69,-0.67,120.24,-15.32,True,1,6237,-101.82,-497202.56,635051.34,137848.78
12984,1979-11-06,101.2,-0.62,-0.61,120.24,-15.84,True,1,6238,-101.2,-497303.76,631285.6,133981.84
12985,1979-11-07,99.87,-1.33,-1.31,120.24,-16.94,True,1,6239,-99.87,-497403.63,623088.93,125685.3
12986,1979-11-08,100.3,0.43,0.43,120.24,-16.58,True,1,6240,-100.3,-497503.93,625872.0,128368.07
12987,1979-11-09,101.51,1.21,1.21,120.24,-15.58,True,1,6241,-101.51,-497605.44,633523.91,135918.47
12988,1979-11-12,103.51,2.0,1.97,120.24,-13.91,True,1,6242,-103.51,-497708.95,646109.42,148400.47
12989,1979-11-13,102.94,-0.57,-0.55,120.24,-14.39,True,1,6243,-102.94,-497811.89,642654.42,144842.53
12990,1979-11-14,103.39,0.45,0.44,120.24,-14.01,True,1,6244,-103.39,-497915.28,645567.16,147651.88
12991,1979-11-15,104.13,0.74,0.72,120.24,-13.4,True,1,6245,-104.13,-498019.41,650291.85,152272.44
12992,1979-11-16,103.79,-0.34,-0.33,120.24,-13.68,True,1,6246,-103.79,-498123.2,648272.34,150149.14
12993,1979-11-19,104.23,0.44,0.42,120.24,-13.32,True,1,6247,-104.23,-498227.43,651124.81,152897.38
12994,1979-11-20,103.69,-0.54,-0.52,120.24,-13.76,True,1,6248,-103.69,-498331.12,647855.12,149524.0
12995,1979-11-21,103.89,0.2,0.19,120.24,-13.6,True,1,6249,-103.89,-498435.01,649208.61,150773.6
12996,1979-11-23,104.67,0.78,0.75,120.24,-12.95,True,1,6250,-104.67,-498539.68,654187.5,155647.82
12997,1979-11-26,106.8,2.13,2.04,120.24,-11.18,True,1,6251,-106.8,-498646.48,667606.8,168960.32
12998,1979-11-27,106.38,-0.42,-0.39,120.24,-11.53,True,1,6252,-106.38,-498752.86,665087.76,166334.9
12999,1979-11-28,106.77,0.39,0.37,120.24,-11.2,True,1,6253,-106.77,-498859.63,667632.81,168773.18
13000,1979-11-29,106.81,0.04,0.04,120.24,-11.17,True,1,6254,-106.81,-498966.44,667989.74,169023.3
13001,1979-11-30,106.16,-0.65,-0.61,120.24,-11.71,True,1,6255,-106.16,-499072.6,664030.8,164958.2
13002,1979-12-03,105.83,-0.33,-0.31,120.24,-11.98,True,1,6256,-105.83,-499178.43,662072.48,162894.05
13003,1979-12-04,106.79,0.96,0.91,120.24,-11.19,True,1,6257,-106.79,-499285.22,668185.03,168899.81
13004,1979-12-05,107.25,0.46,0.43,120.24,-10.8,True,1,6258,-107.25,-499392.47,671170.5,171778.03
13005,1979-12-06,108.0,0.75,0.7,120.24,-10.18,True,1,6259,-108.0,-499500.47,675972.0,176471.53
13006,1979-12-07,107.52,-0.48,-0.44,120.24,-10.58,True,1,6260,-107.52,-499607.99,673075.2,173467.21
13007,1979-12-10,107.67,0.15,0.14,120.24,-10.45,True,1,6261,-107.67,-499715.66,674121.87,174406.21
13008,1979-12-11,107.49,-0.18,-0.17,120.24,-10.6,True,1,6262,-107.49,-499823.15,673102.38,173279.23
13009,1979-12-12,107.52,0.03,0.03,120.24,-10.58,True,1,6263,-107.52,-499930.67,673397.76,173467.09
13010,1979-12-13,107.67,0.15,0.14,120.24,-10.45,True,1,6264,-107.67,-500038.34,674444.88,174406.54
13011,1979-12-14,108.92,1.25,1.16,120.24,-9.41,True,1,6265,-108.92,-500147.26,682383.8,182236.54
13012,1979-12-17,109.33,0.41,0.38,120.24,-9.07,True,1,6266,-109.33,-500256.59,685061.78,184805.19
13013,1979-12-18,108.3,-1.03,-0.94,120.24,-9.93,True,1,6267,-108.3,-500364.89,678716.1,178351.21
13014,1979-12-19,108.2,-0.1,-0.09,120.24,-10.01,True,1,6268,-108.2,-500473.09,678197.6,177724.51
13015,1979-12-20,108.26,0.06,0.06,120.24,-9.96,True,1,6269,-108.26,-500581.35,678681.94,178100.59
13016,1979-12-21,107.59,-0.67,-0.62,120.24,-10.52,True,1,6270,-107.59,-500688.94,674589.3,173900.36
13017,1979-12-24,107.66,0.07,0.06,120.24,-10.46,True,1,6271,-107.66,-500796.6,675135.86,174339.26
13018,1979-12-26,107.78,0.12,0.11,120.24,-10.36,True,1,6272,-107.78,-500904.38,675996.16,175091.78
13019,1979-12-27,107.96,0.18,0.17,120.24,-10.21,True,1,6273,-107.96,-501012.34,677233.08,176220.74
13020,1979-12-28,107.84,-0.12,-0.11,120.24,-10.31,True,1,6274,-107.84,-501120.18,676588.16,175467.98
13021,1979-12-31,107.94,0.1,0.09,120.24,-10.23,True,1,6275,-107.94,-501228.12,677323.5,176095.38
13022,1980-01-02,105.76,-2.18,-2.02,120.24,-12.04,True,1,6276,-105.76,-501333.88,663749.76,162415.88
13023,1980-01-03,105.22,-0.54,-0.51,120.24,-12.49,True,1,6277,-105.22,-501439.1,660465.94,159026.84
13024,1980-01-04,106.52,1.3,1.24,120.24,-11.41,True,1,6278,-106.52,-501545.62,668732.56,167186.94
13025,1980-01-07,106.81,0.29,0.27,120.24,-11.17,True,1,6279,-106.81,-501652.43,670659.99,169007.56
13026,1980-01-08,108.95,2.14,2.0,120.24,-9.39,True,1,6280,-108.95,-501761.38,684206.0,182444.62
13027,1980-01-09,109.05,0.1,0.09,120.24,-9.31,True,1,6281,-109.05,-501870.43,684943.05,183072.62
13028,1980-01-10,109.89,0.84,0.77,120.24,-8.61,True,1,6282,-109.89,-501980.32,690328.98,188348.66
13029,1980-01-11,109.92,0.03,0.03,120.24,-8.58,True,1,6283,-109.92,-502090.24,690627.36,188537.12
13030,1980-01-14,110.38,0.46,0.42,120.24,-8.2,True,1,6284,-110.38,-502200.62,693627.92,191427.3
13031,1980-01-15,111.14,0.76,0.69,120.24,-7.57,True,1,6285,-111.14,-502311.76,698514.9,196203.14
13032,1980-01-16,111.05,-0.09,-0.08,120.24,-7.64,True,1,6286,-111.05,-502422.81,698060.3,195637.49
13033,1980-01-17,110.7,-0.35,-0.32,120.24,-7.93,True,1,6287,-110.7,-502533.51,695970.9,193437.39
13034,1980-01-18,111.07,0.37,0.33,120.24,-7.63,True,1,6288,-111.07,-502644.58,698408.16,195763.58
13035,1980-01-21,112.1,1.03,0.93,120.24,-6.77,True,1,6289,-112.1,-502756.68,704996.9,202240.22
13036,1980-01-22,111.51,-0.59,-0.53,120.24,-7.26,True,1,6290,-111.51,-502868.19,701397.9,198529.71
13037,1980-01-23,113.44,1.93,1.73,120.24,-5.66,True,1,6291,-113.44,-502981.63,713651.04,210669.41
13038,1980-01-24,113.7,0.26,0.23,120.24,-5.44,True,1,6292,-113.7,-503095.33,715400.4,212305.07
13039,1980-01-25,113.61,-0.09,-0.08,120.24,-5.51,True,1,6293,-113.61,-503208.94,714947.73,211738.79
13040,1980-01-28,114.85,1.24,1.09,120.24,-4.48,True,1,6294,-114.85,-503323.79,722865.9,219542.11
13041,1980-01-29,114.07,-0.78,-0.68,120.24,-5.13,True,1,6295,-114.07,-503437.86,718070.65,214632.79
13042,1980-01-30,115.2,1.13,0.99,120.24,-4.19,True,1,6296,-115.2,-503553.06,725299.2,221746.14
13043,1980-01-31,114.16,-1.04,-0.9,120.24,-5.06,True,1,6297,-114.16,-503667.22,718865.52,215198.3
13044,1980-02-01,115.12,0.96,0.84,120.24,-4.26,True,1,6298,-115.12,-503782.34,725025.76,221243.42
13045,1980-02-04,114.37,-0.75,-0.65,120.24,-4.88,True,1,6299,-114.37,-503896.71,720416.63,216519.92
13046,1980-02-05,114.66,0.29,0.25,120.24,-4.64,True,1,6300,-114.66,-504011.37,722358.0,218346.63
13047,1980-02-06,115.72,1.06,0.92,120.24,-3.76,True,1,6301,-115.72,-504127.09,729151.72,225024.63
13048,1980-02-07,116.28,0.56,0.48,120.24,-3.29,True,1,6302,-116.28,-504243.37,732796.56,228553.19
13049,1980-02-08,117.95,1.67,1.44,120.24,-1.9,True,1,6303,-117.95,-504361.32,743438.85,239077.53
13050,1980-02-11,117.12,-0.83,-0.7,120.24,-2.6,True,1,6304,-117.12,-504478.44,738324.48,233846.04
13051,1980-02-12,117.9,0.78,0.67,120.24,-1.95,True,1,6305,-117.9,-504596.34,743359.5,238763.16
13052,1980-02-13,118.44,0.54,0.46,120.24,-1.5,True,1,6306,-118.44,-504714.78,746882.64,242167.86
13053,1980-02-14,116.72,-1.72,-1.45,120.24,-2.93,True,1,6307,-116.72,-504831.5,736153.04,231321.54
13054,1980-02-15,115.41,-1.31,-1.12,120.24,-4.02,True,1,6308,-115.41,-504946.91,728006.28,223059.37
13055,1980-02-19,114.6,-0.81,-0.7,120.24,-4.69,True,1,6309,-114.6,-505061.51,723011.4,217949.89
13056,1980-02-20,116.47,1.87,1.63,120.24,-3.14,True,1,6310,-116.47,-505177.98,734925.7,229747.72
13057,1980-02-21,115.28,-1.19,-1.02,120.24,-4.12,True,1,6311,-115.28,-505293.26,727532.08,222238.82
13058,1980-02-22,115.04,-0.24,-0.21,120.24,-4.32,True,1,6312,-115.04,-505408.3,726132.48,220724.18
13059,1980-02-25,113.33,-1.71,-1.49,120.24,-5.75,True,1,6313,-113.33,-505521.63,715452.29,209930.66
13060,1980-02-26,113.98,0.65,0.57,120.24,-5.21,True,1,6314,-113.98,-505635.61,719669.72,214034.11
13061,1980-02-27,112.38,-1.6,-1.4,120.24,-6.54,True,1,6315,-112.38,-505747.99,709679.7,203931.71
13062,1980-02-28,112.35,-0.03,-0.03,120.24,-6.56,True,1,6316,-112.35,-505860.34,709602.6,203742.26
13063,1980-02-29,113.66,1.31,1.17,120.24,-5.47,True,1,6317,-113.66,-505974.0,717990.22,212016.22
13064,1980-03-03,112.5,-1.16,-1.02,120.24,-6.44,True,1,6318,-112.5,-506086.5,710775.0,204688.5
13065,1980-03-04,112.78,0.28,0.25,120.24,-6.2,True,1,6319,-112.78,-506199.28,712656.82,206457.54
13066,1980-03-05,111.13,-1.65,-1.46,120.24,-7.58,True,1,6320,-111.13,-506310.41,702341.6,196031.19
13067,1980-03-06,108.65,-2.48,-2.23,120.24,-9.64,True,1,6321,-108.65,-506419.06,686776.65,180357.59
13068,1980-03-07,106.9,-1.75,-1.61,120.24,-11.09,True,1,6322,-106.9,-506525.96,675821.8,169295.84
13069,1980-03-10,106.51,-0.39,-0.36,120.24,-11.42,True,1,6323,-106.51,-506632.47,673462.73,166830.26
13070,1980-03-11,107.78,1.27,1.19,120.24,-10.36,True,1,6324,-107.78,-506740.25,681600.72,174860.47
13071,1980-03-12,106.87,-0.91,-0.84,120.24,-11.12,True,1,6325,-106.87,-506847.12,675952.75,169105.63
13072,1980-03-13,105.62,-1.25,-1.17,120.24,-12.16,True,1,6326,-105.62,-506952.74,668152.12,161199.38
13073,1980-03-14,105.43,-0.19,-0.18,120.24,-12.32,True,1,6327,-105.43,-507058.17,667055.61,159997.44
13074,1980-03-17,102.26,-3.17,-3.01,120.24,-14.95,True,1,6328,-102.26,-507160.43,647101.28,139940.85
13075,1980-03-18,104.1,1.84,1.8,120.24,-13.42,True,1,6329,-104.1,-507264.53,658848.9,151584.37
13076,1980-03-19,104.31,0.21,0.2,120.24,-13.25,True,1,6330,-104.31,-507368.84,660282.3,152913.46
13077,1980-03-20,103.12,-1.19,-1.14,120.24,-14.24,True,1,6331,-103.12,-507471.96,652852.72,145380.76
13078,1980-03-21,102.31,-0.81,-0.78,120.24,-14.91,True,1,6332,-102.31,-507574.27,647826.92,140252.65
13079,1980-03-24,99.28,-3.03,-2.96,120.24,-17.43,True,1,6333,-99.28,-507673.55,628740.24,121066.69
13080,1980-03-25,99.19,-0.09,-0.09,120.24,-17.51,True,1,6334,-99.19,-507772.74,628269.46,120496.72
13081,1980-03-26,98.68,-0.51,-0.51,120.24,-17.93,True,1,6335,-98.68,-507871.42,625137.8,117266.38
13082,1980-03-27,98.22,-0.46,-0.47,120.24,-18.31,True,1,6336,-98.22,-507969.64,622321.92,114352.28
13083,1980-03-28,100.68,2.46,2.5,120.24,-16.27,True,1,6337,-100.68,-508070.32,638009.16,129938.84
13084,1980-03-31,102.09,1.41,1.4,120.24,-15.1,True,1,6338,-102.09,-508172.41,647046.42,138874.01
13085,1980-04-01,102.18,0.09,0.09,120.24,-15.02,True,1,6339,-102.18,-508274.59,647719.02,139444.43
13086,1980-04-02,102.68,0.5,0.49,120.24,-14.6,True,1,6340,-102.68,-508377.27,650991.2,142613.93
13087,1980-04-03,102.15,-0.53,-0.52,120.24,-15.04,True,1,6341,-102.15,-508479.42,647733.15,139253.73
13088,1980-04-07,100.19,-1.96,-1.92,120.24,-16.68,True,1,6342,-100.19,-508579.61,635404.98,126825.37
13089,1980-04-08,101.2,1.01,1.01,120.24,-15.84,True,1,6343,-101.2,-508680.81,641911.6,133230.79
13090,1980-04-09,103.11,1.91,1.89,120.24,-14.25,True,1,6344,-103.11,-508783.92,654129.84,145345.92
13091,1980-04-10,104.08,0.97,0.94,120.24,-13.44,True,1,6345,-104.08,-508888.0,660387.6,151499.6
13092,1980-04-11,103.79,-0.29,-0.28,120.24,-13.68,True,1,6346,-103.79,-508991.79,658651.34,149659.55
13093,1980-04-14,102.84,-0.95,-0.92,120.24,-14.47,True,1,6347,-102.84,-509094.63,652725.48,143630.85
13094,1980-04-15,102.63,-0.21,-0.2,120.24,-14.65,True,1,6348,-102.63,-509197.26,651495.24,142297.98
13095,1980-04-16,101.54,-1.09,-1.06,120.24,-15.55,True,1,6349,-101.54,-509298.8,644677.46,135378.66
13096,1980-04-17,101.05,-0.49,-0.48,120.24,-15.96,True,1,6350,-101.05,-509399.85,641667.5,132267.65
13097,1980-04-18,100.55,-0.5,-0.5,120.24,-16.38,True,1,6351,-100.55,-509500.4,638593.05,129092.65
13098,1980-04-21,99.8,-0.75,-0.75,120.24,-17.0,True,1,6352,-99.8,-509600.2,633929.6,124329.4
13099,1980-04-22,103.43,3.63,3.64,120.24,-13.98,True,1,6353,-103.43,-509703.63,657090.79,147387.16
13100,1980-04-23,103.73,0.3,0.29,120.24,-13.73,True,1,6354,-103.73,-509807.36,659100.42,149293.06
13101,1980-04-24,104.4,0.67,0.65,120.24,-13.17,True,1,6355,-104.4,-509911.76,663462.0,153550.24
13102,1980-04-25,105.16,0.76,0.73,120.24,-12.54,True,1,6356,-105.16,-510016.92,668396.96,158380.04
13103,1980-04-28,105.64,0.48,0.46,120.24,-12.14,True,1,6357,-105.64,-510122.56,671553.48,161430.92
13104,1980-04-29,105.86,0.22,0.21,120.24,-11.96,True,1,6358,-105.86,-510228.42,673057.88,162829.46
13105,1980-04-30,106.29,0.43,0.41,120.24,-11.6,True,1,6359,-106.29,-510334.71,675898.11,165563.4
13106,1980-05-01,105.46,-0.83,-0.78,120.24,-12.29,True,1,6360,-105.46,-510440.17,670725.6,160285.43
13107,1980-05-02,105.58,0.12,0.11,120.24,-12.19,True,1,6361,-105.58,-510545.75,671594.38,161048.63
13108,1980-05-05,106.38,0.8,0.76,120.24,-11.53,True,1,6362,-106.38,-510652.13,676789.56,166137.43
13109,1980-05-06,106.25,-0.13,-0.12,120.24,-11.64,True,1,6363,-106.25,-510758.38,676068.75,165310.37
13110,1980-05-07,107.18,0.93,0.88,120.24,-10.86,True,1,6364,-107.18,-510865.56,682093.52,171227.96
13111,1980-05-08,106.13,-1.05,-0.98,120.24,-11.74,True,1,6365,-106.13,-510971.69,675517.45,164545.76
13112,1980-05-09,104.72,-1.41,-1.33,120.24,-12.91,True,1,6366,-104.72,-511076.41,666647.52,155571.11
13113,1980-05-12,104.78,0.06,0.06,120.24,-12.86,True,1,6367,-104.78,-511181.19,667134.26,155953.07
13114,1980-05-13,106.3,1.52,1.45,120.24,-11.59,True,1,6368,-106.3,-511287.49,676918.4,165630.91
13115,1980-05-14,106.85,0.55,0.52,120.24,-11.14,True,1,6369,-106.85,-511394.34,680527.65,169133.31
13116,1980-05-15,106.99,0.14,0.13,120.24,-11.02,True,1,6370,-106.99,-511501.33,681526.3,170024.97
13117,1980-05-16,107.35,0.36,0.34,120.24,-10.72,True,1,6371,-107.35,-511608.68,683926.85,172318.17
13118,1980-05-19,107.67,0.32,0.3,120.24,-10.45,True,1,6372,-107.67,-511716.35,686073.24,174356.89
13119,1980-05-20,107.62,-0.05,-0.05,120.24,-10.5,True,1,6373,-107.62,-511823.97,685862.26,174038.29
13120,1980-05-21,107.72,0.1,0.09,120.24,-10.41,True,1,6374,-107.72,-511931.69,686607.28,174675.59
13121,1980-05-22,109.01,1.29,1.2,120.24,-9.34,True,1,6375,-109.01,-512040.7,694938.75,182898.05
13122,1980-05-23,110.62,1.61,1.48,120.24,-8.0,True,1,6376,-110.62,-512151.32,705313.12,193161.8
13123,1980-05-27,111.4,0.78,0.7,120.24,-7.35,True,1,6377,-111.4,-512262.72,710397.8,198135.08
13124,1980-05-28,112.06,0.66,0.59,120.24,-6.8,True,1,6378,-112.06,-512374.78,714718.68,202343.9
13125,1980-05-29,110.27,-1.79,-1.6,120.24,-8.29,True,1,6379,-110.27,-512485.05,703412.33,190927.28
13126,1980-05-30,111.24,0.97,0.88,120.24,-7.48,True,1,6380,-111.24,-512596.29,709711.2,197114.91
13127,1980-06-02,110.76,-0.48,-0.43,120.24,-7.88,True,1,6381,-110.76,-512707.05,706759.56,194052.51
13128,1980-06-03,110.51,-0.25,-0.23,120.24,-8.09,True,1,6382,-110.51,-512817.56,705274.82,192457.26
13129,1980-06-04,112.61,2.1,1.9,120.24,-6.35,True,1,6383,-112.61,-512930.17,718789.63,205859.46
13130,1980-06-05,112.78,0.17,0.15,120.24,-6.2,True,1,6384,-112.78,-513042.95,719987.52,206944.57
13131,1980-06-06,113.2,0.42,0.37,120.24,-5.86,True,1,6385,-113.2,-513156.15,722782.0,209625.85
13132,1980-06-09,113.71,0.51,0.45,120.24,-5.43,True,1,6386,-113.71,-513269.86,726152.06,212882.2
13133,1980-06-10,114.66,0.95,0.84,120.24,-4.64,True,1,6387,-114.66,-513384.52,732333.42,218948.9
13134,1980-06-11,116.02,1.36,1.19,120.24,-3.51,True,1,6388,-116.02,-513500.54,741135.76,227635.22
13135,1980-06-12,115.52,-0.5,-0.43,120.24,-3.92,True,1,6389,-115.52,-513616.06,738057.28,224441.22
13136,1980-06-13,115.81,0.29,0.25,120.24,-3.68,True,1,6390,-115.81,-513731.87,740025.9,226294.03
13137,1980-06-16,116.09,0.28,0.24,120.24,-3.45,True,1,6391,-116.09,-513847.96,741931.19,228083.23
13138,1980-06-17,116.03,-0.06,-0.05,120.24,-3.5,True,1,6392,-116.03,-513963.99,741663.76,227699.77
13139,1980-06-18,116.26,0.23,0.2,120.24,-3.31,True,1,6393,-116.26,-514080.25,743250.18,229169.93
13140,1980-06-19,114.66,-1.6,-1.38,120.24,-4.64,True,1,6394,-114.66,-514194.91,733136.04,218941.13
13141,1980-06-20,114.06,-0.6,-0.52,120.24,-5.14,True,1,6395,-114.06,-514308.97,729413.7,215104.73
13142,1980-06-23,114.51,0.45,0.4,120.24,-4.76,True,1,6396,-114.51,-514423.48,732405.96,217982.48
13143,1980-06-24,115.14,0.63,0.55,120.24,-4.24,True,1,6397,-115.14,-514538.62,736550.58,222011.96
13144,1980-06-25,116.72,1.58,1.37,120.24,-2.93,True,1,6398,-116.72,-514655.34,746774.56,232119.22
13145,1980-06-26,116.19,-0.53,-0.45,120.24,-3.37,True,1,6399,-116.19,-514771.53,743499.81,228728.28
13146,1980-06-27,116.0,-0.19,-0.16,120.24,-3.53,True,1,6400,-116.0,-514887.53,742400.0,227512.47
13147,1980-06-30,114.24,-1.76,-1.52,120.24,-4.99,True,1,6401,-114.24,-515001.77,731250.24,216248.47
13148,1980-07-01,114.93,0.69,0.6,120.24,-4.42,True,1,6402,-114.93,-515116.7,735781.86,220665.16
13149,1980-07-02,115.68,0.75,0.65,120.24,-3.79,True,1,6403,-115.68,-515232.38,740699.04,225466.66
13150,1980-07-03,117.46,1.78,1.54,120.24,-2.31,True,1,6404,-117.46,-515349.84,752213.84,236864.0
13151,1980-07-07,118.29,0.83,0.71,120.24,-1.62,True,1,6405,-118.29,-515468.13,757647.45,242179.32
13152,1980-07-08,117.84,-0.45,-0.38,120.24,-2.0,True,1,6406,-117.84,-515585.97,754883.04,239297.07
13153,1980-07-09,117.98,0.14,0.12,120.24,-1.88,True,1,6407,-117.98,-515703.95,755897.86,240193.91
13154,1980-07-10,116.95,-1.03,-0.87,120.24,-2.74,True,1,6408,-116.95,-515820.9,749415.6,233594.7
13155,1980-07-11,117.84,0.89,0.76,120.24,-2.0,True,1,6409,-117.84,-515938.74,755236.56,239297.82
13156,1980-07-14,120.01,2.17,1.84,120.24,-0.19,True,1,6410,-120.01,-516058.75,769264.1,253205.35
13157,1980-07-15,119.3,-0.71,-0.59,120.24,-0.78,True,1,6411,-119.3,-516178.05,764832.3,248654.25
13158,1980-07-16,119.63,0.33,0.28,120.24,-0.51,True,1,6412,-119.63,-516297.68,767067.56,250769.88
13159,1980-07-17,121.44,1.81,1.51,121.44,0.0,True,1,6413,-121.44,-516419.12,778794.72,262375.6
13160,1980-07-18,122.04,0.6,0.49,122.04,0.0,True,1,6414,-122.04,-516541.16,782764.56,266223.4
13161,1980-07-21,122.51,0.47,0.38,122.51,0.0,True,1,6415,-122.51,-516663.67,785901.65,269237.98
13162,1980-07-22,122.19,-0.32,-0.26,122.51,-0.26,True,1,6416,-122.19,-516785.86,783971.04,267185.18
13163,1980-07-23,121.93,-0.26,-0.21,122.51,-0.47,True,1,6417,-121.93,-516907.79,782424.81,265517.02
13164,1980-07-24,121.79,-0.14,-0.12,122.51,-0.59,True,1,6418,-121.79,-517029.58,781648.22,264618.64
13165,1980-07-25,120.78,-1.01,-0.83,122.51,-1.41,True,1,6419,-120.78,-517150.36,775286.82,258136.46
13166,1980-07-28,121.43,0.65,0.54,122.51,-0.88,True,1,6420,-121.43,-517271.79,779580.6,262308.81
13167,1980-07-29,122.4,0.97,0.8,122.51,-0.09,True,1,6421,-122.4,-517394.19,785930.4,268536.21
13168,1980-07-30,122.23,-0.17,-0.14,122.51,-0.23,True,1,6422,-122.23,-517516.42,784961.06,267444.64
13169,1980-07-31,121.67,-0.56,-0.46,122.51,-0.69,True,1,6423,-121.67,-517638.09,781486.41,263848.32
13170,1980-08-01,121.21,-0.46,-0.38,122.51,-1.06,True,1,6424,-121.21,-517759.3,778653.04,260893.74
13171,1980-08-04,120.98,-0.23,-0.19,122.51,-1.25,True,1,6425,-120.98,-517880.28,777296.5,259416.22
13172,1980-08-05,120.74,-0.24,-0.2,122.51,-1.44,True,1,6426,-120.74,-518001.02,775875.24,257874.22
13173,1980-08-06,121.55,0.81,0.67,122.51,-0.78,True,1,6427,-121.55,-518122.57,781201.85,263079.28
13174,1980-08-07,123.3,1.75,1.44,123.3,0.0,True,1,6428,-123.3,-518245.87,792572.4,274326.53
13175,1980-08-08,123.61,0.31,0.25,123.61,0.0,True,1,6429,-123.61,-518369.48,794688.69,276319.21
13176,1980-08-11,124.78,1.17,0.95,124.78,0.0,True,1,6430,-124.78,-518494.26,802335.4,283841.14
13177,1980-08-12,123.79,-0.99,-0.79,124.78,-0.79,True,1,6431,-123.79,-518618.05,796093.49,277475.44
13178,1980-08-13,123.28,-0.51,-0.41,124.78,-1.2,True,1,6432,-123.28,-518741.33,792936.96,274195.63
13179,1980-08-14,125.25,1.97,1.6,125.25,0.0,True,1,6433,-125.25,-518866.58,805733.25,286866.67
13180,1980-08-15,125.72,0.47,0.38,125.72,0.0,True,1,6434,-125.72,-518992.3,808882.48,289890.18
13181,1980-08-18,123.39,-2.33,-1.85,125.72,-1.85,True,1,6435,-123.39,-519115.69,794014.65,274898.96
13182,1980-08-19,122.6,-0.79,-0.64,125.72,-2.48,True,1,6436,-122.6,-519238.29,789053.6,269815.31
13183,1980-08-20,123.77,1.17,0.95,125.72,-1.55,True,1,6437,-123.77,-519362.06,796707.49,277345.43
13184,1980-08-21,125.46,1.69,1.36,125.72,-0.21,True,1,6438,-125.46,-519487.52,807711.48,288223.96
13185,1980-08-22,126.02,0.56,0.45,126.02,0.0,True,1,6439,-126.02,-519613.54,811442.78,291829.24
13186,1980-08-25,125.16,-0.86,-0.68,126.02,-0.68,True,1,6440,-125.16,-519738.7,806030.4,286291.7
13187,1980-08-26,124.84,-0.32,-0.26,126.02,-0.94,True,1,6441,-124.84,-519863.54,804094.44,284230.9
13188,1980-08-27,123.52,-1.32,-1.06,126.02,-1.98,True,1,6442,-123.52,-519987.06,795715.84,275728.78
13189,1980-08-28,122.08,-1.44,-1.17,126.02,-3.13,True,1,6443,-122.08,-520109.14,786561.44,266452.3
13190,1980-08-29,122.38,0.3,0.25,126.02,-2.89,True,1,6444,-122.38,-520231.52,788616.72,268385.2
13191,1980-09-02,123.74,1.36,1.11,126.02,-1.81,True,1,6445,-123.74,-520355.26,797504.3,277149.04
13192,1980-09-03,126.12,2.38,1.92,126.12,0.0,True,1,6446,-126.12,-520481.38,812969.52,292488.14
13193,1980-09-04,125.42,-0.7,-0.56,126.12,-0.56,True,1,6447,-125.42,-520606.8,808582.74,287975.94
13194,1980-09-05,124.88,-0.54,-0.43,126.12,-0.98,True,1,6448,-124.88,-520731.68,805226.24,284494.56
13195,1980-09-08,123.31,-1.57,-1.26,126.12,-2.23,True,1,6449,-123.31,-520854.99,795226.19,274371.2
13196,1980-09-09,124.07,0.76,0.62,126.12,-1.62,True,1,6450,-124.07,-520979.06,800251.5,279272.44
13197,1980-09-10,124.81,0.74,0.6,126.12,-1.04,True,1,6451,-124.81,-521103.87,805149.31,284045.44
13198,1980-09-11,125.66,0.85,0.68,126.12,-0.36,True,1,6452,-125.66,-521229.53,810758.32,289528.79
13199,1980-09-12,125.54,-0.12,-0.1,126.12,-0.46,True,1,6453,-125.54,-521355.07,810109.62,288754.55
13200,1980-09-15,125.67,0.13,0.1,126.12,-0.36,True,1,6454,-125.67,-521480.74,811074.18,289593.44
13201,1980-09-16,126.74,1.07,0.85,126.74,0.0,True,1,6455,-126.74,-521607.48,818106.7,296499.22
13202,1980-09-17,128.87,2.13,1.68,128.87,0.0,True,1,6456,-128.87,-521736.35,831984.72,310248.37
13203,1980-09-18,128.4,-0.47,-0.36,128.87,-0.36,True,1,6457,-128.4,-521864.75,829078.8,307214.05
13204,1980-09-19,129.25,0.85,0.66,129.25,0.0,True,1,6458,-129.25,-521994.0,834696.5,312702.5
13205,1980-09-22,130.4,1.15,0.89,130.4,0.0,True,1,6459,-130.4,-522124.4,842253.6,320129.2
13206,1980-09-23,129.43,-0.97,-0.74,130.4,-0.74,True,1,6460,-129.43,-522253.83,836117.8,313863.97
13207,1980-09-24,130.37,0.94,0.73,130.4,-0.02,True,1,6461,-130.37,-522384.2,842320.57,319936.37
13208,1980-09-25,128.72,-1.65,-1.27,130.4,-1.29,True,1,6462,-128.72,-522512.92,831788.64,309275.72
13209,1980-09-26,126.35,-2.37,-1.84,130.4,-3.11,True,1,6463,-126.35,-522639.27,816600.05,293960.78
13210,1980-09-29,123.54,-2.81,-2.22,130.4,-5.26,True,1,6464,-123.54,-522762.81,798562.56,275799.75
13211,1980-09-30,125.46,1.92,1.55,130.4,-3.79,True,1,6465,-125.46,-522888.27,811098.9,288210.63
13212,1980-10-01,127.13,1.67,1.33,130.4,-2.51,True,1,6466,-127.13,-523015.4,822022.58,299007.18
13213,1980-10-02,128.09,0.96,0.76,130.4,-1.77,True,1,6467,-128.09,-523143.49,828358.03,305214.54
13214,1980-10-03,129.33,1.24,0.97,130.4,-0.82,True,1,6468,-129.33,-523272.82,836506.44,313233.62
13215,1980-10-06,131.73,2.4,1.86,131.73,0.0,True,1,6469,-131.73,-523404.55,852161.37,328756.82
13216,1980-10-07,131.0,-0.73,-0.55,131.73,-0.55,True,1,6470,-131.0,-523535.55,847570.0,324034.45
13217,1980-10-08,131.65,0.65,0.5,131.73,-0.06,True,1,6471,-131.65,-523667.2,851907.15,328239.95
13218,1980-10-09,131.04,-0.61,-0.46,131.73,-0.52,True,1,6472,-131.04,-523798.24,848090.88,324292.64
13219,1980-10-10,130.29,-0.75,-0.57,131.73,-1.09,True,1,6473,-130.29,-523928.53,843367.17,319438.64
13220,1980-10-13,132.03,1.74,1.34,132.03,0.0,True,1,6474,-132.03,-524060.56,854762.22,330701.66
13221,1980-10-14,132.02,-0.01,-0.01,132.03,-0.01,True,1,6475,-132.02,-524192.58,854829.5,330636.92
13222,1980-10-15,133.7,1.68,1.27,133.7,0.0,True,1,6476,-133.7,-524326.28,865841.2,341514.92
13223,1980-10-16,132.22,-1.48,-1.11,133.7,-1.11,True,1,6477,-132.22,-524458.5,856388.94,331930.44
13224,1980-10-17,131.52,-0.7,-0.53,133.7,-1.63,True,1,6478,-131.52,-524590.02,851986.56,327396.54
13225,1980-10-20,132.61,1.09,0.83,133.7,-0.82,True,1,6479,-132.61,-524722.63,859180.19,334457.56
13226,1980-10-21,131.84,-0.77,-0.58,133.7,-1.39,True,1,6480,-131.84,-524854.47,854323.2,329468.73
13227,1980-10-22,131.92,0.08,0.06,133.7,-1.33,True,1,6481,-131.92,-524986.39,854973.52,329987.13
13228,1980-10-23,129.53,-2.39,-1.81,133.7,-3.12,True,1,6482,-129.53,-525115.92,839613.46,314497.54
13229,1980-10-24,129.85,0.32,0.25,133.7,-2.88,True,1,6483,-129.85,-525245.77,841817.55,316571.78
13230,1980-10-27,127.88,-1.97,-1.52,133.7,-4.35,True,1,6484,-127.88,-525373.65,829173.92,303800.27
13231,1980-10-28,128.05,0.17,0.13,133.7,-4.23,True,1,6485,-128.05,-525501.7,830404.25,304902.55
13232,1980-10-29,127.91,-0.14,-0.11,133.7,-4.33,True,1,6486,-127.91,-525629.61,829624.26,303994.65
13233,1980-10-30,126.29,-1.62,-1.27,133.7,-5.54,True,1,6487,-126.29,-525755.9,819243.23,293487.33
13234,1980-10-31,127.47,1.18,0.93,133.7,-4.66,True,1,6488,-127.47,-525883.37,827025.36,301141.99
13235,1980-11-03,129.04,1.57,1.23,133.7,-3.48,True,1,6489,-129.04,-526012.41,837340.56,311328.15
13236,1980-11-05,131.33,2.29,1.78,133.7,-1.77,True,1,6490,-131.33,-526143.74,852331.7,326187.96
13237,1980-11-06,128.91,-2.42,-1.84,133.7,-3.58,True,1,6491,-128.91,-526272.65,836754.81,310482.16
13238,1980-11-07,129.18,0.27,0.21,133.7,-3.38,True,1,6492,-129.18,-526401.83,838636.56,312234.73
13239,1980-11-10,129.48,0.3,0.23,133.7,-3.16,True,1,6493,-129.48,-526531.31,840713.64,314182.33
13240,1980-11-11,131.26,1.78,1.38,133.7,-1.82,True,1,6494,-131.26,-526662.57,852402.44,325739.87
13241,1980-11-12,134.59,3.33,2.54,134.59,0.0,True,1,6495,-134.59,-526797.16,874162.05,347364.89
13242,1980-11-13,136.49,1.9,1.41,136.49,0.0,True,1,6496,-136.49,-526933.65,886639.04,359705.39
13243,1980-11-14,137.15,0.66,0.48,137.15,0.0,True,1,6497,-137.15,-527070.8,891063.55,363992.75
13244,1980-11-17,137.75,0.6,0.44,137.75,0.0,True,1,6498,-137.75,-527208.55,895099.5,367890.95
13245,1980-11-18,139.7,1.95,1.42,139.7,0.0,True,1,6499,-139.7,-527348.25,907910.3,380562.05
13246,1980-11-19,139.06,-0.64,-0.46,139.7,-0.46,True,1,6500,-139.06,-527487.31,903890.0,376402.69
13247,1980-11-20,140.4,1.34,0.96,140.4,0.0,True,1,6501,-140.4,-527627.71,912740.4,385112.69
13248,1980-11-21,139.11,-1.29,-0.92,140.4,-0.92,True,1,6502,-139.11,-527766.82,904493.22,376726.4
13249,1980-11-24,138.31,-0.8,-0.57,140.4,-1.49,True,1,6503,-138.31,-527905.13,899429.93,371524.8
13250,1980-11-25,139.33,1.02,0.74,140.4,-0.76,True,1,6504,-139.33,-528044.46,906202.32,378157.86
13251,1980-11-26,140.17,0.84,0.6,140.4,-0.16,True,1,6505,-140.17,-528184.63,911805.85,383621.22
13252,1980-11-28,140.52,0.35,0.25,140.52,0.0,True,1,6506,-140.52,-528325.15,914223.12,385897.97
13253,1980-12-01,137.21,-3.31,-2.36,140.52,-2.36,True,1,6507,-137.21,-528462.36,892825.47,364363.11
13254,1980-12-02,136.97,-0.24,-0.18,140.52,-2.53,True,1,6508,-136.97,-528599.33,891400.76,362801.43
13255,1980-12-03,136.71,-0.26,-0.19,140.52,-2.71,True,1,6509,-136.71,-528736.04,889845.39,361109.35
13256,1980-12-04,136.48,-0.23,-0.17,140.52,-2.88,True,1,6510,-136.48,-528872.52,888484.8,359612.28
13257,1980-12-05,134.03,-2.45,-1.8,140.52,-4.62,True,1,6511,-134.03,-529006.55,872669.33,343662.78
13258,1980-12-08,130.61,-3.42,-2.55,140.52,-7.05,True,1,6512,-130.61,-529137.16,850532.32,321395.16
13259,1980-12-09,130.48,-0.13,-0.1,140.52,-7.14,True,1,6513,-130.48,-529267.64,849816.24,320548.6
13260,1980-12-10,128.26,-2.22,-1.7,140.52,-8.72,True,1,6514,-128.26,-529395.9,835485.64,306089.74
13261,1980-12-11,127.36,-0.9,-0.7,140.52,-9.36,True,1,6515,-127.36,-529523.26,829750.4,300227.14
13262,1980-12-12,129.23,1.87,1.47,140.52,-8.03,True,1,6516,-129.23,-529652.49,842062.68,312410.19
13263,1980-12-15,129.45,0.22,0.17,140.52,-7.88,True,1,6517,-129.45,-529781.94,843625.65,313843.71
13264,1980-12-16,130.6,1.15,0.89,140.52,-7.06,True,1,6518,-130.6,-529912.54,851250.8,321338.26
13265,1980-12-17,132.89,2.29,1.75,140.52,-5.43,True,1,6519,-132.89,-530045.43,866309.91,336264.48
13266,1980-12-18,133.0,0.11,0.08,140.52,-5.35,True,1,6520,-133.0,-530178.43,867160.0,336981.57
13267,1980-12-19,133.7,0.7,0.53,140.52,-4.85,True,1,6521,-133.7,-530312.13,871857.7,341545.57
13268,1980-12-22,135.78,2.08,1.56,140.52,-3.37,True,1,6522,-135.78,-530447.91,885557.16,355109.25
13269,1980-12-23,135.3,-0.48,-0.35,140.52,-3.72,True,1,6523,-135.3,-530583.21,882561.9,351978.69
13270,1980-12-24,135.88,0.58,0.43,140.52,-3.3,True,1,6524,-135.88,-530719.09,886481.12,355762.03
13271,1980-12-26,136.57,0.69,0.51,140.52,-2.81,True,1,6525,-136.57,-530855.66,891119.25,360263.59
13272,1980-12-29,135.03,-1.54,-1.13,140.52,-3.91,True,1,6526,-135.03,-530990.69,881205.78,350215.09
13273,1980-12-30,135.33,0.3,0.22,140.52,-3.69,True,1,6527,-135.33,-531126.02,883298.91,352172.89
13274,1980-12-31,135.76,0.43,0.32,140.52,-3.39,True,1,6528,-135.76,-531261.78,886241.28,354979.5
13275,1981-01-02,136.34,0.58,0.43,140.52,-2.98,True,1,6529,-136.34,-531398.12,890163.86,358765.74
13276,1981-01-05,137.97,1.63,1.2,140.52,-1.82,True,1,6530,-137.97,-531536.09,900944.1,369408.01
13277,1981-01-06,138.12,0.15,0.11,140.52,-1.71,True,1,6531,-138.12,-531674.21,902061.72,370387.51
13278,1981-01-07,135.08,-3.04,-2.2,140.52,-3.87,True,1,6532,-135.08,-531809.29,882342.56,350533.27
13279,1981-01-08,133.06,-2.02,-1.5,140.52,-5.31,True,1,6533,-133.06,-531942.35,869280.98,337338.63
13280,1981-01-09,133.48,0.42,0.32,140.52,-5.01,True,1,6534,-133.48,-532075.83,872158.32,340082.49
13281,1981-01-12,133.52,0.04,0.03,140.52,-4.98,True,1,6535,-133.52,-532209.35,872553.2,340343.85
13282,1981-01-13,133.29,-0.23,-0.17,140.52,-5.14,True,1,6536,-133.29,-532342.64,871183.44,338840.8
13283,1981-01-14,133.47,0.18,0.14,140.52,-5.02,True,1,6537,-133.47,-532476.11,872493.39,340017.28
13284,1981-01-15,134.22,0.75,0.56,140.52,-4.48,True,1,6538,-134.22,-532610.33,877530.36,344920.03
13285,1981-01-16,134.77,0.55,0.41,140.52,-4.09,True,1,6539,-134.77,-532745.1,881261.03,348515.93
13286,1981-01-19,134.37,-0.4,-0.3,140.52,-4.38,True,1,6540,-134.37,-532879.47,878779.8,345900.33
13287,1981-01-20,131.65,-2.72,-2.02,140.52,-6.31,True,1,6541,-131.65,-533011.12,861122.65,328111.53
13288,1981-01-21,131.36,-0.29,-0.22,140.52,-6.52,True,1,6542,-131.36,-533142.48,859357.12,326214.64
13289,1981-01-22,130.26,-1.1,-0.84,140.52,-7.3,True,1,6543,-130.26,-533272.74,852291.18,319018.44
13290,1981-01-23,130.23,-0.03,-0.02,140.52,-7.32,True,1,6544,-130.23,-533402.97,852225.12,318822.15
13291,1981-01-26,129.84,-0.39,-0.3,140.52,-7.6,True,1,6545,-129.84,-533532.81,849802.8,316269.99
13292,1981-01-27,131.12,1.28,0.99,140.52,-6.69,True,1,6546,-131.12,-533663.93,858311.52,324647.59
13293,1981-01-28,130.34,-0.78,-0.6,140.52,-7.24,True,1,6547,-130.34,-533794.27,853335.98,319541.71
13294,1981-01-29,130.24,-0.1,-0.08,140.52,-7.32,True,1,6548,-130.24,-533924.51,852811.52,318887.01
13295,1981-01-30,129.55,-0.69,-0.53,140.52,-7.81,True,1,6549,-129.55,-534054.06,848422.95,314368.89
13296,1981-02-02,126.91,-2.64,-2.04,140.52,-9.68,True,1,6550,-126.91,-534180.97,831260.5,297079.53
13297,1981-02-03,128.46,1.55,1.22,140.52,-8.58,True,1,6551,-128.46,-534309.43,841541.46,307232.03
13298,1981-02-04,128.59,0.13,0.1,140.52,-8.49,True,1,6552,-128.59,-534438.02,842521.68,308083.66
13299,1981-02-05,129.63,1.04,0.81,140.52,-7.75,True,1,6553,-129.63,-534567.65,849465.39,314897.74
13300,1981-02-06,130.6,0.97,0.75,140.52,-7.06,True,1,6554,-130.6,-534698.25,855952.4,321254.15
13301,1981-02-09,129.27,-1.33,-1.02,140.52,-8.01,True,1,6555,-129.27,-534827.52,847364.85,312537.33
13302,1981-02-10,129.24,-0.03,-0.02,140.52,-8.03,True,1,6556,-129.24,-534956.76,847297.44,312340.68
13303,1981-02-11,128.24,-1.0,-0.77,140.52,-8.74,True,1,6557,-128.24,-535085.0,840869.68,305784.68
13304,1981-02-12,127.48,-0.76,-0.59,140.52,-9.28,True,1,6558,-127.48,-535212.48,836013.84,300801.36
13305,1981-02-13,126.98,-0.5,-0.39,140.52,-9.64,True,1,6559,-126.98,-535339.46,832861.82,297522.36
13306,1981-02-17,127.81,0.83,0.65,140.52,-9.04,True,1,6560,-127.81,-535467.27,838433.6,302966.33
13307,1981-02-18,128.48,0.67,0.52,140.52,-8.57,True,1,6561,-128.48,-535595.75,842957.28,307361.53
13308,1981-02-19,126.61,-1.87,-1.46,140.52,-9.9,True,1,6562,-126.61,-535722.36,830814.82,295092.46
13309,1981-02-20,126.58,-0.03,-0.02,140.52,-9.92,True,1,6563,-126.58,-535848.94,830744.54,294895.6
13310,1981-02-23,127.35,0.77,0.61,140.52,-9.37,True,1,6564,-127.35,-535976.29,835925.4,299949.11
13311,1981-02-24,127.39,0.04,0.03,140.52,-9.34,True,1,6565,-127.39,-536103.68,836315.35,300211.67
13312,1981-02-25,128.52,1.13,0.89,140.52,-8.54,True,1,6566,-128.52,-536232.2,843862.32,307630.12
13313,1981-02-26,130.1,1.58,1.23,140.52,-7.42,True,1,6567,-130.1,-536362.3,854366.7,318004.4
13314,1981-02-27,131.27,1.17,0.9,140.52,-6.58,True,1,6568,-131.27,-536493.57,862181.36,325687.79
13315,1981-03-02,132.01,0.74,0.56,140.52,-6.06,True,1,6569,-132.01,-536625.58,867173.69,330548.11
13316,1981-03-03,130.56,-1.45,-1.1,140.52,-7.09,True,1,6570,-130.56,-536756.14,857779.2,321023.06
13317,1981-03-04,130.86,0.3,0.23,140.52,-6.87,True,1,6571,-130.86,-536887.0,859881.06,322994.06
13318,1981-03-05,129.93,-0.93,-0.71,140.52,-7.54,True,1,6572,-129.93,-537016.93,853899.96,316883.03
13319,1981-03-06,129.85,-0.08,-0.06,140.52,-7.59,True,1,6573,-129.85,-537146.78,853504.05,316357.27
13320,1981-03-09,131.12,1.27,0.98,140.52,-6.69,True,1,6574,-131.12,-537277.9,861982.88,324704.98
13321,1981-03-10,130.46,-0.66,-0.5,140.52,-7.16,True,1,6575,-130.46,-537408.36,857774.5,320366.14
13322,1981-03-11,129.95,-0.51,-0.39,140.52,-7.52,True,1,6576,-129.95,-537538.31,854551.2,317012.89
13323,1981-03-12,133.19,3.24,2.49,140.52,-5.22,True,1,6577,-133.19,-537671.5,875990.63,338319.13
13324,1981-03-13,133.11,-0.08,-0.06,140.52,-5.27,True,1,6578,-133.11,-537804.61,875597.58,337792.97
13325,1981-03-16,134.68,1.57,1.18,140.52,-4.16,True,1,6579,-134.68,-537939.29,886059.72,348120.43
13326,1981-03-17,133.92,-0.76,-0.56,140.52,-4.7,True,1,6580,-133.92,-538073.21,881193.6,343120.39
13327,1981-03-18,134.22,0.3,0.22,140.52,-4.48,True,1,6581,-134.22,-538207.43,883301.82,345094.39
13328,1981-03-19,133.46,-0.76,-0.57,140.52,-5.02,True,1,6582,-133.46,-538340.89,878433.72,340092.83
13329,1981-03-20,134.08,0.62,0.46,140.52,-4.58,True,1,6583,-134.08,-538474.97,882648.64,344173.67
13330,1981-03-23,135.69,1.61,1.2,140.52,-3.44,True,1,6584,-135.69,-538610.66,893382.96,354772.3
13331,1981-03-24,134.67,-1.02,-0.75,140.52,-4.16,True,1,6585,-134.67,-538745.33,886801.95,348056.62
13332,1981-03-25,137.11,2.44,1.81,140.52,-2.43,True,1,6586,-137.11,-538882.44,903006.46,364124.02
13333,1981-03-26,136.27,-0.84,-0.61,140.52,-3.02,True,1,6587,-136.27,-539018.71,897610.49,358591.78
13334,1981-03-27,134.65,-1.62,-1.19,140.52,-4.18,True,1,6588,-134.65,-539153.36,887074.2,347920.84
13335,1981-03-30,134.28,-0.37,-0.28,140.52,-4.44,True,1,6589,-134.28,-539287.64,884770.92,345483.28
13336,1981-03-31,136.0,1.72,1.28,140.52,-3.22,True,1,6590,-136.0,-539423.64,896240.0,356816.36
13337,1981-04-01,136.57,0.57,0.42,140.52,-2.81,True,1,6591,-136.57,-539560.21,900132.87,360572.66
13338,1981-04-02,136.32,-0.25,-0.18,140.52,-2.99,True,1,6592,-136.32,-539696.53,898621.44,358924.91
13339,1981-04-03,135.49,-0.83,-0.61,140.52,-3.58,True,1,6593,-135.49,-539832.02,893285.57,353453.55
13340,1981-04-06,133.93,-1.56,-1.15,140.52,-4.69,True,1,6594,-133.93,-539965.95,883134.42,343168.47
13341,1981-04-07,133.91,-0.02,-0.02,140.52,-4.7,True,1,6595,-133.91,-540099.86,883136.45,343036.59
13342,1981-04-08,134.31,0.4,0.3,140.52,-4.42,True,1,6596,-134.31,-540234.17,885908.76,345674.59
13343,1981-04-09,134.67,0.36,0.27,140.52,-4.16,True,1,6597,-134.67,-540368.84,888417.99,348049.15
13344,1981-04-10,134.51,-0.16,-0.12,140.52,-4.28,True,1,6598,-134.51,-540503.35,887496.98,346993.63
13345,1981-04-13,133.15,-1.36,-1.01,140.52,-5.24,True,1,6599,-133.15,-540636.5,878656.85,338020.35
13346,1981-04-14,132.68,-0.47,-0.35,140.52,-5.58,True,1,6600,-132.68,-540769.18,875688.0,334918.82
13347,1981-04-15,134.17,1.49,1.12,140.52,-4.52,True,1,6601,-134.17,-540903.35,885656.17,344752.82
13348,1981-04-16,134.7,0.53,0.4,140.52,-4.14,True,1,6602,-134.7,-541038.05,889289.4,348251.35
13349,1981-04-20,135.45,0.75,0.56,140.52,-3.61,True,1,6603,-135.45,-541173.5,894376.35,353202.85
13350,1981-04-21,134.23,-1.22,-0.9,140.52,-4.48,True,1,6604,-134.23,-541307.73,886454.92,345147.19
13351,1981-04-22,134.14,-0.09,-0.07,140.52,-4.54,True,1,6605,-134.14,-541441.87,885994.7,344552.83
13352,1981-04-23,133.94,-0.2,-0.15,140.52,-4.68,True,1,6606,-133.94,-541575.81,884807.64,343231.83
13353,1981-04-24,135.14,1.2,0.9,140.52,-3.83,True,1,6607,-135.14,-541710.95,892869.98,351159.03
13354,1981-04-27,135.48,0.34,0.25,140.52,-3.59,True,1,6608,-135.48,-541846.43,895251.84,353405.41
13355,1981-04-28,134.33,-1.15,-0.85,140.52,-4.4,True,1,6609,-134.33,-541980.76,887786.97,345806.21
13356,1981-04-29,133.05,-1.28,-0.95,140.52,-5.32,True,1,6610,-133.05,-542113.81,879460.5,337346.69
13357,1981-04-30,132.81,-0.24,-0.18,140.52,-5.49,True,1,6611,-132.81,-542246.62,878006.91,335760.29
13358,1981-05-01,132.72,-0.09,-0.07,140.52,-5.55,True,1,6612,-132.72,-542379.34,877544.64,335165.3
13359,1981-05-04,130.67,-2.05,-1.54,140.52,-7.01,True,1,6613,-130.67,-542510.01,864120.71,321610.7
13360,1981-05-05,130.32,-0.35,-0.27,140.52,-7.26,True,1,6614,-130.32,-542640.33,861936.48,319296.15
13361,1981-05-06,130.78,0.46,0.35,140.52,-6.93,True,1,6615,-130.78,-542771.11,865109.7,322338.59
13362,1981-05-07,131.67,0.89,0.68,140.52,-6.3,True,1,6616,-131.67,-542902.78,871128.72,328225.94
13363,1981-05-08,131.66,-0.01,-0.01,140.52,-6.3,True,1,6617,-131.66,-543034.44,871194.22,328159.78
13364,1981-05-11,129.71,-1.95,-1.48,140.52,-7.69,True,1,6618,-129.71,-543164.15,858420.78,315256.63
13365,1981-05-12,130.72,1.01,0.78,140.52,-6.97,True,1,6619,-130.72,-543294.87,865235.68,321940.81
13366,1981-05-13,130.55,-0.17,-0.13,140.52,-7.1,True,1,6620,-130.55,-543425.42,864241.0,320815.58
13367,1981-05-14,131.28,0.73,0.56,140.52,-6.58,True,1,6621,-131.28,-543556.7,869204.88,325648.18
13368,1981-05-15,132.17,0.89,0.68,140.52,-5.94,True,1,6622,-132.17,-543688.87,875229.74,331540.87
13369,1981-05-18,132.54,0.37,0.28,140.52,-5.68,True,1,6623,-132.54,-543821.41,877812.42,333991.01
13370,1981-05-19,132.09,-0.45,-0.34,140.52,-6.0,True,1,6624,-132.09,-543953.5,874964.16,331010.66
13371,1981-05-20,132.0,-0.09,-0.07,140.52,-6.06,True,1,6625,-132.0,-544085.5,874500.0,330414.5
13372,1981-05-21,131.75,-0.25,-0.19,140.52,-6.24,True,1,6626,-131.75,-544217.25,872975.5,328758.25
13373,1981-05-22,131.33,-0.42,-0.32,140.52,-6.54,True,1,6627,-131.33,-544348.58,870323.91,325975.33
13374,1981-05-26,132.77,1.44,1.1,140.52,-5.52,True,1,6628,-132.77,-544481.35,879999.56,335518.21
13375,1981-05-27,133.77,1.0,0.75,140.52,-4.8,True,1,6629,-133.77,-544615.12,886761.33,342146.21
13376,1981-05-28,133.45,-0.32,-0.24,140.52,-5.03,True,1,6630,-133.45,-544748.57,884773.5,340024.93
13377,1981-05-29,132.59,-0.86,-0.64,140.52,-5.64,True,1,6631,-132.59,-544881.16,879204.29,334323.13
13378,1981-06-01,132.41,-0.18,-0.14,140.52,-5.77,True,1,6632,-132.41,-545013.57,878143.12,333129.55
13379,1981-06-02,130.62,-1.79,-1.35,140.52,-7.04,True,1,6633,-130.62,-545144.19,866402.46,321258.27
13380,1981-06-03,130.71,0.09,0.07,140.52,-6.98,True,1,6634,-130.71,-545274.9,867130.14,321855.24
13381,1981-06-04,130.96,0.25,0.19,140.52,-6.8,True,1,6635,-130.96,-545405.86,868919.6,323513.74
13382,1981-06-05,132.22,1.26,0.96,140.52,-5.91,True,1,6636,-132.22,-545538.08,877411.92,331873.84
13383,1981-06-08,132.24,0.02,0.02,140.52,-5.89,True,1,6637,-132.24,-545670.32,877676.88,332006.56
13384,1981-06-09,131.97,-0.27,-0.2,140.52,-6.08,True,1,6638,-131.97,-545802.29,876016.86,330214.57
13385,1981-06-10,132.32,0.35,0.26,140.52,-5.84,True,1,6639,-132.32,-545934.61,878472.48,332537.87
13386,1981-06-11,133.75,1.43,1.08,140.52,-4.82,True,1,6640,-133.75,-546068.36,888100.0,342031.64
13387,1981-06-12,133.49,-0.26,-0.19,140.52,-5.0,True,1,6641,-133.49,-546201.85,886507.09,340305.24
13388,1981-06-15,133.61,0.12,0.09,140.52,-4.92,True,1,6642,-133.61,-546335.46,887437.62,341102.16
13389,1981-06-16,132.15,-1.46,-1.09,140.52,-5.96,True,1,6643,-132.15,-546467.61,877872.45,331404.84
13390,1981-06-17,133.32,1.17,0.88,140.52,-5.12,True,1,6644,-133.32,-546600.93,885778.08,339177.15
13391,1981-06-18,131.64,-1.68,-1.26,140.52,-6.32,True,1,6645,-131.64,-546732.57,874747.8,328015.23
13392,1981-06-19,132.27,0.63,0.48,140.52,-5.87,True,1,6646,-132.27,-546864.84,879066.42,332201.58
13393,1981-06-22,131.95,-0.32,-0.24,140.52,-6.1,True,1,6647,-131.95,-546996.79,877071.65,330074.86
13394,1981-06-23,133.35,1.4,1.06,140.52,-5.1,True,1,6648,-133.35,-547130.14,886510.8,339380.66
13395,1981-06-24,132.66,-0.69,-0.52,140.52,-5.59,True,1,6649,-132.66,-547262.8,882056.34,334793.54
13396,1981-06-25,132.81,0.15,0.11,140.52,-5.49,True,1,6650,-132.81,-547395.61,883186.5,335790.89
13397,1981-06-26,132.56,-0.25,-0.19,140.52,-5.66,True,1,6651,-132.56,-547528.17,881656.56,334128.39
13398,1981-06-29,131.89,-0.67,-0.5,140.52,-6.14,True,1,6652,-131.89,-547660.06,877332.28,329672.22
13399,1981-06-30,131.21,-0.68,-0.52,140.52,-6.62,True,1,6653,-131.21,-547791.27,872940.13,325148.86
13400,1981-07-01,129.77,-1.44,-1.1,140.52,-7.65,True,1,6654,-129.77,-547921.04,863489.58,315568.54
13401,1981-07-02,128.64,-1.13,-0.87,140.52,-8.45,True,1,6655,-128.64,-548049.68,856099.2,308049.52
13402,1981-07-06,127.37,-1.27,-0.99,140.52,-9.36,True,1,6656,-127.37,-548177.05,847774.72,299597.67
13403,1981-07-07,128.24,0.87,0.68,140.52,-8.74,True,1,6657,-128.24,-548305.29,853693.68,305388.39
13404,1981-07-08,128.32,0.08,0.06,140.52,-8.68,True,1,6658,-128.32,-548433.61,854354.56,305920.95
13405,1981-07-09,129.3,0.98,0.76,140.52,-7.98,True,1,6659,-129.3,-548562.91,861008.7,312445.79
13406,1981-07-10,129.37,0.07,0.05,140.52,-7.94,True,1,6660,-129.37,-548692.28,861604.2,312911.92
13407,1981-07-13,129.64,0.27,0.21,140.52,-7.74,True,1,6661,-129.64,-548821.92,863532.04,314710.12
13408,1981-07-14,129.65,0.01,0.01,140.52,-7.74,True,1,6662,-129.65,-548951.57,863728.3,314776.73
13409,1981-07-15,130.23,0.58,0.45,140.52,-7.32,True,1,6663,-130.23,-549081.8,867722.49,318640.69
13410,1981-07-16,130.34,0.11,0.08,140.52,-7.24,True,1,6664,-130.34,-549212.14,868585.76,319373.62
13411,1981-07-17,130.76,0.42,0.32,140.52,-6.95,True,1,6665,-130.76,-549342.9,871515.4,322172.5
13412,1981-07-20,128.72,-2.04,-1.56,140.52,-8.4,True,1,6666,-128.72,-549471.62,858047.52,308575.9
13413,1981-07-21,128.34,-0.38,-0.3,140.52,-8.67,True,1,6667,-128.34,-549599.96,855642.78,306042.82
13414,1981-07-22,127.13,-1.21,-0.94,140.52,-9.53,True,1,6668,-127.13,-549727.09,847702.84,297975.75
13415,1981-07-23,127.4,0.27,0.21,140.52,-9.34,True,1,6669,-127.4,-549854.49,849630.6,299776.11
13416,1981-07-24,128.46,1.06,0.83,140.52,-8.58,True,1,6670,-128.46,-549982.95,856828.2,306845.25
13417,1981-07-27,129.9,1.44,1.12,140.52,-7.56,True,1,6671,-129.9,-550112.85,866562.9,316450.05
13418,1981-07-28,129.14,-0.76,-0.58,140.52,-8.1,True,1,6672,-129.14,-550241.99,861622.08,311380.09
13419,1981-07-29,129.16,0.02,0.02,140.52,-8.08,True,1,6673,-129.16,-550371.15,861884.68,311513.53
13420,1981-07-30,130.01,0.85,0.66,140.52,-7.48,True,1,6674,-130.01,-550501.16,867686.74,317185.58
13421,1981-07-31,130.92,0.91,0.7,140.52,-6.83,True,1,6675,-130.92,-550632.08,873891.0,323258.92
13422,1981-08-03,130.48,-0.44,-0.34,140.52,-7.14,True,1,6676,-130.48,-550762.56,871084.48,320321.92
13423,1981-08-04,131.18,0.7,0.54,140.52,-6.65,True,1,6677,-131.18,-550893.74,875888.86,324995.12
13424,1981-08-05,132.67,1.49,1.14,140.52,-5.59,True,1,6678,-132.67,-551026.41,885970.26,334943.85
13425,1981-08-06,132.64,-0.03,-0.02,140.52,-5.61,True,1,6679,-132.64,-551159.05,885902.56,334743.51
13426,1981-08-07,131.75,-0.89,-0.67,140.52,-6.24,True,1,6680,-131.75,-551290.8,880090.0,328799.2
13427,1981-08-10,132.54,0.79,0.6,140.52,-5.68,True,1,6681,-132.54,-551423.34,885499.74,334076.4
13428,1981-08-11,133.85,1.31,0.99,140.52,-4.75,True,1,6682,-133.85,-551557.19,894385.7,342828.51
13429,1981-08-12,133.4,-0.45,-0.34,140.52,-5.07,True,1,6683,-133.4,-551690.59,891512.2,339821.61
13430,1981-08-13,133.51,0.11,0.08,140.52,-4.99,True,1,6684,-133.51,-551824.1,892380.84,340556.74
13431,1981-08-14,132.49,-1.02,-0.76,140.52,-5.71,True,1,6685,-132.49,-551956.59,885695.65,333739.06
13432,1981-08-17,131.22,-1.27,-0.96,140.52,-6.62,True,1,6686,-131.22,-552087.81,877336.92,325249.11
13433,1981-08-18,130.11,-1.11,-0.85,140.52,-7.41,True,1,6687,-130.11,-552217.92,870045.57,317827.65
13434,1981-08-19,130.49,0.38,0.29,140.52,-7.14,True,1,6688,-130.49,-552348.41,872717.12,320368.71
13435,1981-08-20,130.69,0.2,0.15,140.52,-7.0,True,1,6689,-130.69,-552479.1,874185.41,321706.31
13436,1981-08-21,129.23,-1.46,-1.12,140.52,-8.03,True,1,6690,-129.23,-552608.33,864548.7,311940.37
13437,1981-08-24,125.5,-3.73,-2.89,140.52,-10.69,True,1,6691,-125.5,-552733.83,839720.5,286986.67
13438,1981-08-25,125.13,-0.37,-0.3,140.52,-10.95,True,1,6692,-125.13,-552858.96,837369.96,284511.0
13439,1981-08-26,124.96,-0.17,-0.14,140.52,-11.07,True,1,6693,-124.96,-552983.92,836357.28,283373.36
13440,1981-08-27,123.51,-1.45,-1.16,140.52,-12.1,True,1,6694,-123.51,-553107.43,826775.94,273668.51
13441,1981-08-28,124.08,0.57,0.46,140.52,-11.7,True,1,6695,-124.08,-553231.51,830715.6,277484.09
13442,1981-08-31,122.79,-1.29,-1.04,140.52,-12.62,True,1,6696,-122.79,-553354.3,822201.84,268847.54
13443,1981-09-01,123.02,0.23,0.19,140.52,-12.45,True,1,6697,-123.02,-553477.32,823864.94,270387.62
13444,1981-09-02,123.49,0.47,0.38,140.52,-12.12,True,1,6698,-123.49,-553600.81,827136.02,273535.21
13445,1981-09-03,121.24,-2.25,-1.82,140.52,-13.72,True,1,6699,-121.24,-553722.05,812186.76,258464.71
13446,1981-09-04,120.07,-1.17,-0.96,140.52,-14.55,True,1,6700,-120.07,-553842.12,804469.0,250626.88
13447,1981-09-08,117.98,-2.09,-1.74,140.52,-16.04,True,1,6701,-117.98,-553960.1,790583.98,236623.88
13448,1981-09-09,118.4,0.42,0.36,140.52,-15.74,True,1,6702,-118.4,-554078.5,793516.8,239438.3
13449,1981-09-10,120.14,1.74,1.47,140.52,-14.5,True,1,6703,-120.14,-554198.64,805298.42,251099.78
13450,1981-09-11,121.61,1.47,1.22,140.52,-13.46,True,1,6704,-121.61,-554320.25,815273.44,260953.19
13451,1981-09-14,120.66,-0.95,-0.78,140.52,-14.13,True,1,6705,-120.66,-554440.91,809025.3,254584.39
13452,1981-09-15,119.77,-0.89,-0.74,140.52,-14.77,True,1,6706,-119.77,-554560.68,803177.62,248616.94
13453,1981-09-16,118.87,-0.9,-0.75,140.52,-15.41,True,1,6707,-118.87,-554679.55,797261.09,242581.54
13454,1981-09-17,117.15,-1.72,-1.45,140.52,-16.63,True,1,6708,-117.15,-554796.7,785842.2,231045.5
13455,1981-09-18,116.26,-0.89,-0.76,140.52,-17.26,True,1,6709,-116.26,-554912.96,779988.34,225075.38
13456,1981-09-21,117.24,0.98,0.84,140.52,-16.57,True,1,6710,-117.24,-555030.2,786680.4,231650.2
13457,1981-09-22,116.68,-0.56,-0.48,140.52,-16.97,True,1,6711,-116.68,-555146.88,783039.48,227892.6
13458,1981-09-23,115.65,-1.03,-0.88,140.52,-17.7,True,1,6712,-115.65,-555262.53,776242.8,220980.27
13459,1981-09-24,115.01,-0.64,-0.55,140.52,-18.15,True,1,6713,-115.01,-555377.54,772062.13,216684.59
13460,1981-09-25,112.77,-2.24,-1.95,140.52,-19.75,True,1,6714,-112.77,-555490.31,757137.78,201647.47
13461,1981-09-28,115.53,2.76,2.45,140.52,-17.78,True,1,6715,-115.53,-555605.84,775783.95,220178.11
13462,1981-09-29,115.94,0.41,0.36,140.52,-17.49,True,1,6716,-115.94,-555721.78,778653.04,222931.26
13463,1981-09-30,116.18,0.24,0.21,140.52,-17.32,True,1,6717,-116.18,-555837.96,780381.06,224543.1
13464,1981-10-01,117.08,0.9,0.78,140.52,-16.68,True,1,6718,-117.08,-555955.04,786543.44,230588.4
13465,1981-10-02,119.36,2.28,1.95,140.52,-15.06,True,1,6719,-119.36,-556074.4,801979.84,245905.44
13466,1981-10-05,119.51,0.15,0.13,140.52,-14.95,True,1,6720,-119.51,-556193.91,803107.2,246913.29
13467,1981-10-06,119.39,-0.12,-0.1,140.52,-15.04,True,1,6721,-119.39,-556313.3,802420.19,246106.89
13468,1981-10-07,121.31,1.92,1.61,140.52,-13.67,True,1,6722,-121.31,-556434.61,815445.82,259011.21
13469,1981-10-08,122.31,1.0,0.82,140.52,-12.96,True,1,6723,-122.31,-556556.92,822290.13,265733.21
13470,1981-10-09,121.45,-0.86,-0.7,140.52,-13.57,True,1,6724,-121.45,-556678.37,816629.8,259951.43
13471,1981-10-12,121.21,-0.24,-0.2,140.52,-13.74,True,1,6725,-121.21,-556799.58,815137.25,258337.67
13472,1981-10-13,120.78,-0.43,-0.36,140.52,-14.05,True,1,6726,-120.78,-556920.36,812366.28,255445.92
13473,1981-10-14,118.8,-1.98,-1.64,140.52,-15.46,True,1,6727,-118.8,-557039.16,799167.6,242128.44
13474,1981-10-15,119.71,0.91,0.77,140.52,-14.81,True,1,6728,-119.71,-557158.87,805408.88,248250.01
13475,1981-10-16,119.19,-0.52,-0.43,140.52,-15.18,True,1,6729,-119.19,-557278.06,802029.51,244751.45
13476,1981-10-19,118.98,-0.21,-0.18,140.52,-15.33,True,1,6730,-118.98,-557397.04,800735.4,243338.36
13477,1981-10-20,120.28,1.3,1.09,140.52,-14.4,True,1,6731,-120.28,-557517.32,809604.68,252087.36
13478,1981-10-21,120.1,-0.18,-0.15,140.52,-14.53,True,1,6732,-120.1,-557637.42,808513.2,250875.78
13479,1981-10-22,119.64,-0.46,-0.38,140.52,-14.86,True,1,6733,-119.64,-557757.06,805536.12,247779.06
13480,1981-10-23,118.6,-1.04,-0.87,140.52,-15.6,True,1,6734,-118.6,-557875.66,798652.4,240776.74
13481,1981-10-26,118.16,-0.44,-0.37,140.52,-15.91,True,1,6735,-118.16,-557993.82,795807.6,237813.78
13482,1981-10-27,119.29,1.13,0.96,140.52,-15.11,True,1,6736,-119.29,-558113.11,803537.44,245424.33
13483,1981-10-28,119.45,0.16,0.13,140.52,-14.99,True,1,6737,-119.45,-558232.56,804734.65,246502.09
13484,1981-10-29,119.06,-0.39,-0.33,140.52,-15.27,True,1,6738,-119.06,-558351.62,802226.28,243874.66
13485,1981-10-30,121.89,2.83,2.38,140.52,-13.26,True,1,6739,-121.89,-558473.51,821416.71,262943.2
13486,1981-11-02,124.2,2.31,1.9,140.52,-11.61,True,1,6740,-124.2,-558597.71,837108.0,278510.29
13487,1981-11-03,124.8,0.6,0.48,140.52,-11.19,True,1,6741,-124.8,-558722.51,841276.8,282554.29
13488,1981-11-04,124.74,-0.06,-0.05,140.52,-11.23,True,1,6742,-124.74,-558847.25,840997.08,282149.83
13489,1981-11-05,123.54,-1.2,-0.96,140.52,-12.08,True,1,6743,-123.54,-558970.79,833030.22,274059.43
13490,1981-11-06,122.67,-0.87,-0.7,140.52,-12.7,True,1,6744,-122.67,-559093.46,827286.48,268193.02
13491,1981-11-09,123.29,0.62,0.5,140.52,-12.26,True,1,6745,-123.29,-559216.75,831591.05,272374.3
13492,1981-11-10,122.7,-0.59,-0.48,140.52,-12.68,True,1,6746,-122.7,-559339.45,827734.2,268394.75
13493,1981-11-11,122.92,0.22,0.18,140.52,-12.52,True,1,6747,-122.92,-559462.37,829341.24,269878.87
13494,1981-11-12,123.19,0.27,0.22,140.52,-12.33,True,1,6748,-123.19,-559585.56,831286.12,271700.56
13495,1981-11-13,121.67,-1.52,-1.23,140.52,-13.41,True,1,6749,-121.67,-559707.23,821150.83,261443.6
13496,1981-11-16,120.24,-1.43,-1.18,140.52,-14.43,True,1,6750,-120.24,-559827.47,811620.0,251792.53
13497,1981-11-17,121.15,0.91,0.76,140.52,-13.78,True,1,6751,-121.15,-559948.62,817883.65,257935.03
13498,1981-11-18,120.26,-0.89,-0.74,140.52,-14.42,True,1,6752,-120.26,-560068.88,811995.52,251926.64
13499,1981-11-19,120.71,0.45,0.37,140.52,-14.1,True,1,6753,-120.71,-560189.59,815154.63,254965.04
13500,1981-11-20,121.71,1.0,0.83,140.52,-13.39,True,1,6754,-121.71,-560311.3,822029.34,261718.04
13501,1981-11-23,121.6,-0.11,-0.09,140.52,-13.46,True,1,6755,-121.6,-560432.9,821408.0,260975.1
13502,1981-11-24,123.51,1.91,1.57,140.52,-12.1,True,1,6756,-123.51,-560556.41,834433.56,273877.15
13503,1981-11-25,124.05,0.54,0.44,140.52,-11.72,True,1,6757,-124.05,-560680.46,838205.85,277525.39
13504,1981-11-27,125.09,1.04,0.84,140.52,-10.98,True,1,6758,-125.09,-560805.55,845358.22,284552.67
13505,1981-11-30,126.35,1.26,1.01,140.52,-10.08,True,1,6759,-126.35,-560931.9,853999.65,293067.75
13506,1981-12-01,126.1,-0.25,-0.2,140.52,-10.26,True,1,6760,-126.1,-561058.0,852436.0,291378.0
13507,1981-12-02,124.69,-1.41,-1.12,140.52,-11.26,True,1,6761,-124.69,-561182.69,843029.09,281846.4
13508,1981-12-03,125.12,0.43,0.34,140.52,-10.96,True,1,6762,-125.12,-561307.81,846061.44,284753.63
13509,1981-12-04,126.26,1.14,0.91,140.52,-10.15,True,1,6763,-126.26,-561434.07,853896.38,292462.31
13510,1981-12-07,125.19,-1.07,-0.85,140.52,-10.91,True,1,6764,-125.19,-561559.26,846785.16,285225.9
13511,1981-12-08,124.82,-0.37,-0.3,140.52,-11.17,True,1,6765,-124.82,-561684.08,844407.3,282723.22
13512,1981-12-09,125.48,0.66,0.53,140.52,-10.7,True,1,6766,-125.48,-561809.56,848997.68,287188.12
13513,1981-12-10,125.71,0.23,0.18,140.52,-10.54,True,1,6767,-125.71,-561935.27,850679.57,288744.3
13514,1981-12-11,124.93,-0.78,-0.62,140.52,-11.1,True,1,6768,-124.93,-562060.2,845526.24,283466.04
13515,1981-12-14,122.78,-2.15,-1.72,140.52,-12.62,True,1,6769,-122.78,-562182.98,831097.82,268914.84
13516,1981-12-15,122.99,0.21,0.17,140.52,-12.48,True,1,6770,-122.99,-562305.97,832642.3,270336.33
13517,1981-12-16,122.42,-0.57,-0.46,140.52,-12.88,True,1,6771,-122.42,-562428.39,828905.82,266477.43
13518,1981-12-17,123.12,0.7,0.57,140.52,-12.38,True,1,6772,-123.12,-562551.51,833768.64,271217.13
13519,1981-12-18,124.0,0.88,0.72,140.52,-11.76,True,1,6773,-124.0,-562675.51,839852.0,277176.49
13520,1981-12-21,123.34,-0.66,-0.53,140.52,-12.23,True,1,6774,-123.34,-562798.85,835505.16,272706.31
13521,1981-12-22,122.88,-0.46,-0.37,140.52,-12.55,True,1,6775,-122.88,-562921.73,832512.0,269590.27
13522,1981-12-23,122.31,-0.57,-0.46,140.52,-12.96,True,1,6776,-122.31,-563044.04,828772.56,265728.52
13523,1981-12-24,122.54,0.23,0.19,140.52,-12.8,True,1,6777,-122.54,-563166.58,830453.58,267287.0
13524,1981-12-28,122.27,-0.27,-0.22,140.52,-12.99,True,1,6778,-122.27,-563288.85,828746.06,265457.21
13525,1981-12-29,121.67,-0.6,-0.49,140.52,-13.41,True,1,6779,-121.67,-563410.52,824800.93,261390.41
13526,1981-12-30,122.3,0.63,0.52,140.52,-12.97,True,1,6780,-122.3,-563532.82,829194.0,265661.18
13527,1981-12-31,122.55,0.25,0.2,140.52,-12.79,True,1,6781,-122.55,-563655.37,831011.55,267356.18
13528,1982-01-04,122.74,0.19,0.16,140.52,-12.65,True,1,6782,-122.74,-563778.11,832422.68,268644.57
13529,1982-01-05,120.05,-2.69,-2.19,140.52,-14.57,True,1,6783,-120.05,-563898.16,814299.15,250400.99
13530,1982-01-06,119.18,-0.87,-0.72,140.52,-15.19,True,1,6784,-119.18,-564017.34,808517.12,244499.78
13531,1982-01-07,118.93,-0.25,-0.21,140.52,-15.36,True,1,6785,-118.93,-564136.27,806940.05,242803.78
13532,1982-01-08,119.55,0.62,0.52,140.52,-14.92,True,1,6786,-119.55,-564255.82,811266.3,247010.48
13533,1982-01-11,116.78,-2.77,-2.32,140.52,-16.89,True,1,6787,-116.78,-564372.6,792585.86,228213.26
13534,1982-01-12,116.3,-0.48,-0.41,140.52,-17.24,True,1,6788,-116.3,-564488.9,789444.4,224955.5
13535,1982-01-13,114.88,-1.42,-1.22,140.52,-18.25,True,1,6789,-114.88,-564603.78,779920.32,215316.54
13536,1982-01-14,115.54,0.66,0.57,140.52,-17.78,True,1,6790,-115.54,-564719.32,784516.6,219797.28
13537,1982-01-15,116.33,0.79,0.68,140.52,-17.22,True,1,6791,-116.33,-564835.65,789997.03,225161.38
13538,1982-01-18,117.22,0.89,0.76,140.52,-16.58,True,1,6792,-117.22,-564952.87,796158.24,231205.37
13539,1982-01-19,115.97,-1.25,-1.07,140.52,-17.47,True,1,6793,-115.97,-565068.84,787784.21,222715.37
13540,1982-01-20,115.27,-0.7,-0.6,140.52,-17.97,True,1,6794,-115.27,-565184.11,783144.38,217960.27
13541,1982-01-21,115.75,0.48,0.42,140.52,-17.63,True,1,6795,-115.75,-565299.86,786521.25,221221.39
13542,1982-01-22,115.38,-0.37,-0.32,140.52,-17.89,True,1,6796,-115.38,-565415.24,784122.48,218707.24
13543,1982-01-25,115.41,0.03,0.03,140.52,-17.87,True,1,6797,-115.41,-565530.65,784441.77,218911.12
13544,1982-01-26,115.19,-0.22,-0.19,140.52,-18.03,True,1,6798,-115.19,-565645.84,783061.62,217415.78
13545,1982-01-27,115.74,0.55,0.48,140.52,-17.64,True,1,6799,-115.74,-565761.58,786916.26,221154.68
13546,1982-01-28,118.92,3.18,2.75,140.52,-15.37,True,1,6800,-118.92,-565880.5,808656.0,242775.5
13547,1982-01-29,120.4,1.48,1.25,140.52,-14.32,True,1,6801,-120.4,-566000.9,818840.4,252839.5
13548,1982-02-01,117.78,-2.62,-2.18,140.52,-16.18,True,1,6802,-117.78,-566118.68,801139.56,235020.88
13549,1982-02-02,118.01,0.23,0.2,140.52,-16.02,True,1,6803,-118.01,-566236.69,802822.03,236585.34
13550,1982-02-03,116.48,-1.53,-1.3,140.52,-17.11,True,1,6804,-116.48,-566353.17,792529.92,226176.75
13551,1982-02-04,116.42,-0.06,-0.05,140.52,-17.15,True,1,6805,-116.42,-566469.59,792238.1,225768.51
13552,1982-02-05,117.26,0.84,0.72,140.52,-16.55,True,1,6806,-117.26,-566586.85,798071.56,231484.71
13553,1982-02-08,114.63,-2.63,-2.24,140.52,-18.42,True,1,6807,-114.63,-566701.48,780286.41,213584.93
13554,1982-02-09,113.68,-0.95,-0.83,140.52,-19.1,True,1,6808,-113.68,-566815.16,773933.44,207118.28
13555,1982-02-10,114.66,0.98,0.86,140.52,-18.4,True,1,6809,-114.66,-566929.82,780719.94,213790.12
13556,1982-02-11,114.43,-0.23,-0.2,140.52,-18.57,True,1,6810,-114.43,-567044.25,779268.3,212224.05
13557,1982-02-12,114.38,-0.05,-0.04,140.52,-18.6,True,1,6811,-114.38,-567158.63,779042.18,211883.55
13558,1982-02-16,114.06,-0.32,-0.28,140.52,-18.83,True,1,6812,-114.06,-567272.69,776976.72,209704.03
13559,1982-02-17,113.69,-0.37,-0.32,140.52,-19.09,True,1,6813,-113.69,-567386.38,774569.97,207183.59
13560,1982-02-18,113.82,0.13,0.11,140.52,-19.0,True,1,6814,-113.82,-567500.2,775569.48,208069.28
13561,1982-02-19,113.22,-0.6,-0.53,140.52,-19.43,True,1,6815,-113.22,-567613.42,771594.3,203980.88
13562,1982-02-22,111.59,-1.63,-1.44,140.52,-20.59,True,1,6816,-111.59,-567725.01,760597.44,192872.43
13563,1982-02-23,111.51,-0.08,-0.07,140.52,-20.64,True,1,6817,-111.51,-567836.52,760163.67,192327.15
13564,1982-02-24,113.47,1.96,1.76,140.52,-19.25,True,1,6818,-113.47,-567949.99,773638.46,205688.47
13565,1982-02-25,113.21,-0.26,-0.23,140.52,-19.43,True,1,6819,-113.21,-568063.2,771978.99,203915.79
13566,1982-02-26,113.11,-0.1,-0.09,140.52,-19.51,True,1,6820,-113.11,-568176.31,771410.2,203233.89
13567,1982-03-01,113.31,0.2,0.18,140.52,-19.36,True,1,6821,-113.31,-568289.62,772887.51,204597.89
13568,1982-03-02,112.68,-0.63,-0.56,140.52,-19.81,True,1,6822,-112.68,-568402.3,768702.96,200300.66
13569,1982-03-03,110.92,-1.76,-1.56,140.52,-21.06,True,1,6823,-110.92,-568513.22,756807.16,188293.94
13570,1982-03-04,109.88,-1.04,-0.94,140.52,-21.8,True,1,6824,-109.88,-568623.1,749821.12,181198.02
13571,1982-03-05,109.34,-0.54,-0.49,140.52,-22.19,True,1,6825,-109.34,-568732.44,746245.5,177513.06
13572,1982-03-08,107.34,-2.0,-1.83,140.52,-23.61,True,1,6826,-107.34,-568839.78,732702.84,163863.06
13573,1982-03-09,108.83,1.49,1.39,140.52,-22.55,True,1,6827,-108.83,-568948.61,742982.41,174033.8
13574,1982-03-10,109.41,0.58,0.53,140.52,-22.14,True,1,6828,-109.41,-569058.02,747051.48,177993.46
13575,1982-03-11,109.36,-0.05,-0.05,140.52,-22.18,True,1,6829,-109.36,-569167.38,746819.44,177652.06
13576,1982-03-12,108.61,-0.75,-0.69,140.52,-22.71,True,1,6830,-108.61,-569275.99,741806.3,172530.31
13577,1982-03-15,109.45,0.84,0.77,140.52,-22.11,True,1,6831,-109.45,-569385.44,747652.95,178267.51
13578,1982-03-16,109.28,-0.17,-0.16,140.52,-22.23,True,1,6832,-109.28,-569494.72,746600.96,177106.24
13579,1982-03-17,109.08,-0.2,-0.18,140.52,-22.37,True,1,6833,-109.08,-569603.8,745343.64,175739.84
13580,1982-03-18,110.3,1.22,1.12,140.52,-21.51,True,1,6834,-110.3,-569714.1,753790.2,184076.1
13581,1982-03-19,110.61,0.31,0.28,140.52,-21.28,True,1,6835,-110.61,-569824.71,756019.35,186194.64
13582,1982-03-22,112.77,2.16,1.95,140.52,-19.75,True,1,6836,-112.77,-569937.48,770895.72,200958.24
13583,1982-03-23,113.55,0.78,0.69,140.52,-19.19,True,1,6837,-113.55,-570051.03,776341.35,206290.32
13584,1982-03-24,112.97,-0.58,-0.51,140.52,-19.61,True,1,6838,-112.97,-570164.0,772488.86,202324.86
13585,1982-03-25,113.21,0.24,0.21,140.52,-19.43,True,1,6839,-113.21,-570277.21,774243.19,203965.98
13586,1982-03-26,111.94,-1.27,-1.12,140.52,-20.34,True,1,6840,-111.94,-570389.15,765669.6,195280.45
13587,1982-03-29,112.3,0.36,0.32,140.52,-20.08,True,1,6841,-112.3,-570501.45,768244.3,197742.85
13588,1982-03-30,112.27,-0.03,-0.03,140.52,-20.1,True,1,6842,-112.27,-570613.72,768151.34,197537.62
13589,1982-03-31,111.96,-0.31,-0.28,140.52,-20.32,True,1,6843,-111.96,-570725.68,766142.28,195416.6
13590,1982-04-01,113.79,1.83,1.64,140.52,-19.02,True,1,6844,-113.79,-570839.47,778778.76,207939.29
13591,1982-04-02,115.12,1.33,1.17,140.52,-18.08,True,1,6845,-115.12,-570954.59,787996.4,217041.81
13592,1982-04-05,114.73,-0.39,-0.34,140.52,-18.35,True,1,6846,-114.73,-571069.32,785441.58,214372.26
13593,1982-04-06,115.36,0.63,0.55,140.52,-17.9,True,1,6847,-115.36,-571184.68,789869.92,218685.24
13594,1982-04-07,115.46,0.1,0.09,140.52,-17.83,True,1,6848,-115.46,-571300.14,790670.08,219369.94
13595,1982-04-08,116.22,0.76,0.66,140.52,-17.29,True,1,6849,-116.22,-571416.36,795990.78,224574.42
13596,1982-04-12,116.0,-0.22,-0.19,140.52,-17.45,True,1,6850,-116.0,-571532.36,794600.0,223067.64
13597,1982-04-13,115.99,-0.01,-0.01,140.52,-17.46,True,1,6851,-115.99,-571648.35,794647.49,222999.14
13598,1982-04-14,115.83,-0.16,-0.14,140.52,-17.57,True,1,6852,-115.83,-571764.18,793667.16,221902.98
13599,1982-04-15,116.35,0.52,0.45,140.52,-17.2,True,1,6853,-116.35,-571880.53,797346.55,225466.02
13600,1982-04-16,116.81,0.46,0.4,140.52,-16.87,True,1,6854,-116.81,-571997.34,800615.74,228618.4
13601,1982-04-19,116.7,-0.11,-0.09,140.52,-16.95,True,1,6855,-116.7,-572114.04,799978.5,227864.46
13602,1982-04-20,115.44,-1.26,-1.08,140.52,-17.85,True,1,6856,-115.44,-572229.48,791456.64,219227.16
13603,1982-04-21,115.72,0.28,0.24,140.52,-17.65,True,1,6857,-115.72,-572345.2,793492.04,221146.84
13604,1982-04-22,117.19,1.47,1.27,140.52,-16.6,True,1,6858,-117.19,-572462.39,803689.02,231226.63
13605,1982-04-23,118.64,1.45,1.24,140.52,-15.57,True,1,6859,-118.64,-572581.03,813751.76,241170.73
13606,1982-04-26,119.26,0.62,0.52,140.52,-15.13,True,1,6860,-119.26,-572700.29,818123.6,245423.31
13607,1982-04-27,118.0,-1.26,-1.06,140.52,-16.03,True,1,6861,-118.0,-572818.29,809598.0,236779.71
13608,1982-04-28,117.26,-0.74,-0.63,140.52,-16.55,True,1,6862,-117.26,-572935.55,804638.12,231702.57
13609,1982-04-29,116.14,-1.12,-0.96,140.52,-17.35,True,1,6863,-116.14,-573051.69,797068.82,224017.13
13610,1982-04-30,116.44,0.3,0.26,140.52,-17.14,True,1,6864,-116.44,-573168.13,799244.16,226076.03
13611,1982-05-03,116.82,0.38,0.33,140.52,-16.87,True,1,6865,-116.82,-573284.95,801969.3,228684.35
13612,1982-05-04,117.46,0.64,0.55,140.52,-16.41,True,1,6866,-117.46,-573402.41,806480.36,233077.95
13613,1982-05-05,117.67,0.21,0.18,140.52,-16.26,True,1,6867,-117.67,-573520.08,808039.89,234519.81
13614,1982-05-06,118.68,1.01,0.86,140.52,-15.54,True,1,6868,-118.68,-573638.76,815094.24,241455.48
13615,1982-05-07,119.47,0.79,0.67,140.52,-14.98,True,1,6869,-119.47,-573758.23,820639.43,246881.2
13616,1982-05-10,118.38,-1.09,-0.91,140.52,-15.76,True,1,6870,-118.38,-573876.61,813270.6,239393.99
13617,1982-05-11,119.42,1.04,0.88,140.52,-15.02,True,1,6871,-119.42,-573996.03,820534.82,246538.79
13618,1982-05-12,119.17,-0.25,-0.21,140.52,-15.19,True,1,6872,-119.17,-574115.2,818936.24,244821.04
13619,1982-05-13,118.22,-0.95,-0.8,140.52,-15.87,True,1,6873,-118.22,-574233.42,812526.06,238292.64
13620,1982-05-14,118.01,-0.21,-0.18,140.52,-16.02,True,1,6874,-118.01,-574351.43,811200.74,236849.31
13621,1982-05-17,116.71,-1.3,-1.1,140.52,-16.94,True,1,6875,-116.71,-574468.14,802381.25,227913.11
13622,1982-05-18,115.84,-0.87,-0.74,140.52,-17.56,True,1,6876,-115.84,-574583.98,796515.84,221931.86
13623,1982-05-19,114.89,-0.95,-0.82,140.52,-18.24,True,1,6877,-114.89,-574698.87,790098.53,215399.66
13624,1982-05-20,114.59,-0.3,-0.26,140.52,-18.45,True,1,6878,-114.59,-574813.46,788150.02,213336.56
13625,1982-05-21,114.89,0.3,0.26,140.52,-18.24,True,1,6879,-114.89,-574928.35,790328.31,215399.96
13626,1982-05-24,114.79,-0.1,-0.09,140.52,-18.31,True,1,6880,-114.79,-575043.14,789755.2,214712.06
13627,1982-05-25,114.4,-0.39,-0.34,140.52,-18.59,True,1,6881,-114.4,-575157.54,787186.4,212028.86
13628,1982-05-26,113.11,-1.29,-1.13,140.52,-19.51,True,1,6882,-113.11,-575270.65,778423.02,203152.37
13629,1982-05-27,112.66,-0.45,-0.4,140.52,-19.83,True,1,6883,-112.66,-575383.31,775438.78,200055.47
13630,1982-05-28,111.88,-0.78,-0.69,140.52,-20.38,True,1,6884,-111.88,-575495.19,770181.92,194686.73
13631,1982-06-01,111.68,-0.2,-0.18,140.52,-20.52,True,1,6885,-111.68,-575606.87,768916.8,193309.93
13632,1982-06-02,112.04,0.36,0.32,140.52,-20.27,True,1,6886,-112.04,-575718.91,771507.44,195788.53
13633,1982-06-03,111.86,-0.18,-0.16,140.52,-20.4,True,1,6887,-111.86,-575830.77,770379.82,194549.05
13634,1982-06-04,110.09,-1.77,-1.58,140.52,-21.66,True,1,6888,-110.09,-575940.86,758299.92,182359.06
13635,1982-06-07,110.12,0.03,0.03,140.52,-21.63,True,1,6889,-110.12,-576050.98,758616.68,182565.7
13636,1982-06-08,109.63,-0.49,-0.44,140.52,-21.98,True,1,6890,-109.63,-576160.61,755350.7,179190.09
13637,1982-06-09,108.99,-0.64,-0.58,140.52,-22.44,True,1,6891,-108.99,-576269.6,751050.09,174780.49
13638,1982-06-10,109.61,0.62,0.57,140.52,-22.0,True,1,6892,-109.61,-576379.21,755432.12,179052.91
13639,1982-06-11,111.24,1.63,1.49,140.52,-20.84,True,1,6893,-111.24,-576490.45,766777.32,190286.87
13640,1982-06-14,109.96,-1.28,-1.15,140.52,-21.75,True,1,6894,-109.96,-576600.41,758064.24,181463.83
13641,1982-06-15,109.69,-0.27,-0.25,140.52,-21.94,True,1,6895,-109.69,-576710.1,756312.55,179602.45
13642,1982-06-16,108.87,-0.82,-0.75,140.52,-22.52,True,1,6896,-108.87,-576818.97,750767.52,173948.55
13643,1982-06-17,107.6,-1.27,-1.17,140.52,-23.43,True,1,6897,-107.6,-576926.57,742117.2,165190.63
13644,1982-06-18,107.28,-0.32,-0.3,140.52,-23.66,True,1,6898,-107.28,-577033.85,740017.44,162983.59
13645,1982-06-21,107.2,-0.08,-0.08,140.52,-23.71,True,1,6899,-107.2,-577141.05,739572.8,162431.75
13646,1982-06-22,108.3,1.1,1.03,140.52,-22.93,True,1,6900,-108.3,-577249.35,747270.0,170020.65
13647,1982-06-23,110.14,1.84,1.7,140.52,-21.62,True,1,6901,-110.14,-577359.49,760076.14,182716.65
13648,1982-06-24,109.83,-0.31,-0.28,140.52,-21.84,True,1,6902,-109.83,-577469.32,758046.66,180577.34
13649,1982-06-25,109.14,-0.69,-0.63,140.52,-22.33,True,1,6903,-109.14,-577578.46,753393.42,175814.96
13650,1982-06-28,110.26,1.12,1.03,140.52,-21.53,True,1,6904,-110.26,-577688.72,761235.04,183546.32
13651,1982-06-29,110.21,-0.05,-0.04,140.52,-21.57,True,1,6905,-110.21,-577798.93,761000.05,183201.12
13652,1982-06-30,109.61,-0.6,-0.54,140.52,-22.0,True,1,6906,-109.61,-577908.54,756966.66,179058.12
13653,1982-07-01,108.71,-0.9,-0.82,140.52,-22.64,True,1,6907,-108.71,-578017.25,750859.97,172842.72
13654,1982-07-02,107.65,-1.06,-0.98,140.52,-23.39,True,1,6908,-107.65,-578124.9,743646.2,165521.3
13655,1982-07-06,107.29,-0.36,-0.33,140.52,-23.65,True,1,6909,-107.29,-578232.19,741266.61,163034.42
13656,1982-07-07,107.22,-0.07,-0.06,140.52,-23.7,True,1,6910,-107.22,-578339.41,740890.2,162550.79
13657,1982-07-08,107.53,0.31,0.29,140.52,-23.48,True,1,6911,-107.53,-578446.94,743139.83,164692.89
13658,1982-07-09,108.83,1.3,1.21,140.52,-22.55,True,1,6912,-108.83,-578555.77,752232.96,173677.19
13659,1982-07-12,109.57,0.74,0.68,140.52,-22.02,True,1,6913,-109.57,-578665.34,757457.41,178792.07
13660,1982-07-13,109.45,-0.12,-0.11,140.52,-22.11,True,1,6914,-109.45,-578774.79,756737.3,177962.51
13661,1982-07-14,110.44,0.99,0.9,140.52,-21.41,True,1,6915,-110.44,-578885.23,763692.6,184807.37
13662,1982-07-15,110.47,0.03,0.03,140.52,-21.38,True,1,6916,-110.47,-578995.7,764010.52,185014.82
13663,1982-07-16,111.07,0.6,0.54,140.52,-20.96,True,1,6917,-111.07,-579106.77,768271.19,189164.42
13664,1982-07-19,110.73,-0.34,-0.31,140.52,-21.2,True,1,6918,-110.73,-579217.5,766030.14,186812.64
13665,1982-07-20,111.54,0.81,0.73,140.52,-20.62,True,1,6919,-111.54,-579329.04,771745.26,192416.22
13666,1982-07-21,111.42,-0.12,-0.11,140.52,-20.71,True,1,6920,-111.42,-579440.46,771026.4,191585.94
13667,1982-07-22,111.48,0.06,0.05,140.52,-20.67,True,1,6921,-111.48,-579551.94,771553.08,192001.14
13668,1982-07-23,111.17,-0.31,-0.28,140.52,-20.89,True,1,6922,-111.17,-579663.11,769518.74,189855.63
13669,1982-07-26,110.36,-0.81,-0.73,140.52,-21.46,True,1,6923,-110.36,-579773.47,764022.28,184248.81
13670,1982-07-27,109.43,-0.93,-0.84,140.52,-22.12,True,1,6924,-109.43,-579882.9,757693.32,177810.42
13671,1982-07-28,107.74,-1.69,-1.54,140.52,-23.33,True,1,6925,-107.74,-579990.64,746099.5,166108.86
13672,1982-07-29,107.72,-0.02,-0.02,140.52,-23.34,True,1,6926,-107.72,-580098.36,746068.72,165970.36
13673,1982-07-30,107.09,-0.63,-0.58,140.52,-23.79,True,1,6927,-107.09,-580205.45,741812.43,161606.98
13674,1982-08-02,108.98,1.89,1.76,140.52,-22.44,True,1,6928,-108.98,-580314.43,755013.44,174699.01
13675,1982-08-03,107.83,-1.15,-1.06,140.52,-23.26,True,1,6929,-107.83,-580422.26,747154.07,166731.81
13676,1982-08-04,106.14,-1.69,-1.57,140.52,-24.47,True,1,6930,-106.14,-580528.4,735550.2,155021.8
13677,1982-08-05,105.16,-0.98,-0.92,140.52,-25.16,True,1,6931,-105.16,-580633.56,728863.96,148230.4
13678,1982-08-06,103.71,-1.45,-1.38,140.52,-26.2,True,1,6932,-103.71,-580737.27,718917.72,138180.45
13679,1982-08-09,103.08,-0.63,-0.61,140.52,-26.64,True,1,6933,-103.08,-580840.35,714653.64,133813.29
13680,1982-08-10,102.84,-0.24,-0.23,140.52,-26.82,True,1,6934,-102.84,-580943.19,713092.56,132149.37
13681,1982-08-11,102.6,-0.24,-0.23,140.52,-26.98,True,1,6935,-102.6,-581045.79,711531.0,130485.21
13682,1982-08-12,102.42,-0.18,-0.18,140.52,-27.11,True,1,6936,-102.42,-581148.21,710385.12,129236.91
13683,1982-08-13,103.85,1.43,1.4,140.52,-26.1,True,1,6937,-103.85,-581252.06,720407.45,139155.39
13684,1982-08-16,104.09,0.24,0.23,140.52,-25.92,True,1,6938,-104.09,-581356.15,722176.42,140820.27
13685,1982-08-17,109.04,4.95,4.76,140.52,-22.4,True,1,6939,-109.04,-581465.19,756628.56,175163.37
13686,1982-08-18,108.54,-0.5,-0.46,140.52,-22.76,True,1,6940,-108.54,-581573.73,753267.6,171693.87
13687,1982-08-19,109.16,0.62,0.57,140.52,-22.32,True,1,6941,-109.16,-581682.89,757679.56,175996.67
13688,1982-08-20,113.02,3.86,3.54,140.52,-19.57,True,1,6942,-113.02,-581795.91,784584.84,202788.93
13689,1982-08-23,116.11,3.09,2.73,140.52,-17.37,True,1,6943,-116.11,-581912.02,806151.73,224239.71
13690,1982-08-24,115.35,-0.76,-0.66,140.52,-17.91,True,1,6944,-115.35,-582027.37,800990.4,218963.03
13691,1982-08-25,117.58,2.23,1.93,140.52,-16.32,True,1,6945,-117.58,-582144.95,816593.1,234448.15
13692,1982-08-26,118.55,0.97,0.82,140.52,-15.64,True,1,6946,-118.55,-582263.5,823448.3,241184.8
13693,1982-08-27,117.11,-1.44,-1.22,140.52,-16.66,True,1,6947,-117.11,-582380.61,813563.17,231182.56
13694,1982-08-30,117.66,0.55,0.47,140.52,-16.27,True,1,6948,-117.66,-582498.27,817501.68,235003.41
13695,1982-08-31,119.51,1.85,1.57,140.52,-14.95,True,1,6949,-119.51,-582617.78,830474.99,247857.21
13696,1982-09-01,118.25,-1.26,-1.05,140.52,-15.85,True,1,6950,-118.25,-582736.03,821837.5,239101.47
13697,1982-09-02,120.29,2.04,1.72,140.52,-14.4,True,1,6951,-120.29,-582856.32,836135.79,253279.47
13698,1982-09-03,122.68,2.39,1.99,140.52,-12.7,True,1,6952,-122.68,-582979.0,852871.36,269892.36
13699,1982-09-07,121.37,-1.31,-1.07,140.52,-13.63,True,1,6953,-121.37,-583100.37,843885.61,260785.24
13700,1982-09-08,122.2,0.83,0.68,140.52,-13.04,True,1,6954,-122.2,-583222.57,849778.8,266556.23
13701,1982-09-09,121.97,-0.23,-0.19,140.52,-13.2,True,1,6955,-121.97,-583344.54,848301.35,264956.81
13702,1982-09-10,120.97,-1.0,-0.82,140.52,-13.91,True,1,6956,-120.97,-583465.51,841467.32,258001.81
13703,1982-09-13,122.24,1.27,1.05,140.52,-13.01,True,1,6957,-122.24,-583587.75,850423.68,266835.93
13704,1982-09-14,123.1,0.86,0.7,140.52,-12.4,True,1,6958,-123.1,-583710.85,856529.8,272818.95
13705,1982-09-15,124.29,1.19,0.97,140.52,-11.55,True,1,6959,-124.29,-583835.14,864934.11,281098.97
13706,1982-09-16,123.77,-0.52,-0.42,140.52,-11.92,True,1,6960,-123.77,-583958.91,861439.2,277480.29
13707,1982-09-17,122.55,-1.22,-0.99,140.52,-12.79,True,1,6961,-122.55,-584081.46,853070.55,268989.09
13708,1982-09-20,122.51,-0.04,-0.03,140.52,-12.82,True,1,6962,-122.51,-584203.97,852914.62,268710.65
13709,1982-09-21,124.88,2.37,1.94,140.52,-11.13,True,1,6963,-124.88,-584328.85,869539.44,285210.59
13710,1982-09-22,123.99,-0.89,-0.71,140.52,-11.76,True,1,6964,-123.99,-584452.84,863466.36,279013.52
13711,1982-09-23,123.81,-0.18,-0.14,140.52,-11.89,True,1,6965,-123.81,-584576.65,862336.65,277760.0
13712,1982-09-24,123.32,-0.49,-0.4,140.52,-12.24,True,1,6966,-123.32,-584699.97,859047.12,274347.15
13713,1982-09-27,123.62,0.3,0.24,140.52,-12.03,True,1,6967,-123.62,-584823.59,861260.54,276436.95
13714,1982-09-28,123.24,-0.38,-0.31,140.52,-12.3,True,1,6968,-123.24,-584946.83,858736.32,273789.49
13715,1982-09-29,121.63,-1.61,-1.31,140.52,-13.44,True,1,6969,-121.63,-585068.46,847639.47,262571.01
13716,1982-09-30,120.42,-1.21,-1.0,140.52,-14.3,True,1,6970,-120.42,-585188.88,839327.4,254138.52
13717,1982-10-01,121.97,1.55,1.29,140.52,-13.2,True,1,6971,-121.97,-585310.85,850252.87,264942.02
13718,1982-10-04,121.51,-0.46,-0.38,140.52,-13.53,True,1,6972,-121.51,-585432.36,847167.72,261735.36
13719,1982-10-05,121.98,0.47,0.39,140.52,-13.19,True,1,6973,-121.98,-585554.34,850566.54,265012.2
13720,1982-10-06,125.97,3.99,3.27,140.52,-10.35,True,1,6974,-125.97,-585680.31,878514.78,292834.47
13721,1982-10-07,128.8,2.83,2.25,140.52,-8.34,True,1,6975,-128.8,-585809.11,898380.0,312570.89
13722,1982-10-08,131.05,2.25,1.75,140.52,-6.74,True,1,6976,-131.05,-585940.16,914204.8,328264.64
13723,1982-10-11,134.47,3.42,2.61,140.52,-4.3,True,1,6977,-134.47,-586074.63,938197.19,352122.56
13724,1982-10-12,134.44,-0.03,-0.02,140.52,-4.33,True,1,6978,-134.44,-586209.07,938122.32,351913.25
13725,1982-10-13,136.71,2.27,1.69,140.52,-2.71,True,1,6979,-136.71,-586345.78,954099.09,367753.31
13726,1982-10-14,134.57,-2.14,-1.56,140.52,-4.23,True,1,6980,-134.57,-586480.35,939298.6,352818.25
13727,1982-10-15,133.57,-1.0,-0.74,140.52,-4.95,True,1,6981,-133.57,-586613.92,932452.17,345838.25
13728,1982-10-18,136.73,3.16,2.37,140.52,-2.7,True,1,6982,-136.73,-586750.65,954648.86,367898.21
13729,1982-10-19,136.58,-0.15,-0.11,140.52,-2.8,True,1,6983,-136.58,-586887.23,953738.14,366850.91
13730,1982-10-20,139.23,2.65,1.94,140.52,-0.92,True,1,6984,-139.23,-587026.46,972382.32,385355.86
13731,1982-10-21,139.06,-0.17,-0.12,140.52,-1.04,True,1,6985,-139.06,-587165.52,971334.1,384168.58
13732,1982-10-22,138.83,-0.23,-0.16,140.52,-1.2,True,1,6986,-138.83,-587304.35,969866.38,382562.03
13733,1982-10-25,133.32,-5.51,-3.97,140.52,-5.12,True,1,6987,-133.32,-587437.67,931506.84,344069.17
13734,1982-10-26,134.48,1.16,0.87,140.52,-4.3,True,1,6988,-134.48,-587572.15,939746.24,352174.09
13735,1982-10-27,135.29,0.81,0.6,140.52,-3.72,True,1,6989,-135.29,-587707.44,945541.81,357834.37
13736,1982-10-28,133.59,-1.7,-1.26,140.52,-4.93,True,1,6990,-133.59,-587841.03,933794.1,345953.07
13737,1982-10-29,133.72,0.13,0.1,140.52,-4.84,True,1,6991,-133.72,-587974.75,934836.52,346861.77
13738,1982-11-01,135.47,1.75,1.31,140.52,-3.59,True,1,6992,-135.47,-588110.22,947206.24,359096.02
13739,1982-11-02,137.49,2.02,1.49,140.52,-2.16,True,1,6993,-137.49,-588247.71,961467.57,373219.86
13740,1982-11-03,142.87,5.38,3.91,142.87,0.0,True,1,6994,-142.87,-588390.58,999232.78,410842.2
13741,1982-11-04,141.85,-1.02,-0.71,142.87,-0.71,True,1,6995,-141.85,-588532.43,992240.75,403708.32
13742,1982-11-05,142.16,0.31,0.22,142.87,-0.5,True,1,6996,-142.16,-588674.59,994551.36,405876.77
13743,1982-11-08,140.44,-1.72,-1.21,142.87,-1.7,True,1,6997,-140.44,-588815.03,982658.68,393843.65
13744,1982-11-09,143.02,2.58,1.84,143.02,0.0,True,1,6998,-143.02,-588958.05,1000853.96,411895.91
13745,1982-11-10,141.16,-1.86,-1.3,143.02,-1.3,True,1,6999,-141.16,-589099.21,987978.84,398879.63
13746,1982-11-11,141.75,0.59,0.42,143.02,-0.89,True,1,7000,-141.75,-589240.96,992250.0,403009.04
13747,1982-11-12,139.53,-2.22,-1.57,143.02,-2.44,True,1,7001,-139.53,-589380.49,976849.53,387469.04
13748,1982-11-15,137.03,-2.5,-1.79,143.02,-4.19,True,1,7002,-137.03,-589517.52,959484.06,369966.54
13749,1982-11-16,135.42,-1.61,-1.18,143.02,-5.31,True,1,7003,-135.42,-589652.94,948346.26,358693.32
13750,1982-11-17,137.93,2.51,1.85,143.02,-3.56,True,1,7004,-137.93,-589790.87,966061.72,376270.85
13751,1982-11-18,138.34,0.41,0.3,143.02,-3.27,True,1,7005,-138.34,-589929.21,969071.7,379142.49
13752,1982-11-19,137.02,-1.32,-0.95,143.02,-4.2,True,1,7006,-137.02,-590066.23,959962.12,369895.89
13753,1982-11-22,134.22,-2.8,-2.04,143.02,-6.15,True,1,7007,-134.22,-590200.45,940479.54,350279.09
13754,1982-11-23,132.93,-1.29,-0.96,143.02,-7.06,True,1,7008,-132.93,-590333.38,931573.44,341240.06
13755,1982-11-24,133.88,0.95,0.72,143.02,-6.39,True,1,7009,-133.88,-590467.26,938364.92,347897.66
13756,1982-11-26,134.88,1.0,0.75,143.02,-5.69,True,1,7010,-134.88,-590602.14,945508.8,354906.66
13757,1982-11-29,134.2,-0.68,-0.5,143.02,-6.17,True,1,7011,-134.2,-590736.34,940876.2,350139.86
13758,1982-11-30,138.53,4.33,3.23,143.02,-3.14,True,1,7012,-138.53,-590874.87,971372.36,380497.49
13759,1982-12-01,138.72,0.19,0.14,143.02,-3.01,True,1,7013,-138.72,-591013.59,972843.36,381829.77
13760,1982-12-02,138.82,0.1,0.07,143.02,-2.94,True,1,7014,-138.82,-591152.41,973683.48,382531.07
13761,1982-12-03,138.69,-0.13,-0.09,143.02,-3.03,True,1,7015,-138.69,-591291.1,972910.35,381619.25
13762,1982-12-06,141.77,3.08,2.22,143.02,-0.87,True,1,7016,-141.77,-591432.87,994658.32,403225.45
13763,1982-12-07,142.72,0.95,0.67,143.02,-0.21,True,1,7017,-142.72,-591575.59,1001466.24,409890.65
13764,1982-12-08,141.82,-0.9,-0.63,143.02,-0.84,True,1,7018,-141.82,-591717.41,995292.76,403575.35
13765,1982-12-09,140.0,-1.82,-1.28,143.02,-2.11,True,1,7019,-140.0,-591857.41,982660.0,390802.59
13766,1982-12-10,139.57,-0.43,-0.31,143.02,-2.41,True,1,7020,-139.57,-591996.98,979781.4,387784.42
13767,1982-12-13,139.95,0.38,0.27,143.02,-2.15,True,1,7021,-139.95,-592136.93,982588.95,390452.02
13768,1982-12-14,137.4,-2.55,-1.82,143.02,-3.93,True,1,7022,-137.4,-592274.33,964822.8,372548.47
13769,1982-12-15,135.24,-2.16,-1.57,143.02,-5.44,True,1,7023,-135.24,-592409.57,949790.52,357380.95
13770,1982-12-16,135.3,0.06,0.04,143.02,-5.4,True,1,7024,-135.3,-592544.87,950347.2,357802.33
13771,1982-12-17,137.49,2.19,1.62,143.02,-3.87,True,1,7025,-137.49,-592682.36,965867.25,373184.89
13772,1982-12-20,136.25,-1.24,-0.9,143.02,-4.73,True,1,7026,-136.25,-592818.61,957292.5,364473.89
13773,1982-12-21,138.61,2.36,1.73,143.02,-3.08,True,1,7027,-138.61,-592957.22,974012.47,381055.25
13774,1982-12-22,138.83,0.22,0.16,143.02,-2.93,True,1,7028,-138.83,-593096.05,975697.24,382601.19
13775,1982-12-23,139.72,0.89,0.64,143.02,-2.31,True,1,7029,-139.72,-593235.77,982091.88,388856.11
13776,1982-12-27,142.17,2.45,1.75,143.02,-0.59,True,1,7030,-142.17,-593377.94,999455.1,406077.16
13777,1982-12-28,140.77,-1.4,-0.98,143.02,-1.57,True,1,7031,-140.77,-593518.71,989753.87,396235.16
13778,1982-12-29,141.24,0.47,0.33,143.02,-1.25,True,1,7032,-141.24,-593659.95,993199.68,399539.73
13779,1982-12-30,140.33,-0.91,-0.64,143.02,-1.88,True,1,7033,-140.33,-593800.28,986940.89,393140.61
13780,1982-12-31,140.64,0.31,0.22,143.02,-1.66,True,1,7034,-140.64,-593940.92,989261.76,395320.84
13781,1983-01-03,138.34,-2.3,-1.64,143.02,-3.27,True,1,7035,-138.34,-594079.26,973221.9,379142.64
13782,1983-01-04,141.36,3.02,2.18,143.02,-1.16,True,1,7036,-141.36,-594220.62,994608.96,400388.34
13783,1983-01-05,141.96,0.6,0.42,143.02,-0.74,True,1,7037,-141.96,-594362.58,998972.52,404609.94
13784,1983-01-06,145.27,3.31,2.33,145.27,0.0,True,1,7038,-145.27,-594507.85,1022410.26,427902.41
13785,1983-01-07,145.18,-0.09,-0.06,145.27,-0.06,True,1,7039,-145.18,-594653.03,1021922.02,427268.99
13786,1983-01-10,146.78,1.6,1.1,146.78,0.0,True,1,7040,-146.78,-594799.81,1033331.2,438531.39
13787,1983-01-11,145.78,-1.0,-0.68,146.78,-0.68,True,1,7041,-145.78,-594945.59,1026436.98,431491.39
13788,1983-01-12,146.69,0.91,0.62,146.78,-0.06,True,1,7042,-146.69,-595092.28,1032990.98,437898.7
13789,1983-01-13,145.73,-0.96,-0.65,146.78,-0.72,True,1,7043,-145.73,-595238.01,1026376.39,431138.38
13790,1983-01-14,146.65,0.92,0.63,146.78,-0.09,True,1,7044,-146.65,-595384.66,1033002.6,437617.94
13791,1983-01-17,146.72,0.07,0.05,146.78,-0.04,True,1,7045,-146.72,-595531.38,1033642.4,438111.02
13792,1983-01-18,146.4,-0.32,-0.22,146.78,-0.26,True,1,7046,-146.4,-595677.78,1031534.4,435856.62
13793,1983-01-19,145.27,-1.13,-0.77,146.78,-1.03,True,1,7047,-145.27,-595823.05,1023717.69,427894.64
13794,1983-01-20,146.29,1.02,0.7,146.78,-0.33,True,1,7048,-146.29,-595969.34,1031051.92,435082.58
13795,1983-01-21,143.85,-2.44,-1.67,146.78,-2.0,True,1,7049,-143.85,-596113.19,1013998.65,417885.46
13796,1983-01-24,139.97,-3.88,-2.7,146.78,-4.64,True,1,7050,-139.97,-596253.16,986788.5,390535.34
13797,1983-01-25,141.75,1.78,1.27,146.78,-3.43,True,1,7051,-141.75,-596394.91,999479.25,403084.34
13798,1983-01-26,141.54,-0.21,-0.15,146.78,-3.57,True,1,7052,-141.54,-596536.45,998140.08,401603.63
13799,1983-01-27,144.27,2.73,1.93,146.78,-1.71,True,1,7053,-144.27,-596680.72,1017536.31,420855.59
13800,1983-01-28,144.51,0.24,0.17,146.78,-1.55,True,1,7054,-144.51,-596825.23,1019373.54,422548.31
13801,1983-01-31,145.3,0.79,0.55,146.78,-1.01,True,1,7055,-145.3,-596970.53,1025091.5,428120.97
13802,1983-02-01,142.96,-2.34,-1.61,146.78,-2.6,True,1,7056,-142.96,-597113.49,1008725.76,411612.27
13803,1983-02-02,143.23,0.27,0.19,146.78,-2.42,True,1,7057,-143.23,-597256.72,1010774.11,413517.39
13804,1983-02-03,144.26,1.03,0.72,146.78,-1.72,True,1,7058,-144.26,-597400.98,1018187.08,420786.1
13805,1983-02-04,146.14,1.88,1.3,146.78,-0.44,True,1,7059,-146.14,-597547.12,1031602.26,434055.14
13806,1983-02-07,146.93,0.79,0.54,146.93,0.0,True,1,7060,-146.93,-597694.05,1037325.8,439631.75
13807,1983-02-08,145.7,-1.23,-0.84,146.93,-0.84,True,1,7061,-145.7,-597839.75,1028787.7,430947.95
13808,1983-02-09,145.0,-0.7,-0.48,146.93,-1.31,True,1,7062,-145.0,-597984.75,1023990.0,426005.25
13809,1983-02-10,147.5,2.5,1.72,147.5,0.0,True,1,7063,-147.5,-598132.25,1041792.5,443660.25
13810,1983-02-11,147.65,0.15,0.1,147.65,0.0,True,1,7064,-147.65,-598279.9,1042999.6,444719.7
13811,1983-02-14,148.93,1.28,0.87,148.93,0.0,True,1,7065,-148.93,-598428.83,1052190.45,453761.62
13812,1983-02-15,148.3,-0.63,-0.42,148.93,-0.42,True,1,7066,-148.3,-598577.13,1047887.8,449310.67
13813,1983-02-16,147.43,-0.87,-0.59,148.93,-1.01,True,1,7067,-147.43,-598724.56,1041887.81,443163.25
13814,1983-02-17,147.44,0.01,0.01,148.93,-1.0,True,1,7068,-147.44,-598872.0,1042105.92,443233.92
13815,1983-02-18,148.0,0.56,0.38,148.93,-0.62,True,1,7069,-148.0,-599020.0,1046212.0,447192.0
13816,1983-02-22,145.48,-2.52,-1.7,148.93,-2.32,True,1,7070,-145.48,-599165.48,1028543.6,429378.12
13817,1983-02-23,146.79,1.31,0.9,148.93,-1.44,True,1,7071,-146.79,-599312.27,1037952.09,438639.82
13818,1983-02-24,149.6,2.81,1.91,149.6,0.0,True,1,7072,-149.6,-599461.87,1057971.2,458509.33
13819,1983-02-25,149.74,0.14,0.09,149.74,0.0,True,1,7073,-149.74,-599611.61,1059111.02,459499.41
13820,1983-02-28,148.06,-1.68,-1.12,149.74,-1.12,True,1,7074,-148.06,-599759.67,1047376.44,447616.77
13821,1983-03-01,150.88,2.82,1.9,150.88,0.0,True,1,7075,-150.88,-599910.55,1067476.0,467565.45
13822,1983-03-02,152.3,1.42,0.94,152.3,0.0,True,1,7076,-152.3,-600062.85,1077674.8,477611.95
13823,1983-03-03,153.48,1.18,0.78,153.48,0.0,True,1,7077,-153.48,-600216.33,1086177.96,485961.63
13824,1983-03-04,153.67,0.19,0.12,153.67,0.0,True,1,7078,-153.67,-600370.0,1087676.26,487306.26
13825,1983-03-07,153.67,0.0,0.0,153.67,0.0,True,1,7079,-153.67,-600523.67,1087829.93,487306.26
13826,1983-03-08,151.26,-2.41,-1.57,153.67,-1.57,True,1,7080,-151.26,-600674.93,1070920.8,470245.87
13827,1983-03-09,152.87,1.61,1.06,153.67,-0.52,True,1,7081,-152.87,-600827.8,1082472.47,481644.67
13828,1983-03-10,151.8,-1.07,-0.7,153.67,-1.22,True,1,7082,-151.8,-600979.6,1075047.6,474068.0
13829,1983-03-11,151.24,-0.56,-0.37,153.67,-1.58,True,1,7083,-151.24,-601130.84,1071232.92,470102.08
13830,1983-03-14,150.83,-0.41,-0.27,153.67,-1.85,True,1,7084,-150.83,-601281.67,1068479.72,467198.05
13831,1983-03-15,151.37,0.54,0.36,153.67,-1.5,True,1,7085,-151.37,-601433.04,1072456.45,471023.41
13832,1983-03-16,149.81,-1.56,-1.03,153.67,-2.51,True,1,7086,-149.81,-601582.85,1061553.66,459970.81
13833,1983-03-17,149.59,-0.22,-0.15,153.67,-2.66,True,1,7087,-149.59,-601732.44,1060144.33,458411.89
13834,1983-03-18,149.9,0.31,0.21,153.67,-2.45,True,1,7088,-149.9,-601882.34,1062491.2,460608.86
13835,1983-03-21,151.19,1.29,0.86,153.67,-1.61,True,1,7089,-151.19,-602033.53,1071785.91,469752.38
13836,1983-03-22,150.66,-0.53,-0.35,153.67,-1.96,True,1,7090,-150.66,-602184.19,1068179.4,465995.21
13837,1983-03-23,152.81,2.15,1.43,153.67,-0.56,True,1,7091,-152.81,-602337.0,1083575.71,481238.71
13838,1983-03-24,153.37,0.56,0.37,153.67,-0.2,True,1,7092,-153.37,-602490.37,1087700.04,485209.67
13839,1983-03-25,152.67,-0.7,-0.46,153.67,-0.65,True,1,7093,-152.67,-602643.04,1082888.31,480245.27
13840,1983-03-28,151.85,-0.82,-0.54,153.67,-1.18,True,1,7094,-151.85,-602794.89,1077223.9,474429.01
13841,1983-03-29,151.59,-0.26,-0.17,153.67,-1.35,True,1,7095,-151.59,-602946.48,1075531.05,472584.57
13842,1983-03-30,153.39,1.8,1.19,153.67,-0.18,True,1,7096,-153.39,-603099.87,1088455.44,485355.57
13843,1983-03-31,152.96,-0.43,-0.28,153.67,-0.46,True,1,7097,-152.96,-603252.83,1085557.12,482304.29
13844,1983-04-04,153.02,0.06,0.04,153.67,-0.42,True,1,7098,-153.02,-603405.85,1086135.96,482730.11
13845,1983-04-05,151.9,-1.12,-0.73,153.67,-1.15,True,1,7099,-151.9,-603557.75,1078338.1,474780.35
13846,1983-04-06,151.04,-0.86,-0.57,153.67,-1.71,True,1,7100,-151.04,-603708.79,1072384.0,468675.21
13847,1983-04-07,151.76,0.72,0.48,153.67,-1.24,True,1,7101,-151.76,-603860.55,1077647.76,473787.21
13848,1983-04-08,152.85,1.09,0.72,153.67,-0.53,True,1,7102,-152.85,-604013.4,1085540.7,481527.3
13849,1983-04-11,155.14,2.29,1.5,155.14,0.0,True,1,7103,-155.14,-604168.54,1101959.42,497790.88
13850,1983-04-12,155.82,0.68,0.44,155.82,0.0,True,1,7104,-155.82,-604324.36,1106945.28,502620.92
13851,1983-04-13,156.77,0.95,0.61,156.77,0.0,True,1,7105,-156.77,-604481.13,1113850.85,509369.72
13852,1983-04-14,158.12,1.35,0.86,158.12,0.0,True,1,7106,-158.12,-604639.25,1123600.72,518961.47
13853,1983-04-15,158.75,0.63,0.4,158.75,0.0,True,1,7107,-158.75,-604798.0,1128236.25,523438.25
13854,1983-04-18,159.74,0.99,0.62,159.74,0.0,True,1,7108,-159.74,-604957.74,1135431.92,530474.18
13855,1983-04-19,158.71,-1.03,-0.64,159.74,-0.64,True,1,7109,-158.71,-605116.45,1128269.39,523152.94
13856,1983-04-20,160.71,2.0,1.26,160.71,0.0,True,1,7110,-160.71,-605277.16,1142648.1,537370.94
13857,1983-04-21,160.05,-0.66,-0.41,160.71,-0.41,True,1,7111,-160.05,-605437.21,1138115.55,532678.34
13858,1983-04-22,160.42,0.37,0.23,160.71,-0.18,True,1,7112,-160.42,-605597.63,1140907.04,535309.41
13859,1983-04-25,158.81,-1.61,-1.0,160.71,-1.18,True,1,7113,-158.81,-605756.44,1129615.53,523859.09
13860,1983-04-26,161.81,3.0,1.89,161.81,0.0,True,1,7114,-161.81,-605918.25,1151116.34,545198.09
13861,1983-04-27,161.44,-0.37,-0.23,161.81,-0.23,True,1,7115,-161.44,-606079.69,1148645.6,542565.91
13862,1983-04-28,162.95,1.51,0.94,162.95,0.0,True,1,7116,-162.95,-606242.64,1159552.2,553309.56
13863,1983-04-29,164.43,1.48,0.91,164.43,0.0,True,1,7117,-164.43,-606407.07,1170248.31,563841.24
13864,1983-05-02,162.11,-2.32,-1.41,164.43,-1.41,True,1,7118,-162.11,-606569.18,1153898.98,547329.8
13865,1983-05-03,162.34,0.23,0.14,164.43,-1.27,True,1,7119,-162.34,-606731.52,1155698.46,548966.94
13866,1983-05-04,163.31,0.97,0.6,164.43,-0.68,True,1,7120,-163.31,-606894.83,1162767.2,555872.37
13867,1983-05-05,164.28,0.97,0.59,164.43,-0.09,True,1,7121,-164.28,-607059.11,1169837.88,562778.77
13868,1983-05-06,166.1,1.82,1.11,166.1,0.0,True,1,7122,-166.1,-607225.21,1182964.2,575738.99
13869,1983-05-09,165.81,-0.29,-0.18,166.1,-0.18,True,1,7123,-165.81,-607391.02,1181064.63,573673.61
13870,1983-05-10,165.95,0.14,0.08,166.1,-0.09,True,1,7124,-165.95,-607556.97,1182227.8,574670.83
13871,1983-05-11,164.96,-0.99,-0.6,166.1,-0.69,True,1,7125,-164.96,-607721.93,1175340.0,567618.07
13872,1983-05-12,164.25,-0.71,-0.43,166.1,-1.11,True,1,7126,-164.25,-607886.18,1170445.5,562559.32
13873,1983-05-13,164.91,0.66,0.4,166.1,-0.72,True,1,7127,-164.91,-608051.09,1175313.57,567262.48
13874,1983-05-16,163.4,-1.51,-0.92,166.1,-1.63,True,1,7128,-163.4,-608214.49,1164715.2,556500.71
13875,1983-05-17,163.71,0.31,0.19,166.1,-1.44,True,1,7129,-163.71,-608378.2,1167088.59,558710.39
13876,1983-05-18,163.27,-0.44,-0.27,166.1,-1.7,True,1,7130,-163.27,-608541.47,1164115.1,555573.63
13877,1983-05-19,161.99,-1.28,-0.78,166.1,-2.47,True,1,7131,-161.99,-608703.46,1155150.69,546447.23
13878,1983-05-20,162.14,0.15,0.09,166.1,-2.38,True,1,7132,-162.14,-608865.6,1156382.48,547516.88
13879,1983-05-23,163.43,1.29,0.8,166.1,-1.61,True,1,7133,-163.43,-609029.03,1165746.19,556717.16
13880,1983-05-24,165.54,2.11,1.29,166.1,-0.34,True,1,7134,-165.54,-609194.57,1180962.36,571767.79
13881,1983-05-25,166.21,0.67,0.4,166.21,0.0,True,1,7135,-166.21,-609360.78,1185908.35,576547.57
13882,1983-05-26,165.48,-0.73,-0.44,166.21,-0.44,True,1,7136,-165.48,-609526.26,1180865.28,571339.02
13883,1983-05-27,164.46,-1.02,-0.62,166.21,-1.05,True,1,7137,-164.46,-609690.72,1173751.02,564060.3
13884,1983-05-31,162.39,-2.07,-1.26,166.21,-2.3,True,1,7138,-162.39,-609853.11,1159139.82,549286.71
13885,1983-06-01,162.55,0.16,0.1,166.21,-2.2,True,1,7139,-162.55,-610015.66,1160444.45,550428.79
13886,1983-06-02,163.98,1.43,0.88,166.21,-1.34,True,1,7140,-163.98,-610179.64,1170817.2,560637.56
13887,1983-06-03,164.42,0.44,0.27,166.21,-1.08,True,1,7141,-164.42,-610344.06,1174123.22,563779.16
13888,1983-06-06,164.83,0.41,0.25,166.21,-0.83,True,1,7142,-164.83,-610508.89,1177215.86,566706.97
13889,1983-06-07,162.77,-2.06,-1.25,166.21,-2.07,True,1,7143,-162.77,-610671.66,1162666.11,551994.45
13890,1983-06-08,161.36,-1.41,-0.87,166.21,-2.92,True,1,7144,-161.36,-610833.02,1152755.84,541922.82
13891,1983-06-09,161.83,0.47,0.29,166.21,-2.64,True,1,7145,-161.83,-610994.85,1156275.35,545280.5
13892,1983-06-10,162.68,0.85,0.52,166.21,-2.12,True,1,7146,-162.68,-611157.53,1162511.28,551353.75
13893,1983-06-13,164.84,2.16,1.33,166.21,-0.82,True,1,7147,-164.84,-611322.37,1178111.48,566789.11
13894,1983-06-14,165.53,0.69,0.42,166.21,-0.41,True,1,7148,-165.53,-611487.9,1183208.44,571720.54
13895,1983-06-15,167.12,1.59,0.96,167.12,0.0,True,1,7149,-167.12,-611655.02,1194740.88,583085.86
13896,1983-06-16,169.14,2.02,1.21,169.14,0.0,True,1,7150,-169.14,-611824.16,1209351.0,597526.84
13897,1983-06-17,169.13,-0.01,-0.01,169.14,-0.01,True,1,7151,-169.13,-611993.29,1209448.63,597455.34
13898,1983-06-20,169.02,-0.11,-0.06,169.14,-0.07,True,1,7152,-169.02,-612162.31,1208831.04,596668.73
13899,1983-06-21,170.53,1.51,0.89,170.53,0.0,True,1,7153,-170.53,-612332.84,1219801.09,607468.25
13900,1983-06-22,170.99,0.46,0.27,170.99,0.0,True,1,7154,-170.99,-612503.83,1223262.46,610758.63
13901,1983-06-23,170.57,-0.42,-0.25,170.99,-0.25,True,1,7155,-170.57,-612674.4,1220428.35,607753.95
13902,1983-06-24,170.41,-0.16,-0.09,170.99,-0.34,True,1,7156,-170.41,-612844.81,1219453.96,606609.15
13903,1983-06-27,168.46,-1.95,-1.14,170.99,-1.48,True,1,7157,-168.46,-613013.27,1205668.22,592654.95
13904,1983-06-28,165.68,-2.78,-1.65,170.99,-3.1,True,1,7158,-165.68,-613178.95,1185937.44,572758.49
13905,1983-06-29,166.64,0.96,0.58,170.99,-2.54,True,1,7159,-166.64,-613345.59,1192975.76,579630.17
13906,1983-06-30,167.64,1.0,0.6,170.99,-1.96,True,1,7160,-167.64,-613513.23,1200302.4,586789.17
13907,1983-07-01,168.64,1.0,0.6,170.99,-1.37,True,1,7161,-168.64,-613681.87,1207631.04,593949.17
13908,1983-07-05,166.6,-2.04,-1.21,170.99,-2.57,True,1,7162,-166.6,-613848.47,1193189.2,579340.73
13909,1983-07-06,168.48,1.88,1.13,170.99,-1.47,True,1,7163,-168.48,-614016.95,1206822.24,592805.29
13910,1983-07-07,167.56,-0.92,-0.55,170.99,-2.01,True,1,7164,-167.56,-614184.51,1200399.84,586215.33
13911,1983-07-08,167.08,-0.48,-0.29,170.99,-2.29,True,1,7165,-167.08,-614351.59,1197128.2,582776.61
13912,1983-07-11,168.11,1.03,0.62,170.99,-1.68,True,1,7166,-168.11,-614519.7,1204676.26,590156.56
13913,1983-07-12,165.53,-2.58,-1.54,170.99,-3.19,True,1,7167,-165.53,-614685.23,1186353.51,571668.28
13914,1983-07-13,165.46,-0.07,-0.04,170.99,-3.23,True,1,7168,-165.46,-614850.69,1186017.28,571166.59
13915,1983-07-14,166.01,0.55,0.33,170.99,-2.91,True,1,7169,-166.01,-615016.7,1190125.69,575108.99
13916,1983-07-15,164.29,-1.72,-1.04,170.99,-3.92,True,1,7170,-164.29,-615180.99,1177959.3,562778.31
13917,1983-07-18,163.95,-0.34,-0.21,170.99,-4.12,True,1,7171,-163.95,-615344.94,1175685.45,560340.51
13918,1983-07-19,164.82,0.87,0.53,170.99,-3.61,True,1,7172,-164.82,-615509.76,1182089.04,566579.28
13919,1983-07-20,169.29,4.47,2.71,170.99,-0.99,True,1,7173,-169.29,-615679.05,1214317.17,598638.12
13920,1983-07-21,169.06,-0.23,-0.14,170.99,-1.13,True,1,7174,-169.06,-615848.11,1212836.44,596988.33
13921,1983-07-22,168.89,-0.17,-0.1,170.99,-1.23,True,1,7175,-168.89,-616017.0,1211785.75,595768.75
13922,1983-07-25,169.53,0.64,0.38,170.99,-0.85,True,1,7176,-169.53,-616186.53,1216547.28,600360.75
13923,1983-07-26,170.53,1.0,0.59,170.99,-0.27,True,1,7177,-170.53,-616357.06,1223893.81,607536.75
13924,1983-07-27,167.59,-2.94,-1.72,170.99,-1.99,True,1,7178,-167.59,-616524.65,1202961.02,586436.37
13925,1983-07-28,165.04,-2.55,-1.52,170.99,-3.48,True,1,7179,-165.04,-616689.69,1184822.16,568132.47
13926,1983-07-29,162.56,-2.48,-1.5,170.99,-4.93,True,1,7180,-162.56,-616852.25,1167180.8,550328.55
13927,1983-08-01,162.04,-0.52,-0.32,170.99,-5.23,True,1,7181,-162.04,-617014.29,1163609.24,546594.95
13928,1983-08-02,162.01,-0.03,-0.02,170.99,-5.25,True,1,7182,-162.01,-617176.3,1163555.82,546379.52
13929,1983-08-03,163.44,1.43,0.88,170.99,-4.42,True,1,7183,-163.44,-617339.74,1173989.52,556649.78
13930,1983-08-04,161.33,-2.11,-1.29,170.99,-5.65,True,1,7184,-161.33,-617501.07,1158994.72,541493.65
13931,1983-08-05,161.74,0.41,0.25,170.99,-5.41,True,1,7185,-161.74,-617662.81,1162101.9,544439.09
13932,1983-08-08,159.18,-2.56,-1.58,170.99,-6.91,True,1,7186,-159.18,-617821.99,1143867.48,526045.49
13933,1983-08-09,160.13,0.95,0.6,170.99,-6.35,True,1,7187,-160.13,-617982.12,1150854.31,532872.19
13934,1983-08-10,161.54,1.41,0.88,170.99,-5.53,True,1,7188,-161.54,-618143.66,1161149.52,543005.86
13935,1983-08-11,161.54,0.0,0.0,170.99,-5.53,True,1,7189,-161.54,-618305.2,1161311.06,543005.86
13936,1983-08-12,162.16,0.62,0.38,170.99,-5.16,True,1,7190,-162.16,-618467.36,1165930.4,547463.04
13937,1983-08-15,163.7,1.54,0.95,170.99,-4.26,True,1,7191,-163.7,-618631.06,1177166.7,558535.64
13938,1983-08-16,163.41,-0.29,-0.18,170.99,-4.43,True,1,7192,-163.41,-618794.47,1175244.72,556450.25
13939,1983-08-17,165.29,1.88,1.15,170.99,-3.33,True,1,7193,-165.29,-618959.76,1188930.97,569971.21
13940,1983-08-18,163.55,-1.74,-1.05,170.99,-4.35,True,1,7194,-163.55,-619123.31,1176578.7,557455.39
13941,1983-08-19,163.98,0.43,0.26,170.99,-4.1,True,1,7195,-163.98,-619287.29,1179836.1,560548.81
13942,1983-08-22,164.34,0.36,0.22,170.99,-3.89,True,1,7196,-164.34,-619451.63,1182590.64,563139.01
13943,1983-08-23,162.77,-1.57,-0.96,170.99,-4.81,True,1,7197,-162.77,-619614.4,1171455.69,551841.29
13944,1983-08-24,161.25,-1.52,-0.93,170.99,-5.7,True,1,7198,-161.25,-619775.65,1160677.5,540901.85
13945,1983-08-25,160.84,-0.41,-0.25,170.99,-5.94,True,1,7199,-160.84,-619936.49,1157887.16,537950.67
13946,1983-08-26,162.14,1.3,0.81,170.99,-5.18,True,1,7200,-162.14,-620098.63,1167408.0,547309.37
13947,1983-08-29,162.25,0.11,0.07,170.99,-5.11,True,1,7201,-162.25,-620260.88,1168362.25,548101.37
13948,1983-08-30,162.58,0.33,0.2,170.99,-4.92,True,1,7202,-162.58,-620423.46,1170901.16,550477.7
13949,1983-08-31,164.4,1.82,1.12,170.99,-3.85,True,1,7203,-164.4,-620587.86,1184173.2,563585.34
13950,1983-09-01,164.23,-0.17,-0.1,170.99,-3.95,True,1,7204,-164.23,-620752.09,1183112.92,562360.83
13951,1983-09-02,165.0,0.77,0.47,170.99,-3.5,True,1,7205,-165.0,-620917.09,1188825.0,567907.91
13952,1983-09-06,167.89,2.89,1.75,170.99,-1.81,True,1,7206,-167.89,-621084.98,1209815.34,588730.36
13953,1983-09-07,167.96,0.07,0.04,170.99,-1.77,True,1,7207,-167.96,-621252.94,1210487.72,589234.78
13954,1983-09-08,167.77,-0.19,-0.11,170.99,-1.88,True,1,7208,-167.77,-621420.71,1209286.16,587865.45
13955,1983-09-09,166.92,-0.85,-0.51,170.99,-2.38,True,1,7209,-166.92,-621587.63,1203326.28,581738.65
13956,1983-09-12,165.48,-1.44,-0.86,170.99,-3.22,True,1,7210,-165.48,-621753.11,1193110.8,571357.69
13957,1983-09-13,164.8,-0.68,-0.41,170.99,-3.62,True,1,7211,-164.8,-621917.91,1188372.8,566454.89
13958,1983-09-14,165.35,0.55,0.33,170.99,-3.3,True,1,7212,-165.35,-622083.26,1192504.2,570420.94
13959,1983-09-15,164.38,-0.97,-0.59,170.99,-3.87,True,1,7213,-164.38,-622247.64,1185672.94,563425.3
13960,1983-09-16,166.25,1.87,1.14,170.99,-2.77,True,1,7214,-166.25,-622413.89,1199327.5,576913.61
13961,1983-09-19,167.62,1.37,0.82,170.99,-1.97,True,1,7215,-167.62,-622581.51,1209378.3,586796.79
13962,1983-09-20,169.24,1.62,0.97,170.99,-1.02,True,1,7216,-169.24,-622750.75,1221235.84,598485.09
13963,1983-09-21,168.41,-0.83,-0.49,170.99,-1.51,True,1,7217,-168.41,-622919.16,1215414.97,592495.81
13964,1983-09-22,169.76,1.35,0.8,170.99,-0.72,True,1,7218,-169.76,-623088.92,1225327.68,602238.76
13965,1983-09-23,169.51,-0.25,-0.15,170.99,-0.87,True,1,7219,-169.51,-623258.43,1223692.69,600434.26
13966,1983-09-26,170.07,0.56,0.33,170.99,-0.54,True,1,7220,-170.07,-623428.5,1227905.4,604476.9
13967,1983-09-27,168.43,-1.64,-0.96,170.99,-1.5,True,1,7221,-168.43,-623596.93,1216233.03,592636.1
13968,1983-09-28,168.0,-0.43,-0.26,170.99,-1.75,True,1,7222,-168.0,-623764.93,1213296.0,589531.07
13969,1983-09-29,167.23,-0.77,-0.46,170.99,-2.2,True,1,7223,-167.23,-623932.16,1207902.29,583970.13
13970,1983-09-30,166.07,-1.16,-0.69,170.99,-2.88,True,1,7224,-166.07,-624098.23,1199689.68,575591.45
13971,1983-10-03,165.81,-0.26,-0.16,170.99,-3.03,True,1,7225,-165.81,-624264.04,1197977.25,573713.21
13972,1983-10-04,166.27,0.46,0.28,170.99,-2.76,True,1,7226,-166.27,-624430.31,1201467.02,577036.71
13973,1983-10-05,167.74,1.47,0.88,170.99,-1.9,True,1,7227,-167.74,-624598.05,1212256.98,587658.93
13974,1983-10-06,170.28,2.54,1.51,170.99,-0.42,True,1,7228,-170.28,-624768.33,1230783.84,606015.51
13975,1983-10-07,170.8,0.52,0.3,170.99,-0.11,True,1,7229,-170.8,-624939.13,1234713.2,609774.07
13976,1983-10-10,172.65,1.85,1.08,172.65,0.0,True,1,7230,-172.65,-625111.78,1248259.5,623147.72
13977,1983-10-11,170.34,-2.31,-1.34,172.65,-1.34,True,1,7231,-170.34,-625282.12,1231728.54,606446.42
13978,1983-10-12,169.62,-0.72,-0.42,172.65,-1.76,True,1,7232,-169.62,-625451.74,1226691.84,601240.1
13979,1983-10-13,169.87,0.25,0.15,172.65,-1.61,True,1,7233,-169.87,-625621.61,1228669.71,603048.1
13980,1983-10-14,169.86,-0.01,-0.01,172.65,-1.62,True,1,7234,-169.86,-625791.47,1228767.24,602975.77
13981,1983-10-17,170.43,0.57,0.34,172.65,-1.29,True,1,7235,-170.43,-625961.9,1233061.05,607099.15
13982,1983-10-18,167.81,-2.62,-1.54,172.65,-2.8,True,1,7236,-167.81,-626129.71,1214273.16,588143.45
13983,1983-10-19,166.73,-1.08,-0.64,172.65,-3.43,True,1,7237,-166.73,-626296.44,1206625.01,580328.57
13984,1983-10-20,166.98,0.25,0.15,172.65,-3.28,True,1,7238,-166.98,-626463.42,1208601.24,582137.82
13985,1983-10-21,165.95,-1.03,-0.62,172.65,-3.88,True,1,7239,-165.95,-626629.37,1201312.05,574682.68
13986,1983-10-24,165.99,0.04,0.02,172.65,-3.86,True,1,7240,-165.99,-626795.36,1201767.6,574972.24
13987,1983-10-25,166.47,0.48,0.29,172.65,-3.58,True,1,7241,-166.47,-626961.83,1205409.27,578447.44
13988,1983-10-26,165.38,-1.09,-0.66,172.65,-4.21,True,1,7242,-165.38,-627127.21,1197681.96,570554.75
13989,1983-10-27,164.84,-0.54,-0.33,172.65,-4.52,True,1,7243,-164.84,-627292.05,1193936.12,566644.07
13990,1983-10-28,163.37,-1.47,-0.89,172.65,-5.38,True,1,7244,-163.37,-627455.42,1183452.28,555996.86
13991,1983-10-31,163.55,0.18,0.11,172.65,-5.27,True,1,7245,-163.55,-627618.97,1184919.75,557300.78
13992,1983-11-01,163.66,0.11,0.07,172.65,-5.21,True,1,7246,-163.66,-627782.63,1185880.36,558097.73
13993,1983-11-02,164.84,1.18,0.72,172.65,-4.52,True,1,7247,-164.84,-627947.47,1194595.48,566648.01
13994,1983-11-03,163.45,-1.39,-0.84,172.65,-5.33,True,1,7248,-163.45,-628110.92,1184685.6,556574.68
13995,1983-11-04,162.44,-1.01,-0.62,172.65,-5.91,True,1,7249,-162.44,-628273.36,1177527.56,549254.2
13996,1983-11-07,161.91,-0.53,-0.33,172.65,-6.22,True,1,7250,-161.91,-628435.27,1173847.5,545412.23
13997,1983-11-08,161.76,-0.15,-0.09,172.65,-6.31,True,1,7251,-161.76,-628597.03,1172921.76,544324.73
13998,1983-11-09,163.97,2.21,1.37,172.65,-5.03,True,1,7252,-163.97,-628761.0,1189110.44,560349.44
13999,1983-11-10,164.41,0.44,0.27,172.65,-4.77,True,1,7253,-164.41,-628925.41,1192465.73,563540.32
14000,1983-11-11,166.29,1.88,1.14,172.65,-3.68,True,1,7254,-166.29,-629091.7,1206267.66,577175.96
14001,1983-11-14,166.58,0.29,0.17,172.65,-3.52,True,1,7255,-166.58,-629258.28,1208537.9,579279.62
14002,1983-11-15,165.36,-1.22,-0.73,172.65,-4.22,True,1,7256,-165.36,-629423.64,1199852.16,570428.52
14003,1983-11-16,166.08,0.72,0.44,172.65,-3.8,True,1,7257,-166.08,-629589.72,1205242.56,575652.84
14004,1983-11-17,166.13,0.05,0.03,172.65,-3.78,True,1,7258,-166.13,-629755.85,1205771.54,576015.69
14005,1983-11-18,165.09,-1.04,-0.63,172.65,-4.38,True,1,7259,-165.09,-629920.94,1198388.31,568467.37
14006,1983-11-21,166.05,0.96,0.58,172.65,-3.82,True,1,7260,-166.05,-630086.99,1205523.0,575436.01
14007,1983-11-22,166.84,0.79,0.48,172.65,-3.36,True,1,7261,-166.84,-630253.83,1211425.24,581171.41
14008,1983-11-23,166.96,0.12,0.07,172.65,-3.3,True,1,7262,-166.96,-630420.79,1212463.52,582042.73
14009,1983-11-25,167.18,0.22,0.13,172.65,-3.17,True,1,7263,-167.18,-630587.97,1214228.34,583640.37
14010,1983-11-28,166.54,-0.64,-0.38,172.65,-3.54,True,1,7264,-166.54,-630754.51,1209746.56,578992.05
14011,1983-11-29,167.91,1.37,0.82,172.65,-2.74,True,1,7265,-167.91,-630922.42,1219866.15,588943.73
14012,1983-11-30,166.4,-1.51,-0.9,172.65,-3.62,True,1,7266,-166.4,-631088.82,1209062.4,577973.58
14013,1983-12-01,166.49,0.09,0.05,172.65,-3.57,True,1,7267,-166.49,-631255.31,1209882.83,578627.52
14014,1983-12-02,165.44,-1.05,-0.63,172.65,-4.18,True,1,7268,-165.44,-631420.75,1202417.92,570997.17
14015,1983-12-05,165.76,0.32,0.19,172.65,-3.99,True,1,7269,-165.76,-631586.51,1204909.44,573322.93
14016,1983-12-06,165.47,-0.29,-0.18,172.65,-4.16,True,1,7270,-165.47,-631751.98,1202966.9,571214.92
14017,1983-12-07,165.91,0.44,0.27,172.65,-3.9,True,1,7271,-165.91,-631917.89,1206331.61,574413.72
14018,1983-12-08,165.2,-0.71,-0.43,172.65,-4.32,True,1,7272,-165.2,-632083.09,1201334.4,569251.31
14019,1983-12-09,165.08,-0.12,-0.07,172.65,-4.38,True,1,7273,-165.08,-632248.17,1200626.84,568378.67
14020,1983-12-12,165.62,0.54,0.33,172.65,-4.07,True,1,7274,-165.62,-632413.79,1204719.88,572306.09
14021,1983-12-13,164.93,-0.69,-0.42,172.65,-4.47,True,1,7275,-164.93,-632578.72,1199865.75,567287.03
14022,1983-12-14,163.33,-1.6,-0.97,172.65,-5.4,True,1,7276,-163.33,-632742.05,1188389.08,555647.03
14023,1983-12-15,161.66,-1.67,-1.02,172.65,-6.36,True,1,7277,-161.66,-632903.71,1176399.82,543496.11
14024,1983-12-16,162.39,0.73,0.45,172.65,-5.94,True,1,7278,-162.39,-633066.1,1181874.42,548808.32
14025,1983-12-19,162.32,-0.07,-0.04,172.65,-5.98,True,1,7279,-162.32,-633228.42,1181527.28,548298.86
14026,1983-12-20,162.0,-0.32,-0.2,172.65,-6.17,True,1,7280,-162.0,-633390.42,1179360.0,545969.58
14027,1983-12-21,163.56,1.56,0.96,172.65,-5.26,True,1,7281,-163.56,-633553.98,1190880.36,557326.38
14028,1983-12-22,163.53,-0.03,-0.02,172.65,-5.28,True,1,7282,-163.53,-633717.51,1190825.46,557107.95
14029,1983-12-23,163.22,-0.31,-0.19,172.65,-5.46,True,1,7283,-163.22,-633880.73,1188731.26,554850.53
14030,1983-12-27,164.76,1.54,0.94,172.65,-4.57,True,1,7284,-164.76,-634045.49,1200111.84,566066.35
14031,1983-12-28,165.34,0.58,0.35,172.65,-4.23,True,1,7285,-165.34,-634210.83,1204501.9,570291.07
14032,1983-12-29,164.86,-0.48,-0.29,172.65,-4.51,True,1,7286,-164.86,-634375.69,1201169.96,566794.27
14033,1983-12-30,164.93,0.07,0.04,172.65,-4.47,True,1,7287,-164.93,-634540.62,1201844.91,567304.29
14034,1984-01-03,164.04,-0.89,-0.54,172.65,-4.99,True,1,7288,-164.04,-634704.66,1195523.52,560818.86
14035,1984-01-04,166.78,2.74,1.67,172.65,-3.4,True,1,7289,-166.78,-634871.44,1215659.42,580787.98
14036,1984-01-05,168.81,2.03,1.22,172.65,-2.22,True,1,7290,-168.81,-635040.25,1230624.9,595584.65
14037,1984-01-06,169.28,0.47,0.28,172.65,-1.95,True,1,7291,-169.28,-635209.53,1234220.48,599010.95
14038,1984-01-09,168.9,-0.38,-0.22,172.65,-2.17,True,1,7292,-168.9,-635378.43,1231618.8,596240.37
14039,1984-01-10,167.95,-0.95,-0.56,172.65,-2.72,True,1,7293,-167.95,-635546.38,1224859.35,589312.97
14040,1984-01-11,167.8,-0.15,-0.09,172.65,-2.81,True,1,7294,-167.8,-635714.18,1223933.2,588219.02
14041,1984-01-12,167.75,-0.05,-0.03,172.65,-2.84,True,1,7295,-167.75,-635881.93,1223736.25,587854.32
14042,1984-01-13,167.02,-0.73,-0.44,172.65,-3.26,True,1,7296,-167.02,-636048.95,1218577.92,582528.97
14043,1984-01-16,167.18,0.16,0.1,172.65,-3.17,True,1,7297,-167.18,-636216.13,1219912.46,583696.33
14044,1984-01-17,167.83,0.65,0.39,172.65,-2.79,True,1,7298,-167.83,-636383.96,1224823.34,588439.38
14045,1984-01-18,167.55,-0.28,-0.17,172.65,-2.95,True,1,7299,-167.55,-636551.51,1222947.45,586395.94
14046,1984-01-19,167.04,-0.51,-0.3,172.65,-3.25,True,1,7300,-167.04,-636718.55,1219392.0,582673.45
14047,1984-01-20,166.21,-0.83,-0.5,172.65,-3.73,True,1,7301,-166.21,-636884.76,1213499.21,576614.45
14048,1984-01-23,164.87,-1.34,-0.81,172.65,-4.51,True,1,7302,-164.87,-637049.63,1203880.74,566831.11
14049,1984-01-24,165.94,1.07,0.65,172.65,-3.89,True,1,7303,-165.94,-637215.57,1211859.82,574644.25
14050,1984-01-25,164.84,-1.1,-0.66,172.65,-4.52,True,1,7304,-164.84,-637380.41,1203991.36,566610.95
14051,1984-01-26,164.24,-0.6,-0.36,172.65,-4.87,True,1,7305,-164.24,-637544.65,1199773.2,562228.55
14052,1984-01-27,163.94,-0.3,-0.18,172.65,-5.04,True,1,7306,-163.94,-637708.59,1197745.64,560037.05
14053,1984-01-30,162.87,-1.07,-0.65,172.65,-5.66,True,1,7307,-162.87,-637871.46,1190091.09,552219.63
14054,1984-01-31,163.41,0.54,0.33,172.65,-5.35,True,1,7308,-163.41,-638034.87,1194200.28,556165.41
14055,1984-02-01,162.74,-0.67,-0.41,172.65,-5.74,True,1,7309,-162.74,-638197.61,1189466.66,551269.05
14056,1984-02-02,163.36,0.62,0.38,172.65,-5.38,True,1,7310,-163.36,-638360.97,1194161.6,555800.63
14057,1984-02-03,160.91,-2.45,-1.5,172.65,-6.8,True,1,7311,-160.91,-638521.88,1176413.01,537891.13
14058,1984-02-06,158.08,-2.83,-1.76,172.65,-8.44,True,1,7312,-158.08,-638679.96,1155880.96,517201.0
14059,1984-02-07,158.74,0.66,0.42,172.65,-8.06,True,1,7313,-158.74,-638838.7,1160865.62,522026.92
14060,1984-02-08,155.85,-2.89,-1.82,172.65,-9.73,True,1,7314,-155.85,-638994.55,1139886.9,500892.35
14061,1984-02-09,155.42,-0.43,-0.28,172.65,-9.98,True,1,7315,-155.42,-639149.97,1136897.3,497747.33
14062,1984-02-10,156.3,0.88,0.57,172.65,-9.47,True,1,7316,-156.3,-639306.27,1143490.8,504184.53
14063,1984-02-13,154.95,-1.35,-0.86,172.65,-10.25,True,1,7317,-154.95,-639461.22,1133769.15,494307.93
14064,1984-02-14,156.61,1.66,1.07,172.65,-9.29,True,1,7318,-156.61,-639617.83,1146071.98,506454.15
14065,1984-02-15,156.25,-0.36,-0.23,172.65,-9.5,True,1,7319,-156.25,-639774.08,1143593.75,503819.67
14066,1984-02-16,156.13,-0.12,-0.08,172.65,-9.57,True,1,7320,-156.13,-639930.21,1142871.6,502941.39
14067,1984-02-17,155.74,-0.39,-0.25,172.65,-9.79,True,1,7321,-155.74,-640085.95,1140172.54,500086.59
14068,1984-02-21,154.64,-1.1,-0.71,172.65,-10.43,True,1,7322,-154.64,-640240.59,1132274.08,492033.49
14069,1984-02-22,154.31,-0.33,-0.21,172.65,-10.62,True,1,7323,-154.31,-640394.9,1130012.13,489617.23
14070,1984-02-23,154.29,-0.02,-0.01,172.65,-10.63,True,1,7324,-154.29,-640549.19,1130019.96,489470.77
14071,1984-02-24,157.51,3.22,2.09,172.65,-8.77,True,1,7325,-157.51,-640706.7,1153760.75,513054.05
14072,1984-02-27,159.3,1.79,1.14,172.65,-7.73,True,1,7326,-159.3,-640866.0,1167031.8,526165.8
14073,1984-02-28,156.82,-2.48,-1.56,172.65,-9.17,True,1,7327,-156.82,-641022.82,1149020.14,507997.32
14074,1984-02-29,157.06,0.24,0.15,172.65,-9.03,True,1,7328,-157.06,-641179.88,1150935.68,509755.8
14075,1984-03-01,158.19,1.13,0.72,172.65,-8.38,True,1,7329,-158.19,-641338.07,1159374.51,518036.44
14076,1984-03-02,159.24,1.05,0.66,172.65,-7.77,True,1,7330,-159.24,-641497.31,1167229.2,525731.89
14077,1984-03-05,157.89,-1.35,-0.85,172.65,-8.55,True,1,7331,-157.89,-641655.2,1157491.59,515836.39
14078,1984-03-06,156.25,-1.64,-1.04,172.65,-9.5,True,1,7332,-156.25,-641811.45,1145625.0,503813.55
14079,1984-03-07,154.57,-1.68,-1.08,172.65,-10.47,True,1,7333,-154.57,-641966.02,1133461.81,491495.79
14080,1984-03-08,155.19,0.62,0.4,172.65,-10.11,True,1,7334,-155.19,-642121.21,1138163.46,496042.25
14081,1984-03-09,154.35,-0.84,-0.54,172.65,-10.6,True,1,7335,-154.35,-642275.56,1132157.25,489881.69
14082,1984-03-12,156.34,1.99,1.29,172.65,-9.45,True,1,7336,-156.34,-642431.9,1146910.24,504478.34
14083,1984-03-13,156.78,0.44,0.28,172.65,-9.19,True,1,7337,-156.78,-642588.68,1150294.86,507706.18
14084,1984-03-14,156.77,-0.01,-0.01,172.65,-9.2,True,1,7338,-156.77,-642745.45,1150378.26,507632.81
14085,1984-03-15,157.41,0.64,0.41,172.65,-8.83,True,1,7339,-157.41,-642902.86,1155231.99,512329.13
14086,1984-03-16,159.27,1.86,1.18,172.65,-7.75,True,1,7340,-159.27,-643062.13,1169041.8,525979.67
14087,1984-03-19,157.78,-1.49,-0.94,172.65,-8.61,True,1,7341,-157.78,-643219.91,1158262.98,515043.07
14088,1984-03-20,158.86,1.08,0.68,172.65,-7.99,True,1,7342,-158.86,-643378.77,1166350.12,522971.35
14089,1984-03-21,158.66,-0.2,-0.13,172.65,-8.1,True,1,7343,-158.66,-643537.43,1165040.38,521502.95
14090,1984-03-22,156.69,-1.97,-1.24,172.65,-9.24,True,1,7344,-156.69,-643694.12,1150731.36,507037.24
14091,1984-03-23,156.86,0.17,0.11,172.65,-9.15,True,1,7345,-156.86,-643850.98,1152136.7,508285.72
14092,1984-03-26,156.67,-0.19,-0.12,172.65,-9.26,True,1,7346,-156.67,-644007.65,1150897.82,506890.17
14093,1984-03-27,157.3,0.63,0.4,172.65,-8.89,True,1,7347,-157.3,-644164.95,1155683.1,511518.15
14094,1984-03-28,159.88,2.58,1.64,172.65,-7.4,True,1,7348,-159.88,-644324.83,1174798.24,530473.41
14095,1984-03-29,159.52,-0.36,-0.22,172.65,-7.6,True,1,7349,-159.52,-644484.35,1172312.48,527828.13
14096,1984-03-30,159.18,-0.34,-0.21,172.65,-7.8,True,1,7350,-159.18,-644643.53,1169973.0,525329.47
14097,1984-04-02,157.98,-1.2,-0.75,172.65,-8.5,True,1,7351,-157.98,-644801.51,1161310.98,516509.47
14098,1984-04-03,157.66,-0.32,-0.2,172.65,-8.68,True,1,7352,-157.66,-644959.17,1159116.32,514157.15
14099,1984-04-04,157.54,-0.12,-0.08,172.65,-8.75,True,1,7353,-157.54,-645116.71,1158391.62,513274.91
14100,1984-04-05,155.04,-2.5,-1.59,172.65,-10.2,True,1,7354,-155.04,-645271.75,1140164.16,494892.41
14101,1984-04-06,155.48,0.44,0.28,172.65,-9.94,True,1,7355,-155.48,-645427.23,1143555.4,498128.17
14102,1984-04-09,155.45,-0.03,-0.02,172.65,-9.96,True,1,7356,-155.45,-645582.68,1143490.2,497907.52
14103,1984-04-10,155.87,0.42,0.27,172.65,-9.72,True,1,7357,-155.87,-645738.55,1146735.59,500997.04
14104,1984-04-11,155.0,-0.87,-0.56,172.65,-10.22,True,1,7358,-155.0,-645893.55,1140490.0,494596.45
14105,1984-04-12,157.73,2.73,1.76,172.65,-8.64,True,1,7359,-157.73,-646051.28,1160735.07,514683.79
14106,1984-04-13,157.31,-0.42,-0.27,172.65,-8.88,True,1,7360,-157.31,-646208.59,1157801.6,511593.01
14107,1984-04-16,158.32,1.01,0.64,172.65,-8.3,True,1,7361,-158.32,-646366.91,1165393.52,519026.61
14108,1984-04-17,158.97,0.65,0.41,172.65,-7.92,True,1,7362,-158.97,-646525.88,1170337.14,523811.26
14109,1984-04-18,157.9,-1.07,-0.67,172.65,-8.54,True,1,7363,-157.9,-646683.78,1162617.7,515933.92
14110,1984-04-19,158.02,0.12,0.08,172.65,-8.47,True,1,7364,-158.02,-646841.8,1163659.28,516817.48
14111,1984-04-23,156.8,-1.22,-0.77,172.65,-9.18,True,1,7365,-156.8,-646998.6,1154832.0,507833.4
14112,1984-04-24,158.07,1.27,0.81,172.65,-8.44,True,1,7366,-158.07,-647156.67,1164343.62,517186.95
14113,1984-04-25,158.65,0.58,0.37,172.65,-8.11,True,1,7367,-158.65,-647315.32,1168774.55,521459.23
14114,1984-04-26,160.3,1.65,1.04,172.65,-7.15,True,1,7368,-160.3,-647475.62,1181090.4,533614.78
14115,1984-04-27,159.89,-0.41,-0.26,172.65,-7.39,True,1,7369,-159.89,-647635.51,1178229.41,530593.9
14116,1984-04-30,160.05,0.16,0.1,172.65,-7.3,True,1,7370,-160.05,-647795.56,1179568.5,531772.94
14117,1984-05-01,161.68,1.63,1.02,172.65,-6.35,True,1,7371,-161.68,-647957.24,1191743.28,543786.04
14118,1984-05-02,161.9,0.22,0.14,172.65,-6.23,True,1,7372,-161.9,-648119.14,1193526.8,545407.66
14119,1984-05-03,161.2,-0.7,-0.43,172.65,-6.63,True,1,7373,-161.2,-648280.34,1188527.6,540247.26
14120,1984-05-04,159.11,-2.09,-1.3,172.65,-7.84,True,1,7374,-159.11,-648439.45,1173277.14,524837.69
14121,1984-05-07,159.47,0.36,0.23,172.65,-7.63,True,1,7375,-159.47,-648598.92,1176091.25,527492.33
14122,1984-05-08,160.52,1.05,0.66,172.65,-7.03,True,1,7376,-160.52,-648759.44,1183995.52,535236.08
14123,1984-05-09,160.11,-0.41,-0.26,172.65,-7.26,True,1,7377,-160.11,-648919.55,1181131.47,532211.92
14124,1984-05-10,160.0,-0.11,-0.07,172.65,-7.33,True,1,7378,-160.0,-649079.55,1180480.0,531400.45
14125,1984-05-11,158.49,-1.51,-0.94,172.65,-8.2,True,1,7379,-158.49,-649238.04,1169497.71,520259.67
14126,1984-05-14,157.5,-0.99,-0.62,172.65,-8.78,True,1,7380,-157.5,-649395.54,1162350.0,512954.46
14127,1984-05-15,158.0,0.5,0.32,172.65,-8.48,True,1,7381,-158.0,-649553.54,1166198.0,516644.46
14128,1984-05-16,157.99,-0.01,-0.01,172.65,-8.49,True,1,7382,-157.99,-649711.53,1166282.18,516570.65
14129,1984-05-17,156.57,-1.42,-0.9,172.65,-9.31,True,1,7383,-156.57,-649868.1,1155956.31,506088.21
14130,1984-05-18,155.78,-0.79,-0.5,172.65,-9.77,True,1,7384,-155.78,-650023.88,1150279.52,500255.64
14131,1984-05-21,154.73,-1.05,-0.67,172.65,-10.38,True,1,7385,-154.73,-650178.61,1142681.05,492502.44
14132,1984-05-22,153.88,-0.85,-0.55,172.65,-10.87,True,1,7386,-153.88,-650332.49,1136557.68,486225.19
14133,1984-05-23,153.15,-0.73,-0.47,172.65,-11.3,True,1,7387,-153.15,-650485.64,1131319.05,480833.41
14134,1984-05-24,151.23,-1.92,-1.25,172.65,-12.41,True,1,7388,-151.23,-650636.87,1117287.24,466650.37
14135,1984-05-25,151.62,0.39,0.26,172.65,-12.18,True,1,7389,-151.62,-650788.49,1120320.18,469531.69
14136,1984-05-29,150.29,-1.33,-0.88,172.65,-12.95,True,1,7390,-150.29,-650938.78,1110643.1,459704.32
14137,1984-05-30,150.35,0.06,0.04,172.65,-12.92,True,1,7391,-150.35,-651089.13,1111236.85,460147.72
14138,1984-05-31,150.55,0.2,0.13,172.65,-12.8,True,1,7392,-150.55,-651239.68,1112865.6,461625.92
14139,1984-06-01,153.24,2.69,1.79,172.65,-11.24,True,1,7393,-153.24,-651392.92,1132903.32,481510.4
14140,1984-06-04,154.34,1.1,0.72,172.65,-10.6,True,1,7394,-154.34,-651547.26,1141189.96,489642.7
14141,1984-06-05,153.65,-0.69,-0.45,172.65,-11.0,True,1,7395,-153.65,-651700.91,1136241.75,484540.84
14142,1984-06-06,155.01,1.36,0.88,172.65,-10.22,True,1,7396,-155.01,-651855.92,1146453.96,494598.04
14143,1984-06-07,154.92,-0.09,-0.06,172.65,-10.27,True,1,7397,-154.92,-652010.84,1145943.24,493932.4
14144,1984-06-08,155.17,0.25,0.16,172.65,-10.12,True,1,7398,-155.17,-652166.01,1147947.66,495781.65
14145,1984-06-11,153.06,-2.11,-1.36,172.65,-11.35,True,1,7399,-153.06,-652319.07,1132490.94,480171.87
14146,1984-06-12,152.19,-0.87,-0.57,172.65,-11.85,True,1,7400,-152.19,-652471.26,1126206.0,473734.74
14147,1984-06-13,152.13,-0.06,-0.04,172.65,-11.88,True,1,7401,-152.13,-652623.39,1125914.13,473290.74
14148,1984-06-14,150.39,-1.74,-1.14,172.65,-12.89,True,1,7402,-150.39,-652773.78,1113186.78,460413.0
14149,1984-06-15,149.03,-1.36,-0.9,172.65,-13.68,True,1,7403,-149.03,-652922.81,1103269.09,450346.28
14150,1984-06-18,151.73,2.7,1.81,172.65,-12.12,True,1,7404,-151.73,-653074.54,1123408.92,470334.38
14151,1984-06-19,152.61,0.88,0.58,172.65,-11.61,True,1,7405,-152.61,-653227.15,1130077.05,476849.9
14152,1984-06-20,154.84,2.23,1.46,172.65,-10.32,True,1,7406,-154.84,-653381.99,1146745.04,493363.05
14153,1984-06-21,154.51,-0.33,-0.21,172.65,-10.51,True,1,7407,-154.51,-653536.5,1144455.57,490919.07
14154,1984-06-22,154.46,-0.05,-0.03,172.65,-10.54,True,1,7408,-154.46,-653690.96,1144239.68,490548.72
14155,1984-06-25,153.97,-0.49,-0.32,172.65,-10.82,True,1,7409,-153.97,-653844.93,1140763.73,486918.8
14156,1984-06-26,152.71,-1.26,-0.82,172.65,-11.55,True,1,7410,-152.71,-653997.64,1131581.1,477583.46
14157,1984-06-27,151.64,-1.07,-0.7,172.65,-12.17,True,1,7411,-151.64,-654149.28,1123804.04,469654.76
14158,1984-06-28,152.84,1.2,0.79,172.65,-11.47,True,1,7412,-152.84,-654302.12,1132850.08,478547.96
14159,1984-06-29,153.18,0.34,0.22,172.65,-11.28,True,1,7413,-153.18,-654455.3,1135523.34,481068.04
14160,1984-07-02,153.2,0.02,0.01,172.65,-11.27,True,1,7414,-153.2,-654608.5,1135824.8,481216.3
14161,1984-07-03,153.7,0.5,0.33,172.65,-10.98,True,1,7415,-153.7,-654762.2,1139685.5,484923.3
14162,1984-07-05,152.76,-0.94,-0.61,172.65,-11.52,True,1,7416,-152.76,-654914.96,1132868.16,477953.2
14163,1984-07-06,152.24,-0.52,-0.34,172.65,-11.82,True,1,7417,-152.24,-655067.2,1129164.08,474096.88
14164,1984-07-09,153.36,1.12,0.74,172.65,-11.17,True,1,7418,-153.36,-655220.56,1137624.48,482403.92
14165,1984-07-10,152.89,-0.47,-0.31,172.65,-11.44,True,1,7419,-152.89,-655373.45,1134290.91,478917.46
14166,1984-07-11,150.56,-2.33,-1.52,172.65,-12.8,True,1,7420,-150.56,-655524.01,1117155.2,461631.19
14167,1984-07-12,150.03,-0.53,-0.35,172.65,-13.1,True,1,7421,-150.03,-655674.04,1113372.63,457698.59
14168,1984-07-13,150.88,0.85,0.57,172.65,-12.61,True,1,7422,-150.88,-655824.92,1119831.36,464006.44
14169,1984-07-16,151.6,0.72,0.48,172.65,-12.19,True,1,7423,-151.6,-655976.52,1125326.8,469350.28
14170,1984-07-17,152.38,0.78,0.52,172.65,-11.74,True,1,7424,-152.38,-656128.9,1131269.12,475140.22
14171,1984-07-18,151.4,-0.98,-0.64,172.65,-12.31,True,1,7425,-151.4,-656280.3,1124145.0,467864.7
14172,1984-07-19,150.37,-1.03,-0.68,172.65,-12.9,True,1,7426,-150.37,-656430.67,1116647.62,460216.95
14173,1984-07-20,149.55,-0.82,-0.55,172.65,-13.38,True,1,7427,-149.55,-656580.22,1110707.85,454127.63
14174,1984-07-23,148.95,-0.6,-0.4,172.65,-13.73,True,1,7428,-148.95,-656729.17,1106400.6,449671.43
14175,1984-07-24,147.82,-1.13,-0.76,172.65,-14.38,True,1,7429,-147.82,-656876.99,1098154.78,441277.79
14176,1984-07-25,148.83,1.01,0.68,172.65,-13.8,True,1,7430,-148.83,-657025.82,1105806.9,448781.08
14177,1984-07-26,150.08,1.25,0.84,172.65,-13.07,True,1,7431,-150.08,-657175.9,1115244.48,458068.58
14178,1984-07-27,151.19,1.11,0.74,172.65,-12.43,True,1,7432,-151.19,-657327.09,1123644.08,466316.99
14179,1984-07-30,150.19,-1.0,-0.66,172.65,-13.01,True,1,7433,-150.19,-657477.28,1116362.27,458884.99
14180,1984-07-31,150.66,0.47,0.31,172.65,-12.74,True,1,7434,-150.66,-657627.94,1120006.44,462378.5
14181,1984-08-01,154.08,3.42,2.27,172.65,-10.76,True,1,7435,-154.08,-657782.02,1145584.8,487802.78
14182,1984-08-02,157.99,3.91,2.54,172.65,-8.49,True,1,7436,-157.99,-657940.01,1174813.64,516873.63
14183,1984-08-03,162.35,4.36,2.76,172.65,-5.97,True,1,7437,-162.35,-658102.36,1207396.95,549294.59
14184,1984-08-06,162.6,0.25,0.15,172.65,-5.82,True,1,7438,-162.6,-658264.96,1209418.8,551153.84
14185,1984-08-07,162.72,0.12,0.07,172.65,-5.75,True,1,7439,-162.72,-658427.68,1210474.08,552046.4
14186,1984-08-08,161.75,-0.97,-0.6,172.65,-6.31,True,1,7440,-161.75,-658589.43,1203420.0,544830.57
14187,1984-08-09,165.54,3.79,2.34,172.65,-4.12,True,1,7441,-165.54,-658754.97,1231783.14,573028.17
14188,1984-08-10,165.42,-0.12,-0.07,172.65,-4.19,True,1,7442,-165.42,-658920.39,1231055.64,572135.25
14189,1984-08-13,165.43,0.01,0.01,172.65,-4.18,True,1,7443,-165.43,-659085.82,1231295.49,572209.67
14190,1984-08-14,164.42,-1.01,-0.61,172.65,-4.77,True,1,7444,-164.42,-659250.24,1223942.48,564692.24
14191,1984-08-15,162.8,-1.62,-0.98,172.65,-5.7,True,1,7445,-162.8,-659413.04,1212046.0,552632.96
14192,1984-08-16,163.77,0.97,0.6,172.65,-5.14,True,1,7446,-163.77,-659576.81,1219431.42,559854.61
14193,1984-08-17,164.14,0.37,0.23,172.65,-4.93,True,1,7447,-164.14,-659740.95,1222350.58,562609.63
14194,1984-08-20,164.94,0.8,0.49,172.65,-4.47,True,1,7448,-164.94,-659905.89,1228473.12,568567.23
14195,1984-08-21,167.83,2.89,1.75,172.65,-2.79,True,1,7449,-167.83,-660073.72,1250165.67,590091.95
14196,1984-08-22,167.06,-0.77,-0.46,172.65,-3.24,True,1,7450,-167.06,-660240.78,1244597.0,584356.22
14197,1984-08-23,167.12,0.06,0.04,172.65,-3.2,True,1,7451,-167.12,-660407.9,1245211.12,584803.22
14198,1984-08-24,167.51,0.39,0.23,172.65,-2.98,True,1,7452,-167.51,-660575.41,1248284.52,587709.11
14199,1984-08-27,166.44,-1.07,-0.64,172.65,-3.6,True,1,7453,-166.44,-660741.85,1240477.32,579735.47
14200,1984-08-28,167.4,0.96,0.58,172.65,-3.04,True,1,7454,-167.4,-660909.25,1247799.6,586890.35
14201,1984-08-29,167.09,-0.31,-0.18,172.65,-3.22,True,1,7455,-167.09,-661076.34,1245655.95,584579.61
14202,1984-08-30,166.6,-0.49,-0.29,172.65,-3.5,True,1,7456,-166.6,-661242.94,1242169.6,580926.66
14203,1984-08-31,166.68,0.08,0.05,172.65,-3.46,True,1,7457,-166.68,-661409.62,1242932.76,581523.14
14204,1984-09-04,164.88,-1.8,-1.08,172.65,-4.5,True,1,7458,-164.88,-661574.5,1229675.04,568100.54
14205,1984-09-05,164.29,-0.59,-0.36,172.65,-4.84,True,1,7459,-164.29,-661738.79,1225439.11,563700.32
14206,1984-09-06,165.65,1.36,0.83,172.65,-4.05,True,1,7460,-165.65,-661904.44,1235749.0,573844.56
14207,1984-09-07,164.37,-1.28,-0.77,172.65,-4.8,True,1,7461,-164.37,-662068.81,1226364.57,564295.76
14208,1984-09-10,164.26,-0.11,-0.07,172.65,-4.86,True,1,7462,-164.26,-662233.07,1225708.12,563475.05
14209,1984-09-11,164.45,0.19,0.12,172.65,-4.75,True,1,7463,-164.45,-662397.52,1227290.35,564892.83
14210,1984-09-12,164.68,0.23,0.14,172.65,-4.62,True,1,7464,-164.68,-662562.2,1229171.52,566609.32
14211,1984-09-13,167.94,3.26,1.98,172.65,-2.73,True,1,7465,-167.94,-662730.14,1253672.1,590941.96
14212,1984-09-14,168.78,0.84,0.5,172.65,-2.24,True,1,7466,-168.78,-662898.92,1260111.48,597212.56
14213,1984-09-17,168.87,0.09,0.05,172.65,-2.19,True,1,7467,-168.87,-663067.79,1260952.29,597884.5
14214,1984-09-18,167.65,-1.22,-0.72,172.65,-2.9,True,1,7468,-167.65,-663235.44,1252010.2,588774.76
14215,1984-09-19,166.94,-0.71,-0.42,172.65,-3.31,True,1,7469,-166.94,-663402.38,1246874.86,583472.48
14216,1984-09-20,167.47,0.53,0.32,172.65,-3.0,True,1,7470,-167.47,-663569.85,1251000.9,587431.05
14217,1984-09-21,165.67,-1.8,-1.08,172.65,-4.04,True,1,7471,-165.67,-663735.52,1237720.57,573985.05
14218,1984-09-24,165.28,-0.39,-0.24,172.65,-4.27,True,1,7472,-165.28,-663900.8,1234972.16,571071.36
14219,1984-09-25,165.62,0.34,0.21,172.65,-4.07,True,1,7473,-165.62,-664066.42,1237678.26,573611.84
14220,1984-09-26,166.28,0.66,0.4,172.65,-3.69,True,1,7474,-166.28,-664232.7,1242776.72,578544.02
14221,1984-09-27,166.96,0.68,0.41,172.65,-3.3,True,1,7475,-166.96,-664399.66,1248026.0,583626.34
14222,1984-09-28,166.1,-0.86,-0.52,172.65,-3.79,True,1,7476,-166.1,-664565.76,1241763.6,577197.84
14223,1984-10-01,164.62,-1.48,-0.89,172.65,-4.65,True,1,7477,-164.62,-664730.38,1230863.74,566133.36
14224,1984-10-02,163.59,-1.03,-0.63,172.65,-5.25,True,1,7478,-163.59,-664893.97,1223326.02,558432.05
14225,1984-10-03,162.44,-1.15,-0.7,172.65,-5.91,True,1,7479,-162.44,-665056.41,1214888.76,549832.35
14226,1984-10-04,162.92,0.48,0.3,172.65,-5.64,True,1,7480,-162.92,-665219.33,1218641.6,553422.27
14227,1984-10-05,162.68,-0.24,-0.15,172.65,-5.78,True,1,7481,-162.68,-665382.01,1217009.08,551627.07
14228,1984-10-08,162.13,-0.55,-0.34,172.65,-6.09,True,1,7482,-162.13,-665544.14,1213056.66,547512.52
14229,1984-10-09,161.67,-0.46,-0.28,172.65,-6.36,True,1,7483,-161.67,-665705.81,1209776.61,544070.8
14230,1984-10-10,162.11,0.44,0.27,172.65,-6.1,True,1,7484,-162.11,-665867.92,1213231.24,547363.32
14231,1984-10-11,162.78,0.67,0.41,172.65,-5.72,True,1,7485,-162.78,-666030.7,1218408.3,552377.6
14232,1984-10-12,164.18,1.4,0.86,172.65,-4.91,True,1,7486,-164.18,-666194.88,1229051.48,562856.6
14233,1984-10-15,165.77,1.59,0.97,172.65,-3.98,True,1,7487,-165.77,-666360.65,1241119.99,574759.34
14234,1984-10-16,164.78,-0.99,-0.6,172.65,-4.56,True,1,7488,-164.78,-666525.43,1233872.64,567347.21
14235,1984-10-17,164.14,-0.64,-0.39,172.65,-4.93,True,1,7489,-164.14,-666689.57,1229244.46,562554.89
14236,1984-10-18,168.1,3.96,2.41,172.65,-2.64,True,1,7490,-168.1,-666857.67,1259069.0,592211.33
14237,1984-10-19,167.96,-0.14,-0.08,172.65,-2.72,True,1,7491,-167.96,-667025.63,1258188.36,591162.73
14238,1984-10-22,167.36,-0.6,-0.36,172.65,-3.06,True,1,7492,-167.36,-667192.99,1253861.12,586668.13
14239,1984-10-23,167.09,-0.27,-0.16,172.65,-3.22,True,1,7493,-167.09,-667360.08,1252005.37,584645.29
14240,1984-10-24,167.2,0.11,0.07,172.65,-3.16,True,1,7494,-167.2,-667527.28,1252996.8,585469.52
14241,1984-10-25,166.31,-0.89,-0.53,172.65,-3.67,True,1,7495,-166.31,-667693.59,1246493.45,578799.86
14242,1984-10-26,165.29,-1.02,-0.61,172.65,-4.26,True,1,7496,-165.29,-667858.88,1239013.84,571154.96
14243,1984-10-29,164.78,-0.51,-0.31,172.65,-4.56,True,1,7497,-164.78,-668023.66,1235355.66,567332.0
14244,1984-10-30,166.84,2.06,1.25,172.65,-3.36,True,1,7498,-166.84,-668190.5,1250966.32,582775.82
14245,1984-10-31,166.09,-0.75,-0.45,172.65,-3.8,True,1,7499,-166.09,-668356.59,1245508.91,577152.32
14246,1984-11-01,167.49,1.4,0.84,172.65,-2.99,True,1,7500,-167.49,-668524.08,1256175.0,587650.92
14247,1984-11-02,167.42,-0.07,-0.04,172.65,-3.03,True,1,7501,-167.42,-668691.5,1255817.42,587125.92
14248,1984-11-05,168.58,1.16,0.69,172.65,-2.36,True,1,7502,-168.58,-668860.08,1264687.16,595827.08
14249,1984-11-06,170.41,1.83,1.09,172.65,-1.3,True,1,7503,-170.41,-669030.49,1278586.23,609555.74
14250,1984-11-07,169.17,-1.24,-0.73,172.65,-2.02,True,1,7504,-169.17,-669199.66,1269451.68,600252.02
14251,1984-11-08,168.68,-0.49,-0.29,172.65,-2.3,True,1,7505,-168.68,-669368.34,1265943.4,596575.06
14252,1984-11-09,167.6,-1.08,-0.64,172.65,-2.92,True,1,7506,-167.6,-669535.94,1258005.6,588469.66
14253,1984-11-12,167.36,-0.24,-0.14,172.65,-3.06,True,1,7507,-167.36,-669703.3,1256371.52,586668.22
14254,1984-11-13,165.97,-1.39,-0.83,172.65,-3.87,True,1,7508,-165.97,-669869.27,1246102.76,576233.49
14255,1984-11-14,165.99,0.02,0.01,172.65,-3.86,True,1,7509,-165.99,-670035.26,1246418.91,576383.65
14256,1984-11-15,165.89,-0.1,-0.06,172.65,-3.92,True,1,7510,-165.89,-670201.15,1245833.9,575632.75
14257,1984-11-16,164.1,-1.79,-1.08,172.65,-4.95,True,1,7511,-164.1,-670365.25,1232555.1,562189.85
14258,1984-11-19,163.09,-1.01,-0.62,172.65,-5.54,True,1,7512,-163.09,-670528.34,1225132.08,554603.74
14259,1984-11-20,164.18,1.09,0.67,172.65,-4.91,True,1,7513,-164.18,-670692.52,1233484.34,562791.82
14260,1984-11-21,164.51,0.33,0.2,172.65,-4.72,True,1,7514,-164.51,-670857.03,1236128.14,565271.11
14261,1984-11-23,166.92,2.41,1.46,172.65,-3.32,True,1,7515,-166.92,-671023.95,1254403.8,583379.85
14262,1984-11-26,165.55,-1.37,-0.82,172.65,-4.11,True,1,7516,-165.55,-671189.5,1244273.8,573084.3
14263,1984-11-27,166.29,0.74,0.45,172.65,-3.68,True,1,7517,-166.29,-671355.79,1250001.93,578646.14
14264,1984-11-28,165.02,-1.27,-0.76,172.65,-4.42,True,1,7518,-165.02,-671520.81,1240620.36,569099.55
14265,1984-11-29,163.91,-1.11,-0.67,172.65,-5.06,True,1,7519,-163.91,-671684.72,1232439.29,560754.57
14266,1984-11-30,163.58,-0.33,-0.2,172.65,-5.25,True,1,7520,-163.58,-671848.3,1230121.6,558273.3
14267,1984-12-03,162.82,-0.76,-0.46,172.65,-5.69,True,1,7521,-162.82,-672011.12,1224569.22,552558.1
14268,1984-12-04,163.38,0.56,0.34,172.65,-5.37,True,1,7522,-163.38,-672174.5,1228944.36,556769.86
14269,1984-12-05,162.1,-1.28,-0.78,172.65,-6.11,True,1,7523,-162.1,-672336.6,1219478.3,547141.7
14270,1984-12-06,162.76,0.66,0.41,172.65,-5.73,True,1,7524,-162.76,-672499.36,1224606.24,552106.88
14271,1984-12-07,162.26,-0.5,-0.31,172.65,-6.02,True,1,7525,-162.26,-672661.62,1221006.5,548344.88
14272,1984-12-10,162.83,0.57,0.35,172.65,-5.69,True,1,7526,-162.83,-672824.45,1225458.58,552634.13
14273,1984-12-11,163.07,0.24,0.15,172.65,-5.55,True,1,7527,-163.07,-672987.52,1227427.89,554440.37
14274,1984-12-12,162.63,-0.44,-0.27,172.65,-5.8,True,1,7528,-162.63,-673150.15,1224278.64,551128.49
14275,1984-12-13,161.81,-0.82,-0.5,172.65,-6.28,True,1,7529,-161.81,-673311.96,1218267.49,544955.53
14276,1984-12-14,162.69,0.88,0.54,172.65,-5.77,True,1,7530,-162.69,-673474.65,1225055.7,551581.05
14277,1984-12-17,163.61,0.92,0.56,172.65,-5.24,True,1,7531,-163.61,-673638.26,1232146.91,558508.65
14278,1984-12-18,168.11,4.5,2.75,172.65,-2.63,True,1,7532,-168.11,-673806.37,1266204.52,592398.15
14279,1984-12-19,167.16,-0.95,-0.56,172.65,-3.18,True,1,7533,-167.16,-673973.53,1259216.28,585242.75
14280,1984-12-20,166.38,-0.78,-0.47,172.65,-3.63,True,1,7534,-166.38,-674139.91,1253506.92,579367.01
14281,1984-12-21,165.51,-0.87,-0.52,172.65,-4.14,True,1,7535,-165.51,-674305.42,1247117.85,572812.43
14282,1984-12-24,166.76,1.25,0.76,172.65,-3.41,True,1,7536,-166.76,-674472.18,1256703.36,582231.18
14283,1984-12-26,166.47,-0.29,-0.17,172.65,-3.58,True,1,7537,-166.47,-674638.65,1254684.39,580045.74
14284,1984-12-27,165.75,-0.72,-0.43,172.65,-4.0,True,1,7538,-165.75,-674804.4,1249423.5,574619.1
14285,1984-12-28,166.26,0.51,0.31,172.65,-3.7,True,1,7539,-166.26,-674970.66,1253434.14,578463.48
14286,1984-12-31,167.24,0.98,0.59,172.65,-3.13,True,1,7540,-167.24,-675137.9,1260989.6,585851.7
14287,1985-01-02,165.37,-1.87,-1.12,172.65,-4.22,True,1,7541,-165.37,-675303.27,1247055.17,571751.9
14288,1985-01-03,164.57,-0.8,-0.48,172.65,-4.68,True,1,7542,-164.57,-675467.84,1241186.94,565719.1
14289,1985-01-04,163.68,-0.89,-0.54,172.65,-5.2,True,1,7543,-163.68,-675631.52,1234638.24,559006.72
14290,1985-01-07,164.24,0.56,0.34,172.65,-4.87,True,1,7544,-164.24,-675795.76,1239026.56,563230.8
14291,1985-01-08,163.99,-0.25,-0.15,172.65,-5.02,True,1,7545,-163.99,-675959.75,1237304.55,561344.8
14292,1985-01-09,165.18,1.19,0.73,172.65,-4.33,True,1,7546,-165.18,-676124.93,1246448.28,570323.35
14293,1985-01-10,168.31,3.13,1.9,172.65,-2.51,True,1,7547,-168.31,-676293.24,1270235.57,593942.33
14294,1985-01-11,167.91,-0.4,-0.24,172.65,-2.74,True,1,7548,-167.91,-676461.15,1267384.68,590923.53
14295,1985-01-14,170.51,2.6,1.55,172.65,-1.24,True,1,7549,-170.51,-676631.66,1287179.99,610548.33
14296,1985-01-15,170.81,0.3,0.18,172.65,-1.07,True,1,7550,-170.81,-676802.47,1289615.5,612813.03
14297,1985-01-16,171.19,0.38,0.22,172.65,-0.85,True,1,7551,-171.19,-676973.66,1292655.69,615682.03
14298,1985-01-17,170.73,-0.46,-0.27,172.65,-1.11,True,1,7552,-170.73,-677144.39,1289352.96,612208.57
14299,1985-01-18,171.32,0.59,0.35,172.65,-0.77,True,1,7553,-171.32,-677315.71,1293979.96,616664.25
14300,1985-01-21,175.23,3.91,2.28,175.23,0.0,True,1,7554,-175.23,-677490.94,1323687.42,646196.48
14301,1985-01-22,175.48,0.25,0.14,175.48,0.0,True,1,7555,-175.48,-677666.42,1325751.4,648084.98
14302,1985-01-23,177.3,1.82,1.04,177.3,0.0,True,1,7556,-177.3,-677843.72,1339678.8,661835.08
14303,1985-01-24,176.71,-0.59,-0.33,177.3,-0.33,True,1,7557,-176.71,-678020.43,1335397.47,657377.04
14304,1985-01-25,177.35,0.64,0.36,177.35,0.0,True,1,7558,-177.35,-678197.78,1340411.3,662213.52
14305,1985-01-28,177.4,0.05,0.03,177.4,0.0,True,1,7559,-177.4,-678375.18,1340966.6,662591.42
14306,1985-01-29,179.18,1.78,1.0,179.18,0.0,True,1,7560,-179.18,-678554.36,1354600.8,676046.44
14307,1985-01-30,179.39,0.21,0.12,179.39,0.0,True,1,7561,-179.39,-678733.75,1356367.79,677634.04
14308,1985-01-31,179.63,0.24,0.13,179.63,0.0,True,1,7562,-179.63,-678913.38,1358362.06,679448.68
14309,1985-02-01,178.63,-1.0,-0.56,179.63,-0.56,True,1,7563,-178.63,-679092.01,1350978.69,671886.68
14310,1985-02-04,180.35,1.72,0.96,180.35,0.0,True,1,7564,-180.35,-679272.36,1364167.4,684895.04
14311,1985-02-05,180.61,0.26,0.14,180.61,0.0,True,1,7565,-180.61,-679452.97,1366314.65,686861.68
14312,1985-02-06,180.43,-0.18,-0.1,180.61,-0.1,True,1,7566,-180.43,-679633.4,1365133.38,685499.98
14313,1985-02-07,181.82,1.39,0.77,181.82,0.0,True,1,7567,-181.82,-679815.22,1375831.94,696016.72
14314,1985-02-08,182.19,0.37,0.2,182.19,0.0,True,1,7568,-182.19,-679997.41,1378813.92,698816.51
14315,1985-02-11,180.51,-1.68,-0.92,182.19,-0.92,True,1,7569,-180.51,-680177.92,1366280.19,686102.27
14316,1985-02-12,180.56,0.05,0.03,182.19,-0.9,True,1,7570,-180.56,-680358.48,1366839.2,686480.72
14317,1985-02-13,183.35,2.79,1.54,183.35,0.0,True,1,7571,-183.35,-680541.83,1388142.85,707601.02
14318,1985-02-14,182.41,-0.94,-0.51,183.35,-0.51,True,1,7572,-182.41,-680724.24,1381208.52,700484.28
14319,1985-02-15,181.6,-0.81,-0.44,183.35,-0.95,True,1,7573,-181.6,-680905.84,1375256.8,694350.96
14320,1985-02-19,181.33,-0.27,-0.15,183.35,-1.1,True,1,7574,-181.33,-681087.17,1373393.42,692306.25
14321,1985-02-20,181.18,-0.15,-0.08,183.35,-1.18,True,1,7575,-181.18,-681268.35,1372438.5,691170.15
14322,1985-02-21,180.19,-0.99,-0.55,183.35,-1.72,True,1,7576,-180.19,-681448.54,1365119.44,683670.9
14323,1985-02-22,179.36,-0.83,-0.46,183.35,-2.18,True,1,7577,-179.36,-681627.9,1359010.72,677382.82
14324,1985-02-25,179.23,-0.13,-0.07,183.35,-2.25,True,1,7578,-179.23,-681807.13,1358204.94,676397.81
14325,1985-02-26,181.17,1.94,1.08,183.35,-1.19,True,1,7579,-181.17,-681988.3,1373087.43,691099.13
14326,1985-02-27,180.71,-0.46,-0.25,183.35,-1.44,True,1,7580,-180.71,-682169.01,1369781.8,687612.79
14327,1985-02-28,181.18,0.47,0.26,183.35,-1.18,True,1,7581,-181.18,-682350.19,1373525.58,691175.39
14328,1985-03-01,183.23,2.05,1.13,183.35,-0.06,True,1,7582,-183.23,-682533.42,1389249.86,706716.44
14329,1985-03-04,182.06,-1.17,-0.64,183.35,-0.7,True,1,7583,-182.06,-682715.48,1380560.98,697845.5
14330,1985-03-05,182.23,0.17,0.09,183.35,-0.61,True,1,7584,-182.23,-682897.71,1382032.32,699134.61
14331,1985-03-06,180.65,-1.58,-0.87,183.35,-1.47,True,1,7585,-180.65,-683078.36,1370230.25,687151.89
14332,1985-03-07,179.51,-1.14,-0.63,183.35,-2.09,True,1,7586,-179.51,-683257.87,1361762.86,678504.99
14333,1985-03-08,179.1,-0.41,-0.23,183.35,-2.32,True,1,7587,-179.1,-683436.97,1358831.7,675394.73
14334,1985-03-11,178.79,-0.31,-0.17,183.35,-2.49,True,1,7588,-178.79,-683615.76,1356658.52,673042.76
14335,1985-03-12,179.66,0.87,0.49,183.35,-2.01,True,1,7589,-179.66,-683795.42,1363439.74,679644.32
14336,1985-03-13,178.19,-1.47,-0.82,183.35,-2.81,True,1,7590,-178.19,-683973.61,1352462.1,668488.49
14337,1985-03-14,177.84,-0.35,-0.2,183.35,-3.0,True,1,7591,-177.84,-684151.45,1349983.44,665831.99
14338,1985-03-15,176.53,-1.31,-0.74,183.35,-3.72,True,1,7592,-176.53,-684327.98,1340215.76,655887.78
14339,1985-03-18,176.88,0.35,0.2,183.35,-3.53,True,1,7593,-176.88,-684504.86,1343049.84,658544.98
14340,1985-03-19,179.54,2.66,1.5,183.35,-2.08,True,1,7594,-179.54,-684684.4,1363426.76,678742.36
14341,1985-03-20,179.08,-0.46,-0.26,183.35,-2.33,True,1,7595,-179.08,-684863.48,1360112.6,675249.12
14342,1985-03-21,179.35,0.27,0.15,183.35,-2.18,True,1,7596,-179.35,-685042.83,1362342.6,677299.77
14343,1985-03-22,179.04,-0.31,-0.17,183.35,-2.35,True,1,7597,-179.04,-685221.87,1360166.88,674945.01
14344,1985-03-25,177.97,-1.07,-0.6,183.35,-2.93,True,1,7598,-177.97,-685399.84,1352216.06,666816.22
14345,1985-03-26,178.43,0.46,0.26,183.35,-2.68,True,1,7599,-178.43,-685578.27,1355889.57,670311.3
14346,1985-03-27,179.54,1.11,0.62,183.35,-2.08,True,1,7600,-179.54,-685757.81,1364504.0,678746.19
14347,1985-03-28,179.54,0.0,0.0,183.35,-2.08,True,1,7601,-179.54,-685937.35,1364683.54,678746.19
14348,1985-03-29,180.66,1.12,0.62,183.35,-1.47,True,1,7602,-180.66,-686118.01,1373377.32,687259.31
14349,1985-04-01,181.27,0.61,0.34,183.35,-1.13,True,1,7603,-181.27,-686299.28,1378195.81,691896.53
14350,1985-04-02,180.53,-0.74,-0.41,183.35,-1.54,True,1,7604,-180.53,-686479.81,1372750.12,686270.31
14351,1985-04-03,179.11,-1.42,-0.79,183.35,-2.31,True,1,7605,-179.11,-686658.92,1362131.55,675472.63
14352,1985-04-04,179.03,-0.08,-0.04,183.35,-2.36,True,1,7606,-179.03,-686837.95,1361702.18,674864.23
14353,1985-04-08,178.03,-1.0,-0.56,183.35,-2.9,True,1,7607,-178.03,-687015.98,1354274.21,667258.23
14354,1985-04-09,178.21,0.18,0.1,183.35,-2.8,True,1,7608,-178.21,-687194.19,1355821.68,668627.49
14355,1985-04-10,179.42,1.21,0.68,183.35,-2.14,True,1,7609,-179.42,-687373.61,1365206.78,677833.17
14356,1985-04-11,180.19,0.77,0.43,183.35,-1.72,True,1,7610,-180.19,-687553.8,1371245.9,683692.1
14357,1985-04-12,180.54,0.35,0.19,183.35,-1.53,True,1,7611,-180.54,-687734.34,1374089.94,686355.6
14358,1985-04-15,180.92,0.38,0.21,183.35,-1.32,True,1,7612,-180.92,-687915.26,1377163.04,689247.78
14359,1985-04-16,181.2,0.28,0.16,183.35,-1.17,True,1,7613,-181.2,-688096.46,1379475.6,691379.14
14360,1985-04-17,181.68,0.48,0.26,183.35,-0.91,True,1,7614,-181.68,-688278.14,1383311.52,695033.38
14361,1985-04-18,180.84,-0.84,-0.46,183.35,-1.37,True,1,7615,-180.84,-688458.98,1377096.6,688637.62
14362,1985-04-19,181.11,0.27,0.15,183.35,-1.22,True,1,7616,-181.11,-688640.09,1379333.76,690693.67
14363,1985-04-22,180.7,-0.41,-0.23,183.35,-1.44,True,1,7617,-180.7,-688820.79,1376391.9,687571.11
14364,1985-04-23,181.88,1.18,0.65,183.35,-0.8,True,1,7618,-181.88,-689002.67,1385561.84,696559.17
14365,1985-04-24,182.26,0.38,0.21,183.35,-0.59,True,1,7619,-182.26,-689184.93,1388638.94,699454.01
14366,1985-04-25,183.43,1.17,0.64,183.43,0.0,True,1,7620,-183.43,-689368.36,1397736.6,708368.24
14367,1985-04-26,182.18,-1.25,-0.68,183.43,-0.68,True,1,7621,-182.18,-689550.54,1388393.78,698843.24
14368,1985-04-29,180.63,-1.55,-0.85,183.43,-1.53,True,1,7622,-180.63,-689731.17,1376761.86,687030.69
14369,1985-04-30,179.83,-0.8,-0.44,183.43,-1.96,True,1,7623,-179.83,-689911.0,1370844.09,680933.09
14370,1985-05-01,178.37,-1.46,-0.81,183.43,-2.76,True,1,7624,-178.37,-690089.37,1359892.88,669803.51
14371,1985-05-02,179.01,0.64,0.36,183.43,-2.41,True,1,7625,-179.01,-690268.38,1364951.25,674682.87
14372,1985-05-03,180.08,1.07,0.6,183.43,-1.83,True,1,7626,-180.08,-690448.46,1373290.08,682841.62
14373,1985-05-06,179.99,-0.09,-0.05,183.43,-1.88,True,1,7627,-179.99,-690628.45,1372783.73,682155.28
14374,1985-05-07,180.76,0.77,0.43,183.43,-1.46,True,1,7628,-180.76,-690809.21,1378837.28,688028.07
14375,1985-05-08,180.62,-0.14,-0.08,183.43,-1.53,True,1,7629,-180.62,-690989.83,1377949.98,686960.15
14376,1985-05-09,181.92,1.3,0.72,183.43,-0.82,True,1,7630,-181.92,-691171.75,1388049.6,696877.85
14377,1985-05-10,184.28,2.36,1.3,184.28,0.0,True,1,7631,-184.28,-691356.03,1406240.68,714884.65
14378,1985-05-13,184.61,0.33,0.18,184.61,0.0,True,1,7632,-184.61,-691540.64,1408943.52,717402.88
14379,1985-05-14,183.87,-0.74,-0.4,184.61,-0.4,True,1,7633,-183.87,-691724.51,1403479.71,711755.2
14380,1985-05-15,184.54,0.67,0.36,184.61,-0.04,True,1,7634,-184.54,-691909.05,1408778.36,716869.31
14381,1985-05-16,185.66,1.12,0.61,185.66,0.0,True,1,7635,-185.66,-692094.71,1417514.1,725419.39
14382,1985-05-17,187.42,1.76,0.95,187.42,0.0,True,1,7636,-187.42,-692282.13,1431139.12,738856.99
14383,1985-05-20,189.72,2.3,1.23,189.72,0.0,True,1,7637,-189.72,-692471.85,1448891.64,756419.79
14384,1985-05-21,189.64,-0.08,-0.04,189.72,-0.04,True,1,7638,-189.64,-692661.49,1448470.32,755808.83
14385,1985-05-22,188.56,-1.08,-0.57,189.72,-0.61,True,1,7639,-188.56,-692850.05,1440409.84,747559.79
14386,1985-05-23,187.6,-0.96,-0.51,189.72,-1.12,True,1,7640,-187.6,-693037.65,1433264.0,740226.35
14387,1985-05-24,188.29,0.69,0.37,189.72,-0.75,True,1,7641,-188.29,-693225.94,1438723.89,745497.95
14388,1985-05-28,187.86,-0.43,-0.23,189.72,-0.98,True,1,7642,-187.86,-693413.8,1435626.12,742212.32
14389,1985-05-29,187.68,-0.18,-0.1,189.72,-1.08,True,1,7643,-187.68,-693601.48,1434438.24,740836.76
14390,1985-05-30,187.75,0.07,0.04,189.72,-1.04,True,1,7644,-187.75,-693789.23,1435161.0,741371.77
14391,1985-05-31,189.55,1.8,0.96,189.72,-0.09,True,1,7645,-189.55,-693978.78,1449109.75,755130.97
14392,1985-06-03,189.32,-0.23,-0.12,189.72,-0.21,True,1,7646,-189.32,-694168.1,1447540.72,753372.62
14393,1985-06-04,190.04,0.72,0.38,190.04,0.0,True,1,7647,-190.04,-694358.14,1453235.88,758877.74
14394,1985-06-05,190.16,0.12,0.06,190.16,0.0,True,1,7648,-190.16,-694548.3,1454343.68,759795.38
14395,1985-06-06,191.06,0.9,0.47,191.06,0.0,True,1,7649,-191.06,-694739.36,1461417.94,766678.58
14396,1985-06-07,189.68,-1.38,-0.72,191.06,-0.72,True,1,7650,-189.68,-694929.04,1451052.0,756122.96
14397,1985-06-10,189.51,-0.17,-0.09,191.06,-0.81,True,1,7651,-189.51,-695118.55,1449941.01,754822.46
14398,1985-06-11,189.04,-0.47,-0.25,191.06,-1.06,True,1,7652,-189.04,-695307.59,1446534.08,751226.49
14399,1985-06-12,187.61,-1.43,-0.76,191.06,-1.81,True,1,7653,-187.61,-695495.2,1435779.33,740284.13
14400,1985-06-13,185.33,-2.28,-1.22,191.06,-3.0,True,1,7654,-185.33,-695680.53,1418515.82,722835.29
14401,1985-06-14,187.1,1.77,0.96,191.06,-2.07,True,1,7655,-187.1,-695867.63,1432250.5,736382.87
14402,1985-06-17,186.53,-0.57,-0.3,191.06,-2.37,True,1,7656,-186.53,-696054.16,1428073.68,732019.52
14403,1985-06-18,187.34,0.81,0.43,191.06,-1.95,True,1,7657,-187.34,-696241.5,1434462.38,738220.88
14404,1985-06-19,186.63,-0.71,-0.38,191.06,-2.32,True,1,7658,-186.63,-696428.13,1429212.54,732784.41
14405,1985-06-20,186.73,0.1,0.05,191.06,-2.27,True,1,7659,-186.73,-696614.86,1430165.07,733550.21
14406,1985-06-21,189.61,2.88,1.54,191.06,-0.76,True,1,7660,-189.61,-696804.47,1452412.6,755608.13
14407,1985-06-24,189.15,-0.46,-0.24,191.06,-1.0,True,1,7661,-189.15,-696993.62,1449078.15,752084.53
14408,1985-06-25,189.74,0.59,0.31,191.06,-0.69,True,1,7662,-189.74,-697183.36,1453787.88,756604.52
14409,1985-06-26,190.06,0.32,0.17,191.06,-0.52,True,1,7663,-190.06,-697373.42,1456429.78,759056.36
14410,1985-06-27,191.23,1.17,0.62,191.23,0.0,True,1,7664,-191.23,-697564.65,1465586.72,768022.07
14411,1985-06-28,191.85,0.62,0.32,191.85,0.0,True,1,7665,-191.85,-697756.5,1470530.25,772773.75
14412,1985-07-01,192.43,0.58,0.3,192.43,0.0,True,1,7666,-192.43,-697948.93,1475168.38,777219.45
14413,1985-07-02,192.01,-0.42,-0.22,192.43,-0.22,True,1,7667,-192.01,-698140.94,1472140.67,773999.73
14414,1985-07-03,191.45,-0.56,-0.29,192.43,-0.51,True,1,7668,-191.45,-698332.39,1468038.6,769706.21
14415,1985-07-05,192.52,1.07,0.56,192.52,0.0,True,1,7669,-192.52,-698524.91,1476435.88,777910.97
14416,1985-07-08,191.93,-0.59,-0.31,192.52,-0.31,True,1,7670,-191.93,-698716.84,1472103.1,773386.26
14417,1985-07-09,191.05,-0.88,-0.46,192.52,-0.76,True,1,7671,-191.05,-698907.89,1465544.55,766636.66
14418,1985-07-10,192.37,1.32,0.69,192.52,-0.08,True,1,7672,-192.37,-699100.26,1475862.64,776762.38
14419,1985-07-11,192.94,0.57,0.3,192.94,0.0,True,1,7673,-192.94,-699293.2,1480428.62,781135.42
14420,1985-07-12,193.29,0.35,0.18,193.29,0.0,True,1,7674,-193.29,-699486.49,1483307.46,783820.97
14421,1985-07-15,192.72,-0.57,-0.3,193.29,-0.3,True,1,7675,-192.72,-699679.21,1479126.0,779446.79
14422,1985-07-16,194.72,2.0,1.04,194.72,0.0,True,1,7676,-194.72,-699873.93,1494670.72,794796.79
14423,1985-07-17,195.65,0.93,0.48,195.65,0.0,True,1,7677,-195.65,-700069.58,1502005.05,801935.47
14424,1985-07-18,194.38,-1.27,-0.65,195.65,-0.65,True,1,7678,-194.38,-700263.96,1492449.64,792185.68
14425,1985-07-19,195.13,0.75,0.39,195.65,-0.27,True,1,7679,-195.13,-700459.09,1498403.27,797944.18
14426,1985-07-22,194.35,-0.78,-0.4,195.65,-0.66,True,1,7680,-194.35,-700653.44,1492608.0,791954.56
14427,1985-07-23,192.55,-1.8,-0.93,195.65,-1.58,True,1,7681,-192.55,-700845.99,1478976.55,778130.56
14428,1985-07-24,191.58,-0.97,-0.5,195.65,-2.08,True,1,7682,-191.58,-701037.57,1471717.56,770679.99
14429,1985-07-25,192.06,0.48,0.25,195.65,-1.84,True,1,7683,-192.06,-701229.63,1475596.98,774367.35
14430,1985-07-26,192.4,0.34,0.18,195.65,-1.66,True,1,7684,-192.4,-701422.03,1478401.6,776979.57
14431,1985-07-29,189.6,-2.8,-1.46,195.65,-3.09,True,1,7685,-189.6,-701611.63,1457076.0,755464.37
14432,1985-07-30,189.93,0.33,0.17,195.65,-2.92,True,1,7686,-189.93,-701801.56,1459801.98,758000.42
14433,1985-07-31,190.92,0.99,0.52,195.65,-2.42,True,1,7687,-190.92,-701992.48,1467602.04,765609.56
14434,1985-08-01,192.11,1.19,0.62,195.65,-1.81,True,1,7688,-192.11,-702184.59,1476941.68,774757.09
14435,1985-08-02,191.48,-0.63,-0.33,195.65,-2.13,True,1,7689,-191.48,-702376.07,1472289.72,769913.65
14436,1985-08-05,190.62,-0.86,-0.45,195.65,-2.57,True,1,7690,-190.62,-702566.69,1465867.8,763301.11
14437,1985-08-06,187.93,-2.69,-1.41,195.65,-3.95,True,1,7691,-187.93,-702754.62,1445369.63,742615.01
14438,1985-08-07,187.68,-0.25,-0.13,195.65,-4.07,True,1,7692,-187.68,-702942.3,1443634.56,740692.26
14439,1985-08-08,188.95,1.27,0.68,195.65,-3.42,True,1,7693,-188.95,-703131.25,1453592.35,750461.1
14440,1985-08-09,188.32,-0.63,-0.33,195.65,-3.75,True,1,7694,-188.32,-703319.57,1448934.08,745614.51
14441,1985-08-12,187.63,-0.69,-0.37,195.65,-4.1,True,1,7695,-187.63,-703507.2,1443812.85,740305.65
14442,1985-08-13,187.3,-0.33,-0.18,195.65,-4.27,True,1,7696,-187.3,-703694.5,1441460.8,737766.3
14443,1985-08-14,187.41,0.11,0.06,195.65,-4.21,True,1,7697,-187.41,-703881.91,1442494.77,738612.86
14444,1985-08-15,187.26,-0.15,-0.08,195.65,-4.29,True,1,7698,-187.26,-704069.17,1441527.48,737458.31
14445,1985-08-16,186.1,-1.16,-0.62,195.65,-4.88,True,1,7699,-186.1,-704255.27,1432783.9,728528.63
14446,1985-08-19,186.38,0.28,0.15,195.65,-4.74,True,1,7700,-186.38,-704441.65,1435126.0,730684.35
14447,1985-08-20,188.08,1.7,0.91,195.65,-3.87,True,1,7701,-188.08,-704629.73,1448404.08,743774.35
14448,1985-08-21,189.16,1.08,0.57,195.65,-3.32,True,1,7702,-189.16,-704818.89,1456910.32,752091.43
14449,1985-08-22,187.36,-1.8,-0.95,195.65,-4.24,True,1,7703,-187.36,-705006.25,1443234.08,738227.83
14450,1985-08-23,187.17,-0.19,-0.1,195.65,-4.33,True,1,7704,-187.17,-705193.42,1441957.68,736764.26
14451,1985-08-26,187.31,0.14,0.08,195.65,-4.26,True,1,7705,-187.31,-705380.73,1443223.55,737842.82
14452,1985-08-27,188.1,0.79,0.42,195.65,-3.86,True,1,7706,-188.1,-705568.83,1449498.6,743929.77
14453,1985-08-28,188.83,0.73,0.39,195.65,-3.49,True,1,7707,-188.83,-705757.66,1455312.81,749555.15
14454,1985-08-29,188.93,0.1,0.05,195.65,-3.44,True,1,7708,-188.93,-705946.59,1456272.44,750325.85
14455,1985-08-30,188.63,-0.3,-0.16,195.65,-3.59,True,1,7709,-188.63,-706135.22,1454148.67,748013.45
14456,1985-09-03,187.91,-0.72,-0.38,195.65,-3.96,True,1,7710,-187.91,-706323.13,1448786.1,742462.97
14457,1985-09-04,187.37,-0.54,-0.29,195.65,-4.23,True,1,7711,-187.37,-706510.5,1444810.07,738299.57
14458,1985-09-05,187.27,-0.1,-0.05,195.65,-4.28,True,1,7712,-187.27,-706697.77,1444226.24,737528.47
14459,1985-09-06,188.24,0.97,0.52,195.65,-3.79,True,1,7713,-188.24,-706886.01,1451895.12,745009.11
14460,1985-09-09,188.25,0.01,0.0,195.65,-3.78,True,1,7714,-188.25,-707074.26,1452160.5,745086.24
14461,1985-09-10,186.9,-1.35,-0.72,195.65,-4.47,True,1,7715,-186.9,-707261.16,1441933.5,734672.34
14462,1985-09-11,185.03,-1.87,-1.0,195.65,-5.43,True,1,7716,-185.03,-707446.19,1427691.48,720245.29
14463,1985-09-12,183.69,-1.34,-0.72,195.65,-6.11,True,1,7717,-183.69,-707629.88,1417535.73,709905.85
14464,1985-09-13,182.91,-0.78,-0.42,195.65,-6.51,True,1,7718,-182.91,-707812.79,1411699.38,703886.59
14465,1985-09-16,182.88,-0.03,-0.02,195.65,-6.53,True,1,7719,-182.88,-707995.67,1411650.72,703655.05
14466,1985-09-17,181.36,-1.52,-0.83,195.65,-7.3,True,1,7720,-181.36,-708177.03,1400099.2,691922.17
14467,1985-09-18,181.71,0.35,0.19,195.65,-7.12,True,1,7721,-181.71,-708358.74,1402982.91,694624.17
14468,1985-09-19,183.39,1.68,0.92,195.65,-6.27,True,1,7722,-183.39,-708542.13,1416137.58,707595.45
14469,1985-09-20,182.05,-1.34,-0.73,195.65,-6.95,True,1,7723,-182.05,-708724.18,1405972.15,697247.97
14470,1985-09-23,184.3,2.25,1.24,195.65,-5.8,True,1,7724,-184.3,-708908.48,1423533.2,714624.72
14471,1985-09-24,182.62,-1.68,-0.91,195.65,-6.66,True,1,7725,-182.62,-709091.1,1410739.5,701648.4
14472,1985-09-25,180.66,-1.96,-1.07,195.65,-7.66,True,1,7726,-180.66,-709271.76,1395779.16,686507.4
14473,1985-09-26,181.29,0.63,0.35,195.65,-7.34,True,1,7727,-181.29,-709453.05,1400827.83,691374.78
14474,1985-09-30,182.08,0.79,0.44,195.65,-6.94,True,1,7728,-182.08,-709635.13,1407114.24,697479.11
14475,1985-10-01,185.07,2.99,1.64,195.65,-5.41,True,1,7729,-185.07,-709820.2,1430406.03,720585.83
14476,1985-10-02,184.06,-1.01,-0.55,195.65,-5.92,True,1,7730,-184.06,-710004.26,1422783.8,712779.54
14477,1985-10-03,184.36,0.3,0.16,195.65,-5.77,True,1,7731,-184.36,-710188.62,1425287.16,715098.54
14478,1985-10-04,183.22,-1.14,-0.62,195.65,-6.35,True,1,7732,-183.22,-710371.84,1416657.04,706285.2
14479,1985-10-07,181.87,-1.35,-0.74,195.65,-7.04,True,1,7733,-181.87,-710553.71,1406400.71,695847.0
14480,1985-10-08,181.87,0.0,0.0,195.65,-7.04,True,1,7734,-181.87,-710735.58,1406582.58,695847.0
14481,1985-10-09,182.52,0.65,0.36,195.65,-6.71,True,1,7735,-182.52,-710918.1,1411792.2,700874.1
14482,1985-10-10,182.78,0.26,0.14,195.65,-6.58,True,1,7736,-182.78,-711100.88,1413986.08,702885.2
14483,1985-10-11,184.28,1.5,0.82,195.65,-5.81,True,1,7737,-184.28,-711285.16,1425774.36,714489.2
14484,1985-10-14,186.37,2.09,1.13,195.65,-4.74,True,1,7738,-186.37,-711471.53,1442131.06,730659.53
14485,1985-10-15,186.08,-0.29,-0.16,195.65,-4.89,True,1,7739,-186.08,-711657.61,1440073.12,728415.51
14486,1985-10-16,187.98,1.9,1.02,195.65,-3.92,True,1,7740,-187.98,-711845.59,1454965.2,743119.61
14487,1985-10-17,187.66,-0.32,-0.17,195.65,-4.08,True,1,7741,-187.66,-712033.25,1452676.06,740642.81
14488,1985-10-18,187.04,-0.62,-0.33,195.65,-4.4,True,1,7742,-187.04,-712220.29,1448063.68,735843.39
14489,1985-10-21,186.96,-0.08,-0.04,195.65,-4.44,True,1,7743,-186.96,-712407.25,1447631.28,735224.03
14490,1985-10-22,188.04,1.08,0.58,195.65,-3.89,True,1,7744,-188.04,-712595.29,1456181.76,743586.47
14491,1985-10-23,189.09,1.05,0.56,195.65,-3.35,True,1,7745,-189.09,-712784.38,1464502.05,751717.67
14492,1985-10-24,188.5,-0.59,-0.31,195.65,-3.65,True,1,7746,-188.5,-712972.88,1460121.0,747148.12
14493,1985-10-25,187.52,-0.98,-0.52,195.65,-4.16,True,1,7747,-187.52,-713160.4,1452717.44,739557.04
14494,1985-10-28,187.76,0.24,0.13,195.65,-4.03,True,1,7748,-187.76,-713348.16,1454764.48,741416.32
14495,1985-10-29,189.23,1.47,0.78,195.65,-3.28,True,1,7749,-189.23,-713537.39,1466343.27,752805.88
14496,1985-10-30,190.07,0.84,0.44,195.65,-2.85,True,1,7750,-190.07,-713727.46,1473042.5,759315.04
14497,1985-10-31,189.82,-0.25,-0.13,195.65,-2.98,True,1,7751,-189.82,-713917.28,1471294.82,757377.54
14498,1985-11-01,191.53,1.71,0.9,195.65,-2.11,True,1,7752,-191.53,-714108.81,1484740.56,770631.75
14499,1985-11-04,191.25,-0.28,-0.15,195.65,-2.25,True,1,7753,-191.25,-714300.06,1482761.25,768461.19
14500,1985-11-05,192.37,1.12,0.59,195.65,-1.68,True,1,7754,-192.37,-714492.43,1491636.98,777144.55
14501,1985-11-06,192.76,0.39,0.2,195.65,-1.48,True,1,7755,-192.76,-714685.19,1494853.8,780168.61
14502,1985-11-07,192.62,-0.14,-0.07,195.65,-1.55,True,1,7756,-192.62,-714877.81,1493960.72,779082.91
14503,1985-11-08,193.72,1.1,0.57,195.65,-0.99,True,1,7757,-193.72,-715071.53,1502686.04,787614.51
14504,1985-11-11,197.28,3.56,1.84,197.28,0.0,True,1,7758,-197.28,-715268.81,1530498.24,815229.43
14505,1985-11-12,198.08,0.8,0.41,198.08,0.0,True,1,7759,-198.08,-715466.89,1536902.72,821435.83
14506,1985-11-13,197.1,-0.98,-0.5,198.08,-0.5,True,1,7760,-197.1,-715663.99,1529496.0,813832.01
14507,1985-11-14,199.06,1.96,0.99,199.06,0.0,True,1,7761,-199.06,-715863.05,1544904.66,829041.61
14508,1985-11-15,198.11,-0.95,-0.48,199.06,-0.48,True,1,7762,-198.11,-716061.16,1537729.82,821668.66
14509,1985-11-18,198.71,0.6,0.3,199.06,-0.18,True,1,7763,-198.71,-716259.87,1542585.73,826325.86
14510,1985-11-19,198.67,-0.04,-0.02,199.06,-0.2,True,1,7764,-198.67,-716458.54,1542473.88,826015.34
14511,1985-11-20,198.99,0.32,0.16,199.06,-0.04,True,1,7765,-198.99,-716657.53,1545157.35,828499.82
14512,1985-11-21,201.41,2.42,1.22,201.41,0.0,True,1,7766,-201.41,-716858.94,1564150.06,847291.12
14513,1985-11-22,201.52,0.11,0.06,201.52,0.0,True,1,7767,-201.52,-717060.46,1565205.84,848145.38
14514,1985-11-25,200.35,-1.17,-0.58,201.52,-0.58,True,1,7768,-200.35,-717260.81,1556318.8,839057.99
14515,1985-11-26,200.67,0.32,0.16,201.52,-0.42,True,1,7769,-200.67,-717461.48,1559005.23,841543.75
14516,1985-11-27,202.54,1.87,0.93,202.54,0.0,True,1,7770,-202.54,-717664.02,1573735.8,856071.78
14517,1985-11-29,202.17,-0.37,-0.18,202.54,-0.18,True,1,7771,-202.17,-717866.19,1571063.07,853196.88
14518,1985-12-02,200.46,-1.71,-0.85,202.54,-1.03,True,1,7772,-200.46,-718066.65,1557975.12,839908.47
14519,1985-12-03,200.86,0.4,0.2,202.54,-0.83,True,1,7773,-200.86,-718267.51,1561284.78,843017.27
14520,1985-12-04,204.23,3.37,1.68,204.23,0.0,True,1,7774,-204.23,-718471.74,1587684.02,869212.28
14521,1985-12-05,203.88,-0.35,-0.17,204.23,-0.17,True,1,7775,-203.88,-718675.62,1585167.0,866491.38
14522,1985-12-06,202.99,-0.89,-0.44,204.23,-0.61,True,1,7776,-202.99,-718878.61,1578450.24,859571.63
14523,1985-12-09,204.25,1.26,0.62,204.25,0.0,True,1,7777,-204.25,-719082.86,1588452.25,869369.39
14524,1985-12-10,204.39,0.14,0.07,204.39,0.0,True,1,7778,-204.39,-719287.25,1589745.42,870458.17
14525,1985-12-11,206.31,1.92,0.94,206.31,0.0,True,1,7779,-206.31,-719493.56,1604885.49,885391.93
14526,1985-12-12,206.73,0.42,0.2,206.73,0.0,True,1,7780,-206.73,-719700.29,1608359.4,888659.11
14527,1985-12-13,209.94,3.21,1.55,209.94,0.0,True,1,7781,-209.94,-719910.23,1633543.14,913632.91
14528,1985-12-16,212.02,2.08,0.99,212.02,0.0,True,1,7782,-212.02,-720122.25,1649939.64,929817.39
14529,1985-12-17,210.65,-1.37,-0.65,212.02,-0.65,True,1,7783,-210.65,-720332.9,1639488.95,919156.05
14530,1985-12-18,209.81,-0.84,-0.4,212.02,-1.04,True,1,7784,-209.81,-720542.71,1633161.04,912618.33
14531,1985-12-19,210.02,0.21,0.1,212.02,-0.94,True,1,7785,-210.02,-720752.73,1635005.7,914252.97
14532,1985-12-20,210.94,0.92,0.44,212.02,-0.51,True,1,7786,-210.94,-720963.67,1642378.84,921415.17
14533,1985-12-23,208.57,-2.37,-1.12,212.02,-1.63,True,1,7787,-208.57,-721172.24,1624134.59,902962.35
14534,1985-12-24,207.14,-1.43,-0.69,212.02,-2.3,True,1,7788,-207.14,-721379.38,1613206.32,891826.94
14535,1985-12-26,207.65,0.51,0.25,212.02,-2.06,True,1,7789,-207.65,-721587.03,1617385.85,895798.82
14536,1985-12-27,209.61,1.96,0.94,212.02,-1.14,True,1,7790,-209.61,-721796.64,1632861.9,911065.26
14537,1985-12-30,210.68,1.07,0.51,212.02,-0.63,True,1,7791,-210.68,-722007.32,1641407.88,919400.56
14538,1985-12-31,211.28,0.6,0.28,212.02,-0.35,True,1,7792,-211.28,-722218.6,1646293.76,924075.16
14539,1986-01-02,209.59,-1.69,-0.8,212.02,-1.15,True,1,7793,-209.59,-722428.19,1633334.87,910906.68
14540,1986-01-03,210.88,1.29,0.62,212.02,-0.54,True,1,7794,-210.88,-722639.07,1643598.72,920959.65
14541,1986-01-06,210.65,-0.23,-0.11,212.02,-0.65,True,1,7795,-210.65,-722849.72,1642016.75,919167.03
14542,1986-01-07,213.8,3.15,1.5,213.8,0.0,True,1,7796,-213.8,-723063.52,1666784.8,943721.28
14543,1986-01-08,207.97,-5.83,-2.73,213.8,-2.73,True,1,7797,-207.97,-723271.49,1621542.09,898270.6
14544,1986-01-09,206.11,-1.86,-0.89,213.8,-3.6,True,1,7798,-206.11,-723477.6,1607245.78,883768.18
14545,1986-01-10,205.96,-0.15,-0.07,213.8,-3.67,True,1,7799,-205.96,-723683.56,1606282.04,882598.48
14546,1986-01-13,206.72,0.76,0.37,213.8,-3.31,True,1,7800,-206.72,-723890.28,1612416.0,888525.72
14547,1986-01-14,206.64,-0.08,-0.04,213.8,-3.35,True,1,7801,-206.64,-724096.92,1611998.64,887901.72
14548,1986-01-15,208.26,1.62,0.78,213.8,-2.59,True,1,7802,-208.26,-724305.18,1624844.52,900539.34
14549,1986-01-16,209.17,0.91,0.44,213.8,-2.17,True,1,7803,-209.17,-724514.35,1632153.51,907639.16
14550,1986-01-17,208.43,-0.74,-0.35,213.8,-2.51,True,1,7804,-208.43,-724722.78,1626587.72,901864.94
14551,1986-01-20,207.53,-0.9,-0.43,213.8,-2.93,True,1,7805,-207.53,-724930.31,1619771.65,894841.34
14552,1986-01-21,205.79,-1.74,-0.84,213.8,-3.75,True,1,7806,-205.79,-725136.1,1606396.74,881260.64
14553,1986-01-22,203.49,-2.3,-1.12,213.8,-4.82,True,1,7807,-203.49,-725339.59,1588646.43,863306.84
14554,1986-01-23,204.25,0.76,0.37,213.8,-4.47,True,1,7808,-204.25,-725543.84,1594784.0,869240.16
14555,1986-01-24,206.43,2.18,1.07,213.8,-3.45,True,1,7809,-206.43,-725750.27,1612011.87,886261.6
14556,1986-01-27,207.39,0.96,0.46,213.8,-3.0,True,1,7810,-207.39,-725957.66,1619715.9,893758.24
14557,1986-01-28,209.81,2.42,1.17,213.8,-1.87,True,1,7811,-209.81,-726167.47,1638825.91,912658.44
14558,1986-01-29,210.29,0.48,0.23,213.8,-1.64,True,1,7812,-210.29,-726377.76,1642785.48,916407.72
14559,1986-01-30,209.33,-0.96,-0.46,213.8,-2.09,True,1,7813,-209.33,-726587.09,1635495.29,908908.2
14560,1986-01-31,211.78,2.45,1.17,213.8,-0.94,True,1,7814,-211.78,-726798.87,1654848.92,928050.05
14561,1986-02-03,213.96,2.18,1.03,213.96,0.0,True,1,7815,-213.96,-727012.83,1672097.4,945084.57
14562,1986-02-04,212.79,-1.17,-0.55,213.96,-0.55,True,1,7816,-212.79,-727225.62,1663166.64,935941.02
14563,1986-02-05,212.96,0.17,0.08,213.96,-0.47,True,1,7817,-212.96,-727438.58,1664708.32,937269.74
14564,1986-02-06,213.47,0.51,0.24,213.96,-0.23,True,1,7818,-213.47,-727652.05,1668908.46,941256.41
14565,1986-02-07,214.56,1.09,0.51,214.56,0.0,True,1,7819,-214.56,-727866.61,1677644.64,949778.03
14566,1986-02-10,216.24,1.68,0.78,216.24,0.0,True,1,7820,-216.24,-728082.85,1690996.8,962913.95
14567,1986-02-11,215.92,-0.32,-0.15,216.24,-0.15,True,1,7821,-215.92,-728298.77,1688710.32,960411.55
14568,1986-02-12,215.97,0.05,0.02,216.24,-0.12,True,1,7822,-215.97,-728514.74,1689317.34,960802.6
14569,1986-02-13,217.4,1.43,0.66,217.4,0.0,True,1,7823,-217.4,-728732.14,1700720.2,971988.06
14570,1986-02-14,219.76,2.36,1.09,219.76,0.0,True,1,7824,-219.76,-728951.9,1719402.24,990450.34
14571,1986-02-18,222.45,2.69,1.22,222.45,0.0,True,1,7825,-222.45,-729174.35,1740671.25,1011496.9
14572,1986-02-19,219.76,-2.69,-1.21,222.45,-1.21,True,1,7826,-219.76,-729394.11,1719841.76,990447.65
14573,1986-02-20,222.22,2.46,1.12,222.45,-0.1,True,1,7827,-222.22,-729616.33,1739315.94,1009699.61
14574,1986-02-21,224.62,2.4,1.08,224.62,0.0,True,1,7828,-224.62,-729840.95,1758325.36,1028484.41
14575,1986-02-24,224.34,-0.28,-0.12,224.62,-0.12,True,1,7829,-224.34,-730065.29,1756357.86,1026292.57
14576,1986-02-25,223.79,-0.55,-0.24,224.62,-0.37,True,1,7830,-223.79,-730289.08,1752275.7,1021986.62
14577,1986-02-26,224.04,0.25,0.11,224.62,-0.26,True,1,7831,-224.04,-730513.12,1754457.24,1023944.12
14578,1986-02-27,226.77,2.73,1.22,226.77,0.0,True,1,7832,-226.77,-730739.89,1776062.64,1045322.75
14579,1986-02-28,226.92,0.15,0.07,226.92,0.0,True,1,7833,-226.92,-730966.81,1777464.36,1046497.55
14580,1986-03-03,225.42,-1.5,-0.66,226.92,-0.66,True,1,7834,-225.42,-731192.23,1765940.28,1034748.05
14581,1986-03-04,224.38,-1.04,-0.46,226.92,-1.12,True,1,7835,-224.38,-731416.61,1758017.3,1026600.69
14582,1986-03-05,224.34,-0.04,-0.02,226.92,-1.14,True,1,7836,-224.34,-731640.95,1757928.24,1026287.29
14583,1986-03-06,225.13,0.79,0.35,226.92,-0.79,True,1,7837,-225.13,-731866.08,1764343.81,1032477.73
14584,1986-03-07,225.57,0.44,0.2,226.92,-0.6,True,1,7838,-225.57,-732091.65,1768017.66,1035926.01
14585,1986-03-10,226.58,1.01,0.45,226.92,-0.15,True,1,7839,-226.58,-732318.23,1776160.62,1043842.39
14586,1986-03-11,231.69,5.11,2.26,231.69,0.0,True,1,7840,-231.69,-732549.92,1816449.6,1083899.68
14587,1986-03-12,232.54,0.85,0.37,232.54,0.0,True,1,7841,-232.54,-732782.46,1823346.14,1090563.68
14588,1986-03-13,233.19,0.65,0.28,233.19,0.0,True,1,7842,-233.19,-733015.65,1828675.98,1095660.33
14589,1986-03-14,236.55,3.36,1.44,236.55,0.0,True,1,7843,-236.55,-733252.2,1855261.65,1122009.45
14590,1986-03-17,234.67,-1.88,-0.8,236.55,-0.8,True,1,7844,-234.67,-733486.87,1840751.48,1107264.61
14591,1986-03-18,235.78,1.11,0.47,236.55,-0.33,True,1,7845,-235.78,-733722.65,1849694.1,1115971.45
14592,1986-03-19,235.6,-0.18,-0.08,236.55,-0.4,True,1,7846,-235.6,-733958.25,1848517.6,1114559.35
14593,1986-03-20,236.54,0.94,0.4,236.55,-0.0,True,1,7847,-236.54,-734194.79,1856129.38,1121934.59
14594,1986-03-21,233.34,-3.2,-1.35,236.55,-1.36,True,1,7848,-233.34,-734428.13,1831252.32,1096824.19
14595,1986-03-24,235.33,1.99,0.85,236.55,-0.52,True,1,7849,-235.33,-734663.46,1847105.17,1112441.71
14596,1986-03-25,234.72,-0.61,-0.26,236.55,-0.77,True,1,7850,-234.72,-734898.18,1842552.0,1107653.82
14597,1986-03-26,237.3,2.58,1.1,237.3,0.0,True,1,7851,-237.3,-735135.48,1863042.3,1127906.82
14598,1986-03-27,238.97,1.67,0.7,238.97,0.0,True,1,7852,-238.97,-735374.45,1876392.44,1141017.99
14599,1986-03-31,238.9,-0.07,-0.03,238.97,-0.03,True,1,7853,-238.9,-735613.35,1876081.7,1140468.35
14600,1986-04-01,235.14,-3.76,-1.57,238.97,-1.6,True,1,7854,-235.14,-735848.49,1846789.56,1110941.07
14601,1986-04-02,235.71,0.57,0.24,238.97,-1.36,True,1,7855,-235.71,-736084.2,1851502.05,1115417.85
14602,1986-04-03,232.47,-3.24,-1.38,238.97,-2.72,True,1,7856,-232.47,-736316.67,1826284.32,1089967.65
14603,1986-04-04,228.69,-3.78,-1.63,238.97,-4.3,True,1,7857,-228.69,-736545.36,1796817.33,1060271.97
14604,1986-04-07,228.63,-0.06,-0.03,238.97,-4.33,True,1,7858,-228.63,-736773.99,1796574.54,1059800.55
14605,1986-04-08,233.52,4.89,2.14,238.97,-2.28,True,1,7859,-233.52,-737007.51,1835233.68,1098226.17
14606,1986-04-09,233.75,0.23,0.1,238.97,-2.18,True,1,7860,-233.75,-737241.26,1837275.0,1100033.74
14607,1986-04-10,236.44,2.69,1.15,238.97,-1.06,True,1,7861,-236.44,-737477.7,1858654.84,1121177.14
14608,1986-04-11,235.97,-0.47,-0.2,238.97,-1.25,True,1,7862,-235.97,-737713.67,1855196.14,1117482.47
14609,1986-04-14,237.28,1.31,0.56,238.97,-0.71,True,1,7863,-237.28,-737950.95,1865732.64,1127781.69
14610,1986-04-15,237.73,0.45,0.19,238.97,-0.52,True,1,7864,-237.73,-738188.68,1869508.72,1131320.04
14611,1986-04-16,242.22,4.49,1.89,242.22,0.0,True,1,7865,-242.22,-738430.9,1905060.3,1166629.4
14612,1986-04-17,243.03,0.81,0.33,243.03,0.0,True,1,7866,-243.03,-738673.93,1911673.98,1173000.05
14613,1986-04-18,242.38,-0.65,-0.27,243.03,-0.27,True,1,7867,-242.38,-738916.31,1906803.46,1167887.15
14614,1986-04-21,244.74,2.36,0.97,244.74,0.0,True,1,7868,-244.74,-739161.05,1925614.32,1186453.27
14615,1986-04-22,242.42,-2.32,-0.95,244.74,-0.95,True,1,7869,-242.42,-739403.47,1907602.98,1168199.51
14616,1986-04-23,241.75,-0.67,-0.28,244.74,-1.22,True,1,7870,-241.75,-739645.22,1902572.5,1162927.28
14617,1986-04-24,242.02,0.27,0.11,244.74,-1.11,True,1,7871,-242.02,-739887.24,1904939.42,1165052.18
14618,1986-04-25,242.29,0.27,0.11,244.74,-1.0,True,1,7872,-242.29,-740129.53,1907306.88,1167177.35
14619,1986-04-28,243.08,0.79,0.33,244.74,-0.68,True,1,7873,-243.08,-740372.61,1913768.84,1173396.23
14620,1986-04-29,240.51,-2.57,-1.06,244.74,-1.73,True,1,7874,-240.51,-740613.12,1893775.74,1153162.62
14621,1986-04-30,235.52,-4.99,-2.08,244.74,-3.77,True,1,7875,-235.52,-740848.64,1854720.0,1113871.36
14622,1986-05-01,235.16,-0.36,-0.15,244.74,-3.91,True,1,7876,-235.16,-741083.8,1852120.16,1111036.36
14623,1986-05-02,234.79,-0.37,-0.16,244.74,-4.07,True,1,7877,-234.79,-741318.59,1849440.83,1108122.24
14624,1986-05-05,237.73,2.94,1.25,244.74,-2.86,True,1,7878,-237.73,-741556.32,1872836.94,1131280.62
14625,1986-05-06,237.24,-0.49,-0.21,244.74,-3.06,True,1,7879,-237.24,-741793.56,1869213.96,1127420.4
14626,1986-05-07,236.08,-1.16,-0.49,244.74,-3.54,True,1,7880,-236.08,-742029.64,1860310.4,1118280.76
14627,1986-05-08,237.13,1.05,0.44,244.74,-3.11,True,1,7881,-237.13,-742266.77,1868821.53,1126554.76
14628,1986-05-09,237.85,0.72,0.3,244.74,-2.82,True,1,7882,-237.85,-742504.62,1874733.7,1132229.08
14629,1986-05-12,237.58,-0.27,-0.11,244.74,-2.93,True,1,7883,-237.58,-742742.2,1872843.14,1130100.94
14630,1986-05-13,236.41,-1.17,-0.49,244.74,-3.4,True,1,7884,-236.41,-742978.61,1863856.44,1120877.83
14631,1986-05-14,237.54,1.13,0.48,244.74,-2.94,True,1,7885,-237.54,-743216.15,1873002.9,1129786.75
14632,1986-05-15,234.43,-3.11,-1.31,244.74,-4.21,True,1,7886,-234.43,-743450.58,1848714.98,1105264.4
14633,1986-05-16,232.76,-1.67,-0.71,244.74,-4.89,True,1,7887,-232.76,-743683.34,1835778.12,1092094.78
14634,1986-05-19,233.2,0.44,0.19,244.74,-4.72,True,1,7888,-233.2,-743916.54,1839481.6,1095565.06
14635,1986-05-20,236.11,2.91,1.25,244.74,-3.53,True,1,7889,-236.11,-744152.65,1862671.79,1118519.14
14636,1986-05-21,235.45,-0.66,-0.28,244.74,-3.8,True,1,7890,-235.45,-744388.1,1857700.5,1113312.4
14637,1986-05-22,240.12,4.67,1.98,244.74,-1.89,True,1,7891,-240.12,-744628.22,1894786.92,1150158.7
14638,1986-05-23,241.35,1.23,0.51,244.74,-1.38,True,1,7892,-241.35,-744869.57,1904734.2,1159864.63
14639,1986-05-27,244.75,3.4,1.41,244.75,0.0,True,1,7893,-244.75,-745114.32,1931811.75,1186697.43
14640,1986-05-28,246.63,1.88,0.77,246.63,0.0,True,1,7894,-246.63,-745360.95,1946897.22,1201536.27
14641,1986-05-29,247.98,1.35,0.55,247.98,0.0,True,1,7895,-247.98,-745608.93,1957802.1,1212193.17
14642,1986-05-30,247.35,-0.63,-0.25,247.98,-0.25,True,1,7896,-247.35,-745856.28,1953075.6,1207219.32
14643,1986-06-02,245.04,-2.31,-0.93,247.98,-1.19,True,1,7897,-245.04,-746101.32,1935080.88,1188979.56
14644,1986-06-03,245.51,0.47,0.19,247.98,-1.0,True,1,7898,-245.51,-746346.83,1939037.98,1192691.15
14645,1986-06-04,243.94,-1.57,-0.64,247.98,-1.63,True,1,7899,-243.94,-746590.77,1926882.06,1180291.29
14646,1986-06-05,245.65,1.71,0.7,247.98,-0.94,True,1,7900,-245.65,-746836.42,1940635.0,1193798.58
14647,1986-06-06,245.67,0.02,0.01,247.98,-0.93,True,1,7901,-245.67,-747082.09,1941038.67,1193956.58
14648,1986-06-09,239.96,-5.71,-2.32,247.98,-3.23,True,1,7902,-239.96,-747322.05,1896163.92,1148841.87
14649,1986-06-10,239.58,-0.38,-0.16,247.98,-3.39,True,1,7903,-239.58,-747561.63,1893400.74,1145839.11
14650,1986-06-11,241.13,1.55,0.65,247.98,-2.76,True,1,7904,-241.13,-747802.76,1905891.52,1158088.76
14651,1986-06-12,241.49,0.36,0.15,247.98,-2.62,True,1,7905,-241.49,-748044.25,1908978.45,1160934.2
14652,1986-06-13,245.73,4.24,1.76,247.98,-0.91,True,1,7906,-245.73,-748289.98,1942741.38,1194451.4
14653,1986-06-16,246.13,0.4,0.16,247.98,-0.75,True,1,7907,-246.13,-748536.11,1946149.91,1197613.8
14654,1986-06-17,244.35,-1.78,-0.72,247.98,-1.46,True,1,7908,-244.35,-748780.46,1932319.8,1183539.34
14655,1986-06-18,244.99,0.64,0.26,247.98,-1.21,True,1,7909,-244.99,-749025.45,1937625.91,1188600.46
14656,1986-06-19,244.06,-0.93,-0.38,247.98,-1.58,True,1,7910,-244.06,-749269.51,1930514.6,1181245.09
14657,1986-06-20,247.58,3.52,1.44,247.98,-0.16,True,1,7911,-247.58,-749517.09,1958605.38,1209088.29
14658,1986-06-23,245.26,-2.32,-0.94,247.98,-1.1,True,1,7912,-245.26,-749762.35,1940497.12,1190734.77
14659,1986-06-24,247.03,1.77,0.72,247.98,-0.38,True,1,7913,-247.03,-750009.38,1954748.39,1204739.01
14660,1986-06-25,248.93,1.9,0.77,248.93,0.0,True,1,7914,-248.93,-750258.31,1970032.02,1219773.71
14661,1986-06-26,248.74,-0.19,-0.08,248.93,-0.08,True,1,7915,-248.74,-750507.05,1968777.1,1218270.05
14662,1986-06-27,249.6,0.86,0.35,249.6,0.0,True,1,7916,-249.6,-750756.65,1975833.6,1225076.95
14663,1986-06-30,250.84,1.24,0.5,250.84,0.0,True,1,7917,-250.84,-751007.49,1985900.28,1234892.79
14664,1986-07-01,252.04,1.2,0.48,252.04,0.0,True,1,7918,-252.04,-751259.53,1995652.72,1244393.19
14665,1986-07-02,252.7,0.66,0.26,252.7,0.0,True,1,7919,-252.7,-751512.23,2001131.3,1249619.07
14666,1986-07-03,251.79,-0.91,-0.36,252.7,-0.36,True,1,7920,-251.79,-751764.02,1994176.8,1242412.78
14667,1986-07-07,244.05,-7.74,-3.07,252.7,-3.42,True,1,7921,-244.05,-752008.07,1933120.05,1181111.98
14668,1986-07-08,241.59,-2.46,-1.01,252.7,-4.4,True,1,7922,-241.59,-752249.66,1913875.98,1161626.32
14669,1986-07-09,242.82,1.23,0.51,252.7,-3.91,True,1,7923,-242.82,-752492.48,1923862.86,1171370.38
14670,1986-07-10,243.01,0.19,0.08,252.7,-3.84,True,1,7924,-243.01,-752735.49,1925611.24,1172875.75
14671,1986-07-11,242.22,-0.79,-0.32,252.7,-4.15,True,1,7925,-242.22,-752977.71,1919593.5,1166615.79
14672,1986-07-14,238.11,-4.11,-1.7,252.7,-5.77,True,1,7926,-238.11,-753215.82,1887259.86,1134044.04
14673,1986-07-15,233.66,-4.45,-1.87,252.7,-7.54,True,1,7927,-233.66,-753449.48,1852222.82,1098773.34
14674,1986-07-16,235.01,1.35,0.58,252.7,-7.0,True,1,7928,-235.01,-753684.49,1863159.28,1109474.79
14675,1986-07-17,236.07,1.06,0.45,252.7,-6.58,True,1,7929,-236.07,-753920.56,1871799.03,1117878.47
14676,1986-07-18,236.36,0.29,0.12,252.7,-6.47,True,1,7930,-236.36,-754156.92,1874334.8,1120177.88
14677,1986-07-21,236.24,-0.12,-0.05,252.7,-6.51,True,1,7931,-236.24,-754393.16,1873619.44,1119226.28
14678,1986-07-22,238.18,1.94,0.82,252.7,-5.75,True,1,7932,-238.18,-754631.34,1889243.76,1134612.42
14679,1986-07-23,238.67,0.49,0.21,252.7,-5.55,True,1,7933,-238.67,-754870.01,1893369.11,1138499.1
14680,1986-07-24,237.95,-0.72,-0.3,252.7,-5.84,True,1,7934,-237.95,-755107.96,1887895.3,1132787.34
14681,1986-07-25,240.22,2.27,0.95,252.7,-4.94,True,1,7935,-240.22,-755348.18,1906145.7,1150797.52
14682,1986-07-28,236.01,-4.21,-1.75,252.7,-6.6,True,1,7936,-236.01,-755584.19,1872975.36,1117391.17
14683,1986-07-29,234.55,-1.46,-0.62,252.7,-7.18,True,1,7937,-234.55,-755818.74,1861623.35,1105804.61
14684,1986-07-30,236.59,2.04,0.87,252.7,-6.38,True,1,7938,-236.59,-756055.33,1878051.42,1121996.09
14685,1986-07-31,236.12,-0.47,-0.2,252.7,-6.56,True,1,7939,-236.12,-756291.45,1874556.68,1118265.23
14686,1986-08-01,234.91,-1.21,-0.51,252.7,-7.04,True,1,7940,-234.91,-756526.36,1865185.4,1108659.04
14687,1986-08-04,235.99,1.08,0.46,252.7,-6.61,True,1,7941,-235.99,-756762.35,1873996.59,1117234.24
14688,1986-08-05,237.03,1.04,0.44,252.7,-6.2,True,1,7942,-237.03,-756999.38,1882492.26,1125492.88
14689,1986-08-06,236.84,-0.19,-0.08,252.7,-6.28,True,1,7943,-236.84,-757236.22,1881220.12,1123983.9
14690,1986-08-07,237.04,0.2,0.08,252.7,-6.2,True,1,7944,-237.04,-757473.26,1883045.76,1125572.5
14691,1986-08-08,236.88,-0.16,-0.07,252.7,-6.26,True,1,7945,-236.88,-757710.14,1882011.6,1124301.46
14692,1986-08-11,240.68,3.8,1.6,252.7,-4.76,True,1,7946,-240.68,-757950.82,1912443.28,1154492.46
14693,1986-08-12,243.34,2.66,1.1,252.7,-3.7,True,1,7947,-243.34,-758194.16,1933822.98,1175628.82
14694,1986-08-13,245.67,2.33,0.96,252.7,-2.78,True,1,7948,-245.67,-758439.83,1952585.16,1194145.33
14695,1986-08-14,246.25,0.58,0.24,252.7,-2.55,True,1,7949,-246.25,-758686.08,1957441.25,1198755.17
14696,1986-08-15,247.15,0.9,0.36,252.7,-2.2,True,1,7950,-247.15,-758933.23,1964842.5,1205909.27
14697,1986-08-18,247.38,0.23,0.09,252.7,-2.1,True,1,7951,-247.38,-759180.61,1966918.38,1207737.77
14698,1986-08-19,246.51,-0.87,-0.35,252.7,-2.45,True,1,7952,-246.51,-759427.12,1960247.52,1200820.4
14699,1986-08-20,249.77,3.26,1.32,252.7,-1.16,True,1,7953,-249.77,-759676.89,1986420.81,1226743.92
14700,1986-08-21,249.67,-0.1,-0.04,252.7,-1.2,True,1,7954,-249.67,-759926.56,1985875.18,1225948.62
14701,1986-08-22,250.19,0.52,0.21,252.7,-0.99,True,1,7955,-250.19,-760176.75,1990261.45,1230084.7
14702,1986-08-25,247.81,-2.38,-0.95,252.7,-1.94,True,1,7956,-247.81,-760424.56,1971576.36,1211151.8
14703,1986-08-26,252.84,5.03,2.03,252.84,0.0,True,1,7957,-252.84,-760677.4,2011847.88,1251170.48
14704,1986-08-27,253.3,0.46,0.18,253.3,0.0,True,1,7958,-253.3,-760930.7,2015761.4,1254830.7
14705,1986-08-28,252.84,-0.46,-0.18,253.3,-0.18,True,1,7959,-252.84,-761183.54,2012353.56,1251170.02
14706,1986-08-29,252.93,0.09,0.04,253.3,-0.15,True,1,7960,-252.93,-761436.47,2013322.8,1251886.33
14707,1986-09-02,248.52,-4.41,-1.74,253.3,-1.89,True,1,7961,-248.52,-761684.99,1978467.72,1216782.73
14708,1986-09-03,250.08,1.56,0.63,253.3,-1.27,True,1,7962,-250.08,-761935.07,1991136.96,1229201.89
14709,1986-09-04,253.83,3.75,1.5,253.83,0.0,True,1,7963,-253.83,-762188.9,2021248.29,1259059.39
14710,1986-09-05,250.47,-3.36,-1.32,253.83,-1.32,True,1,7964,-250.47,-762439.37,1994743.08,1232303.71
14711,1986-09-08,248.14,-2.33,-0.93,253.83,-2.24,True,1,7965,-248.14,-762687.51,1976435.1,1213747.59
14712,1986-09-09,247.67,-0.47,-0.19,253.83,-2.43,True,1,7966,-247.67,-762935.18,1972939.22,1210004.04
14713,1986-09-10,247.06,-0.61,-0.25,253.83,-2.67,True,1,7967,-247.06,-763182.24,1968327.02,1205144.78
14714,1986-09-11,235.18,-11.88,-4.81,253.83,-7.35,True,1,7968,-235.18,-763417.42,1873914.24,1110496.82
14715,1986-09-12,230.67,-4.51,-1.92,253.83,-9.12,True,1,7969,-230.67,-763648.09,1838209.23,1074561.14
14716,1986-09-15,231.94,1.27,0.55,253.83,-8.62,True,1,7970,-231.94,-763880.03,1848561.8,1084681.77
14717,1986-09-16,231.72,-0.22,-0.1,253.83,-8.71,True,1,7971,-231.72,-764111.75,1847040.12,1082928.37
14718,1986-09-17,231.68,-0.04,-0.02,253.83,-8.73,True,1,7972,-231.68,-764343.43,1846952.96,1082609.53
14719,1986-09-18,232.31,0.63,0.27,253.83,-8.48,True,1,7973,-232.31,-764575.74,1852207.63,1087631.89
14720,1986-09-19,232.21,-0.1,-0.04,253.83,-8.52,True,1,7974,-232.21,-764807.95,1851642.54,1086834.59
14721,1986-09-22,234.93,2.72,1.17,253.83,-7.45,True,1,7975,-234.93,-765042.88,1873566.75,1108523.87
14722,1986-09-23,235.67,0.74,0.32,253.83,-7.15,True,1,7976,-235.67,-765278.55,1879703.92,1114425.37
14723,1986-09-24,236.28,0.61,0.26,253.83,-6.91,True,1,7977,-236.28,-765514.83,1884805.56,1119290.73
14724,1986-09-25,231.83,-4.45,-1.88,253.83,-8.67,True,1,7978,-231.83,-765746.66,1849539.74,1083793.08
14725,1986-09-26,232.23,0.4,0.17,253.83,-8.51,True,1,7979,-232.23,-765978.89,1852963.17,1086984.28
14726,1986-09-29,229.91,-2.32,-1.0,253.83,-9.42,True,1,7980,-229.91,-766208.8,1834681.8,1068473.0
14727,1986-09-30,231.32,1.41,0.61,253.83,-8.87,True,1,7981,-231.32,-766440.12,1846164.92,1079724.8
14728,1986-10-01,233.6,2.28,0.99,253.83,-7.97,True,1,7982,-233.6,-766673.72,1864595.2,1097921.48
14729,1986-10-02,233.92,0.32,0.14,253.83,-7.84,True,1,7983,-233.92,-766907.64,1867383.36,1100475.72
14730,1986-10-03,233.71,-0.21,-0.09,253.83,-7.93,True,1,7984,-233.71,-767141.35,1865940.64,1098799.29
14731,1986-10-06,234.78,1.07,0.46,253.83,-7.5,True,1,7985,-234.78,-767376.13,1874718.3,1107342.17
14732,1986-10-07,234.41,-0.37,-0.16,253.83,-7.65,True,1,7986,-234.41,-767610.54,1871998.26,1104387.72
14733,1986-10-08,236.68,2.27,0.97,253.83,-6.76,True,1,7987,-236.68,-767847.22,1890363.16,1122515.94
14734,1986-10-09,235.85,-0.83,-0.35,253.83,-7.08,True,1,7988,-235.85,-768083.07,1883969.8,1115886.73
14735,1986-10-10,235.48,-0.37,-0.16,253.83,-7.23,True,1,7989,-235.48,-768318.55,1881249.72,1112931.17
14736,1986-10-13,235.91,0.43,0.18,253.83,-7.06,True,1,7990,-235.91,-768554.46,1884920.9,1116366.44
14737,1986-10-14,235.37,-0.54,-0.23,253.83,-7.27,True,1,7991,-235.37,-768789.83,1880841.67,1112051.84
14738,1986-10-15,238.8,3.43,1.46,253.83,-5.92,True,1,7992,-238.8,-769028.63,1908489.6,1139460.97
14739,1986-10-16,239.53,0.73,0.31,253.83,-5.63,True,1,7993,-239.53,-769268.16,1914563.29,1145295.13
14740,1986-10-17,238.84,-0.69,-0.29,253.83,-5.91,True,1,7994,-238.84,-769507.0,1909286.96,1139779.96
14741,1986-10-20,235.97,-2.87,-1.2,253.83,-7.04,True,1,7995,-235.97,-769742.97,1886580.15,1116837.18
14742,1986-10-21,235.88,-0.09,-0.04,253.83,-7.07,True,1,7996,-235.88,-769978.85,1886096.48,1116117.63
14743,1986-10-22,236.26,0.38,0.16,253.83,-6.92,True,1,7997,-236.26,-770215.11,1889371.22,1119156.11
14744,1986-10-23,239.28,3.02,1.28,253.83,-5.73,True,1,7998,-239.28,-770454.39,1913761.44,1143307.05
14745,1986-10-24,238.26,-1.02,-0.43,253.83,-6.13,True,1,7999,-238.26,-770692.65,1905841.74,1135149.09
14746,1986-10-27,238.77,0.51,0.21,253.83,-5.93,True,1,8000,-238.77,-770931.42,1910160.0,1139228.58
14747,1986-10-28,239.26,0.49,0.2,253.83,-5.74,True,1,8001,-239.26,-771170.68,1914319.26,1143148.58
14748,1986-10-29,240.94,1.68,0.7,253.83,-5.08,True,1,8002,-240.94,-771411.62,1928001.88,1156590.26
14749,1986-10-30,243.71,2.77,1.15,253.83,-3.99,True,1,8003,-243.71,-771655.33,1950411.13,1178755.8
14750,1986-10-31,243.98,0.27,0.11,253.83,-3.88,True,1,8004,-243.98,-771899.31,1952815.92,1180916.61
14751,1986-11-03,245.8,1.82,0.75,253.83,-3.16,True,1,8005,-245.8,-772145.11,1967629.0,1195483.89
14752,1986-11-04,246.2,0.4,0.16,253.83,-3.01,True,1,8006,-246.2,-772391.31,1971077.2,1198685.89
14753,1986-11-05,246.58,0.38,0.15,253.83,-2.86,True,1,8007,-246.58,-772637.89,1974366.06,1201728.17
14754,1986-11-06,245.87,-0.71,-0.29,253.83,-3.14,True,1,8008,-245.87,-772883.76,1968926.96,1196043.2
14755,1986-11-07,245.77,-0.1,-0.04,253.83,-3.18,True,1,8009,-245.77,-773129.53,1968371.93,1195242.4
14756,1986-11-10,246.13,0.36,0.15,253.83,-3.03,True,1,8010,-246.13,-773375.66,1971501.3,1198125.64
14757,1986-11-11,247.08,0.95,0.39,253.83,-2.66,True,1,8011,-247.08,-773622.74,1979357.88,1205735.14
14758,1986-11-12,246.64,-0.44,-0.18,253.83,-2.83,True,1,8012,-246.64,-773869.38,1976079.68,1202210.3
14759,1986-11-13,243.02,-3.62,-1.47,253.83,-4.26,True,1,8013,-243.02,-774112.4,1947319.26,1173206.86
14760,1986-11-14,244.5,1.48,0.61,253.83,-3.68,True,1,8014,-244.5,-774356.9,1959423.0,1185066.1
14761,1986-11-17,243.21,-1.29,-0.53,253.83,-4.18,True,1,8015,-243.21,-774600.11,1949328.15,1174728.04
14762,1986-11-18,236.78,-6.43,-2.64,253.83,-6.72,True,1,8016,-236.78,-774836.89,1898028.48,1123191.59
14763,1986-11-19,237.66,0.88,0.37,253.83,-6.37,True,1,8017,-237.66,-775074.55,1905320.22,1130245.67
14764,1986-11-20,242.05,4.39,1.85,253.83,-4.64,True,1,8018,-242.05,-775316.6,1940756.9,1165440.3
14765,1986-11-21,245.86,3.81,1.57,253.83,-3.14,True,1,8019,-245.86,-775562.46,1971551.34,1195988.88
14766,1986-11-24,247.45,1.59,0.65,253.83,-2.51,True,1,8020,-247.45,-775809.91,1984549.0,1208739.09
14767,1986-11-25,248.17,0.72,0.29,253.83,-2.23,True,1,8021,-248.17,-776058.08,1990571.57,1214513.49
14768,1986-11-26,248.77,0.6,0.24,253.83,-1.99,True,1,8022,-248.77,-776306.85,1995632.94,1219326.09
14769,1986-11-28,249.22,0.45,0.18,253.83,-1.82,True,1,8023,-249.22,-776556.07,1999492.06,1222935.99
14770,1986-12-01,249.05,-0.17,-0.07,253.83,-1.88,True,1,8024,-249.05,-776805.12,1998377.2,1221572.08
14771,1986-12-02,254.0,4.95,1.99,254.0,0.0,True,1,8025,-254.0,-777059.12,2038350.0,1261290.88
14772,1986-12-03,253.85,-0.15,-0.06,254.0,-0.06,True,1,8026,-253.85,-777312.97,2037400.1,1260087.13
14773,1986-12-04,253.04,-0.81,-0.32,254.0,-0.38,True,1,8027,-253.04,-777566.01,2031152.08,1253586.07
14774,1986-12-05,251.17,-1.87,-0.74,254.0,-1.11,True,1,8028,-251.17,-777817.18,2016392.76,1238575.58
14775,1986-12-08,251.16,-0.01,-0.0,254.0,-1.12,True,1,8029,-251.16,-778068.34,2016563.64,1238495.3
14776,1986-12-09,249.28,-1.88,-0.75,254.0,-1.86,True,1,8030,-249.28,-778317.62,2001718.4,1223400.78
14777,1986-12-10,250.96,1.68,0.67,254.0,-1.2,True,1,8031,-250.96,-778568.58,2015459.76,1236891.18
14778,1986-12-11,248.17,-2.79,-1.11,254.0,-2.3,True,1,8032,-248.17,-778816.75,1993301.44,1214484.69
14779,1986-12-12,247.35,-0.82,-0.33,254.0,-2.62,True,1,8033,-247.35,-779064.1,1986962.55,1207898.45
14780,1986-12-15,248.21,0.86,0.35,254.0,-2.28,True,1,8034,-248.21,-779312.31,1994119.14,1214806.83
14781,1986-12-16,250.04,1.83,0.74,254.0,-1.56,True,1,8035,-250.04,-779562.35,2009071.4,1229509.05
14782,1986-12-17,247.56,-2.48,-0.99,254.0,-2.54,True,1,8036,-247.56,-779809.91,1989392.16,1209582.25
14783,1986-12-18,246.78,-0.78,-0.32,254.0,-2.84,True,1,8037,-246.78,-780056.69,1983370.86,1203314.17
14784,1986-12-19,249.73,2.95,1.2,254.0,-1.68,True,1,8038,-249.73,-780306.42,2007329.74,1227023.32
14785,1986-12-22,248.75,-0.98,-0.39,254.0,-2.07,True,1,8039,-248.75,-780555.17,1999701.25,1219146.08
14786,1986-12-23,246.34,-2.41,-0.97,254.0,-3.02,True,1,8040,-246.34,-780801.51,1980573.6,1199772.09
14787,1986-12-24,246.75,0.41,0.17,254.0,-2.85,True,1,8041,-246.75,-781048.26,1984116.75,1203068.49
14788,1986-12-26,246.92,0.17,0.07,254.0,-2.79,True,1,8042,-246.92,-781295.18,1985730.64,1204435.46
14789,1986-12-29,244.67,-2.25,-0.91,254.0,-3.67,True,1,8043,-244.67,-781539.85,1967880.81,1186340.96
14790,1986-12-30,243.37,-1.3,-0.53,254.0,-4.18,True,1,8044,-243.37,-781783.22,1957668.28,1175885.06
14791,1986-12-31,242.17,-1.2,-0.49,254.0,-4.66,True,1,8045,-242.17,-782025.39,1948257.65,1166232.26
14792,1987-01-02,246.45,4.28,1.77,254.0,-2.97,True,1,8046,-246.45,-782271.84,1982936.7,1200664.86
14793,1987-01-05,252.19,5.74,2.33,254.0,-0.71,True,1,8047,-252.19,-782524.03,2029372.93,1246848.9
14794,1987-01-06,252.78,0.59,0.23,254.0,-0.48,True,1,8048,-252.78,-782776.81,2034373.44,1251596.63
14795,1987-01-07,255.33,2.55,1.01,255.33,0.0,True,1,8049,-255.33,-783032.14,2055151.17,1272119.03
14796,1987-01-08,257.28,1.95,0.76,257.28,0.0,True,1,8050,-257.28,-783289.42,2071104.0,1287814.58
14797,1987-01-09,258.73,1.45,0.56,258.73,0.0,True,1,8051,-258.73,-783548.15,2083035.23,1299487.08
14798,1987-01-12,260.3,1.57,0.61,260.3,0.0,True,1,8052,-260.3,-783808.45,2095935.6,1312127.15
14799,1987-01-13,259.95,-0.35,-0.13,260.3,-0.13,True,1,8053,-259.95,-784068.4,2093377.35,1309308.95
14800,1987-01-14,262.64,2.69,1.03,262.64,0.0,True,1,8054,-262.64,-784331.04,2115302.56,1330971.52
14801,1987-01-15,265.49,2.85,1.08,265.49,0.0,True,1,8055,-265.49,-784596.53,2138521.95,1353925.42
14802,1987-01-16,266.28,0.79,0.3,266.28,0.0,True,1,8056,-266.28,-784862.81,2145151.68,1360288.87
14803,1987-01-19,269.34,3.06,1.15,269.34,0.0,True,1,8057,-269.34,-785132.15,2170072.38,1384940.23
14804,1987-01-20,269.04,-0.3,-0.11,269.34,-0.11,True,1,8058,-269.04,-785401.19,2167924.32,1382523.13
14805,1987-01-21,267.84,-1.2,-0.45,269.34,-0.56,True,1,8059,-267.84,-785669.03,2158522.56,1372853.53
14806,1987-01-22,273.91,6.07,2.27,273.91,0.0,True,1,8060,-273.91,-785942.94,2207714.6,1421771.66
14807,1987-01-23,270.1,-3.81,-1.39,273.91,-1.39,True,1,8061,-270.1,-786213.04,2177276.1,1391063.06
14808,1987-01-26,269.61,-0.49,-0.18,273.91,-1.57,True,1,8062,-269.61,-786482.65,2173595.82,1387113.17
14809,1987-01-27,273.75,4.14,1.54,273.91,-0.06,True,1,8063,-273.75,-786756.4,2207246.25,1420489.85
14810,1987-01-28,275.4,1.65,0.6,275.4,0.0,True,1,8064,-275.4,-787031.8,2220825.6,1433793.8
14811,1987-01-29,274.24,-1.16,-0.42,275.4,-0.42,True,1,8065,-274.24,-787306.04,2211745.6,1424439.56
14812,1987-01-30,274.08,-0.16,-0.06,275.4,-0.48,True,1,8066,-274.08,-787580.12,2210729.28,1423149.16
14813,1987-02-02,276.45,2.37,0.86,276.45,0.0,True,1,8067,-276.45,-787856.57,2230122.15,1442265.58
14814,1987-02-03,275.99,-0.46,-0.17,276.45,-0.17,True,1,8068,-275.99,-788132.56,2226687.32,1438554.76
14815,1987-02-04,279.64,3.65,1.32,279.64,0.0,True,1,8069,-279.64,-788412.2,2256415.16,1468002.96
14816,1987-02-05,281.16,1.52,0.54,281.16,0.0,True,1,8070,-281.16,-788693.36,2268961.2,1480267.84
14817,1987-02-06,280.04,-1.12,-0.4,281.16,-0.4,True,1,8071,-280.04,-788973.4,2260202.84,1471229.44
14818,1987-02-09,278.16,-1.88,-0.67,281.16,-1.07,True,1,8072,-278.16,-789251.56,2245307.52,1456055.96
14819,1987-02-10,275.07,-3.09,-1.11,281.16,-2.17,True,1,8073,-275.07,-789526.63,2220640.11,1431113.48
14820,1987-02-11,277.54,2.47,0.9,281.16,-1.29,True,1,8074,-277.54,-789804.17,2240857.96,1451053.79
14821,1987-02-12,275.62,-1.92,-0.69,281.16,-1.97,True,1,8075,-275.62,-790079.79,2225631.5,1435551.71
14822,1987-02-13,279.7,4.08,1.48,281.16,-0.52,True,1,8076,-279.7,-790359.49,2258857.2,1468497.71
14823,1987-02-17,285.49,5.79,2.07,285.49,0.0,True,1,8077,-285.49,-790644.98,2305902.73,1515257.75
14824,1987-02-18,285.42,-0.07,-0.02,285.49,-0.02,True,1,8078,-285.42,-790930.4,2305622.76,1514692.36
14825,1987-02-19,285.57,0.15,0.05,285.57,0.0,True,1,8079,-285.57,-791215.97,2307120.03,1515904.06
14826,1987-02-20,285.48,-0.09,-0.03,285.57,-0.03,True,1,8080,-285.48,-791501.45,2306678.4,1515176.95
14827,1987-02-23,282.38,-3.1,-1.09,285.57,-1.12,True,1,8081,-282.38,-791783.83,2281912.78,1490128.95
14828,1987-02-24,282.88,0.5,0.18,285.57,-0.94,True,1,8082,-282.88,-792066.71,2286236.16,1494169.45
14829,1987-02-25,284.0,1.12,0.4,285.57,-0.55,True,1,8083,-284.0,-792350.71,2295572.0,1503221.29
14830,1987-02-26,282.96,-1.04,-0.37,285.57,-0.91,True,1,8084,-282.96,-792633.67,2287448.64,1494814.97
14831,1987-02-27,284.2,1.24,0.44,285.57,-0.48,True,1,8085,-284.2,-792917.87,2297757.0,1504839.13
14832,1987-03-02,283.0,-1.2,-0.42,285.57,-0.9,True,1,8086,-283.0,-793200.87,2288338.0,1495137.13
14833,1987-03-03,284.12,1.12,0.4,285.57,-0.51,True,1,8087,-284.12,-793484.99,2297678.44,1504193.45
14834,1987-03-04,288.62,4.5,1.58,288.62,0.0,True,1,8088,-288.62,-793773.61,2334358.56,1540584.95
14835,1987-03-05,290.52,1.9,0.66,290.52,0.0,True,1,8089,-290.52,-794064.13,2350016.28,1555952.15
14836,1987-03-06,290.66,0.14,0.05,290.66,0.0,True,1,8090,-290.66,-794354.79,2351439.4,1557084.61
14837,1987-03-09,288.3,-2.36,-0.81,290.66,-0.81,True,1,8091,-288.3,-794643.09,2332635.3,1537992.21
14838,1987-03-10,290.86,2.56,0.89,290.86,0.0,True,1,8092,-290.86,-794933.95,2353639.12,1558705.17
14839,1987-03-11,290.31,-0.55,-0.19,290.86,-0.19,True,1,8093,-290.31,-795224.26,2349478.83,1554254.57
14840,1987-03-12,291.22,0.91,0.31,291.22,0.0,True,1,8094,-291.22,-795515.48,2357134.68,1561619.2
14841,1987-03-13,289.89,-1.33,-0.46,291.22,-0.46,True,1,8095,-289.89,-795805.37,2346659.55,1550854.18
14842,1987-03-16,288.23,-1.66,-0.57,291.22,-1.03,True,1,8096,-288.23,-796093.6,2333510.08,1537416.48
14843,1987-03-17,292.47,4.24,1.47,292.47,0.0,True,1,8097,-292.47,-796386.07,2368129.59,1571743.52
14844,1987-03-18,292.78,0.31,0.11,292.78,0.0,True,1,8098,-292.78,-796678.85,2370932.44,1574253.59
14845,1987-03-19,294.08,1.3,0.44,294.08,0.0,True,1,8099,-294.08,-796972.93,2381753.92,1584780.99
14846,1987-03-20,298.17,4.09,1.39,298.17,0.0,True,1,8100,-298.17,-797271.1,2415177.0,1617905.9
14847,1987-03-23,301.16,2.99,1.0,301.16,0.0,True,1,8101,-301.16,-797572.26,2439697.16,1642124.9
14848,1987-03-24,301.64,0.48,0.16,301.64,0.0,True,1,8102,-301.64,-797873.9,2443887.28,1646013.38
14849,1987-03-25,300.38,-1.26,-0.42,301.64,-0.42,True,1,8103,-300.38,-798174.28,2433979.14,1635804.86
14850,1987-03-26,300.93,0.55,0.18,301.64,-0.24,True,1,8104,-300.93,-798475.21,2438736.72,1640261.51
14851,1987-03-27,296.13,-4.8,-1.6,301.64,-1.83,True,1,8105,-296.13,-798771.34,2400133.65,1601362.31
14852,1987-03-30,289.2,-6.93,-2.34,301.64,-4.12,True,1,8106,-289.2,-799060.54,2344255.2,1545194.66
14853,1987-03-31,291.7,2.5,0.86,301.64,-3.3,True,1,8107,-291.7,-799352.24,2364811.9,1565459.66
14854,1987-04-01,292.38,0.68,0.23,301.64,-3.07,True,1,8108,-292.38,-799644.62,2370617.04,1570972.42
14855,1987-04-02,293.63,1.25,0.43,301.64,-2.66,True,1,8109,-293.63,-799938.25,2381045.67,1581107.42
14856,1987-04-03,300.41,6.78,2.31,301.64,-0.41,True,1,8110,-300.41,-800238.66,2436325.1,1636086.44
14857,1987-04-06,301.95,1.54,0.51,301.95,0.0,True,1,8111,-301.95,-800540.61,2449116.45,1648575.84
14858,1987-04-07,296.69,-5.26,-1.74,301.95,-1.74,True,1,8112,-296.69,-800837.3,2406749.28,1605911.98
14859,1987-04-08,297.26,0.57,0.19,301.95,-1.55,True,1,8113,-297.26,-801134.56,2411670.38,1610535.82
14860,1987-04-09,292.86,-4.4,-1.48,301.95,-3.01,True,1,8114,-292.86,-801427.42,2376266.04,1574838.62
14861,1987-04-10,292.49,-0.37,-0.13,301.95,-3.13,True,1,8115,-292.49,-801719.91,2373556.35,1571836.44
14862,1987-04-13,285.62,-6.87,-2.35,301.95,-5.41,True,1,8116,-285.62,-802005.53,2318091.92,1516086.39
14863,1987-04-14,279.16,-6.46,-2.26,301.95,-7.55,True,1,8117,-279.16,-802284.69,2265941.72,1463657.03
14864,1987-04-15,284.44,5.28,1.89,301.95,-5.8,True,1,8118,-284.44,-802569.13,2309083.92,1506514.79
14865,1987-04-16,286.91,2.47,0.87,301.95,-4.98,True,1,8119,-286.91,-802856.04,2329422.29,1526566.25
14866,1987-04-20,286.09,-0.82,-0.29,301.95,-5.25,True,1,8120,-286.09,-803142.13,2323050.8,1519908.67
14867,1987-04-21,293.07,6.98,2.44,301.95,-2.94,True,1,8121,-293.07,-803435.2,2380021.47,1576586.27
14868,1987-04-22,287.19,-5.88,-2.01,301.95,-4.89,True,1,8122,-287.19,-803722.39,2332557.18,1528834.79
14869,1987-04-23,286.82,-0.37,-0.13,301.95,-5.01,True,1,8123,-286.82,-804009.21,2329838.86,1525829.65
14870,1987-04-24,281.52,-5.3,-1.85,301.95,-6.77,True,1,8124,-281.52,-804290.73,2287068.48,1482777.75
14871,1987-04-27,281.83,0.31,0.11,301.95,-6.66,True,1,8125,-281.83,-804572.56,2289868.75,1485296.19
14872,1987-04-28,282.51,0.68,0.24,301.95,-6.44,True,1,8126,-282.51,-804855.07,2295676.26,1490821.19
14873,1987-04-29,284.57,2.06,0.73,301.95,-5.76,True,1,8127,-284.57,-805139.64,2312700.39,1507560.75
14874,1987-04-30,288.36,3.79,1.33,301.95,-4.5,True,1,8128,-288.36,-805428.0,2343790.08,1538362.08
14875,1987-05-01,288.03,-0.33,-0.11,301.95,-4.61,True,1,8129,-288.03,-805716.03,2341395.87,1535679.84
14876,1987-05-04,289.36,1.33,0.46,301.95,-4.17,True,1,8130,-289.36,-806005.39,2352496.8,1546491.41
14877,1987-05-05,295.34,5.98,2.07,301.95,-2.19,True,1,8131,-295.34,-806300.73,2401409.54,1595108.81
14878,1987-05-06,295.47,0.13,0.04,301.95,-2.15,True,1,8132,-295.47,-806596.2,2402762.04,1596165.84
14879,1987-05-07,294.71,-0.76,-0.26,301.95,-2.4,True,1,8133,-294.71,-806890.91,2396876.43,1589985.52
14880,1987-05-08,293.37,-1.34,-0.46,301.95,-2.84,True,1,8134,-293.37,-807184.28,2386271.58,1579087.3
14881,1987-05-11,291.57,-1.8,-0.61,301.95,-3.44,True,1,8135,-291.57,-807475.85,2371921.95,1564446.1
14882,1987-05-12,293.3,1.73,0.59,301.95,-2.86,True,1,8136,-293.3,-807769.15,2386288.8,1578519.65
14883,1987-05-13,293.98,0.68,0.23,301.95,-2.64,True,1,8137,-293.98,-808063.13,2392115.26,1584052.13
14884,1987-05-14,294.24,0.26,0.09,301.95,-2.55,True,1,8138,-294.24,-808357.37,2394525.12,1586167.75
14885,1987-05-15,287.43,-6.81,-2.31,301.95,-4.81,True,1,8139,-287.43,-808644.8,2339392.77,1530747.97
14886,1987-05-18,286.65,-0.78,-0.27,301.95,-5.07,True,1,8140,-286.65,-808931.45,2333331.0,1524399.55
14887,1987-05-19,279.62,-7.03,-2.45,301.95,-7.4,True,1,8141,-279.62,-809211.07,2276386.42,1467175.35
14888,1987-05-20,278.21,-1.41,-0.5,301.95,-7.86,True,1,8142,-278.21,-809489.28,2265185.82,1455696.54
14889,1987-05-21,280.17,1.96,0.7,301.95,-7.21,True,1,8143,-280.17,-809769.45,2281424.31,1471654.86
14890,1987-05-22,282.16,1.99,0.71,301.95,-6.55,True,1,8144,-282.16,-810051.61,2297911.04,1487859.43
14891,1987-05-26,289.11,6.95,2.46,301.95,-4.25,True,1,8145,-289.11,-810340.72,2354800.95,1544460.23
14892,1987-05-27,288.73,-0.38,-0.13,301.95,-4.38,True,1,8146,-288.73,-810629.45,2351994.58,1541365.13
14893,1987-05-28,290.76,2.03,0.7,301.95,-3.71,True,1,8147,-290.76,-810920.21,2368821.72,1557901.51
14894,1987-05-29,290.1,-0.66,-0.23,301.95,-3.92,True,1,8148,-290.1,-811210.31,2363734.8,1552524.49
14895,1987-06-01,289.83,-0.27,-0.09,301.95,-4.01,True,1,8149,-289.83,-811500.14,2361824.67,1550324.53
14896,1987-06-02,288.46,-1.37,-0.47,301.95,-4.47,True,1,8150,-288.46,-811788.6,2350949.0,1539160.4
14897,1987-06-03,293.47,5.01,1.74,301.95,-2.81,True,1,8151,-293.47,-812082.07,2392073.97,1579991.9
14898,1987-06-04,295.09,1.62,0.55,301.95,-2.27,True,1,8152,-295.09,-812377.16,2405573.68,1593196.52
14899,1987-06-05,293.45,-1.64,-0.56,301.95,-2.82,True,1,8153,-293.45,-812670.61,2392497.85,1579827.24
14900,1987-06-08,296.72,3.27,1.11,301.95,-1.73,True,1,8154,-296.72,-812967.33,2419454.88,1606487.55
14901,1987-06-09,297.28,0.56,0.19,301.95,-1.55,True,1,8155,-297.28,-813264.61,2424318.4,1611053.79
14902,1987-06-10,297.47,0.19,0.06,301.95,-1.48,True,1,8156,-297.47,-813562.08,2426165.32,1612603.24
14903,1987-06-11,298.73,1.26,0.42,301.95,-1.07,True,1,8157,-298.73,-813860.81,2436740.61,1622879.8
14904,1987-06-12,301.62,2.89,0.97,301.95,-0.11,True,1,8158,-301.62,-814162.43,2460615.96,1646453.53
14905,1987-06-15,303.14,1.52,0.5,303.14,0.0,True,1,8159,-303.14,-814465.57,2473319.26,1658853.69
14906,1987-06-16,304.76,1.62,0.53,304.76,0.0,True,1,8160,-304.76,-814770.33,2486841.6,1672071.27
14907,1987-06-17,304.81,0.05,0.02,304.81,0.0,True,1,8161,-304.81,-815075.14,2487554.41,1672479.27
14908,1987-06-18,305.69,0.88,0.29,305.69,0.0,True,1,8162,-305.69,-815380.83,2495041.78,1679660.95
14909,1987-06-19,306.97,1.28,0.42,306.97,0.0,True,1,8163,-306.97,-815687.8,2505796.11,1690108.31
14910,1987-06-22,309.65,2.68,0.87,309.65,0.0,True,1,8164,-309.65,-815997.45,2527982.6,1711985.15
14911,1987-06-23,308.43,-1.22,-0.39,309.65,-0.39,True,1,8165,-308.43,-816305.88,2518330.95,1702025.07
14912,1987-06-24,306.86,-1.57,-0.51,309.65,-0.9,True,1,8166,-306.86,-816612.74,2505818.76,1689206.02
14913,1987-06-25,308.96,2.1,0.68,309.65,-0.22,True,1,8167,-308.96,-816921.7,2523276.32,1706354.62
14914,1987-06-26,307.16,-1.8,-0.58,309.65,-0.8,True,1,8168,-307.16,-817228.86,2508882.88,1691654.02
14915,1987-06-29,307.9,0.74,0.24,309.65,-0.56,True,1,8169,-307.9,-817536.76,2515235.1,1697698.34
14916,1987-06-30,304.0,-3.9,-1.27,309.65,-1.82,True,1,8170,-304.0,-817840.76,2483680.0,1665839.24
14917,1987-07-01,302.94,-1.06,-0.35,309.65,-2.17,True,1,8171,-302.94,-818143.7,2475322.74,1657179.04
14918,1987-07-02,305.63,2.69,0.89,309.65,-1.3,True,1,8172,-305.63,-818449.33,2497608.36,1679159.03
14919,1987-07-06,304.92,-0.71,-0.23,309.65,-1.53,True,1,8173,-304.92,-818754.25,2492111.16,1673356.91
14920,1987-07-07,307.4,2.48,0.81,309.65,-0.73,True,1,8174,-307.4,-819061.65,2512687.6,1693625.95
14921,1987-07-08,308.29,0.89,0.29,309.65,-0.44,True,1,8175,-308.29,-819369.94,2520270.75,1700900.81
14922,1987-07-09,307.52,-0.77,-0.25,309.65,-0.69,True,1,8176,-307.52,-819677.46,2514283.52,1694606.06
14923,1987-07-10,308.37,0.85,0.28,309.65,-0.41,True,1,8177,-308.37,-819985.83,2521541.49,1701555.66
14924,1987-07-13,307.63,-0.74,-0.24,309.65,-0.65,True,1,8178,-307.63,-820293.46,2515798.14,1695504.68
14925,1987-07-14,310.68,3.05,0.99,310.68,0.0,True,1,8179,-310.68,-820604.14,2541051.72,1720447.58
14926,1987-07-15,310.42,-0.26,-0.08,310.68,-0.08,True,1,8180,-310.42,-820914.56,2539235.6,1718321.04
14927,1987-07-16,312.7,2.28,0.73,312.7,0.0,True,1,8181,-312.7,-821227.26,2558198.7,1736971.44
14928,1987-07-17,314.59,1.89,0.6,314.59,0.0,True,1,8182,-314.59,-821541.85,2573975.38,1752433.53
14929,1987-07-20,311.39,-3.2,-1.02,314.59,-1.02,True,1,8183,-311.39,-821853.24,2548104.37,1726251.13
14930,1987-07-21,308.55,-2.84,-0.91,314.59,-1.92,True,1,8184,-308.55,-822161.79,2525173.2,1703011.41
14931,1987-07-22,308.47,-0.08,-0.03,314.59,-1.94,True,1,8185,-308.47,-822470.26,2524826.95,1702356.69
14932,1987-07-23,307.81,-0.66,-0.21,314.59,-2.15,True,1,8186,-307.81,-822778.07,2519732.66,1696954.59
14933,1987-07-24,309.27,1.46,0.47,314.59,-1.69,True,1,8187,-309.27,-823087.34,2531993.49,1708906.15
14934,1987-07-27,310.65,1.38,0.45,314.59,-1.25,True,1,8188,-310.65,-823397.99,2543602.2,1720204.21
14935,1987-07-28,312.33,1.68,0.54,314.59,-0.72,True,1,8189,-312.33,-823710.32,2557670.37,1733960.05
14936,1987-07-29,315.65,3.32,1.06,315.65,0.0,True,1,8190,-315.65,-824025.97,2585173.5,1761147.53
14937,1987-07-30,318.05,2.4,0.76,318.05,0.0,True,1,8191,-318.05,-824344.02,2605147.55,1780803.53
14938,1987-07-31,318.66,0.61,0.19,318.66,0.0,True,1,8192,-318.66,-824662.68,2610462.72,1785800.04
14939,1987-08-03,317.57,-1.09,-0.34,318.66,-0.34,True,1,8193,-317.57,-824980.25,2601851.01,1776870.76
14940,1987-08-04,316.23,-1.34,-0.42,318.66,-0.76,True,1,8194,-316.23,-825296.48,2591188.62,1765892.14
14941,1987-08-05,318.45,2.22,0.7,318.66,-0.07,True,1,8195,-318.45,-825614.93,2609697.75,1784082.82
14942,1987-08-06,322.09,3.64,1.14,322.09,0.0,True,1,8196,-322.09,-825937.02,2639849.64,1813912.62
14943,1987-08-07,323.0,0.91,0.28,323.0,0.0,True,1,8197,-323.0,-826260.02,2647631.0,1821370.98
14944,1987-08-10,328.0,5.0,1.55,328.0,0.0,True,1,8198,-328.0,-826588.02,2688944.0,1862355.98
14945,1987-08-11,333.33,5.33,1.62,333.33,0.0,True,1,8199,-333.33,-826921.35,2732972.67,1906051.32
14946,1987-08-12,332.39,-0.94,-0.28,333.33,-0.28,True,1,8200,-332.39,-827253.74,2725598.0,1898344.26
14947,1987-08-13,334.65,2.26,0.68,334.65,0.0,True,1,8201,-334.65,-827588.39,2744464.65,1916876.26
14948,1987-08-14,333.99,-0.66,-0.2,334.65,-0.2,True,1,8202,-333.99,-827922.38,2739385.98,1911463.6
14949,1987-08-17,334.11,0.12,0.04,334.65,-0.16,True,1,8203,-334.11,-828256.49,2740704.33,1912447.84
14950,1987-08-18,329.25,-4.86,-1.46,334.65,-1.61,True,1,8204,-329.25,-828585.74,2701167.0,1872581.26
14951,1987-08-19,329.83,0.58,0.18,334.65,-1.44,True,1,8205,-329.83,-828915.57,2706255.15,1877339.58
14952,1987-08-20,334.84,5.01,1.52,334.84,0.0,True,1,8206,-334.84,-829250.41,2747697.04,1918446.63
14953,1987-08-21,335.9,1.06,0.32,335.9,0.0,True,1,8207,-335.9,-829586.31,2756731.3,1927144.99
14954,1987-08-24,333.33,-2.57,-0.76,335.9,-0.76,True,1,8208,-333.33,-829919.64,2735972.64,1906053.0
14955,1987-08-25,336.77,3.44,1.03,336.77,0.0,True,1,8209,-336.77,-830256.41,2764544.93,1934288.52
14956,1987-08-26,334.57,-2.2,-0.65,336.77,-0.65,True,1,8210,-334.57,-830590.98,2746819.7,1916228.72
14957,1987-08-27,331.38,-3.19,-0.95,336.77,-1.6,True,1,8211,-331.38,-830922.36,2720961.18,1890038.82
14958,1987-08-28,327.04,-4.34,-1.31,336.77,-2.89,True,1,8212,-327.04,-831249.4,2685652.48,1854403.08
14959,1987-08-31,329.8,2.76,0.84,336.77,-2.07,True,1,8213,-329.8,-831579.2,2708647.4,1877068.2
14960,1987-09-01,323.4,-6.4,-1.94,336.77,-3.97,True,1,8214,-323.4,-831902.6,2656407.6,1824505.0
14961,1987-09-02,321.68,-1.72,-0.53,336.77,-4.48,True,1,8215,-321.68,-832224.28,2642601.2,1810376.92
14962,1987-09-03,320.21,-1.47,-0.46,336.77,-4.92,True,1,8216,-320.21,-832544.49,2630845.36,1798300.87
14963,1987-09-04,316.7,-3.51,-1.1,336.77,-5.96,True,1,8217,-316.7,-832861.19,2602323.9,1769462.71
14964,1987-09-08,313.56,-3.14,-0.99,336.77,-6.89,True,1,8218,-313.56,-833174.75,2576836.08,1743661.33
14965,1987-09-09,313.92,0.36,0.12,336.77,-6.78,True,1,8219,-313.92,-833488.67,2580108.48,1746619.81
14966,1987-09-10,317.13,3.21,1.02,336.77,-5.83,True,1,8220,-317.13,-833805.8,2606808.6,1773002.8
14967,1987-09-11,321.98,4.85,1.53,336.77,-4.39,True,1,8221,-321.98,-834127.78,2646997.58,1812869.8
14968,1987-09-14,323.08,1.1,0.34,336.77,-4.07,True,1,8222,-323.08,-834450.86,2656363.76,1821912.9
14969,1987-09-15,317.74,-5.34,-1.65,336.77,-5.65,True,1,8223,-317.74,-834768.6,2612776.02,1778007.42
14970,1987-09-16,314.86,-2.88,-0.91,336.77,-6.51,True,1,8224,-314.86,-835083.46,2589408.64,1754325.18
14971,1987-09-17,314.93,0.07,0.02,336.77,-6.48,True,1,8225,-314.93,-835398.39,2590299.25,1754900.86
14972,1987-09-18,314.86,-0.07,-0.02,336.77,-6.51,True,1,8226,-314.86,-835713.25,2590038.36,1754325.11
14973,1987-09-21,310.54,-4.32,-1.37,336.77,-7.79,True,1,8227,-310.54,-836023.79,2554812.58,1718788.79
14974,1987-09-22,319.5,8.96,2.88,336.77,-5.13,True,1,8228,-319.5,-836343.29,2628846.0,1792502.71
14975,1987-09-23,321.19,1.69,0.53,336.77,-4.63,True,1,8229,-321.19,-836664.48,2643072.51,1806408.03
14976,1987-09-24,319.72,-1.47,-0.46,336.77,-5.06,True,1,8230,-319.72,-836984.2,2631295.6,1794311.4
14977,1987-09-25,320.16,0.44,0.14,336.77,-4.93,True,1,8231,-320.16,-837304.36,2635236.96,1797932.6
14978,1987-09-28,323.2,3.04,0.95,336.77,-4.03,True,1,8232,-323.2,-837627.56,2660582.4,1822954.84
14979,1987-09-29,321.69,-1.51,-0.47,336.77,-4.48,True,1,8233,-321.69,-837949.25,2648473.77,1810524.52
14980,1987-09-30,321.83,0.14,0.04,336.77,-4.44,True,1,8234,-321.83,-838271.08,2649948.22,1811677.14
14981,1987-10-01,327.33,5.5,1.71,336.77,-2.8,True,1,8235,-327.33,-838598.41,2695562.55,1856964.14
14982,1987-10-02,328.07,0.74,0.23,336.77,-2.58,True,1,8236,-328.07,-838926.48,2701984.52,1863058.04
14983,1987-10-05,328.08,0.01,0.0,336.77,-2.58,True,1,8237,-328.08,-839254.56,2702394.96,1863140.4
14984,1987-10-06,319.22,-8.86,-2.7,336.77,-5.21,True,1,8238,-319.22,-839573.78,2629734.36,1790160.58
14985,1987-10-07,318.54,-0.68,-0.21,336.77,-5.41,True,1,8239,-318.54,-839892.32,2624451.06,1784558.74
14986,1987-10-08,314.16,-4.38,-1.38,336.77,-6.71,True,1,8240,-314.16,-840206.48,2588678.4,1748471.92
14987,1987-10-09,311.07,-3.09,-0.98,336.77,-7.63,True,1,8241,-311.07,-840517.55,2563527.87,1723010.32
14988,1987-10-12,309.39,-1.68,-0.54,336.77,-8.13,True,1,8242,-309.39,-840826.94,2549992.38,1709165.44
14989,1987-10-13,314.52,5.13,1.66,336.77,-6.61,True,1,8243,-314.52,-841141.46,2592588.36,1751446.9
14990,1987-10-14,305.23,-9.29,-2.95,336.77,-9.36,True,1,8244,-305.23,-841446.69,2516316.12,1674869.43
14991,1987-10-15,298.08,-7.15,-2.34,336.77,-11.49,True,1,8245,-298.08,-841744.77,2457669.6,1615924.83
14992,1987-10-16,282.7,-15.38,-5.16,336.77,-16.06,True,1,8246,-282.7,-842027.47,2331144.2,1489116.73
14993,1987-10-19,224.84,-57.86,-20.47,336.77,-33.24,True,1,8247,-224.84,-842252.31,1854255.48,1012003.17
14994,1987-10-20,236.83,11.99,5.33,336.77,-29.68,True,1,8248,-236.83,-842489.14,1953373.84,1110884.7
14995,1987-10-21,258.38,21.55,9.1,336.77,-23.28,True,1,8249,-258.38,-842747.52,2131376.62,1288629.1
14996,1987-10-22,248.25,-10.13,-3.92,336.77,-26.28,True,1,8250,-248.25,-842995.77,2048062.5,1205066.73
14997,1987-10-23,248.22,-0.03,-0.01,336.77,-26.29,True,1,8251,-248.22,-843243.99,2048063.22,1204819.23
14998,1987-10-26,227.67,-20.55,-8.28,336.77,-32.4,True,1,8252,-227.67,-843471.66,1878732.84,1035261.18
14999,1987-10-27,233.19,5.52,2.42,336.77,-30.76,True,1,8253,-233.19,-843704.85,1924517.07,1080812.22
15000,1987-10-28,233.28,0.09,0.04,336.77,-30.73,True,1,8254,-233.28,-843938.13,1925493.12,1081554.99
15001,1987-10-29,244.77,11.49,4.92,336.77,-27.32,True,1,8255,-244.77,-844182.9,2020576.35,1176393.45
15002,1987-10-30,251.79,7.02,2.87,336.77,-25.23,True,1,8256,-251.79,-844434.69,2078778.24,1234343.55
15003,1987-11-02,255.75,3.96,1.57,336.77,-24.06,True,1,8257,-255.75,-844690.44,2111727.75,1267037.31
15004,1987-11-03,250.82,-4.93,-1.93,336.77,-25.52,True,1,8258,-250.82,-844941.26,2071271.56,1226330.3
15005,1987-11-04,248.96,-1.86,-0.74,336.77,-26.07,True,1,8259,-248.96,-845190.22,2056160.64,1210970.42
15006,1987-11-05,254.48,5.52,2.22,336.77,-24.44,True,1,8260,-254.48,-845444.7,2102004.8,1256560.1
15007,1987-11-06,250.41,-4.07,-1.6,336.77,-25.64,True,1,8261,-250.41,-845695.11,2068637.01,1222941.9
15008,1987-11-09,243.17,-7.24,-2.89,336.77,-27.79,True,1,8262,-243.17,-845938.28,2009070.54,1163132.26
15009,1987-11-10,239.0,-4.17,-1.72,336.77,-29.03,True,1,8263,-239.0,-846177.28,1974857.0,1128679.72
15010,1987-11-11,241.9,2.9,1.21,336.77,-28.17,True,1,8264,-241.9,-846419.18,1999061.6,1152642.42
15011,1987-11-12,248.52,6.62,2.74,336.77,-26.2,True,1,8265,-248.52,-846667.7,2054017.8,1207350.1
15012,1987-11-13,245.64,-2.88,-1.16,336.77,-27.06,True,1,8266,-245.64,-846913.34,2030460.24,1183546.9
15013,1987-11-16,246.76,1.12,0.46,336.77,-26.73,True,1,8267,-246.76,-847160.1,2039964.92,1192804.82
15014,1987-11-17,243.04,-3.72,-1.51,336.77,-27.83,True,1,8268,-243.04,-847403.14,2009454.72,1162051.58
15015,1987-11-18,245.55,2.51,1.03,336.77,-27.09,True,1,8269,-245.55,-847648.69,2030452.95,1182804.26
15016,1987-11-19,240.05,-5.5,-2.24,336.77,-28.72,True,1,8270,-240.05,-847888.74,1985213.5,1137324.76
15017,1987-11-20,242.0,1.95,0.81,336.77,-28.14,True,1,8271,-242.0,-848130.74,2001582.0,1153451.26
15018,1987-11-23,242.99,0.99,0.41,336.77,-27.85,True,1,8272,-242.99,-848373.73,2010013.28,1161639.55
15019,1987-11-24,246.39,3.4,1.4,336.77,-26.84,True,1,8273,-246.39,-848620.12,2038384.47,1189764.35
15020,1987-11-25,244.1,-2.29,-0.93,336.77,-27.52,True,1,8274,-244.1,-848864.22,2019683.4,1170819.18
15021,1987-11-27,240.34,-3.76,-1.54,336.77,-28.63,True,1,8275,-240.34,-849104.56,1988813.5,1139708.94
15022,1987-11-30,230.3,-10.04,-4.18,336.77,-31.62,True,1,8276,-230.3,-849334.86,1905962.8,1056627.94
15023,1987-12-01,232.0,1.7,0.74,336.77,-31.11,True,1,8277,-232.0,-849566.86,1920264.0,1070697.14
15024,1987-12-02,233.45,1.45,0.62,336.77,-30.68,True,1,8278,-233.45,-849800.31,1932499.1,1082698.79
15025,1987-12-03,225.21,-8.24,-3.53,336.77,-33.13,True,1,8279,-225.21,-850025.52,1864513.59,1014488.07
15026,1987-12-04,223.92,-1.29,-0.57,336.77,-33.51,True,1,8280,-223.92,-850249.44,1854057.6,1003808.16
15027,1987-12-07,228.76,4.84,2.16,336.77,-32.07,True,1,8281,-228.76,-850478.2,1894361.56,1043883.36
15028,1987-12-08,234.91,6.15,2.69,336.77,-30.25,True,1,8282,-234.91,-850713.11,1945524.62,1094811.51
15029,1987-12-09,238.89,3.98,1.69,336.77,-29.06,True,1,8283,-238.89,-850952.0,1978725.87,1127773.87
15030,1987-12-10,233.57,-5.32,-2.23,336.77,-30.64,True,1,8284,-233.57,-851185.57,1934893.88,1083708.31
15031,1987-12-11,235.32,1.75,0.75,336.77,-30.12,True,1,8285,-235.32,-851420.89,1949626.2,1098205.31
15032,1987-12-14,242.19,6.87,2.92,336.77,-28.08,True,1,8286,-242.19,-851663.08,2006786.34,1155123.26
15033,1987-12-15,242.81,0.62,0.26,336.77,-27.9,True,1,8287,-242.81,-851905.89,2012166.47,1160260.58
15034,1987-12-16,248.08,5.27,2.17,336.77,-26.34,True,1,8288,-248.08,-852153.97,2056087.04,1203933.07
15035,1987-12-17,242.98,-5.1,-2.06,336.77,-27.85,True,1,8289,-242.98,-852396.95,2014061.22,1161664.27
15036,1987-12-18,249.16,6.18,2.54,336.77,-26.02,True,1,8290,-249.16,-852646.11,2065536.4,1212890.29
15037,1987-12-21,249.54,0.38,0.15,336.77,-25.9,True,1,8291,-249.54,-852895.65,2068936.14,1216040.49
15038,1987-12-22,249.95,0.41,0.16,336.77,-25.78,True,1,8292,-249.95,-853145.6,2072585.4,1219439.8
15039,1987-12-23,253.16,3.21,1.28,336.77,-24.83,True,1,8293,-253.16,-853398.76,2099455.88,1246057.12
15040,1987-12-24,252.03,-1.13,-0.45,336.77,-25.16,True,1,8294,-252.03,-853650.79,2090336.82,1236686.03
15041,1987-12-28,245.57,-6.46,-2.56,336.77,-27.08,True,1,8295,-245.57,-853896.36,2037003.15,1183106.79
15042,1987-12-29,244.59,-0.98,-0.4,336.77,-27.37,True,1,8296,-244.59,-854140.95,2029118.64,1174977.69
15043,1987-12-30,247.86,3.27,1.34,336.77,-26.4,True,1,8297,-247.86,-854388.81,2056494.42,1202105.61
15044,1987-12-31,247.08,-0.78,-0.32,336.77,-26.63,True,1,8298,-247.08,-854635.89,2050269.84,1195633.95
15045,1988-01-04,255.94,8.86,3.59,336.77,-24.0,True,1,8299,-255.94,-854891.83,2124046.06,1269154.23
15046,1988-01-05,258.63,2.69,1.05,336.77,-23.2,True,1,8300,-258.63,-855150.46,2146629.0,1291478.54
15047,1988-01-06,258.89,0.26,0.1,336.77,-23.13,True,1,8301,-258.89,-855409.35,2149045.89,1293636.54
15048,1988-01-07,261.07,2.18,0.84,336.77,-22.48,True,1,8302,-261.07,-855670.42,2167403.14,1311732.72
15049,1988-01-08,243.4,-17.67,-6.77,336.77,-27.72,True,1,8303,-243.4,-855913.82,2020950.2,1165036.38
15050,1988-01-11,247.49,4.09,1.68,336.77,-26.51,True,1,8304,-247.49,-856161.31,2055156.96,1198995.65
15051,1988-01-12,245.42,-2.07,-0.84,336.77,-27.12,True,1,8305,-245.42,-856406.73,2038213.1,1181806.37
15052,1988-01-13,245.81,0.39,0.16,336.77,-27.01,True,1,8306,-245.81,-856652.54,2041697.86,1185045.32
15053,1988-01-14,245.88,0.07,0.03,336.77,-26.99,True,1,8307,-245.88,-856898.42,2042525.16,1185626.74
15054,1988-01-15,252.05,6.17,2.51,336.77,-25.16,True,1,8308,-252.05,-857150.47,2094031.4,1236880.93
15055,1988-01-18,251.88,-0.17,-0.07,336.77,-25.21,True,1,8309,-251.88,-857402.35,2092870.92,1235468.57
15056,1988-01-19,249.32,-2.56,-1.02,336.77,-25.97,True,1,8310,-249.32,-857651.67,2071849.2,1214197.53
15057,1988-01-20,242.63,-6.69,-2.68,336.77,-27.95,True,1,8311,-242.63,-857894.3,2016497.93,1158603.63
15058,1988-01-21,243.14,0.51,0.21,336.77,-27.8,True,1,8312,-243.14,-858137.44,2020979.68,1162842.24
15059,1988-01-22,246.5,3.36,1.38,336.77,-26.8,True,1,8313,-246.5,-858383.94,2049154.5,1190770.56
15060,1988-01-25,252.17,5.67,2.3,336.77,-25.12,True,1,8314,-252.17,-858636.11,2096541.38,1237905.27
15061,1988-01-26,249.57,-2.6,-1.03,336.77,-25.89,True,1,8315,-249.57,-858885.68,2075174.55,1216288.87
15062,1988-01-27,249.38,-0.19,-0.08,336.77,-25.95,True,1,8316,-249.38,-859135.06,2073844.08,1214709.02
15063,1988-01-28,253.29,3.91,1.57,336.77,-24.79,True,1,8317,-253.29,-859388.35,2106612.93,1247224.58
15064,1988-01-29,257.07,3.78,1.49,336.77,-23.67,True,1,8318,-257.07,-859645.42,2138308.26,1278662.84
15065,1988-02-01,255.04,-2.03,-0.79,336.77,-24.27,True,1,8319,-255.04,-859900.46,2121677.76,1261777.3
15066,1988-02-02,255.57,0.53,0.21,336.77,-24.11,True,1,8320,-255.57,-860156.03,2126342.4,1266186.37
15067,1988-02-03,252.21,-3.36,-1.32,336.77,-25.11,True,1,8321,-252.21,-860408.24,2098639.41,1238231.17
15068,1988-02-04,252.21,0.0,0.0,336.77,-25.11,True,1,8322,-252.21,-860660.45,2098891.62,1238231.17
15069,1988-02-05,250.96,-1.25,-0.5,336.77,-25.48,True,1,8323,-250.96,-860911.41,2088740.08,1227828.67
15070,1988-02-08,249.1,-1.86,-0.74,336.77,-26.03,True,1,8324,-249.1,-861160.51,2073508.4,1212347.89
15071,1988-02-09,251.72,2.62,1.05,336.77,-25.26,True,1,8325,-251.72,-861412.23,2095569.0,1234156.77
15072,1988-02-10,256.66,4.94,1.96,336.77,-23.79,True,1,8326,-256.66,-861668.89,2136951.16,1275282.27
15073,1988-02-11,255.95,-0.71,-0.28,336.77,-24.0,True,1,8327,-255.95,-861924.84,2131295.65,1269370.81
15074,1988-02-12,257.63,1.68,0.66,336.77,-23.5,True,1,8328,-257.63,-862182.47,2145542.64,1283360.17
15075,1988-02-16,259.83,2.2,0.85,336.77,-22.85,True,1,8329,-259.83,-862442.3,2164124.07,1301681.77
15076,1988-02-17,259.21,-0.62,-0.24,336.77,-23.03,True,1,8330,-259.21,-862701.51,2159219.3,1296517.79
15077,1988-02-18,257.91,-1.3,-0.5,336.77,-23.42,True,1,8331,-257.91,-862959.42,2148648.21,1285688.79
15078,1988-02-19,261.61,3.7,1.44,336.77,-22.32,True,1,8332,-261.61,-863221.03,2179734.52,1316513.49
15079,1988-02-22,265.64,4.03,1.54,336.77,-21.12,True,1,8333,-265.64,-863486.67,2213578.12,1350091.45
15080,1988-02-23,265.02,-0.62,-0.23,336.77,-21.3,True,1,8334,-265.02,-863751.69,2208676.68,1344924.99
15081,1988-02-24,264.43,-0.59,-0.22,336.77,-21.48,True,1,8335,-264.43,-864016.12,2204024.05,1340007.93
15082,1988-02-25,261.58,-2.85,-1.08,336.77,-22.33,True,1,8336,-261.58,-864277.7,2180530.88,1316253.18
15083,1988-02-26,262.46,0.88,0.34,336.77,-22.07,True,1,8337,-262.46,-864540.16,2188129.02,1323588.86
15084,1988-02-29,267.82,5.36,2.04,336.77,-20.47,True,1,8338,-267.82,-864807.98,2233083.16,1368275.18
15085,1988-03-01,267.22,-0.6,-0.22,336.77,-20.65,True,1,8339,-267.22,-865075.2,2228347.58,1363272.38
15086,1988-03-02,267.98,0.76,0.28,336.77,-20.43,True,1,8340,-267.98,-865343.18,2234953.2,1369610.02
15087,1988-03-03,267.88,-0.1,-0.04,336.77,-20.46,True,1,8341,-267.88,-865611.06,2234387.08,1368776.02
15088,1988-03-04,267.3,-0.58,-0.22,336.77,-20.63,True,1,8342,-267.3,-865878.36,2229816.6,1363938.24
15089,1988-03-07,267.38,0.08,0.03,336.77,-20.6,True,1,8343,-267.38,-866145.74,2230751.34,1364605.6
15090,1988-03-08,269.43,2.05,0.77,336.77,-20.0,True,1,8344,-269.43,-866415.17,2248123.92,1381708.75
15091,1988-03-09,269.06,-0.37,-0.14,336.77,-20.11,True,1,8345,-269.06,-866684.23,2245305.7,1378621.47
15092,1988-03-10,263.84,-5.22,-1.94,336.77,-21.66,True,1,8346,-263.84,-866948.07,2202008.64,1335060.57
15093,1988-03-11,264.94,1.1,0.42,336.77,-21.33,True,1,8347,-264.94,-867213.01,2211454.18,1344241.17
15094,1988-03-14,266.37,1.43,0.54,336.77,-20.9,True,1,8348,-266.37,-867479.38,2223656.76,1356177.38
15095,1988-03-15,266.13,-0.24,-0.09,336.77,-20.98,True,1,8349,-266.13,-867745.51,2221919.37,1354173.86
15096,1988-03-16,268.65,2.52,0.95,336.77,-20.23,True,1,8350,-268.65,-868014.16,2243227.5,1375213.34
15097,1988-03-17,271.22,2.57,0.96,336.77,-19.46,True,1,8351,-271.22,-868285.38,2264958.22,1396672.84
15098,1988-03-18,271.12,-0.1,-0.04,336.77,-19.49,True,1,8352,-271.12,-868556.5,2264394.24,1395837.74
15099,1988-03-21,268.74,-2.38,-0.88,336.77,-20.2,True,1,8353,-268.74,-868825.24,2244785.22,1375959.98
15100,1988-03-22,268.84,0.1,0.04,336.77,-20.17,True,1,8354,-268.84,-869094.08,2245889.36,1376795.28
15101,1988-03-23,268.91,0.07,0.03,336.77,-20.15,True,1,8355,-268.91,-869362.99,2246743.05,1377380.06
15102,1988-03-24,263.35,-5.56,-2.07,336.77,-21.8,True,1,8356,-263.35,-869626.34,2200552.6,1330926.26
15103,1988-03-25,258.51,-4.84,-1.84,336.77,-23.24,True,1,8357,-258.51,-869884.85,2160368.07,1290483.22
15104,1988-03-28,258.06,-0.45,-0.17,336.77,-23.37,True,1,8358,-258.06,-870142.91,2156865.48,1286722.57
15105,1988-03-29,260.07,2.01,0.78,336.77,-22.78,True,1,8359,-260.07,-870402.98,2173925.13,1303522.15
15106,1988-03-30,258.07,-2.0,-0.77,336.77,-23.37,True,1,8360,-258.07,-870661.05,2157465.2,1286804.15
15107,1988-03-31,258.89,0.82,0.32,336.77,-23.13,True,1,8361,-258.89,-870919.94,2164579.29,1293659.35
15108,1988-04-04,256.09,-2.8,-1.08,336.77,-23.96,True,1,8362,-256.09,-871176.03,2141424.58,1270248.55
15109,1988-04-05,258.51,2.42,0.94,336.77,-23.24,True,1,8363,-258.51,-871434.54,2161919.13,1290484.59
15110,1988-04-06,265.49,6.98,2.7,336.77,-21.17,True,1,8364,-265.49,-871700.03,2220558.36,1348858.33
15111,1988-04-07,266.16,0.67,0.25,336.77,-20.97,True,1,8365,-266.16,-871966.19,2226428.4,1354462.21
15112,1988-04-08,269.43,3.27,1.23,336.77,-20.0,True,1,8366,-269.43,-872235.62,2254051.38,1381815.76
15113,1988-04-11,270.16,0.73,0.27,336.77,-19.78,True,1,8367,-270.16,-872505.78,2260428.72,1387922.94
15114,1988-04-12,271.37,1.21,0.45,336.77,-19.42,True,1,8368,-271.37,-872777.15,2270824.16,1398047.01
15115,1988-04-13,271.58,0.21,0.08,336.77,-19.36,True,1,8369,-271.58,-873048.73,2272853.02,1399804.29
15116,1988-04-14,259.75,-11.83,-4.36,336.77,-22.87,True,1,8370,-259.75,-873308.48,2174107.5,1300799.02
15117,1988-04-15,259.77,0.02,0.01,336.77,-22.86,True,1,8371,-259.77,-873568.25,2174534.67,1300966.42
15118,1988-04-18,259.21,-0.56,-0.22,336.77,-23.03,True,1,8372,-259.21,-873827.46,2170106.12,1296278.66
15119,1988-04-19,257.92,-1.29,-0.5,336.77,-23.41,True,1,8373,-257.92,-874085.38,2159564.16,1285478.78
15120,1988-04-20,256.13,-1.79,-0.69,336.77,-23.94,True,1,8374,-256.13,-874341.51,2144832.62,1270491.11
15121,1988-04-21,256.42,0.29,0.11,336.77,-23.86,True,1,8375,-256.42,-874597.93,2147517.5,1272919.57
15122,1988-04-22,260.14,3.72,1.45,336.77,-22.75,True,1,8376,-260.14,-874858.07,2178932.64,1304074.57
15123,1988-04-25,262.51,2.37,0.91,336.77,-22.05,True,1,8377,-262.51,-875120.58,2199046.27,1323925.69
15124,1988-04-26,263.93,1.42,0.54,336.77,-21.63,True,1,8378,-263.93,-875384.51,2211205.54,1335821.03
15125,1988-04-27,263.8,-0.13,-0.05,336.77,-21.67,True,1,8379,-263.8,-875648.31,2210380.2,1334731.89
15126,1988-04-28,262.61,-1.19,-0.45,336.77,-22.02,True,1,8380,-262.61,-875910.92,2200671.8,1324760.88
15127,1988-04-29,261.33,-1.28,-0.49,336.77,-22.4,True,1,8381,-261.33,-876172.25,2190206.73,1314034.48
15128,1988-05-02,261.56,0.23,0.09,336.77,-22.33,True,1,8382,-261.56,-876433.81,2192395.92,1315962.11
15129,1988-05-03,263.0,1.44,0.55,336.77,-21.9,True,1,8383,-263.0,-876696.81,2204729.0,1328032.19
15130,1988-05-04,260.32,-2.68,-1.02,336.77,-22.7,True,1,8384,-260.32,-876957.13,2182522.88,1305565.75
15131,1988-05-05,258.79,-1.53,-0.59,336.77,-23.16,True,1,8385,-258.79,-877215.92,2169954.15,1292738.23
15132,1988-05-06,257.48,-1.31,-0.51,336.77,-23.54,True,1,8386,-257.48,-877473.4,2159227.28,1281753.88
15133,1988-05-09,256.54,-0.94,-0.36,336.77,-23.82,True,1,8387,-256.54,-877729.94,2151600.98,1273871.04
15134,1988-05-10,257.62,1.08,0.42,336.77,-23.5,True,1,8388,-257.62,-877987.56,2160916.56,1282929.0
15135,1988-05-11,253.31,-4.31,-1.67,336.77,-24.78,True,1,8389,-253.31,-878240.87,2125017.59,1246776.72
15136,1988-05-12,253.85,0.54,0.21,336.77,-24.62,True,1,8390,-253.85,-878494.72,2129801.5,1251306.78
15137,1988-05-13,256.78,2.93,1.15,336.77,-23.75,True,1,8391,-256.78,-878751.5,2154640.98,1275889.48
15138,1988-05-16,258.71,1.93,0.75,336.77,-23.18,True,1,8392,-258.71,-879010.21,2171094.32,1292084.11
15139,1988-05-17,255.39,-3.32,-1.28,336.77,-24.16,True,1,8393,-255.39,-879265.6,2143488.27,1264222.67
15140,1988-05-18,251.35,-4.04,-1.58,336.77,-25.36,True,1,8394,-251.35,-879516.95,2109831.9,1230314.95
15141,1988-05-19,252.57,1.22,0.48,336.77,-25.0,True,1,8395,-252.57,-879769.52,2120325.15,1240555.63
15142,1988-05-20,253.02,0.45,0.18,336.77,-24.87,True,1,8396,-253.02,-880022.54,2124355.92,1244333.38
15143,1988-05-23,250.83,-2.19,-0.87,336.77,-25.52,True,1,8397,-250.83,-880273.37,2106219.51,1225946.14
15144,1988-05-24,253.51,2.68,1.07,336.77,-24.72,True,1,8398,-253.51,-880526.88,2128976.98,1248450.1
15145,1988-05-25,253.76,0.25,0.1,336.77,-24.65,True,1,8399,-253.76,-880780.64,2131330.24,1250549.6
15146,1988-05-26,254.63,0.87,0.34,336.77,-24.39,True,1,8400,-254.63,-881035.27,2138892.0,1257856.73
15147,1988-05-27,253.42,-1.21,-0.48,336.77,-24.75,True,1,8401,-253.42,-881288.69,2128981.42,1247692.73
15148,1988-05-31,262.16,8.74,3.45,336.77,-22.16,True,1,8402,-262.16,-881550.85,2202668.32,1321117.47
15149,1988-06-01,266.69,4.53,1.73,336.77,-20.81,True,1,8403,-266.69,-881817.54,2240996.07,1359178.53
15150,1988-06-02,265.33,-1.36,-0.51,336.77,-21.21,True,1,8404,-265.33,-882082.87,2229833.32,1347750.45
15151,1988-06-03,266.45,1.12,0.42,336.77,-20.88,True,1,8405,-266.45,-882349.32,2239512.25,1357162.93
15152,1988-06-06,267.05,0.6,0.22,336.77,-20.7,True,1,8406,-267.05,-882616.37,2244822.3,1362205.93
15153,1988-06-07,265.17,-1.88,-0.7,336.77,-21.26,True,1,8407,-265.17,-882881.54,2229284.19,1346402.65
15154,1988-06-08,271.52,6.35,2.4,336.77,-19.38,True,1,8408,-271.52,-883153.06,2282940.16,1399787.1
15155,1988-06-09,270.2,-1.32,-0.49,336.77,-19.77,True,1,8409,-270.2,-883423.26,2272111.8,1388688.54
15156,1988-06-10,271.26,1.06,0.39,336.77,-19.45,True,1,8410,-271.26,-883694.52,2281296.6,1397602.08
15157,1988-06-13,271.43,0.17,0.06,336.77,-19.4,True,1,8411,-271.43,-883965.95,2282997.73,1399031.78
15158,1988-06-14,274.3,2.87,1.06,336.77,-18.55,True,1,8412,-274.3,-884240.25,2307411.6,1423171.35
15159,1988-06-15,274.45,0.15,0.06,336.77,-18.5,True,1,8413,-274.45,-884514.7,2308947.85,1424433.15
15160,1988-06-16,269.77,-4.68,-1.7,336.77,-19.9,True,1,8414,-269.77,-884784.47,2269844.78,1385060.31
15161,1988-06-17,270.68,0.91,0.34,336.77,-19.62,True,1,8415,-270.68,-885055.15,2277772.2,1392717.05
15162,1988-06-20,268.94,-1.74,-0.64,336.77,-20.14,True,1,8416,-268.94,-885324.09,2263399.04,1378074.95
15163,1988-06-21,271.67,2.73,1.01,336.77,-19.33,True,1,8417,-271.67,-885595.76,2286646.39,1401050.63
15164,1988-06-22,275.66,3.99,1.47,336.77,-18.15,True,1,8418,-275.66,-885871.42,2320505.88,1434634.46
15165,1988-06-23,274.82,-0.84,-0.3,336.77,-18.4,True,1,8419,-274.82,-886146.24,2313709.58,1427563.34
15166,1988-06-24,273.78,-1.04,-0.38,336.77,-18.7,True,1,8420,-273.78,-886420.02,2305227.6,1418807.58
15167,1988-06-27,269.06,-4.72,-1.72,336.77,-20.11,True,1,8421,-269.06,-886689.08,2265754.26,1379065.18
15168,1988-06-28,272.31,3.25,1.21,336.77,-19.14,True,1,8422,-272.31,-886961.39,2293394.82,1406433.43
15169,1988-06-29,270.98,-1.33,-0.49,336.77,-19.54,True,1,8423,-270.98,-887232.37,2282464.54,1395232.17
15170,1988-06-30,273.5,2.52,0.93,336.77,-18.79,True,1,8424,-273.5,-887505.87,2303964.0,1416458.13
15171,1988-07-01,271.78,-1.72,-0.63,336.77,-19.3,True,1,8425,-271.78,-887777.65,2289746.5,1401968.85
15172,1988-07-05,275.81,4.03,1.48,336.77,-18.1,True,1,8426,-275.81,-888053.46,2323975.06,1435921.6
15173,1988-07-06,272.02,-3.79,-1.37,336.77,-19.23,True,1,8427,-272.02,-888325.48,2292312.54,1403987.06
15174,1988-07-07,271.78,-0.24,-0.09,336.77,-19.3,True,1,8428,-271.78,-888597.26,2290561.84,1401964.58
15175,1988-07-08,270.02,-1.76,-0.65,336.77,-19.82,True,1,8429,-270.02,-888867.28,2275998.58,1387131.3
15176,1988-07-11,270.55,0.53,0.2,336.77,-19.66,True,1,8430,-270.55,-889137.83,2280736.5,1391598.67
15177,1988-07-12,267.85,-2.7,-1.0,336.77,-20.46,True,1,8431,-267.85,-889405.68,2258243.35,1368837.67
15178,1988-07-13,269.32,1.47,0.55,336.77,-20.03,True,1,8432,-269.32,-889675.0,2270906.24,1381231.24
15179,1988-07-14,270.26,0.94,0.35,336.77,-19.75,True,1,8433,-270.26,-889945.26,2279102.58,1389157.32
15180,1988-07-15,272.05,1.79,0.66,336.77,-19.22,True,1,8434,-272.05,-890217.31,2294469.7,1404252.39
15181,1988-07-18,270.51,-1.54,-0.57,336.77,-19.68,True,1,8435,-270.51,-890487.82,2281751.85,1391264.03
15182,1988-07-19,268.47,-2.04,-0.75,336.77,-20.28,True,1,8436,-268.47,-890756.29,2264812.92,1374056.63
15183,1988-07-20,270.0,1.53,0.57,336.77,-19.83,True,1,8437,-270.0,-891026.29,2277990.0,1386963.71
15184,1988-07-21,266.66,-3.34,-1.24,336.77,-20.82,True,1,8438,-266.66,-891292.95,2250077.08,1358784.13
15185,1988-07-22,263.5,-3.16,-1.18,336.77,-21.76,True,1,8439,-263.5,-891556.45,2223676.5,1332120.05
15186,1988-07-25,264.68,1.18,0.45,336.77,-21.41,True,1,8440,-264.68,-891821.13,2233899.2,1342078.07
15187,1988-07-26,265.19,0.51,0.19,336.77,-21.26,True,1,8441,-265.19,-892086.32,2238468.79,1346382.47
15188,1988-07-27,262.5,-2.69,-1.01,336.77,-22.05,True,1,8442,-262.5,-892348.82,2216025.0,1323676.18
15189,1988-07-28,266.02,3.52,1.34,336.77,-21.01,True,1,8443,-266.02,-892614.84,2246006.86,1353392.02
15190,1988-07-29,272.02,6.0,2.26,336.77,-19.23,True,1,8444,-272.02,-892886.86,2296936.88,1404050.02
15191,1988-08-01,272.21,0.19,0.07,336.77,-19.17,True,1,8445,-272.21,-893159.07,2298813.45,1405654.38
15192,1988-08-02,272.06,-0.15,-0.06,336.77,-19.22,True,1,8446,-272.06,-893431.13,2297818.76,1404387.63
15193,1988-08-03,272.98,0.92,0.34,336.77,-18.94,True,1,8447,-272.98,-893704.11,2305862.06,1412157.95
15194,1988-08-04,271.93,-1.05,-0.38,336.77,-19.25,True,1,8448,-271.93,-893976.04,2297264.64,1403288.6
15195,1988-08-05,271.15,-0.78,-0.29,336.77,-19.48,True,1,8449,-271.15,-894247.19,2290946.35,1396699.16
15196,1988-08-08,269.98,-1.17,-0.43,336.77,-19.83,True,1,8450,-269.98,-894517.17,2281331.0,1386813.83
15197,1988-08-09,266.49,-3.49,-1.29,336.77,-20.87,True,1,8451,-266.49,-894783.66,2252106.99,1357323.33
15198,1988-08-10,261.9,-4.59,-1.72,336.77,-22.23,True,1,8452,-261.9,-895045.56,2213578.8,1318533.24
15199,1988-08-11,262.75,0.85,0.32,336.77,-21.98,True,1,8453,-262.75,-895308.31,2221025.75,1325717.44
15200,1988-08-12,262.55,-0.2,-0.08,336.77,-22.04,True,1,8454,-262.55,-895570.86,2219597.7,1324026.84
15201,1988-08-15,258.69,-3.86,-1.47,336.77,-23.18,True,1,8455,-258.69,-895829.55,2187223.95,1291394.4
15202,1988-08-16,260.56,1.87,0.72,336.77,-22.63,True,1,8456,-260.56,-896090.11,2203295.36,1307205.25
15203,1988-08-17,260.77,0.21,0.08,336.77,-22.57,True,1,8457,-260.77,-896350.88,2205331.89,1308981.01
15204,1988-08-18,261.03,0.26,0.1,336.77,-22.49,True,1,8458,-261.03,-896611.91,2207791.74,1311179.83
15205,1988-08-19,260.24,-0.79,-0.3,336.77,-22.72,True,1,8459,-260.24,-896872.15,2201370.16,1304498.01
15206,1988-08-22,256.98,-3.26,-1.25,336.77,-23.69,True,1,8460,-256.98,-897129.13,2174050.8,1276921.67
15207,1988-08-23,257.09,0.11,0.04,336.77,-23.66,True,1,8461,-257.09,-897386.22,2175238.49,1277852.27
15208,1988-08-24,261.13,4.04,1.57,336.77,-22.46,True,1,8462,-261.13,-897647.35,2209682.06,1312034.71
15209,1988-08-25,259.18,-1.95,-0.75,336.77,-23.04,True,1,8463,-259.18,-897906.53,2193440.34,1295533.81
15210,1988-08-26,259.68,0.5,0.19,336.77,-22.89,True,1,8464,-259.68,-898166.21,2197931.52,1299765.31
15211,1988-08-29,262.33,2.65,1.02,336.77,-22.1,True,1,8465,-262.33,-898428.54,2220623.45,1322194.91
15212,1988-08-30,262.51,0.18,0.07,336.77,-22.05,True,1,8466,-262.51,-898691.05,2222409.66,1323718.61
15213,1988-08-31,261.52,-0.99,-0.38,336.77,-22.34,True,1,8467,-261.52,-898952.57,2214289.84,1315337.27
15214,1988-09-01,258.35,-3.17,-1.21,336.77,-23.29,True,1,8468,-258.35,-899210.92,2187707.8,1288496.88
15215,1988-09-02,264.48,6.13,2.37,336.77,-21.47,True,1,8469,-264.48,-899475.4,2239881.12,1340405.72
15216,1988-09-06,265.59,1.11,0.42,336.77,-21.14,True,1,8470,-265.59,-899740.99,2249547.3,1349806.31
15217,1988-09-07,265.87,0.28,0.1,336.77,-21.05,True,1,8471,-265.87,-900006.86,2252184.77,1352177.91
15218,1988-09-08,265.88,0.01,0.0,336.77,-21.05,True,1,8472,-265.88,-900272.74,2252535.36,1352262.62
15219,1988-09-09,266.84,0.96,0.36,336.77,-20.76,True,1,8473,-266.84,-900539.58,2260935.32,1360395.74
15220,1988-09-12,266.47,-0.37,-0.14,336.77,-20.88,True,1,8474,-266.47,-900806.05,2258066.78,1357260.73
15221,1988-09-13,267.43,0.96,0.36,336.77,-20.59,True,1,8475,-267.43,-901073.48,2266469.25,1365395.77
15222,1988-09-14,269.31,1.88,0.7,336.77,-20.03,True,1,8476,-269.31,-901342.79,2282671.56,1381328.77
15223,1988-09-15,268.13,-1.18,-0.44,336.77,-20.38,True,1,8477,-268.13,-901610.92,2272938.01,1371327.09
15224,1988-09-16,270.65,2.52,0.94,336.77,-19.63,True,1,8478,-270.65,-901881.57,2294570.7,1392689.13
15225,1988-09-19,268.82,-1.83,-0.68,336.77,-20.18,True,1,8479,-268.82,-902150.39,2279324.78,1377174.39
15226,1988-09-20,269.73,0.91,0.34,336.77,-19.91,True,1,8480,-269.73,-902420.12,2287310.4,1384890.28
15227,1988-09-21,270.16,0.43,0.16,336.77,-19.78,True,1,8481,-270.16,-902690.28,2291226.96,1388536.68
15228,1988-09-22,269.18,-0.98,-0.36,336.77,-20.07,True,1,8482,-269.18,-902959.46,2283184.76,1380225.3
15229,1988-09-23,269.76,0.58,0.22,336.77,-19.9,True,1,8483,-269.76,-903229.22,2288374.08,1385144.86
15230,1988-09-26,268.88,-0.88,-0.33,336.77,-20.16,True,1,8484,-268.88,-903498.1,2281177.92,1377679.82
15231,1988-09-27,268.26,-0.62,-0.23,336.77,-20.34,True,1,8485,-268.26,-903766.36,2276186.1,1372419.74
15232,1988-09-28,269.08,0.82,0.31,336.77,-20.1,True,1,8486,-269.08,-904035.44,2283412.88,1379377.44
15233,1988-09-29,272.59,3.51,1.3,336.77,-19.06,True,1,8487,-272.59,-904308.03,2313471.33,1409163.3
15234,1988-09-30,271.91,-0.68,-0.25,336.77,-19.26,True,1,8488,-271.91,-904579.94,2307972.08,1403392.14
15235,1988-10-03,271.38,-0.53,-0.2,336.77,-19.42,True,1,8489,-271.38,-904851.32,2303744.82,1398893.5
15236,1988-10-04,270.62,-0.76,-0.28,336.77,-19.64,True,1,8490,-270.62,-905121.94,2297563.8,1392441.86
15237,1988-10-05,271.86,1.24,0.46,336.77,-19.27,True,1,8491,-271.86,-905393.8,2308363.26,1402969.46
15238,1988-10-06,272.39,0.53,0.2,336.77,-19.12,True,1,8492,-272.39,-905666.19,2313135.88,1407469.69
15239,1988-10-07,278.07,5.68,2.08,336.77,-17.43,True,1,8493,-278.07,-905944.26,2361648.51,1455704.25
15240,1988-10-10,278.24,0.17,0.06,336.77,-17.38,True,1,8494,-278.24,-906222.5,2363370.56,1457148.06
15241,1988-10-11,277.93,-0.31,-0.11,336.77,-17.47,True,1,8495,-277.93,-906500.43,2361015.35,1454514.92
15242,1988-10-12,273.98,-3.95,-1.42,336.77,-18.64,True,1,8496,-273.98,-906774.41,2327734.08,1420959.67
15243,1988-10-13,275.22,1.24,0.45,336.77,-18.28,True,1,8497,-275.22,-907049.63,2338544.34,1431494.71
15244,1988-10-14,275.5,0.28,0.1,336.77,-18.19,True,1,8498,-275.5,-907325.13,2341199.0,1433873.87
15245,1988-10-17,276.41,0.91,0.33,336.77,-17.92,True,1,8499,-276.41,-907601.54,2349208.59,1441607.05
15246,1988-10-18,279.38,2.97,1.07,336.77,-17.04,True,1,8500,-279.38,-907880.92,2374730.0,1466849.08
15247,1988-10-19,276.97,-2.41,-0.86,336.77,-17.76,True,1,8501,-276.97,-908157.89,2354521.97,1446364.08
15248,1988-10-20,282.88,5.91,2.13,336.77,-16.0,True,1,8502,-282.88,-908440.77,2405045.76,1496604.99
15249,1988-10-21,283.66,0.78,0.28,336.77,-15.77,True,1,8503,-283.66,-908724.43,2411960.98,1503236.55
15250,1988-10-24,282.28,-1.38,-0.49,336.77,-16.18,True,1,8504,-282.28,-909006.71,2400509.12,1491502.41
15251,1988-10-25,282.38,0.1,0.04,336.77,-16.15,True,1,8505,-282.38,-909289.09,2401641.9,1492352.81
15252,1988-10-26,281.38,-1.0,-0.35,336.77,-16.45,True,1,8506,-281.38,-909570.47,2393418.28,1483847.81
15253,1988-10-27,277.28,-4.1,-1.46,336.77,-17.66,True,1,8507,-277.28,-909847.75,2358820.96,1448973.21
15254,1988-10-28,278.53,1.25,0.45,336.77,-17.29,True,1,8508,-278.53,-910126.28,2369733.24,1459606.96
15255,1988-10-31,278.97,0.44,0.16,336.77,-17.16,True,1,8509,-278.97,-910405.25,2373755.73,1463350.48
15256,1988-11-01,279.06,0.09,0.03,336.77,-17.14,True,1,8510,-279.06,-910684.31,2374800.6,1464116.29
15257,1988-11-02,279.06,0.0,0.0,336.77,-17.14,True,1,8511,-279.06,-910963.37,2375079.66,1464116.29
15258,1988-11-03,279.2,0.14,0.05,336.77,-17.1,True,1,8512,-279.2,-911242.57,2376550.4,1465307.83
15259,1988-11-04,276.31,-2.89,-1.03,336.77,-17.95,True,1,8513,-276.31,-911518.88,2352227.03,1440708.15
15260,1988-11-07,273.93,-2.38,-0.86,336.77,-18.66,True,1,8514,-273.93,-911792.81,2332240.02,1420447.21
15261,1988-11-08,275.15,1.22,0.44,336.77,-18.3,True,1,8515,-275.15,-912067.96,2342902.25,1430834.29
15262,1988-11-09,273.33,-1.82,-0.66,336.77,-18.84,True,1,8516,-273.33,-912341.29,2327678.28,1415336.99
15263,1988-11-10,273.69,0.36,0.13,336.77,-18.73,True,1,8517,-273.69,-912614.98,2331017.73,1418402.75
15264,1988-11-11,267.92,-5.77,-2.11,336.77,-20.44,True,1,8518,-267.92,-912882.9,2282142.56,1369259.66
15265,1988-11-14,267.72,-0.2,-0.08,336.77,-20.5,True,1,8519,-267.72,-913150.62,2280706.68,1367556.06
15266,1988-11-15,268.34,0.62,0.23,336.77,-20.32,True,1,8520,-268.34,-913418.96,2286256.8,1372837.84
15267,1988-11-16,263.82,-4.52,-1.68,336.77,-21.66,True,1,8521,-263.82,-913682.78,2248010.22,1334327.44
15268,1988-11-17,264.6,0.78,0.3,336.77,-21.43,True,1,8522,-264.6,-913947.38,2254921.2,1340973.82
15269,1988-11-18,266.47,1.87,0.71,336.77,-20.88,True,1,8523,-266.47,-914213.85,2271123.81,1356909.96
15270,1988-11-21,266.22,-0.25,-0.09,336.77,-20.95,True,1,8524,-266.22,-914480.07,2269259.28,1354779.21
15271,1988-11-22,267.21,0.99,0.37,336.77,-20.66,True,1,8525,-267.21,-914747.28,2277965.25,1363217.97
15272,1988-11-23,269.0,1.79,0.67,336.77,-20.12,True,1,8526,-269.0,-915016.28,2293494.0,1378477.72
15273,1988-11-25,267.23,-1.77,-0.66,336.77,-20.65,True,1,8527,-267.23,-915283.51,2278670.21,1363386.7
15274,1988-11-28,268.64,1.41,0.53,336.77,-20.23,True,1,8528,-268.64,-915552.15,2290961.92,1375409.77
15275,1988-11-29,270.91,2.27,0.84,336.77,-19.56,True,1,8529,-270.91,-915823.06,2310591.39,1394768.33
15276,1988-11-30,273.7,2.79,1.03,336.77,-18.73,True,1,8530,-273.7,-916096.76,2334661.0,1418564.24
15277,1988-12-01,272.49,-1.21,-0.44,336.77,-19.09,True,1,8531,-272.49,-916369.25,2324612.19,1408242.94
15278,1988-12-02,271.81,-0.68,-0.25,336.77,-19.29,True,1,8532,-271.81,-916641.06,2319082.92,1402441.86
15279,1988-12-05,274.93,3.12,1.15,336.77,-18.36,True,1,8533,-274.93,-916915.99,2345977.69,1429061.7
15280,1988-12-06,277.59,2.66,0.97,336.77,-17.57,True,1,8534,-277.59,-917193.58,2368953.06,1451759.48
15281,1988-12-07,278.13,0.54,0.2,336.77,-17.41,True,1,8535,-278.13,-917471.71,2373839.55,1456367.84
15282,1988-12-08,276.59,-1.54,-0.55,336.77,-17.87,True,1,8536,-276.59,-917748.3,2360972.24,1443223.94
15283,1988-12-09,277.03,0.44,0.16,336.77,-17.74,True,1,8537,-277.03,-918025.33,2365005.11,1446979.78
15284,1988-12-12,276.52,-0.51,-0.18,336.77,-17.89,True,1,8538,-276.52,-918301.85,2360927.76,1442625.91
15285,1988-12-13,276.31,-0.21,-0.08,336.77,-17.95,True,1,8539,-276.31,-918578.16,2359411.09,1440832.93
15286,1988-12-14,275.31,-1.0,-0.36,336.77,-18.25,True,1,8540,-275.31,-918853.47,2351147.4,1432293.93
15287,1988-12-15,274.28,-1.03,-0.37,336.77,-18.56,True,1,8541,-274.28,-919127.75,2342625.48,1423497.73
15288,1988-12-16,276.29,2.01,0.73,336.77,-17.96,True,1,8542,-276.29,-919404.04,2360069.18,1440665.14
15289,1988-12-19,278.91,2.62,0.95,336.77,-17.18,True,1,8543,-278.91,-919682.95,2382728.13,1463045.18
15290,1988-12-20,277.47,-1.44,-0.52,336.77,-17.61,True,1,8544,-277.47,-919960.42,2370703.68,1450743.26
15291,1988-12-21,277.38,-0.09,-0.03,336.77,-17.64,True,1,8545,-277.38,-920237.8,2370212.1,1449974.3
15292,1988-12-22,276.87,-0.51,-0.18,336.77,-17.79,True,1,8546,-276.87,-920514.67,2366131.02,1445616.35
15293,1988-12-23,277.87,1.0,0.36,336.77,-17.49,True,1,8547,-277.87,-920792.54,2374954.89,1454162.35
15294,1988-12-27,276.83,-1.04,-0.37,336.77,-17.8,True,1,8548,-276.83,-921069.37,2366342.84,1445273.47
15295,1988-12-28,277.08,0.25,0.09,336.77,-17.72,True,1,8549,-277.08,-921346.45,2368756.92,1447410.47
15296,1988-12-29,279.4,2.32,0.84,336.77,-17.04,True,1,8550,-279.4,-921625.85,2388870.0,1467244.15
15297,1988-12-30,277.72,-1.68,-0.6,336.77,-17.53,True,1,8551,-277.72,-921903.57,2374783.72,1452880.15
15298,1989-01-03,275.31,-2.41,-0.87,336.77,-18.25,True,1,8552,-275.31,-922178.88,2354451.12,1432272.24
15299,1989-01-04,279.43,4.12,1.5,336.77,-17.03,True,1,8553,-279.43,-922458.31,2389964.79,1467506.48
15300,1989-01-05,280.01,0.58,0.21,336.77,-16.85,True,1,8554,-280.01,-922738.32,2395205.54,1472467.22
15301,1989-01-06,280.67,0.66,0.24,336.77,-16.66,True,1,8555,-280.67,-923018.99,2401131.85,1478112.86
15302,1989-01-09,280.98,0.31,0.11,336.77,-16.57,True,1,8556,-280.98,-923299.97,2404064.88,1480764.91
15303,1989-01-10,280.38,-0.6,-0.21,336.77,-16.74,True,1,8557,-280.38,-923580.35,2399211.66,1475631.31
15304,1989-01-11,282.01,1.63,0.58,336.77,-16.26,True,1,8558,-282.01,-923862.36,2413441.58,1489579.22
15305,1989-01-12,283.17,1.16,0.41,336.77,-15.92,True,1,8559,-283.17,-924145.53,2423652.03,1499506.5
15306,1989-01-13,283.87,0.7,0.25,336.77,-15.71,True,1,8560,-283.87,-924429.4,2429927.2,1505497.8
15307,1989-01-16,284.14,0.27,0.1,336.77,-15.63,True,1,8561,-284.14,-924713.54,2432522.54,1507809.0
15308,1989-01-17,283.55,-0.59,-0.21,336.77,-15.8,True,1,8562,-283.55,-924997.09,2427755.1,1502758.01
15309,1989-01-18,286.53,2.98,1.05,336.77,-14.92,True,1,8563,-286.53,-925283.62,2453556.39,1528272.77
15310,1989-01-19,286.91,0.38,0.13,336.77,-14.8,True,1,8564,-286.91,-925570.53,2457097.24,1531526.71
15311,1989-01-20,286.63,-0.28,-0.1,336.77,-14.89,True,1,8565,-286.63,-925857.16,2454985.95,1529128.79
15312,1989-01-23,284.5,-2.13,-0.74,336.77,-15.52,True,1,8566,-284.5,-926141.66,2437027.0,1510885.34
15313,1989-01-24,288.49,3.99,1.4,336.77,-14.34,True,1,8567,-288.49,-926430.15,2471493.83,1545063.68
15314,1989-01-25,289.14,0.65,0.22,336.77,-14.14,True,1,8568,-289.14,-926719.29,2477351.52,1550632.23
15315,1989-01-26,291.69,2.55,0.88,336.77,-13.39,True,1,8569,-291.69,-927010.98,2499491.61,1572480.63
15316,1989-01-27,293.82,2.13,0.73,336.77,-12.75,True,1,8570,-293.82,-927304.8,2518037.4,1590732.6
15317,1989-01-30,294.99,1.17,0.4,336.77,-12.41,True,1,8571,-294.99,-927599.79,2528359.29,1600759.5
15318,1989-01-31,297.47,2.48,0.84,336.77,-11.67,True,1,8572,-297.47,-927897.26,2549912.84,1622015.58
15319,1989-02-01,297.09,-0.38,-0.13,336.77,-11.78,True,1,8573,-297.09,-928194.35,2546952.57,1618758.22
15320,1989-02-02,296.84,-0.25,-0.08,336.77,-11.86,True,1,8574,-296.84,-928491.19,2545106.16,1616614.97
15321,1989-02-03,296.97,0.13,0.04,336.77,-11.82,True,1,8575,-296.97,-928788.16,2546517.75,1617729.59
15322,1989-02-06,296.04,-0.93,-0.31,336.77,-12.09,True,1,8576,-296.04,-929084.2,2538839.04,1609754.84
15323,1989-02-07,299.63,3.59,1.21,336.77,-11.03,True,1,8577,-299.63,-929383.83,2569926.51,1640542.68
15324,1989-02-08,298.65,-0.98,-0.33,336.77,-11.32,True,1,8578,-298.65,-929682.48,2561819.7,1632137.22
15325,1989-02-09,296.06,-2.59,-0.87,336.77,-12.09,True,1,8579,-296.06,-929978.54,2539898.74,1609920.2
15326,1989-02-10,292.02,-4.04,-1.36,336.77,-13.29,True,1,8580,-292.02,-930270.56,2505531.6,1575261.04
15327,1989-02-13,292.54,0.52,0.18,336.77,-13.13,True,1,8581,-292.54,-930563.1,2510285.74,1579722.64
15328,1989-02-14,291.81,-0.73,-0.25,336.77,-13.35,True,1,8582,-291.81,-930854.91,2504313.42,1573458.51
15329,1989-02-15,294.24,2.43,0.83,336.77,-12.63,True,1,8583,-294.24,-931149.15,2525461.92,1594312.77
15330,1989-02-16,294.81,0.57,0.19,336.77,-12.46,True,1,8584,-294.81,-931443.96,2530649.04,1599205.08
15331,1989-02-17,296.76,1.95,0.66,336.77,-11.88,True,1,8585,-296.76,-931740.72,2547684.6,1615943.88
15332,1989-02-21,295.98,-0.78,-0.26,336.77,-12.11,True,1,8586,-295.98,-932036.7,2541284.28,1609247.58
15333,1989-02-22,290.91,-5.07,-1.71,336.77,-13.62,True,1,8587,-290.91,-932327.61,2498044.17,1565716.56
15334,1989-02-23,292.05,1.14,0.39,336.77,-13.28,True,1,8588,-292.05,-932619.66,2508125.4,1575505.74
15335,1989-02-24,287.13,-4.92,-1.68,336.77,-14.74,True,1,8589,-287.13,-932906.79,2466159.57,1533252.78
15336,1989-02-27,287.82,0.69,0.24,336.77,-14.54,True,1,8590,-287.82,-933194.61,2472373.8,1539179.19
15337,1989-02-28,288.86,1.04,0.36,336.77,-14.23,True,1,8591,-288.86,-933483.47,2481596.26,1548112.79
15338,1989-03-01,287.11,-1.75,-0.61,336.77,-14.75,True,1,8592,-287.11,-933770.58,2466849.12,1533078.54
15339,1989-03-02,289.95,2.84,0.99,336.77,-13.9,True,1,8593,-289.95,-934060.53,2491540.35,1557479.82
15340,1989-03-03,291.18,1.23,0.42,336.77,-13.54,True,1,8594,-291.18,-934351.71,2502400.92,1568049.21
15341,1989-03-06,294.81,3.63,1.25,336.77,-12.46,True,1,8595,-294.81,-934646.52,2533891.95,1599245.43
15342,1989-03-07,293.87,-0.94,-0.32,336.77,-12.74,True,1,8596,-293.87,-934940.39,2526106.52,1591166.13
15343,1989-03-08,294.08,0.21,0.07,336.77,-12.68,True,1,8597,-294.08,-935234.47,2528205.76,1592971.29
15344,1989-03-09,293.93,-0.15,-0.05,336.77,-12.72,True,1,8598,-293.93,-935528.4,2527210.14,1591681.74
15345,1989-03-10,292.88,-1.05,-0.36,336.77,-13.03,True,1,8599,-292.88,-935821.28,2518475.12,1582653.84
15346,1989-03-13,295.32,2.44,0.83,336.77,-12.31,True,1,8600,-295.32,-936116.6,2539752.0,1603635.4
15347,1989-03-14,295.14,-0.18,-0.06,336.77,-12.36,True,1,8601,-295.14,-936411.74,2538499.14,1602087.4
15348,1989-03-15,296.67,1.53,0.52,336.77,-11.91,True,1,8602,-296.67,-936708.41,2551955.34,1615246.93
15349,1989-03-16,299.44,2.77,0.93,336.77,-11.08,True,1,8603,-299.44,-937007.85,2576082.32,1639074.47
15350,1989-03-17,292.69,-6.75,-2.25,336.77,-13.09,True,1,8604,-292.69,-937300.54,2518304.76,1581004.22
15351,1989-03-20,289.92,-2.77,-0.95,336.77,-13.91,True,1,8605,-289.92,-937590.46,2494761.6,1557171.14
15352,1989-03-21,291.33,1.41,0.49,336.77,-13.49,True,1,8606,-291.33,-937881.79,2507185.98,1569304.19
15353,1989-03-22,290.49,-0.84,-0.29,336.77,-13.74,True,1,8607,-290.49,-938172.28,2500247.43,1562075.15
15354,1989-03-23,288.98,-1.51,-0.52,336.77,-14.19,True,1,8608,-288.98,-938461.26,2487539.84,1549078.58
15355,1989-03-27,290.57,1.59,0.55,336.77,-13.72,True,1,8609,-290.57,-938751.83,2501517.13,1562765.3
15356,1989-03-28,291.59,1.02,0.35,336.77,-13.42,True,1,8610,-291.59,-939043.42,2510589.9,1571546.48
15357,1989-03-29,292.35,0.76,0.26,336.77,-13.19,True,1,8611,-292.35,-939335.77,2517425.85,1578090.08
15358,1989-03-30,292.52,0.17,0.06,336.77,-13.14,True,1,8612,-292.52,-939628.29,2519182.24,1579553.95
15359,1989-03-31,294.87,2.35,0.8,336.77,-12.44,True,1,8613,-294.87,-939923.16,2539715.31,1599792.15
15360,1989-04-03,296.39,1.52,0.52,336.77,-11.99,True,1,8614,-296.39,-940219.55,2553103.46,1612883.91
15361,1989-04-04,295.31,-1.08,-0.36,336.77,-12.31,True,1,8615,-295.31,-940514.86,2544095.65,1603580.79
15362,1989-04-05,296.24,0.93,0.32,336.77,-12.04,True,1,8616,-296.24,-940811.1,2552403.84,1611592.74
15363,1989-04-06,295.29,-0.95,-0.32,336.77,-12.32,True,1,8617,-295.29,-941106.39,2544513.93,1603407.54
15364,1989-04-07,297.16,1.87,0.63,336.77,-11.76,True,1,8618,-297.16,-941403.55,2560924.88,1619521.33
15365,1989-04-10,297.11,-0.05,-0.02,336.77,-11.78,True,1,8619,-297.11,-941700.66,2560791.09,1619090.43
15366,1989-04-11,298.49,1.38,0.46,336.77,-11.37,True,1,8620,-298.49,-941999.15,2572983.8,1630984.65
15367,1989-04-12,298.99,0.5,0.17,336.77,-11.22,True,1,8621,-298.99,-942298.14,2577592.79,1635294.65
15368,1989-04-13,296.4,-2.59,-0.87,336.77,-11.99,True,1,8622,-296.4,-942594.54,2555560.8,1612966.26
15369,1989-04-14,301.36,4.96,1.67,336.77,-10.52,True,1,8623,-301.36,-942895.9,2598627.28,1655731.38
15370,1989-04-17,301.72,0.36,0.12,336.77,-10.41,True,1,8624,-301.72,-943197.62,2602033.28,1658835.66
15371,1989-04-18,306.02,4.3,1.42,336.77,-9.13,True,1,8625,-306.02,-943503.64,2639422.5,1695918.86
15372,1989-04-19,307.15,1.13,0.37,336.77,-8.8,True,1,8626,-307.15,-943810.79,2649475.9,1705665.11
15373,1989-04-20,306.19,-0.96,-0.31,336.77,-9.08,True,1,8627,-306.19,-944116.98,2641501.13,1697384.15
15374,1989-04-21,309.61,3.42,1.12,336.77,-8.06,True,1,8628,-309.61,-944426.59,2671315.08,1726888.49
15375,1989-04-24,308.69,-0.92,-0.3,336.77,-8.34,True,1,8629,-308.69,-944735.28,2663686.01,1718950.73
15376,1989-04-25,306.75,-1.94,-0.63,336.77,-8.91,True,1,8630,-306.75,-945042.03,2647252.5,1702210.47
15377,1989-04-26,306.93,0.18,0.06,336.77,-8.86,True,1,8631,-306.93,-945348.96,2649112.83,1703763.87
15378,1989-04-27,309.58,2.65,0.86,336.77,-8.07,True,1,8632,-309.58,-945658.54,2672294.56,1726636.02
15379,1989-04-28,309.64,0.06,0.02,336.77,-8.06,True,1,8633,-309.64,-945968.18,2673122.12,1727153.94
15380,1989-05-01,309.12,-0.52,-0.17,336.77,-8.21,True,1,8634,-309.12,-946277.3,2668942.08,1722664.78
15381,1989-05-02,308.12,-1.0,-0.32,336.77,-8.51,True,1,8635,-308.12,-946585.42,2660616.2,1714030.78
15382,1989-05-03,308.16,0.04,0.01,336.77,-8.49,True,1,8636,-308.16,-946893.58,2661269.76,1714376.18
15383,1989-05-04,307.77,-0.39,-0.13,336.77,-8.61,True,1,8637,-307.77,-947201.35,2658209.49,1711008.14
15384,1989-05-05,307.61,-0.16,-0.05,336.77,-8.66,True,1,8638,-307.61,-947508.96,2657135.18,1709626.22
15385,1989-05-08,306.0,-1.61,-0.52,336.77,-9.14,True,1,8639,-306.0,-947814.96,2643534.0,1695719.04
15386,1989-05-09,305.19,-0.81,-0.26,336.77,-9.38,True,1,8640,-305.19,-948120.15,2636841.6,1688721.45
15387,1989-05-10,305.8,0.61,0.2,336.77,-9.2,True,1,8641,-305.8,-948425.95,2642417.8,1693991.85
15388,1989-05-11,306.95,1.15,0.38,336.77,-8.86,True,1,8642,-306.95,-948732.9,2652661.9,1703929.0
15389,1989-05-12,313.84,6.89,2.24,336.77,-6.81,True,1,8643,-313.84,-949046.74,2712519.12,1763472.38
15390,1989-05-15,316.16,2.32,0.74,336.77,-6.12,True,1,8644,-316.16,-949362.9,2732887.04,1783524.14
15391,1989-05-16,315.28,-0.88,-0.28,336.77,-6.38,True,1,8645,-315.28,-949678.18,2725595.6,1775917.42
15392,1989-05-17,317.48,2.2,0.7,336.77,-5.73,True,1,8646,-317.48,-949995.66,2744932.08,1794936.42
15393,1989-05-18,317.97,0.49,0.15,336.77,-5.58,True,1,8647,-317.97,-950313.63,2749486.59,1799172.96
15394,1989-05-19,321.24,3.27,1.03,336.77,-4.61,True,1,8648,-321.24,-950634.87,2778083.52,1827448.65
15395,1989-05-22,321.98,0.74,0.23,336.77,-4.39,True,1,8649,-321.98,-950956.85,2784805.02,1833848.17
15396,1989-05-23,318.32,-3.66,-1.14,336.77,-5.48,True,1,8650,-318.32,-951275.17,2753468.0,1802192.83
15397,1989-05-24,319.14,0.82,0.26,336.77,-5.24,True,1,8651,-319.14,-951594.31,2760880.14,1809285.83
15398,1989-05-25,319.17,0.03,0.01,336.77,-5.23,True,1,8652,-319.17,-951913.48,2761458.84,1809545.36
15399,1989-05-26,321.59,2.42,0.76,336.77,-4.51,True,1,8653,-321.59,-952235.07,2782718.27,1830483.2
15400,1989-05-30,319.05,-2.54,-0.79,336.77,-5.26,True,1,8654,-319.05,-952554.12,2761058.7,1808504.58
15401,1989-05-31,320.52,1.47,0.46,336.77,-4.82,True,1,8655,-320.52,-952874.64,2774100.6,1821225.96
15402,1989-06-01,321.97,1.45,0.45,336.77,-4.39,True,1,8656,-321.97,-953196.61,2786972.32,1833775.71
15403,1989-06-02,325.52,3.55,1.1,336.77,-3.34,True,1,8657,-325.52,-953522.13,2818026.64,1864504.51
15404,1989-06-05,322.03,-3.49,-1.07,336.77,-4.38,True,1,8658,-322.03,-953844.16,2788135.74,1834291.58
15405,1989-06-06,324.24,2.21,0.69,336.77,-3.72,True,1,8659,-324.24,-954168.4,2807594.16,1853425.76
15406,1989-06-07,326.95,2.71,0.84,336.77,-2.92,True,1,8660,-326.95,-954495.35,2831387.0,1876891.65
15407,1989-06-08,326.75,-0.2,-0.06,336.77,-2.98,True,1,8661,-326.75,-954822.1,2829981.75,1875159.65
15408,1989-06-09,326.69,-0.06,-0.02,336.77,-2.99,True,1,8662,-326.69,-955148.79,2829788.78,1874639.99
15409,1989-06-12,326.24,-0.45,-0.14,336.77,-3.13,True,1,8663,-326.24,-955475.03,2826217.12,1870742.09
15410,1989-06-13,323.91,-2.33,-0.71,336.77,-3.82,True,1,8664,-323.91,-955798.94,2806356.24,1850557.3
15411,1989-06-14,323.83,-0.08,-0.02,336.77,-3.84,True,1,8665,-323.83,-956122.77,2805986.95,1849864.18
15412,1989-06-15,320.08,-3.75,-1.16,336.77,-4.96,True,1,8666,-320.08,-956442.85,2773813.28,1817370.43
15413,1989-06-16,321.35,1.27,0.4,336.77,-4.58,True,1,8667,-321.35,-956764.2,2785140.45,1828376.25
15414,1989-06-19,321.89,0.54,0.17,336.77,-4.42,True,1,8668,-321.89,-957086.09,2790142.52,1833056.43
15415,1989-06-20,321.25,-0.64,-0.2,336.77,-4.61,True,1,8669,-321.25,-957407.34,2784916.25,1827508.91
15416,1989-06-21,320.48,-0.77,-0.24,336.77,-4.84,True,1,8670,-320.48,-957727.82,2778561.6,1820833.78
15417,1989-06-22,322.32,1.84,0.57,336.77,-4.29,True,1,8671,-322.32,-958050.14,2794836.72,1836786.58
15418,1989-06-23,328.0,5.68,1.76,336.77,-2.6,True,1,8672,-328.0,-958378.14,2844416.0,1886037.86
15419,1989-06-26,326.6,-1.4,-0.43,336.77,-3.02,True,1,8673,-326.6,-958704.74,2832601.8,1873897.06
15420,1989-06-27,328.44,1.84,0.56,336.77,-2.47,True,1,8674,-328.44,-959033.18,2848888.56,1889855.38
15421,1989-06-28,325.81,-2.63,-0.8,336.77,-3.25,True,1,8675,-325.81,-959358.99,2826401.75,1867042.76
15422,1989-06-29,319.68,-6.13,-1.88,336.77,-5.08,True,1,8676,-319.68,-959678.67,2773543.68,1813865.01
15423,1989-06-30,317.98,-1.7,-0.53,336.77,-5.58,True,1,8677,-317.98,-959996.65,2759112.46,1799115.81
15424,1989-07-03,319.23,1.25,0.39,336.77,-5.21,True,1,8678,-319.23,-960315.88,2770277.94,1809962.06
15425,1989-07-05,320.64,1.41,0.44,336.77,-4.79,True,1,8679,-320.64,-960636.52,2782834.56,1822198.04
15426,1989-07-06,321.55,0.91,0.28,336.77,-4.52,True,1,8680,-321.55,-960958.07,2791054.0,1830095.93
15427,1989-07-07,324.91,3.36,1.04,336.77,-3.52,True,1,8681,-324.91,-961282.98,2820543.71,1859260.73
15428,1989-07-10,327.07,2.16,0.66,336.77,-2.88,True,1,8682,-327.07,-961610.05,2839621.74,1878011.69
15429,1989-07-11,328.78,1.71,0.52,336.77,-2.37,True,1,8683,-328.78,-961938.83,2854796.74,1892857.91
15430,1989-07-12,329.81,1.03,0.31,336.77,-2.07,True,1,8684,-329.81,-962268.64,2864070.04,1901801.4
15431,1989-07-13,329.95,0.14,0.04,336.77,-2.02,True,1,8685,-329.95,-962598.59,2865615.75,1903017.16
15432,1989-07-14,331.84,1.89,0.57,336.77,-1.46,True,1,8686,-331.84,-962930.43,2882362.24,1919431.81
15433,1989-07-17,332.44,0.6,0.18,336.77,-1.29,True,1,8687,-332.44,-963262.87,2887906.28,1924643.41
15434,1989-07-18,331.35,-1.09,-0.33,336.77,-1.61,True,1,8688,-331.35,-963594.22,2878768.8,1915174.58
15435,1989-07-19,335.73,4.38,1.32,336.77,-0.31,True,1,8689,-335.73,-963929.95,2917157.97,1953228.02
15436,1989-07-20,333.51,-2.22,-0.66,336.77,-0.97,True,1,8690,-333.51,-964263.46,2898201.9,1933938.44
15437,1989-07-21,335.9,2.39,0.72,336.77,-0.26,True,1,8691,-335.9,-964599.36,2919306.9,1954707.54
15438,1989-07-24,333.67,-2.23,-0.66,336.77,-0.92,True,1,8692,-333.67,-964933.03,2900259.64,1935326.61
15439,1989-07-25,333.88,0.21,0.06,336.77,-0.86,True,1,8693,-333.88,-965266.91,2902418.84,1937151.93
15440,1989-07-26,338.05,4.17,1.25,338.05,0.0,True,1,8694,-338.05,-965604.96,2939006.7,1973401.74
15441,1989-07-27,341.99,3.94,1.17,341.99,0.0,True,1,8695,-341.99,-965946.95,2973603.05,2007656.1
15442,1989-07-28,342.15,0.16,0.05,342.15,0.0,True,1,8696,-342.15,-966289.1,2975336.4,2009047.3
15443,1989-07-31,346.08,3.93,1.15,346.08,0.0,True,1,8697,-346.08,-966635.18,3009857.76,2043222.58
15444,1989-08-01,343.75,-2.33,-0.67,346.08,-0.67,True,1,8698,-343.75,-966978.93,2989937.5,2022958.57
15445,1989-08-02,344.34,0.59,0.17,346.08,-0.5,True,1,8699,-344.34,-967323.27,2995413.66,2028090.39
15446,1989-08-03,344.74,0.4,0.12,346.08,-0.39,True,1,8700,-344.74,-967668.01,2999238.0,2031569.99
15447,1989-08-04,343.92,-0.82,-0.24,346.08,-0.62,True,1,8701,-343.92,-968011.93,2992447.92,2024435.99
15448,1989-08-07,349.41,5.49,1.6,349.41,0.0,True,1,8702,-349.41,-968361.34,3040565.82,2072204.48
15449,1989-08-08,349.35,-0.06,-0.02,349.41,-0.02,True,1,8703,-349.35,-968710.69,3040393.05,2071682.36
15450,1989-08-09,346.94,-2.41,-0.69,349.41,-0.71,True,1,8704,-346.94,-969057.63,3019765.76,2050708.13
15451,1989-08-10,348.25,1.31,0.38,349.41,-0.33,True,1,8705,-348.25,-969405.88,3031516.25,2062110.37
15452,1989-08-11,344.74,-3.51,-1.01,349.41,-1.34,True,1,8706,-344.74,-969750.62,3001306.44,2031555.82
15453,1989-08-14,343.06,-1.68,-0.49,349.41,-1.82,True,1,8707,-343.06,-970093.68,2987023.42,2016929.74
15454,1989-08-15,344.71,1.65,0.48,349.41,-1.34,True,1,8708,-344.71,-970438.39,3001734.68,2031296.29
15455,1989-08-16,345.66,0.95,0.28,349.41,-1.07,True,1,8709,-345.66,-970784.05,3010352.94,2039568.89
15456,1989-08-17,344.45,-1.21,-0.35,349.41,-1.42,True,1,8710,-344.45,-971128.5,3000159.5,2029031.0
15457,1989-08-18,346.03,1.58,0.46,349.41,-0.97,True,1,8711,-346.03,-971474.53,3014267.33,2042792.8
15458,1989-08-21,340.67,-5.36,-1.55,349.41,-2.5,True,1,8712,-340.67,-971815.2,2967917.04,1996101.84
15459,1989-08-22,341.19,0.52,0.15,349.41,-2.35,True,1,8713,-341.19,-972156.39,2972788.47,2000632.08
15460,1989-08-23,344.7,3.51,1.03,349.41,-1.35,True,1,8714,-344.7,-972501.09,3003715.8,2031214.71
15461,1989-08-24,351.52,6.82,1.98,351.52,0.0,True,1,8715,-351.52,-972852.61,3063496.8,2090644.19
15462,1989-08-25,350.52,-1.0,-0.28,351.52,-0.28,True,1,8716,-350.52,-973203.13,3055132.32,2081929.19
15463,1989-08-28,352.09,1.57,0.45,352.09,0.0,True,1,8717,-352.09,-973555.22,3069168.53,2095613.31
15464,1989-08-29,349.84,-2.25,-0.64,352.09,-0.64,True,1,8718,-349.84,-973905.06,3049905.12,2076000.06
15465,1989-08-30,350.65,0.81,0.23,352.09,-0.41,True,1,8719,-350.65,-974255.71,3057317.35,2083061.64
15466,1989-08-31,351.45,0.8,0.23,352.09,-0.18,True,1,8720,-351.45,-974607.16,3064644.0,2090036.84
15467,1989-09-01,353.73,2.28,0.65,353.73,0.0,True,1,8721,-353.73,-974960.89,3084879.33,2109918.44
15468,1989-09-05,352.56,-1.17,-0.33,353.73,-0.33,True,1,8722,-352.56,-975313.45,3075028.32,2099714.87
15469,1989-09-06,349.24,-3.32,-0.94,353.73,-1.27,True,1,8723,-349.24,-975662.69,3046420.52,2070757.83
15470,1989-09-07,348.35,-0.89,-0.26,353.73,-1.52,True,1,8724,-348.35,-976011.04,3039005.4,2062994.36
15471,1989-09-08,348.76,0.41,0.12,353.73,-1.4,True,1,8725,-348.76,-976359.8,3042931.0,2066571.2
15472,1989-09-11,347.66,-1.1,-0.32,353.73,-1.72,True,1,8726,-347.66,-976707.46,3033681.16,2056973.7
15473,1989-09-12,348.7,1.04,0.3,353.73,-1.42,True,1,8727,-348.7,-977056.16,3043104.9,2066048.74
15474,1989-09-13,345.46,-3.24,-0.93,353.73,-2.34,True,1,8728,-345.46,-977401.62,3015174.88,2037773.26
15475,1989-09-14,343.16,-2.3,-0.67,353.73,-2.99,True,1,8729,-343.16,-977744.78,2995443.64,2017698.86
15476,1989-09-15,345.06,1.9,0.55,353.73,-2.45,True,1,8730,-345.06,-978089.84,3012373.8,2034283.96
15477,1989-09-18,346.73,1.67,0.48,353.73,-1.98,True,1,8731,-346.73,-978436.57,3027299.63,2048863.06
15478,1989-09-19,346.55,-0.18,-0.05,353.73,-2.03,True,1,8732,-346.55,-978783.12,3026074.6,2047291.48
15479,1989-09-20,346.47,-0.08,-0.02,353.73,-2.05,True,1,8733,-346.47,-979129.59,3025722.51,2046592.92
15480,1989-09-21,345.7,-0.77,-0.22,353.73,-2.27,True,1,8734,-345.7,-979475.29,3019343.8,2039868.51
15481,1989-09-22,347.05,1.35,0.39,353.73,-1.89,True,1,8735,-347.05,-979822.34,3031481.75,2051659.41
15482,1989-09-25,344.23,-2.82,-0.81,353.73,-2.69,True,1,8736,-344.23,-980166.57,3007193.28,2027026.71
15483,1989-09-26,344.33,0.1,0.03,353.73,-2.66,True,1,8737,-344.33,-980510.9,3008411.21,2027900.31
15484,1989-09-27,345.1,0.77,0.22,353.73,-2.44,True,1,8738,-345.1,-980856.0,3015483.8,2034627.8
15485,1989-09-28,348.6,3.5,1.01,353.73,-1.45,True,1,8739,-348.6,-981204.6,3046415.4,2065210.8
15486,1989-09-29,349.15,0.55,0.16,353.73,-1.3,True,1,8740,-349.15,-981553.75,3051571.0,2070017.25
15487,1989-10-02,350.87,1.72,0.49,353.73,-0.81,True,1,8741,-350.87,-981904.62,3066954.67,2085050.05
15488,1989-10-03,354.71,3.84,1.09,354.71,0.0,True,1,8742,-354.71,-982259.33,3100874.82,2118615.49
15489,1989-10-04,356.94,2.23,0.63,356.94,0.0,True,1,8743,-356.94,-982616.27,3120726.42,2138110.15
15490,1989-10-05,356.97,0.03,0.01,356.97,0.0,True,1,8744,-356.97,-982973.24,3121345.68,2138372.44
15491,1989-10-06,358.78,1.81,0.51,358.78,0.0,True,1,8745,-358.78,-983332.02,3137531.1,2154199.08
15492,1989-10-09,359.8,1.02,0.28,359.8,0.0,True,1,8746,-359.8,-983691.82,3146810.8,2163118.98
15493,1989-10-10,359.13,-0.67,-0.19,359.8,-0.19,True,1,8747,-359.13,-984050.95,3141310.11,2157259.16
15494,1989-10-11,356.99,-2.14,-0.6,359.8,-0.78,True,1,8748,-356.99,-984407.94,3122948.52,2138540.58
15495,1989-10-12,355.39,-1.6,-0.45,359.8,-1.23,True,1,8749,-355.39,-984763.33,3109307.11,2124543.78
15496,1989-10-13,333.65,-21.74,-6.12,359.8,-7.27,True,1,8750,-333.65,-985096.98,2919437.5,1934340.52
15497,1989-10-16,342.85,9.2,2.76,359.8,-4.71,True,1,8751,-342.85,-985439.83,3000280.35,2014840.52
15498,1989-10-17,341.16,-1.69,-0.49,359.8,-5.18,True,1,8752,-341.16,-985780.99,2985832.32,2000051.33
15499,1989-10-18,341.76,0.6,0.18,359.8,-5.01,True,1,8753,-341.76,-986122.75,2991425.28,2005302.53
15500,1989-10-19,347.13,5.37,1.57,359.8,-3.52,True,1,8754,-347.13,-986469.88,3038776.02,2052306.14
15501,1989-10-20,347.16,0.03,0.01,359.8,-3.51,True,1,8755,-347.16,-986817.04,3039385.8,2052568.76
15502,1989-10-23,344.83,-2.33,-0.67,359.8,-4.16,True,1,8756,-344.83,-987161.87,3019331.48,2032169.61
15503,1989-10-24,343.7,-1.13,-0.33,359.8,-4.47,True,1,8757,-343.7,-987505.57,3009780.9,2022275.33
15504,1989-10-25,342.5,-1.2,-0.35,359.8,-4.81,True,1,8758,-342.5,-987848.07,2999615.0,2011766.93
15505,1989-10-26,337.93,-4.57,-1.33,359.8,-6.08,True,1,8759,-337.93,-988186.0,2959928.87,1971742.87
15506,1989-10-27,335.06,-2.87,-0.85,359.8,-6.88,True,1,8760,-335.06,-988521.06,2935125.6,1946604.54
15507,1989-10-30,335.07,0.01,0.0,359.8,-6.87,True,1,8761,-335.07,-988856.13,2935548.27,1946692.14
15508,1989-10-31,340.36,5.29,1.58,359.8,-5.4,True,1,8762,-340.36,-989196.49,2982234.32,1993037.83
15509,1989-11-01,341.2,0.84,0.25,359.8,-5.17,True,1,8763,-341.2,-989537.69,2989935.6,2000397.91
15510,1989-11-02,338.48,-2.72,-0.8,359.8,-5.93,True,1,8764,-338.48,-989876.17,2966438.72,1976562.55
15511,1989-11-03,337.62,-0.86,-0.25,359.8,-6.16,True,1,8765,-337.62,-990213.79,2959239.3,1969025.51
15512,1989-11-06,332.61,-5.01,-1.48,359.8,-7.56,True,1,8766,-332.61,-990546.4,2915659.26,1925112.86
15513,1989-11-07,334.81,2.2,0.66,359.8,-6.95,True,1,8767,-334.81,-990881.21,2935279.27,1944398.06
15514,1989-11-08,338.15,3.34,1.0,359.8,-6.02,True,1,8768,-338.15,-991219.36,2964899.2,1973679.84
15515,1989-11-09,336.57,-1.58,-0.47,359.8,-6.46,True,1,8769,-336.57,-991555.93,2951382.33,1959826.4
15516,1989-11-10,339.1,2.53,0.75,359.8,-5.75,True,1,8770,-339.1,-991895.03,2973907.0,1982011.97
15517,1989-11-13,339.55,0.45,0.13,359.8,-5.63,True,1,8771,-339.55,-992234.58,2978193.05,1985958.47
15518,1989-11-14,337.99,-1.56,-0.46,359.8,-6.06,True,1,8772,-337.99,-992572.57,2964848.28,1972275.71
15519,1989-11-15,340.54,2.55,0.75,359.8,-5.35,True,1,8773,-340.54,-992913.11,2987557.42,1994644.31
15520,1989-11-16,340.58,0.04,0.01,359.8,-5.34,True,1,8774,-340.58,-993253.69,2988248.92,1994995.23
15521,1989-11-17,341.61,1.03,0.3,359.8,-5.06,True,1,8775,-341.61,-993595.3,2997627.75,2004032.45
15522,1989-11-20,339.35,-2.26,-0.66,359.8,-5.68,True,1,8776,-339.35,-993934.65,2978135.6,1984200.95
15523,1989-11-21,339.59,0.24,0.07,359.8,-5.62,True,1,8777,-339.59,-994274.24,2980581.43,1986307.19
15524,1989-11-22,341.91,2.32,0.68,359.8,-4.97,True,1,8778,-341.91,-994616.15,3001285.98,2006669.83
15525,1989-11-24,343.97,2.06,0.6,359.8,-4.4,True,1,8779,-343.97,-994960.12,3019712.63,2024752.51
15526,1989-11-27,345.61,1.64,0.48,359.8,-3.94,True,1,8780,-345.61,-995305.73,3034455.8,2039150.07
15527,1989-11-28,345.77,0.16,0.05,359.8,-3.9,True,1,8781,-345.77,-995651.5,3036206.37,2040554.87
15528,1989-11-29,343.6,-2.17,-0.63,359.8,-4.5,True,1,8782,-343.6,-995995.1,3017495.2,2021500.1
15529,1989-11-30,345.99,2.39,0.7,359.8,-3.84,True,1,8783,-345.99,-996341.09,3038830.17,2042489.08
15530,1989-12-01,350.63,4.64,1.34,359.8,-2.55,True,1,8784,-350.63,-996691.72,3079933.92,2083242.2
15531,1989-12-04,351.41,0.78,0.22,359.8,-2.33,True,1,8785,-351.41,-997043.13,3087136.85,2090093.72
15532,1989-12-05,349.58,-1.83,-0.52,359.8,-2.84,True,1,8786,-349.58,-997392.71,3071409.88,2074017.17
15533,1989-12-06,348.55,-1.03,-0.3,359.8,-3.13,True,1,8787,-348.55,-997741.26,3062708.85,2064967.59
15534,1989-12-07,347.59,-0.96,-0.28,359.8,-3.39,True,1,8788,-347.59,-998088.85,3054620.92,2056532.07
15535,1989-12-08,348.69,1.1,0.32,359.8,-3.09,True,1,8789,-348.69,-998437.54,3064636.41,2066198.87
15536,1989-12-11,348.56,-0.13,-0.04,359.8,-3.12,True,1,8790,-348.56,-998786.1,3063842.4,2065056.3
15537,1989-12-12,351.73,3.17,0.91,359.8,-2.24,True,1,8791,-351.73,-999137.83,3092058.43,2092920.6
15538,1989-12-13,352.75,1.02,0.29,359.8,-1.96,True,1,8792,-352.75,-999490.58,3101378.0,2101887.42
15539,1989-12-14,350.93,-1.82,-0.52,359.8,-2.46,True,1,8793,-350.93,-999841.51,3085727.49,2085885.98
15540,1989-12-15,350.14,-0.79,-0.22,359.8,-2.68,True,1,8794,-350.14,-1000191.65,3079131.16,2078939.51
15541,1989-12-18,343.69,-6.45,-1.84,359.8,-4.48,True,1,8795,-343.69,-1000535.34,3022753.55,2022218.21
15542,1989-12-19,342.46,-1.23,-0.36,359.8,-4.82,True,1,8796,-342.46,-1000877.8,3012278.16,2011400.36
15543,1989-12-20,342.84,0.38,0.11,359.8,-4.71,True,1,8797,-342.84,-1001220.64,3015963.48,2014742.84
15544,1989-12-21,344.78,1.94,0.57,359.8,-4.18,True,1,8798,-344.78,-1001565.42,3033374.44,2031809.02
15545,1989-12-22,347.42,2.64,0.77,359.8,-3.44,True,1,8799,-347.42,-1001912.84,3056948.58,2055035.74
15546,1989-12-26,346.81,-0.61,-0.18,359.8,-3.61,True,1,8800,-346.81,-1002259.65,3051928.0,2049668.35
15547,1989-12-27,348.81,2.0,0.58,359.8,-3.05,True,1,8801,-348.81,-1002608.46,3069876.81,2067268.35
15548,1989-12-28,350.67,1.86,0.53,359.8,-2.54,True,1,8802,-350.67,-1002959.13,3086597.34,2083638.21
15549,1989-12-29,353.4,2.73,0.78,359.8,-1.78,True,1,8803,-353.4,-1003312.53,3110980.2,2107667.67
15550,1990-01-02,359.69,6.29,1.78,359.8,-0.03,True,1,8804,-359.69,-1003672.22,3166710.76,2163038.54
15551,1990-01-03,358.76,-0.93,-0.26,359.8,-0.29,True,1,8805,-358.76,-1004030.98,3158881.8,2154850.82
15552,1990-01-04,355.67,-3.09,-0.86,359.8,-1.15,True,1,8806,-355.67,-1004386.65,3132030.02,2127643.37
15553,1990-01-05,352.2,-3.47,-0.98,359.8,-2.11,True,1,8807,-352.2,-1004738.85,3101825.4,2097086.55
15554,1990-01-08,353.79,1.59,0.45,359.8,-1.67,True,1,8808,-353.79,-1005092.64,3116182.32,2111089.68
15555,1990-01-09,349.62,-4.17,-1.18,359.8,-2.83,True,1,8809,-349.62,-1005442.26,3079802.58,2074360.32
15556,1990-01-10,347.31,-2.31,-0.66,359.8,-3.47,True,1,8810,-347.31,-1005789.57,3059801.1,2054011.53
15557,1990-01-11,348.53,1.22,0.35,359.8,-3.13,True,1,8811,-348.53,-1006138.1,3070897.83,2064759.73
15558,1990-01-12,339.93,-8.6,-2.47,359.8,-5.52,True,1,8812,-339.93,-1006478.03,2995463.16,1988985.13
15559,1990-01-15,337.0,-2.93,-0.86,359.8,-6.34,True,1,8813,-337.0,-1006815.03,2969981.0,1963165.97
15560,1990-01-16,340.75,3.75,1.11,359.8,-5.3,True,1,8814,-340.75,-1007155.78,3003370.5,1996214.72
15561,1990-01-17,337.4,-3.35,-0.98,359.8,-6.23,True,1,8815,-337.4,-1007493.18,2974181.0,1966687.82
15562,1990-01-18,338.19,0.79,0.23,359.8,-6.01,True,1,8816,-338.19,-1007831.37,2981483.04,1973651.67
15563,1990-01-19,339.15,0.96,0.28,359.8,-5.74,True,1,8817,-339.15,-1008170.52,2990285.55,1982115.03
15564,1990-01-22,330.38,-8.77,-2.59,359.8,-8.18,True,1,8818,-330.38,-1008500.9,2913290.84,1904789.94
15565,1990-01-23,331.61,1.23,0.37,359.8,-7.84,True,1,8819,-331.61,-1008832.51,2924468.59,1915636.08
15566,1990-01-24,330.26,-1.35,-0.41,359.8,-8.21,True,1,8820,-330.26,-1009162.77,2912893.2,1903730.43
15567,1990-01-25,326.08,-4.18,-1.27,359.8,-9.37,True,1,8821,-326.08,-1009488.85,2876351.68,1866862.83
15568,1990-01-26,325.8,-0.28,-0.09,359.8,-9.45,True,1,8822,-325.8,-1009814.65,2874207.6,1864392.95
15569,1990-01-29,325.2,-0.6,-0.18,359.8,-9.62,True,1,8823,-325.2,-1010139.85,2869239.6,1859099.75
15570,1990-01-30,322.98,-2.22,-0.68,359.8,-10.23,True,1,8824,-322.98,-1010462.83,2849975.52,1839512.69
15571,1990-01-31,329.08,6.1,1.89,359.8,-8.54,True,1,8825,-329.08,-1010791.91,2904131.0,1893339.09
15572,1990-02-01,328.79,-0.29,-0.09,359.8,-8.62,True,1,8826,-328.79,-1011120.7,2901900.54,1890779.84
15573,1990-02-02,330.92,2.13,0.65,359.8,-8.03,True,1,8827,-330.92,-1011451.62,2921030.84,1909579.22
15574,1990-02-05,331.85,0.93,0.28,359.8,-7.77,True,1,8828,-331.85,-1011783.47,2929571.8,1917788.33
15575,1990-02-06,329.66,-2.19,-0.66,359.8,-8.38,True,1,8829,-329.66,-1012113.13,2910568.14,1898455.01
15576,1990-02-07,333.75,4.09,1.24,359.8,-7.24,True,1,8830,-333.75,-1012446.88,2947012.5,1934565.62
15577,1990-02-08,332.96,-0.79,-0.24,359.8,-7.46,True,1,8831,-332.96,-1012779.84,2940369.76,1927589.92
15578,1990-02-09,333.62,0.66,0.2,359.8,-7.28,True,1,8832,-333.62,-1013113.46,2946531.84,1933418.38
15579,1990-02-12,330.08,-3.54,-1.06,359.8,-8.26,True,1,8833,-330.08,-1013443.54,2915596.64,1902153.1
15580,1990-02-13,331.02,0.94,0.28,359.8,-8.0,True,1,8834,-331.02,-1013774.56,2924230.68,1910456.12
15581,1990-02-14,332.01,0.99,0.3,359.8,-7.72,True,1,8835,-332.01,-1014106.57,2933308.35,1919201.78
15582,1990-02-15,334.89,2.88,0.87,359.8,-6.92,True,1,8836,-334.89,-1014441.46,2959088.04,1944646.58
15583,1990-02-16,332.72,-2.17,-0.65,359.8,-7.53,True,1,8837,-332.72,-1014774.18,2940246.64,1925472.46
15584,1990-02-20,327.99,-4.73,-1.42,359.8,-8.84,True,1,8838,-327.99,-1015102.17,2898775.62,1883673.45
15585,1990-02-21,327.67,-0.32,-0.1,359.8,-8.93,True,1,8839,-327.67,-1015429.84,2896275.13,1880845.29
15586,1990-02-22,325.7,-1.97,-0.6,359.8,-9.48,True,1,8840,-325.7,-1015755.54,2879188.0,1863432.46
15587,1990-02-23,324.15,-1.55,-0.48,359.8,-9.91,True,1,8841,-324.15,-1016079.69,2865810.15,1849730.46
15588,1990-02-26,328.67,4.52,1.39,359.8,-8.65,True,1,8842,-328.67,-1016408.36,2906100.14,1889691.78
15589,1990-02-27,330.26,1.59,0.48,359.8,-8.21,True,1,8843,-330.26,-1016738.62,2920489.18,1903750.56
15590,1990-02-28,331.89,1.63,0.49,359.8,-7.76,True,1,8844,-331.89,-1017070.51,2935235.16,1918164.65
15591,1990-03-01,332.74,0.85,0.26,359.8,-7.52,True,1,8845,-332.74,-1017403.25,2943085.3,1925682.05
15592,1990-03-02,335.54,2.8,0.84,359.8,-6.74,True,1,8846,-335.54,-1017738.79,2968186.84,1950448.05
15593,1990-03-05,333.74,-1.8,-0.54,359.8,-7.24,True,1,8847,-333.74,-1018072.53,2952597.78,1934525.25
15594,1990-03-06,337.93,4.19,1.25,359.8,-6.08,True,1,8848,-337.93,-1018410.46,2990004.64,1971594.18
15595,1990-03-07,336.95,-0.98,-0.29,359.8,-6.35,True,1,8849,-336.95,-1018747.41,2981670.55,1962923.14
15596,1990-03-08,340.27,3.32,0.98,359.8,-5.43,True,1,8850,-340.27,-1019087.68,3011389.5,1992301.82
15597,1990-03-09,337.93,-2.34,-0.69,359.8,-6.08,True,1,8851,-337.93,-1019425.61,2991018.43,1971592.82
15598,1990-03-12,338.67,0.74,0.22,359.8,-5.87,True,1,8852,-338.67,-1019764.28,2997906.84,1978142.56
15599,1990-03-13,336.0,-2.67,-0.79,359.8,-6.62,True,1,8853,-336.0,-1020100.28,2974608.0,1954507.72
15600,1990-03-14,336.87,0.87,0.26,359.8,-6.37,True,1,8854,-336.87,-1020437.15,2982646.98,1962209.83
15601,1990-03-15,338.07,1.2,0.36,359.8,-6.04,True,1,8855,-338.07,-1020775.22,2993609.85,1972834.63
15602,1990-03-16,341.91,3.84,1.14,359.8,-4.97,True,1,8856,-341.91,-1021117.13,3027954.96,2006837.83
15603,1990-03-19,343.53,1.62,0.47,359.8,-4.52,True,1,8857,-343.53,-1021460.66,3042645.21,2021184.55
15604,1990-03-20,341.57,-1.96,-0.57,359.8,-5.07,True,1,8858,-341.57,-1021802.23,3025627.06,2003824.83
15605,1990-03-21,339.74,-1.83,-0.54,359.8,-5.58,True,1,8859,-339.74,-1022141.97,3009756.66,1987614.69
15606,1990-03-22,335.69,-4.05,-1.19,359.8,-6.7,True,1,8860,-335.69,-1022477.66,2974213.4,1951735.74
15607,1990-03-23,337.22,1.53,0.46,359.8,-6.28,True,1,8861,-337.22,-1022814.88,2988106.42,1965291.54
15608,1990-03-26,337.63,0.41,0.12,359.8,-6.16,True,1,8862,-337.63,-1023152.51,2992077.06,1968924.55
15609,1990-03-27,341.5,3.87,1.15,359.8,-5.09,True,1,8863,-341.5,-1023494.01,3026714.5,2003220.49
15610,1990-03-28,342.0,0.5,0.15,359.8,-4.95,True,1,8864,-342.0,-1023836.01,3031488.0,2007651.99
15611,1990-03-29,340.79,-1.21,-0.35,359.8,-5.28,True,1,8865,-340.79,-1024176.8,3021103.35,1996926.55
15612,1990-03-30,339.94,-0.85,-0.25,359.8,-5.52,True,1,8866,-339.94,-1024516.74,3013908.04,1989391.3
15613,1990-04-02,338.7,-1.24,-0.36,359.8,-5.86,True,1,8867,-338.7,-1024855.44,3003252.9,1978397.46
15614,1990-04-03,343.64,4.94,1.46,359.8,-4.49,True,1,8868,-343.64,-1025199.08,3047399.52,2022200.44
15615,1990-04-04,341.09,-2.55,-0.74,359.8,-5.2,True,1,8869,-341.09,-1025540.17,3025127.21,1999587.04
15616,1990-04-05,340.73,-0.36,-0.11,359.8,-5.3,True,1,8870,-340.73,-1025880.9,3022275.1,1996394.2
15617,1990-04-06,340.08,-0.65,-0.19,359.8,-5.48,True,1,8871,-340.08,-1026220.98,3016849.68,1990628.7
15618,1990-04-09,341.37,1.29,0.38,359.8,-5.12,True,1,8872,-341.37,-1026562.35,3028634.64,2002072.29
15619,1990-04-10,342.07,0.7,0.2,359.8,-4.93,True,1,8873,-342.07,-1026904.42,3035187.11,2008282.69
15620,1990-04-11,341.92,-0.15,-0.04,359.8,-4.97,True,1,8874,-341.92,-1027246.34,3034198.08,2006951.74
15621,1990-04-12,344.34,2.42,0.71,359.8,-4.3,True,1,8875,-344.34,-1027590.68,3056017.5,2028426.82
15622,1990-04-16,344.74,0.4,0.12,359.8,-4.19,True,1,8876,-344.74,-1027935.42,3059912.24,2031976.82
15623,1990-04-17,344.68,-0.06,-0.02,359.8,-4.2,True,1,8877,-344.68,-1028280.1,3059724.36,2031444.26
15624,1990-04-18,340.72,-3.96,-1.15,359.8,-5.3,True,1,8878,-340.72,-1028620.82,3024912.16,1996291.34
15625,1990-04-19,338.09,-2.63,-0.77,359.8,-6.03,True,1,8879,-338.09,-1028958.91,3001901.11,1972942.2
15626,1990-04-20,335.12,-2.97,-0.88,359.8,-6.86,True,1,8880,-335.12,-1029294.03,2975865.6,1946571.57
15627,1990-04-23,331.05,-4.07,-1.21,359.8,-7.99,True,1,8881,-331.05,-1029625.08,2940055.05,1910429.97
15628,1990-04-24,330.36,-0.69,-0.21,359.8,-8.18,True,1,8882,-330.36,-1029955.44,2934257.52,1904302.08
15629,1990-04-25,332.03,1.67,0.51,359.8,-7.72,True,1,8883,-332.03,-1030287.47,2949422.49,1919135.02
15630,1990-04-26,332.92,0.89,0.27,359.8,-7.47,True,1,8884,-332.92,-1030620.39,2957661.28,1927040.89
15631,1990-04-27,329.11,-3.81,-1.14,359.8,-8.53,True,1,8885,-329.11,-1030949.5,2924142.35,1893192.85
15632,1990-04-30,330.8,1.69,0.51,359.8,-8.06,True,1,8886,-330.8,-1031280.3,2939488.8,1908208.5
15633,1990-05-01,332.25,1.45,0.44,359.8,-7.66,True,1,8887,-332.25,-1031612.55,2952705.75,1921093.2
15634,1990-05-02,334.48,2.23,0.67,359.8,-7.04,True,1,8888,-334.48,-1031947.03,2972858.24,1940911.21
15635,1990-05-03,335.57,1.09,0.33,359.8,-6.73,True,1,8889,-335.57,-1032282.6,2982881.73,1950599.13
15636,1990-05-04,338.39,2.82,0.84,359.8,-5.95,True,1,8890,-338.39,-1032620.99,3008287.1,1975666.11
15637,1990-05-07,340.53,2.14,0.63,359.8,-5.36,True,1,8891,-340.53,-1032961.52,3027652.23,1994690.71
15638,1990-05-08,342.01,1.48,0.44,359.8,-4.94,True,1,8892,-342.01,-1033303.53,3041152.92,2007849.39
15639,1990-05-09,342.86,0.85,0.25,359.8,-4.71,True,1,8893,-342.86,-1033646.39,3049053.98,2015407.59
15640,1990-05-10,343.82,0.96,0.28,359.8,-4.44,True,1,8894,-343.82,-1033990.21,3057935.08,2023944.87
15641,1990-05-11,352.0,8.18,2.38,359.8,-2.17,True,1,8895,-352.0,-1034342.21,3131040.0,2096697.79
15642,1990-05-14,354.75,2.75,0.78,359.8,-1.4,True,1,8896,-354.75,-1034696.96,3155856.0,2121159.04
15643,1990-05-15,354.28,-0.47,-0.13,359.8,-1.53,True,1,8897,-354.28,-1035051.24,3152029.16,2116977.92
15644,1990-05-16,354.0,-0.28,-0.08,359.8,-1.61,True,1,8898,-354.0,-1035405.24,3149892.0,2114486.76
15645,1990-05-17,354.47,0.47,0.13,359.8,-1.48,True,1,8899,-354.47,-1035759.71,3154428.53,2118668.82
15646,1990-05-18,354.64,0.17,0.05,359.8,-1.43,True,1,8900,-354.64,-1036114.35,3156296.0,2120181.65
15647,1990-05-21,358.0,3.36,0.95,359.8,-0.5,True,1,8901,-358.0,-1036472.35,3186558.0,2150085.65
15648,1990-05-22,358.43,0.43,0.12,359.8,-0.38,True,1,8902,-358.43,-1036830.78,3190743.86,2153913.08
15649,1990-05-23,359.29,0.86,0.24,359.8,-0.14,True,1,8903,-359.29,-1037190.07,3198758.87,2161568.8
15650,1990-05-24,358.41,-0.88,-0.24,359.8,-0.39,True,1,8904,-358.41,-1037548.48,3191282.64,2153734.16
15651,1990-05-25,354.58,-3.83,-1.07,359.8,-1.45,True,1,8905,-354.58,-1037903.06,3157534.9,2119631.84
15652,1990-05-29,360.65,6.07,1.71,360.65,0.0,True,1,8906,-360.65,-1038263.71,3211948.9,2173685.19
15653,1990-05-30,360.86,0.21,0.06,360.86,0.0,True,1,8907,-360.86,-1038624.57,3214180.02,2175555.45
15654,1990-05-31,361.23,0.37,0.1,361.23,0.0,True,1,8908,-361.23,-1038985.8,3217836.84,2178851.04
15655,1990-06-01,363.16,1.93,0.53,363.16,0.0,True,1,8909,-363.16,-1039348.96,3235392.44,2196043.48
15656,1990-06-04,367.4,4.24,1.17,367.4,0.0,True,1,8910,-367.4,-1039716.36,3273534.0,2233817.64
15657,1990-06-05,366.64,-0.76,-0.21,367.4,-0.21,True,1,8911,-366.64,-1040083.0,3267129.04,2227046.04
15658,1990-06-06,364.96,-1.68,-0.46,367.4,-0.66,True,1,8912,-364.96,-1040447.96,3252523.52,2212075.56
15659,1990-06-07,363.15,-1.81,-0.5,367.4,-1.16,True,1,8913,-363.15,-1040811.11,3236755.95,2195944.84
15660,1990-06-08,358.71,-4.44,-1.22,367.4,-2.37,True,1,8914,-358.71,-1041169.82,3197540.94,2156371.12
15661,1990-06-11,361.63,2.92,0.81,367.4,-1.57,True,1,8915,-361.63,-1041531.45,3223931.45,2182400.0
15662,1990-06-12,366.25,4.62,1.28,367.4,-0.31,True,1,8916,-366.25,-1041897.7,3265485.0,2223587.3
15663,1990-06-13,364.9,-1.35,-0.37,367.4,-0.68,True,1,8917,-364.9,-1042262.6,3253813.3,2211550.7
15664,1990-06-14,362.9,-2.0,-0.55,367.4,-1.23,True,1,8918,-362.9,-1042625.5,3236342.2,2193716.7
15665,1990-06-15,362.91,0.01,0.0,367.4,-1.22,True,1,8919,-362.91,-1042988.41,3236794.29,2193805.88
15666,1990-06-18,356.88,-6.03,-1.66,367.4,-2.86,True,1,8920,-356.88,-1043345.29,3183369.6,2140024.31
15667,1990-06-19,358.47,1.59,0.45,367.4,-2.43,True,1,8921,-358.47,-1043703.76,3197910.87,2154207.11
15668,1990-06-20,359.1,0.63,0.18,367.4,-2.26,True,1,8922,-359.1,-1044062.86,3203890.2,2159827.34
15669,1990-06-21,360.47,1.37,0.38,367.4,-1.89,True,1,8923,-360.47,-1044423.33,3216473.81,2172050.48
15670,1990-06-22,355.43,-5.04,-1.4,367.4,-3.26,True,1,8924,-355.43,-1044778.76,3171857.32,2127078.56
15671,1990-06-25,352.31,-3.12,-0.88,367.4,-4.11,True,1,8925,-352.31,-1045131.07,3144366.75,2099235.68
15672,1990-06-26,352.06,-0.25,-0.07,367.4,-4.18,True,1,8926,-352.06,-1045483.13,3142487.56,2097004.43
15673,1990-06-27,355.14,3.08,0.88,367.4,-3.34,True,1,8927,-355.14,-1045838.27,3170334.78,2124496.51
15674,1990-06-28,357.63,2.49,0.7,367.4,-2.66,True,1,8928,-357.63,-1046195.9,3192920.64,2146724.74
15675,1990-06-29,358.02,0.39,0.11,367.4,-2.55,True,1,8929,-358.02,-1046553.92,3196760.58,2150206.66
15676,1990-07-02,359.54,1.52,0.42,367.4,-2.14,True,1,8930,-359.54,-1046913.46,3210692.2,2163778.74
15677,1990-07-03,360.16,0.62,0.17,367.4,-1.97,True,1,8931,-360.16,-1047273.62,3216588.96,2169315.34
15678,1990-07-05,355.68,-4.48,-1.24,367.4,-3.19,True,1,8932,-355.68,-1047629.3,3176933.76,2129304.46
15679,1990-07-06,358.42,2.74,0.77,367.4,-2.44,True,1,8933,-358.42,-1047987.72,3201765.86,2153778.14
15680,1990-07-09,359.52,1.1,0.31,367.4,-2.14,True,1,8934,-359.52,-1048347.24,3211951.68,2163604.44
15681,1990-07-10,356.49,-3.03,-0.84,367.4,-2.97,True,1,8935,-356.49,-1048703.73,3185238.15,2136534.42
15682,1990-07-11,361.23,4.74,1.33,367.4,-1.68,True,1,8936,-361.23,-1049064.96,3227951.28,2178886.32
15683,1990-07-12,365.44,4.21,1.16,367.4,-0.53,True,1,8937,-365.44,-1049430.4,3265937.28,2216506.88
15684,1990-07-13,367.31,1.87,0.51,367.4,-0.02,True,1,8938,-367.31,-1049797.71,3283016.78,2233219.07
15685,1990-07-16,368.95,1.64,0.45,368.95,0.0,True,1,8939,-368.95,-1050166.66,3298044.05,2247877.39
15686,1990-07-17,367.52,-1.43,-0.39,368.95,-0.39,True,1,8940,-367.52,-1050534.18,3285628.8,2235094.62
15687,1990-07-18,364.22,-3.3,-0.9,368.95,-1.28,True,1,8941,-364.22,-1050898.4,3256491.02,2205592.62
15688,1990-07-19,365.32,1.1,0.3,368.95,-0.98,True,1,8942,-365.32,-1051263.72,3266691.44,2215427.72
15689,1990-07-20,361.61,-3.71,-1.02,368.95,-1.99,True,1,8943,-361.61,-1051625.33,3233878.23,2182252.9
15690,1990-07-23,355.31,-6.3,-1.74,368.95,-3.7,True,1,8944,-355.31,-1051980.64,3177892.64,2125912.0
15691,1990-07-24,355.79,0.48,0.14,368.95,-3.57,True,1,8945,-355.79,-1052336.43,3182541.55,2130205.12
15692,1990-07-25,357.09,1.3,0.36,368.95,-3.22,True,1,8946,-357.09,-1052693.52,3194527.14,2141833.62
15693,1990-07-26,355.91,-1.18,-0.33,368.95,-3.53,True,1,8947,-355.91,-1053049.43,3184326.77,2131277.34
15694,1990-07-27,353.44,-2.47,-0.69,368.95,-4.2,True,1,8948,-353.44,-1053402.87,3162581.12,2109178.25
15695,1990-07-30,355.55,2.11,0.6,368.95,-3.63,True,1,8949,-355.55,-1053758.42,3181816.95,2128058.53
15696,1990-07-31,356.15,0.6,0.17,368.95,-3.47,True,1,8950,-356.15,-1054114.57,3187542.5,2133427.93
15697,1990-08-01,355.52,-0.63,-0.18,368.95,-3.64,True,1,8951,-355.52,-1054470.09,3182259.52,2127789.43
15698,1990-08-02,351.48,-4.04,-1.14,368.95,-4.74,True,1,8952,-351.48,-1054821.57,3146448.96,2091627.39
15699,1990-08-03,344.86,-6.62,-1.88,368.95,-6.53,True,1,8953,-344.86,-1055166.43,3087531.58,2032365.15
15700,1990-08-06,334.43,-10.43,-3.02,368.95,-9.36,True,1,8954,-334.43,-1055500.86,2994486.22,1938985.36
15701,1990-08-07,334.83,0.4,0.12,368.95,-9.25,True,1,8955,-334.83,-1055835.69,2998402.65,1942566.96
15702,1990-08-08,338.35,3.52,1.05,368.95,-8.29,True,1,8956,-338.35,-1056174.04,3030262.6,1974088.56
15703,1990-08-09,339.94,1.59,0.47,368.95,-7.86,True,1,8957,-339.94,-1056513.98,3044842.58,1988328.6
15704,1990-08-10,335.52,-4.42,-1.3,368.95,-9.06,True,1,8958,-335.52,-1056849.5,3005588.16,1948738.66
15705,1990-08-13,338.84,3.32,0.99,368.95,-8.16,True,1,8959,-338.84,-1057188.34,3035667.56,1978479.22
15706,1990-08-14,339.39,0.55,0.16,368.95,-8.01,True,1,8960,-339.39,-1057527.73,3040934.4,1983406.67
15707,1990-08-15,340.06,0.67,0.2,368.95,-7.83,True,1,8961,-340.06,-1057867.79,3047277.66,1989409.87
15708,1990-08-16,332.39,-7.67,-2.26,368.95,-9.91,True,1,8962,-332.39,-1058200.18,2978879.18,1920679.0
15709,1990-08-17,327.83,-4.56,-1.37,368.95,-11.14,True,1,8963,-327.83,-1058528.01,2938340.29,1879812.28
15710,1990-08-20,328.51,0.68,0.21,368.95,-10.96,True,1,8964,-328.51,-1058856.52,2944763.64,1885907.12
15711,1990-08-21,321.86,-6.65,-2.02,368.95,-12.76,True,1,8965,-321.86,-1059178.38,2885474.9,1826296.52
15712,1990-08-22,316.55,-5.31,-1.65,368.95,-14.2,True,1,8966,-316.55,-1059494.93,2838187.3,1778692.37
15713,1990-08-23,307.06,-9.49,-3.0,368.95,-16.77,True,1,8967,-307.06,-1059801.99,2753407.02,1693605.03
15714,1990-08-24,311.51,4.45,1.45,368.95,-15.57,True,1,8968,-311.51,-1060113.5,2793621.68,1733508.18
15715,1990-08-27,321.44,9.93,3.19,368.95,-12.88,True,1,8969,-321.44,-1060434.94,2882995.36,1822560.42
15716,1990-08-28,321.34,-0.1,-0.03,368.95,-12.9,True,1,8970,-321.34,-1060756.28,2882419.8,1821663.52
15717,1990-08-29,324.19,2.85,0.89,368.95,-12.13,True,1,8971,-324.19,-1061080.47,2908308.49,1847228.02
15718,1990-08-30,318.71,-5.48,-1.69,368.95,-13.62,True,1,8972,-318.71,-1061399.18,2859466.12,1798066.94
15719,1990-08-31,322.56,3.85,1.21,368.95,-12.57,True,1,8973,-322.56,-1061721.74,2894330.88,1832609.14
15720,1990-09-04,323.09,0.53,0.16,368.95,-12.43,True,1,8974,-323.09,-1062044.83,2899409.66,1837364.83
15721,1990-09-05,324.39,1.3,0.4,368.95,-12.08,True,1,8975,-324.39,-1062369.22,2911400.25,1849031.03
15722,1990-09-06,320.46,-3.93,-1.21,368.95,-13.14,True,1,8976,-320.46,-1062689.68,2876448.96,1813759.28
15723,1990-09-07,323.4,2.94,0.92,368.95,-12.35,True,1,8977,-323.4,-1063013.08,2903161.8,1840148.72
15724,1990-09-10,321.63,-1.77,-0.55,368.95,-12.83,True,1,8978,-321.63,-1063334.71,2887594.14,1824259.43
15725,1990-09-11,321.04,-0.59,-0.18,368.95,-12.98,True,1,8979,-321.04,-1063655.75,2882618.16,1818962.41
15726,1990-09-12,322.54,1.5,0.47,368.95,-12.58,True,1,8980,-322.54,-1063978.29,2896409.2,1832430.91
15727,1990-09-13,318.65,-3.89,-1.21,368.95,-13.63,True,1,8981,-318.65,-1064296.94,2861795.65,1797498.71
15728,1990-09-14,316.83,-1.82,-0.57,368.95,-14.13,True,1,8982,-316.83,-1064613.77,2845767.06,1781153.29
15729,1990-09-17,317.77,0.94,0.3,368.95,-13.87,True,1,8983,-317.77,-1064931.54,2854527.91,1789596.37
15730,1990-09-18,318.6,0.83,0.26,368.95,-13.65,True,1,8984,-318.6,-1065250.14,2862302.4,1797052.26
15731,1990-09-19,316.6,-2.0,-0.63,368.95,-14.19,True,1,8985,-316.6,-1065566.74,2844651.0,1779084.26
15732,1990-09-20,311.48,-5.12,-1.62,368.95,-15.58,True,1,8986,-311.48,-1065878.22,2798959.28,1733081.06
15733,1990-09-21,311.32,-0.16,-0.05,368.95,-15.62,True,1,8987,-311.32,-1066189.54,2797832.84,1731643.3
15734,1990-09-24,304.59,-6.73,-2.16,368.95,-17.44,True,1,8988,-304.59,-1066494.13,2737654.92,1671160.79
15735,1990-09-25,308.26,3.67,1.2,368.95,-16.45,True,1,8989,-308.26,-1066802.39,2770949.14,1704146.75
15736,1990-09-26,305.06,-3.2,-1.04,368.95,-17.32,True,1,8990,-305.06,-1067107.45,2742489.4,1675381.95
15737,1990-09-27,300.97,-4.09,-1.34,368.95,-18.42,True,1,8991,-300.97,-1067408.42,2706021.27,1638612.85
15738,1990-09-28,306.05,5.08,1.69,368.95,-17.05,True,1,8992,-306.05,-1067714.47,2752001.6,1684287.13
15739,1990-10-01,314.94,8.89,2.9,368.95,-14.64,True,1,8993,-314.94,-1068029.41,2832255.42,1764226.01
15740,1990-10-02,315.21,0.27,0.09,368.95,-14.57,True,1,8994,-315.21,-1068344.62,2834998.74,1766654.12
15741,1990-10-03,311.4,-3.81,-1.21,368.95,-15.6,True,1,8995,-311.4,-1068656.02,2801043.0,1732386.98
15742,1990-10-04,312.69,1.29,0.41,368.95,-15.25,True,1,8996,-312.69,-1068968.71,2812959.24,1743990.53
15743,1990-10-05,311.5,-1.19,-0.38,368.95,-15.57,True,1,8997,-311.5,-1069280.21,2802565.5,1733285.29
15744,1990-10-08,313.48,1.98,0.64,368.95,-15.04,True,1,8998,-313.48,-1069593.69,2820693.04,1751099.35
15745,1990-10-09,305.1,-8.38,-2.67,368.95,-17.31,True,1,8999,-305.1,-1069898.79,2745594.9,1675696.11
15746,1990-10-10,300.39,-4.71,-1.54,368.95,-18.58,True,1,9000,-300.39,-1070199.18,2703510.0,1633310.82
15747,1990-10-11,295.46,-4.93,-1.64,368.95,-19.92,True,1,9001,-295.46,-1070494.64,2659435.46,1588940.82
15748,1990-10-12,300.03,4.57,1.55,368.95,-18.68,True,1,9002,-300.03,-1070794.67,2700870.06,1630075.39
15749,1990-10-15,303.23,3.2,1.07,368.95,-17.81,True,1,9003,-303.23,-1071097.9,2729979.69,1658881.79
15750,1990-10-16,298.92,-4.31,-1.42,368.95,-18.98,True,1,9004,-298.92,-1071396.82,2691475.68,1620078.86
15751,1990-10-17,298.76,-0.16,-0.05,368.95,-19.02,True,1,9005,-298.76,-1071695.58,2690333.8,1618638.22
15752,1990-10-18,305.74,6.98,2.34,368.95,-17.13,True,1,9006,-305.74,-1072001.32,2753494.44,1681493.12
15753,1990-10-19,312.48,6.74,2.2,368.95,-15.31,True,1,9007,-312.48,-1072313.8,2814507.36,1742193.56
15754,1990-10-22,314.76,2.28,0.73,368.95,-14.69,True,1,9008,-314.76,-1072628.56,2835358.08,1762729.52
15755,1990-10-23,312.36,-2.4,-0.76,368.95,-15.34,True,1,9009,-312.36,-1072940.92,2814051.24,1741110.32
15756,1990-10-24,312.6,0.24,0.08,368.95,-15.27,True,1,9010,-312.6,-1073253.52,2816526.0,1743272.48
15757,1990-10-25,310.17,-2.43,-0.78,368.95,-15.93,True,1,9011,-310.17,-1073563.69,2794941.87,1721378.18
15758,1990-10-26,304.71,-5.46,-1.76,368.95,-17.41,True,1,9012,-304.71,-1073868.4,2746046.52,1672178.12
15759,1990-10-29,301.88,-2.83,-0.93,368.95,-18.18,True,1,9013,-301.88,-1074170.28,2720844.44,1646674.16
15760,1990-10-30,304.06,2.18,0.72,368.95,-17.59,True,1,9014,-304.06,-1074474.34,2740796.84,1666322.5
15761,1990-10-31,304.0,-0.06,-0.02,368.95,-17.6,True,1,9015,-304.0,-1074778.34,2740560.0,1665781.66
15762,1990-11-01,307.02,3.02,0.99,368.95,-16.78,True,1,9016,-307.02,-1075085.36,2768092.32,1693006.96
15763,1990-11-02,311.85,4.83,1.57,368.95,-15.48,True,1,9017,-311.85,-1075397.21,2811951.45,1736554.24
15764,1990-11-05,314.59,2.74,0.88,368.95,-14.73,True,1,9018,-314.59,-1075711.8,2836972.62,1761260.82
15765,1990-11-06,311.62,-2.97,-0.94,368.95,-15.54,True,1,9019,-311.62,-1076023.42,2810500.78,1734477.36
15766,1990-11-07,306.01,-5.61,-1.8,368.95,-17.06,True,1,9020,-306.01,-1076329.43,2760210.2,1683880.77
15767,1990-11-08,307.61,1.6,0.52,368.95,-16.63,True,1,9021,-307.61,-1076637.04,2774949.81,1698312.77
15768,1990-11-09,313.74,6.13,1.99,368.95,-14.96,True,1,9022,-313.74,-1076950.78,2830562.28,1753611.5
15769,1990-11-12,319.48,5.74,1.83,368.95,-13.41,True,1,9023,-319.48,-1077270.26,2882668.04,1805397.78
15770,1990-11-13,317.67,-1.81,-0.57,368.95,-13.9,True,1,9024,-317.67,-1077587.93,2866654.08,1789066.15
15771,1990-11-14,320.4,2.73,0.86,368.95,-13.16,True,1,9025,-320.4,-1077908.33,2891610.0,1813701.67
15772,1990-11-15,317.02,-3.38,-1.06,368.95,-14.08,True,1,9026,-317.02,-1078225.35,2861422.52,1783197.17
15773,1990-11-16,317.12,0.1,0.03,368.95,-14.05,True,1,9027,-317.12,-1078542.47,2862642.24,1784099.77
15774,1990-11-19,319.34,2.22,0.7,368.95,-13.45,True,1,9028,-319.34,-1078861.81,2883001.52,1804139.71
15775,1990-11-20,315.31,-4.03,-1.26,368.95,-14.54,True,1,9029,-315.31,-1079177.12,2846933.99,1767756.87
15776,1990-11-21,316.03,0.72,0.23,368.95,-14.34,True,1,9030,-316.03,-1079493.15,2853750.9,1774257.75
15777,1990-11-23,315.1,-0.93,-0.29,368.95,-14.6,True,1,9031,-315.1,-1079808.25,2845668.1,1765859.85
15778,1990-11-26,316.51,1.41,0.45,368.95,-14.21,True,1,9032,-316.51,-1080124.76,2858718.32,1778593.56
15779,1990-11-27,318.1,1.59,0.5,368.95,-13.78,True,1,9033,-318.1,-1080442.86,2873397.3,1792954.44
15780,1990-11-28,317.95,-0.15,-0.05,368.95,-13.82,True,1,9034,-317.95,-1080760.81,2872360.3,1791599.49
15781,1990-11-29,316.42,-1.53,-0.48,368.95,-14.24,True,1,9035,-316.42,-1081077.23,2858854.7,1777777.47
15782,1990-11-30,322.22,5.8,1.83,368.95,-12.67,True,1,9036,-322.22,-1081399.45,2911579.92,1830180.47
15783,1990-12-03,324.1,1.88,0.58,368.95,-12.16,True,1,9037,-324.1,-1081723.55,2928891.7,1847168.15
15784,1990-12-04,326.35,2.25,0.69,368.95,-11.55,True,1,9038,-326.35,-1082049.9,2949551.3,1867501.4
15785,1990-12-05,329.92,3.57,1.09,368.95,-10.58,True,1,9039,-329.92,-1082379.82,2982146.88,1899767.06
15786,1990-12-06,329.07,-0.85,-0.26,368.95,-10.81,True,1,9040,-329.07,-1082708.89,2974792.8,1892083.91
15787,1990-12-07,327.75,-1.32,-0.4,368.95,-11.17,True,1,9041,-327.75,-1083036.64,2963187.75,1880151.11
15788,1990-12-10,328.89,1.14,0.35,368.95,-10.86,True,1,9042,-328.89,-1083365.53,2973823.38,1890457.85
15789,1990-12-11,326.44,-2.45,-0.74,368.95,-11.52,True,1,9043,-326.44,-1083691.97,2951996.92,1868304.95
15790,1990-12-12,330.19,3.75,1.15,368.95,-10.5,True,1,9044,-330.19,-1084022.16,2986238.36,1902216.2
15791,1990-12-13,329.34,-0.85,-0.26,368.95,-10.74,True,1,9045,-329.34,-1084351.5,2978880.3,1894528.8
15792,1990-12-14,326.82,-2.52,-0.76,368.95,-11.42,True,1,9046,-326.82,-1084678.32,2956413.72,1871735.4
15793,1990-12-17,326.02,-0.8,-0.24,368.95,-11.64,True,1,9047,-326.02,-1085004.34,2949502.94,1864498.6
15794,1990-12-18,330.05,4.03,1.24,368.95,-10.54,True,1,9048,-330.05,-1085334.39,2986292.4,1900958.01
15795,1990-12-19,330.2,0.15,0.04,368.95,-10.5,True,1,9049,-330.2,-1085664.59,2987979.8,1902315.21
15796,1990-12-20,330.12,-0.08,-0.02,368.95,-10.52,True,1,9050,-330.12,-1085994.71,2987586.0,1901591.29
15797,1990-12-21,331.75,1.63,0.49,368.95,-10.08,True,1,9051,-331.75,-1086326.46,3002669.25,1916342.79
15798,1990-12-24,329.9,-1.85,-0.56,368.95,-10.58,True,1,9052,-329.9,-1086656.36,2986254.8,1899598.44
15799,1990-12-26,330.85,0.95,0.29,368.95,-10.33,True,1,9053,-330.85,-1086987.21,2995185.05,1908197.84
15800,1990-12-27,328.29,-2.56,-0.77,368.95,-11.02,True,1,9054,-328.29,-1087315.5,2972337.66,1885022.16
15801,1990-12-28,328.72,0.43,0.13,368.95,-10.9,True,1,9055,-328.72,-1087644.22,2976559.6,1888915.38
15802,1990-12-31,330.22,1.5,0.46,368.95,-10.5,True,1,9056,-330.22,-1087974.44,2990472.32,1902497.88
15803,1991-01-02,326.45,-3.77,-1.14,368.95,-11.52,True,1,9057,-326.45,-1088300.89,2956657.65,1868356.76
15804,1991-01-03,321.91,-4.54,-1.39,368.95,-12.75,True,1,9058,-321.91,-1088622.8,2915860.78,1827237.98
15805,1991-01-04,321.0,-0.91,-0.28,368.95,-13.0,True,1,9059,-321.0,-1088943.8,2907939.0,1818995.2
15806,1991-01-07,315.44,-5.56,-1.73,368.95,-14.5,True,1,9060,-315.44,-1089259.24,2857886.4,1768627.16
15807,1991-01-08,314.9,-0.54,-0.17,368.95,-14.65,True,1,9061,-314.9,-1089574.14,2853308.9,1763734.76
15808,1991-01-09,311.49,-3.41,-1.08,368.95,-15.57,True,1,9062,-311.49,-1089885.63,2822722.38,1732836.75
15809,1991-01-10,314.53,3.04,0.98,368.95,-14.75,True,1,9063,-314.53,-1090200.16,2850585.39,1760385.23
15810,1991-01-11,315.23,0.7,0.22,368.95,-14.56,True,1,9064,-315.23,-1090515.39,2857244.72,1766729.33
15811,1991-01-14,312.49,-2.74,-0.87,368.95,-15.3,True,1,9065,-312.49,-1090827.88,2832721.85,1741893.97
15812,1991-01-15,313.73,1.24,0.4,368.95,-14.97,True,1,9066,-313.73,-1091141.61,2844276.18,1753134.57
15813,1991-01-16,316.17,2.44,0.78,368.95,-14.3,True,1,9067,-316.17,-1091457.78,2866713.39,1775255.61
15814,1991-01-17,327.97,11.8,3.73,368.95,-11.11,True,1,9068,-327.97,-1091785.75,2974031.96,1882246.21
15815,1991-01-18,332.23,4.26,1.3,368.95,-9.95,True,1,9069,-332.23,-1092117.98,3012993.87,1920875.89
15816,1991-01-21,331.06,-1.17,-0.35,368.95,-10.27,True,1,9070,-331.06,-1092449.04,3002714.2,1910265.16
15817,1991-01-22,328.31,-2.75,-0.83,368.95,-11.02,True,1,9071,-328.31,-1092777.35,2978100.01,1885322.66
15818,1991-01-23,330.21,1.9,0.58,368.95,-10.5,True,1,9072,-330.21,-1093107.56,2995665.12,1902557.56
15819,1991-01-24,334.78,4.57,1.38,368.95,-9.26,True,1,9073,-334.78,-1093442.34,3037458.94,1944016.6
15820,1991-01-25,336.07,1.29,0.38,368.95,-8.91,True,1,9074,-336.07,-1093778.41,3049499.18,1955720.77
15821,1991-01-28,336.03,-0.04,-0.01,368.95,-8.92,True,1,9075,-336.03,-1094114.44,3049472.25,1955357.81
15822,1991-01-29,335.84,-0.19,-0.06,368.95,-8.97,True,1,9076,-335.84,-1094450.28,3048083.84,1953633.56
15823,1991-01-30,340.91,5.07,1.51,368.95,-7.6,True,1,9077,-340.91,-1094791.19,3094440.07,1999648.88
15824,1991-01-31,343.93,3.02,0.89,368.95,-6.78,True,1,9078,-343.93,-1095135.12,3122196.54,2027061.42
15825,1991-02-01,343.05,-0.88,-0.26,368.95,-7.02,True,1,9079,-343.05,-1095478.17,3114550.95,2019072.78
15826,1991-02-04,348.34,5.29,1.54,368.95,-5.59,True,1,9080,-348.34,-1095826.51,3162927.2,2067100.69
15827,1991-02-05,351.26,2.92,0.84,368.95,-4.8,True,1,9081,-351.26,-1096177.77,3189792.06,2093614.29
15828,1991-02-06,358.07,6.81,1.94,368.95,-2.95,True,1,9082,-358.07,-1096535.84,3251991.74,2155455.9
15829,1991-02-07,356.52,-1.55,-0.43,368.95,-3.37,True,1,9083,-356.52,-1096892.36,3238271.16,2141378.8
15830,1991-02-08,359.35,2.83,0.79,368.95,-2.6,True,1,9084,-359.35,-1097251.71,3264335.4,2167083.69
15831,1991-02-11,368.58,9.23,2.57,368.95,-0.1,True,1,9085,-368.58,-1097620.29,3348549.3,2250929.01
15832,1991-02-12,365.5,-3.08,-0.84,368.95,-0.94,True,1,9086,-365.5,-1097985.79,3320933.0,2222947.21
15833,1991-02-13,369.02,3.52,0.96,369.02,0.0,True,1,9087,-369.02,-1098354.81,3353284.74,2254929.93
15834,1991-02-14,364.22,-4.8,-1.3,369.02,-1.3,True,1,9088,-364.22,-1098719.03,3310031.36,2211312.33
15835,1991-02-15,369.06,4.84,1.33,369.06,0.0,True,1,9089,-369.06,-1099088.09,3354386.34,2255298.25
15836,1991-02-19,369.39,0.33,0.09,369.39,0.0,True,1,9090,-369.39,-1099457.48,3357755.1,2258297.62
15837,1991-02-20,365.14,-4.25,-1.15,369.39,-1.15,True,1,9091,-365.14,-1099822.62,3319487.74,2219665.12
15838,1991-02-21,364.97,-0.17,-0.05,369.39,-1.2,True,1,9092,-364.97,-1100187.59,3318307.24,2218119.65
15839,1991-02-22,365.65,0.68,0.19,369.39,-1.01,True,1,9093,-365.65,-1100553.24,3324855.45,2224302.21
15840,1991-02-25,367.26,1.61,0.44,369.39,-0.58,True,1,9094,-367.26,-1100920.5,3339862.44,2238941.94
15841,1991-02-26,362.81,-4.45,-1.21,369.39,-1.78,True,1,9095,-362.81,-1101283.31,3299756.95,2198473.64
15842,1991-02-27,367.74,4.93,1.36,369.39,-0.45,True,1,9096,-367.74,-1101651.05,3344963.04,2243311.99
15843,1991-02-28,367.07,-0.67,-0.18,369.39,-0.63,True,1,9097,-367.07,-1102018.12,3339235.79,2237217.67
15844,1991-03-01,370.47,3.4,0.93,370.47,0.0,True,1,9098,-370.47,-1102388.59,3370536.06,2268147.47
15845,1991-03-04,369.33,-1.14,-0.31,370.47,-0.31,True,1,9099,-369.33,-1102757.92,3360533.67,2257775.75
15846,1991-03-05,376.72,7.39,2.0,376.72,0.0,True,1,9100,-376.72,-1103134.64,3428152.0,2325017.36
15847,1991-03-06,376.17,-0.55,-0.15,376.72,-0.15,True,1,9101,-376.17,-1103510.81,3423523.17,2320012.36
15848,1991-03-07,375.91,-0.26,-0.07,376.72,-0.22,True,1,9102,-375.91,-1103886.72,3421532.82,2317646.1
15849,1991-03-08,374.95,-0.96,-0.26,376.72,-0.47,True,1,9103,-374.95,-1104261.67,3413169.85,2308908.18
15850,1991-03-11,372.96,-1.99,-0.53,376.72,-1.0,True,1,9104,-372.96,-1104634.63,3395427.84,2290793.21
15851,1991-03-12,370.03,-2.93,-0.79,376.72,-1.78,True,1,9105,-370.03,-1105004.66,3369123.15,2264118.49
15852,1991-03-13,374.57,4.54,1.23,376.72,-0.57,True,1,9106,-374.57,-1105379.23,3410834.42,2305455.19
15853,1991-03-14,373.5,-1.07,-0.29,376.72,-0.86,True,1,9107,-373.5,-1105752.73,3401464.5,2295711.77
15854,1991-03-15,373.59,0.09,0.02,376.72,-0.83,True,1,9108,-373.59,-1106126.32,3402657.72,2296531.4
15855,1991-03-18,372.11,-1.48,-0.4,376.72,-1.22,True,1,9109,-372.11,-1106498.43,3389549.99,2283051.56
15856,1991-03-19,366.59,-5.52,-1.48,376.72,-2.69,True,1,9110,-366.59,-1106865.02,3339634.9,2232769.88
15857,1991-03-20,367.92,1.33,0.36,376.72,-2.34,True,1,9111,-367.92,-1107232.94,3352119.12,2244886.18
15858,1991-03-21,366.58,-1.34,-0.36,376.72,-2.69,True,1,9112,-366.58,-1107599.52,3340276.96,2232677.44
15859,1991-03-22,367.48,0.9,0.25,376.72,-2.45,True,1,9113,-367.48,-1107967.0,3348845.24,2240878.24
15860,1991-03-25,369.83,2.35,0.64,376.72,-1.83,True,1,9114,-369.83,-1108336.83,3370630.62,2262293.79
15861,1991-03-26,376.3,6.47,1.75,376.72,-0.11,True,1,9115,-376.3,-1108713.13,3429974.5,2321261.37
15862,1991-03-27,375.35,-0.95,-0.25,376.72,-0.36,True,1,9116,-375.35,-1109088.48,3421690.6,2312602.12
15863,1991-03-28,375.22,-0.13,-0.04,376.72,-0.4,True,1,9117,-375.22,-1109463.7,3420880.74,2311417.04
15864,1991-04-01,371.3,-3.92,-1.04,376.72,-1.44,True,1,9118,-371.3,-1109835.0,3385513.4,2275678.4
15865,1991-04-02,379.5,8.2,2.21,379.5,0.0,True,1,9119,-379.5,-1110214.5,3460660.5,2350446.0
15866,1991-04-03,378.94,-0.56,-0.15,379.5,-0.15,True,1,9120,-378.94,-1110593.44,3455932.8,2345339.36
15867,1991-04-04,379.77,0.83,0.22,379.77,0.0,True,1,9121,-379.77,-1110973.21,3463882.17,2352908.96
15868,1991-04-05,375.36,-4.41,-1.16,379.77,-1.16,True,1,9122,-375.36,-1111348.57,3424033.92,2312685.35
15869,1991-04-08,378.66,3.3,0.88,379.77,-0.29,True,1,9123,-378.66,-1111727.23,3454515.18,2342787.95
15870,1991-04-09,373.56,-5.1,-1.35,379.77,-1.64,True,1,9124,-373.56,-1112100.79,3408361.44,2296260.65
15871,1991-04-10,373.15,-0.41,-0.11,379.77,-1.74,True,1,9125,-373.15,-1112473.94,3404993.75,2292519.81
15872,1991-04-11,377.63,4.48,1.2,379.77,-0.56,True,1,9126,-377.63,-1112851.57,3446251.38,2333399.81
15873,1991-04-12,380.4,2.77,0.73,380.4,0.0,True,1,9127,-380.4,-1113231.97,3471910.8,2358678.83
15874,1991-04-15,381.19,0.79,0.21,381.19,0.0,True,1,9128,-381.19,-1113613.16,3479502.32,2365889.16
15875,1991-04-16,387.62,6.43,1.69,387.62,0.0,True,1,9129,-387.62,-1114000.78,3538582.98,2424582.2
15876,1991-04-17,390.45,2.83,0.73,390.45,0.0,True,1,9130,-390.45,-1114391.23,3564808.5,2450417.27
15877,1991-04-18,388.46,-1.99,-0.51,390.45,-0.51,True,1,9131,-388.46,-1114779.69,3547028.26,2432248.57
15878,1991-04-19,384.2,-4.26,-1.1,390.45,-1.6,True,1,9132,-384.2,-1115163.89,3508514.4,2393350.51
15879,1991-04-22,380.95,-3.25,-0.85,390.45,-2.43,True,1,9133,-380.95,-1115544.84,3479216.35,2363671.51
15880,1991-04-23,381.76,0.81,0.21,390.45,-2.23,True,1,9134,-381.76,-1115926.6,3486995.84,2371069.24
15881,1991-04-24,382.76,1.0,0.26,390.45,-1.97,True,1,9135,-382.76,-1116309.36,3496512.6,2380203.24
15882,1991-04-25,379.25,-3.51,-0.92,390.45,-2.87,True,1,9136,-379.25,-1116688.61,3464828.0,2348139.39
15883,1991-04-26,379.02,-0.23,-0.06,390.45,-2.93,True,1,9137,-379.02,-1117067.63,3463105.74,2346038.11
15884,1991-04-29,373.66,-5.36,-1.41,390.45,-4.3,True,1,9138,-373.66,-1117441.29,3414505.08,2297063.79
15885,1991-04-30,375.34,1.68,0.45,390.45,-3.87,True,1,9139,-375.34,-1117816.63,3430232.26,2312415.63
15886,1991-05-01,380.29,4.95,1.32,390.45,-2.6,True,1,9140,-380.29,-1118196.92,3475850.6,2357653.68
15887,1991-05-02,380.52,0.23,0.06,390.45,-2.54,True,1,9141,-380.52,-1118577.44,3478333.32,2359755.88
15888,1991-05-03,380.8,0.28,0.07,390.45,-2.47,True,1,9142,-380.8,-1118958.24,3481273.6,2362315.36
15889,1991-05-06,380.08,-0.72,-0.19,390.45,-2.66,True,1,9143,-380.08,-1119338.32,3475071.44,2355733.12
15890,1991-05-07,377.32,-2.76,-0.73,390.45,-3.36,True,1,9144,-377.32,-1119715.64,3450214.08,2330498.44
15891,1991-05-08,378.51,1.19,0.32,390.45,-3.06,True,1,9145,-378.51,-1120094.15,3461473.95,2341379.8
15892,1991-05-09,383.25,4.74,1.25,390.45,-1.84,True,1,9146,-383.25,-1120477.4,3505204.5,2384727.1
15893,1991-05-10,375.74,-7.51,-1.96,390.45,-3.77,True,1,9147,-375.74,-1120853.14,3436893.78,2316040.64
15894,1991-05-13,376.76,1.02,0.27,390.45,-3.51,True,1,9148,-376.76,-1121229.9,3446600.48,2325370.58
15895,1991-05-14,371.62,-5.14,-1.36,390.45,-4.82,True,1,9149,-371.62,-1121601.52,3399951.38,2278349.86
15896,1991-05-15,368.57,-3.05,-0.82,390.45,-5.6,True,1,9150,-368.57,-1121970.09,3372415.5,2250445.41
15897,1991-05-16,372.19,3.62,0.98,390.45,-4.68,True,1,9151,-372.19,-1122342.28,3405910.69,2283568.41
15898,1991-05-17,372.39,0.2,0.05,390.45,-4.62,True,1,9152,-372.39,-1122714.67,3408113.28,2285398.61
15899,1991-05-20,372.28,-0.11,-0.03,390.45,-4.65,True,1,9153,-372.28,-1123086.95,3407478.84,2284391.89
15900,1991-05-21,375.35,3.07,0.82,390.45,-3.87,True,1,9154,-375.35,-1123462.3,3435953.9,2312491.6
15901,1991-05-22,376.19,0.84,0.22,390.45,-3.65,True,1,9155,-376.19,-1123838.49,3444019.45,2320180.96
15902,1991-05-23,374.96,-1.23,-0.33,390.45,-3.97,True,1,9156,-374.96,-1124213.45,3433133.76,2308920.31
15903,1991-05-24,377.49,2.53,0.68,390.45,-3.32,True,1,9157,-377.49,-1124590.94,3456675.93,2332084.99
15904,1991-05-28,381.94,4.45,1.18,390.45,-2.18,True,1,9158,-381.94,-1124972.88,3497806.52,2372833.64
15905,1991-05-29,382.79,0.85,0.22,390.45,-1.96,True,1,9159,-382.79,-1125355.67,3505973.61,2380617.94
15906,1991-05-30,386.96,4.17,1.09,390.45,-0.89,True,1,9160,-386.96,-1125742.63,3544553.6,2418810.97
15907,1991-05-31,389.83,2.87,0.74,390.45,-0.16,True,1,9161,-389.83,-1126132.46,3571232.63,2445100.17
15908,1991-06-03,388.06,-1.77,-0.45,390.45,-0.61,True,1,9162,-388.06,-1126520.52,3555405.72,2428885.2
15909,1991-06-04,387.74,-0.32,-0.08,390.45,-0.69,True,1,9163,-387.74,-1126908.26,3552861.62,2425953.36
15910,1991-06-05,385.09,-2.65,-0.68,390.45,-1.37,True,1,9164,-385.09,-1127293.35,3528964.76,2401671.41
15911,1991-06-06,383.63,-1.46,-0.38,390.45,-1.75,True,1,9165,-383.63,-1127676.98,3515968.95,2388291.97
15912,1991-06-07,379.43,-4.2,-1.1,390.45,-2.82,True,1,9166,-379.43,-1128056.41,3477855.38,2349798.97
15913,1991-06-10,378.57,-0.86,-0.23,390.45,-3.04,True,1,9167,-378.57,-1128434.98,3470351.19,2341916.21
15914,1991-06-11,381.05,2.48,0.66,390.45,-2.41,True,1,9168,-381.05,-1128816.03,3493466.4,2364650.37
15915,1991-06-12,376.65,-4.4,-1.16,390.45,-3.53,True,1,9169,-376.65,-1129192.68,3453503.85,2324311.17
15916,1991-06-13,377.63,0.98,0.26,390.45,-3.28,True,1,9170,-377.63,-1129570.31,3462867.1,2333296.79
15917,1991-06-14,382.29,4.66,1.23,390.45,-2.09,True,1,9171,-382.29,-1129952.6,3505981.59,2376028.99
15918,1991-06-17,380.13,-2.16,-0.56,390.45,-2.64,True,1,9172,-380.13,-1130332.73,3486552.36,2356219.63
15919,1991-06-18,378.59,-1.54,-0.4,390.45,-3.04,True,1,9173,-378.59,-1130711.32,3472806.07,2342094.75
15920,1991-06-19,375.09,-3.5,-0.92,390.45,-3.93,True,1,9174,-375.09,-1131086.41,3441075.66,2309989.25
15921,1991-06-20,375.42,0.33,0.09,390.45,-3.85,True,1,9175,-375.42,-1131461.83,3444478.5,2313016.67
15922,1991-06-21,377.75,2.33,0.62,390.45,-3.25,True,1,9176,-377.75,-1131839.58,3466234.0,2334394.42
15923,1991-06-24,370.94,-6.81,-1.8,390.45,-5.0,True,1,9177,-370.94,-1132210.52,3404116.38,2271905.86
15924,1991-06-25,370.65,-0.29,-0.08,390.45,-5.07,True,1,9178,-370.65,-1132581.17,3401825.7,2269244.53
15925,1991-06-26,371.59,0.94,0.25,390.45,-4.83,True,1,9179,-371.59,-1132952.76,3410824.61,2277871.85
15926,1991-06-27,374.4,2.81,0.76,390.45,-4.11,True,1,9180,-374.4,-1133327.16,3436992.0,2303664.84
15927,1991-06-28,371.16,-3.24,-0.86,390.45,-4.94,True,1,9181,-371.16,-1133698.32,3407619.96,2273921.64
15928,1991-07-01,377.92,6.76,1.82,390.45,-3.21,True,1,9182,-377.92,-1134076.24,3470061.44,2335985.2
15929,1991-07-02,377.47,-0.45,-0.12,390.45,-3.32,True,1,9183,-377.47,-1134453.71,3466307.01,2331853.3
15930,1991-07-03,373.33,-4.14,-1.1,390.45,-4.38,True,1,9184,-373.33,-1134827.04,3428662.72,2293835.68
15931,1991-07-05,374.08,0.75,0.2,390.45,-4.19,True,1,9185,-374.08,-1135201.12,3435924.8,2300723.68
15932,1991-07-08,377.94,3.86,1.03,390.45,-3.2,True,1,9186,-377.94,-1135579.06,3471756.84,2336177.78
15933,1991-07-09,376.11,-1.83,-0.48,390.45,-3.67,True,1,9187,-376.11,-1135955.17,3455322.57,2319367.4
15934,1991-07-10,375.74,-0.37,-0.1,390.45,-3.77,True,1,9188,-375.74,-1136330.91,3452299.12,2315968.21
15935,1991-07-11,376.97,1.23,0.33,390.45,-3.45,True,1,9189,-376.97,-1136707.88,3463977.33,2327269.45
15936,1991-07-12,380.25,3.28,0.87,390.45,-2.61,True,1,9190,-380.25,-1137088.13,3494497.5,2357409.37
15937,1991-07-15,382.39,2.14,0.56,390.45,-2.06,True,1,9191,-382.39,-1137470.52,3514546.49,2377075.97
15938,1991-07-16,381.54,-0.85,-0.22,390.45,-2.28,True,1,9192,-381.54,-1137852.06,3507115.68,2369263.62
15939,1991-07-17,381.18,-0.36,-0.09,390.45,-2.37,True,1,9193,-381.18,-1138233.24,3504187.74,2365954.5
15940,1991-07-18,385.37,4.19,1.1,390.45,-1.3,True,1,9194,-385.37,-1138618.61,3543091.78,2404473.17
15941,1991-07-19,384.22,-1.15,-0.3,390.45,-1.6,True,1,9195,-384.22,-1139002.83,3532902.9,2393900.07
15942,1991-07-22,382.88,-1.34,-0.35,390.45,-1.94,True,1,9196,-382.88,-1139385.71,3520964.48,2381578.77
15943,1991-07-23,379.42,-3.46,-0.9,390.45,-2.82,True,1,9197,-379.42,-1139765.13,3489525.74,2349760.61
15944,1991-07-24,378.64,-0.78,-0.21,390.45,-3.02,True,1,9198,-378.64,-1140143.77,3482730.72,2342586.95
15945,1991-07-25,380.96,2.32,0.61,390.45,-2.43,True,1,9199,-380.96,-1140524.73,3504451.04,2363926.31
15946,1991-07-26,380.93,-0.03,-0.01,390.45,-2.44,True,1,9200,-380.93,-1140905.66,3504556.0,2363650.34
15947,1991-07-29,383.15,2.22,0.58,390.45,-1.87,True,1,9201,-383.15,-1141288.81,3525363.15,2384074.34
15948,1991-07-30,386.69,3.54,0.92,390.45,-0.96,True,1,9202,-386.69,-1141675.5,3558321.38,2416645.88
15949,1991-07-31,387.81,1.12,0.29,390.45,-0.68,True,1,9203,-387.81,-1142063.31,3569015.43,2426952.12
15950,1991-08-01,387.12,-0.69,-0.18,390.45,-0.85,True,1,9204,-387.12,-1142450.43,3563052.48,2420602.05
15951,1991-08-02,387.18,0.06,0.02,390.45,-0.84,True,1,9205,-387.18,-1142837.61,3563991.9,2421154.29
15952,1991-08-05,385.06,-2.12,-0.55,390.45,-1.38,True,1,9206,-385.06,-1143222.67,3544862.36,2401639.69
15953,1991-08-06,390.62,5.56,1.44,390.62,0.0,True,1,9207,-390.62,-1143613.29,3596438.34,2452825.05
15954,1991-08-07,390.56,-0.06,-0.02,390.62,-0.02,True,1,9208,-390.56,-1144003.85,3596276.48,2452272.63
15955,1991-08-08,389.32,-1.24,-0.32,390.62,-0.33,True,1,9209,-389.32,-1144393.17,3585247.88,2440854.71
15956,1991-08-09,387.12,-2.2,-0.56,390.62,-0.9,True,1,9210,-387.12,-1144780.29,3565375.2,2420594.91
15957,1991-08-12,388.02,0.9,0.23,390.62,-0.67,True,1,9211,-388.02,-1145168.31,3574052.22,2428883.91
15958,1991-08-13,389.62,1.6,0.41,390.62,-0.26,True,1,9212,-389.62,-1145557.93,3589179.44,2443621.51
15959,1991-08-14,389.9,0.28,0.07,390.62,-0.18,True,1,9213,-389.9,-1145947.83,3592148.7,2446200.87
15960,1991-08-15,389.33,-0.57,-0.15,390.62,-0.33,True,1,9214,-389.33,-1146337.16,3587286.62,2440949.46
15961,1991-08-16,385.58,-3.75,-0.96,390.62,-1.29,True,1,9215,-385.58,-1146722.74,3553119.7,2406396.96
15962,1991-08-19,376.47,-9.11,-2.36,390.62,-3.62,True,1,9216,-376.47,-1147099.21,3469547.52,2322448.31
15963,1991-08-20,379.43,2.96,0.79,390.62,-2.86,True,1,9217,-379.43,-1147478.64,3497206.31,2349727.67
15964,1991-08-21,390.59,11.16,2.94,390.62,-0.01,True,1,9218,-390.59,-1147869.23,3600458.62,2452589.39
15965,1991-08-22,391.33,0.74,0.19,391.33,0.0,True,1,9219,-391.33,-1148260.56,3607671.27,2459410.71
15966,1991-08-23,394.17,2.84,0.73,394.17,0.0,True,1,9220,-394.17,-1148654.73,3634247.4,2485592.67
15967,1991-08-26,393.85,-0.32,-0.08,394.17,-0.08,True,1,9221,-393.85,-1149048.58,3631690.85,2482642.27
15968,1991-08-27,393.06,-0.79,-0.2,394.17,-0.28,True,1,9222,-393.06,-1149441.64,3624799.32,2475357.68
15969,1991-08-28,396.64,3.58,0.91,396.64,0.0,True,1,9223,-396.64,-1149838.28,3658210.72,2508372.44
15970,1991-08-29,396.47,-0.17,-0.04,396.64,-0.04,True,1,9224,-396.47,-1150234.75,3657039.28,2506804.53
15971,1991-08-30,395.43,-1.04,-0.26,396.64,-0.3,True,1,9225,-395.43,-1150630.18,3647841.75,2497211.57
15972,1991-09-03,392.15,-3.28,-0.83,396.64,-1.13,True,1,9226,-392.15,-1151022.33,3617975.9,2466953.57
15973,1991-09-04,389.97,-2.18,-0.56,396.64,-1.68,True,1,9227,-389.97,-1151412.3,3598253.19,2446840.89
15974,1991-09-05,389.14,-0.83,-0.21,396.64,-1.89,True,1,9228,-389.14,-1151801.44,3590983.92,2439182.48
15975,1991-09-06,389.1,-0.04,-0.01,396.64,-1.9,True,1,9229,-389.1,-1152190.54,3591003.9,2438813.36
15976,1991-09-09,388.57,-0.53,-0.14,396.64,-2.04,True,1,9230,-388.57,-1152579.11,3586501.1,2433921.99
15977,1991-09-10,384.56,-4.01,-1.03,396.64,-3.05,True,1,9231,-384.56,-1152963.67,3549873.36,2396909.69
15978,1991-09-11,385.09,0.53,0.14,396.64,-2.91,True,1,9232,-385.09,-1153348.76,3555150.88,2401802.12
15979,1991-09-12,387.34,2.25,0.58,396.64,-2.35,True,1,9233,-387.34,-1153736.1,3576310.22,2422574.12
15980,1991-09-13,383.59,-3.75,-0.97,396.64,-3.29,True,1,9234,-383.59,-1154119.69,3542070.06,2387950.37
15981,1991-09-16,385.78,2.19,0.57,396.64,-2.74,True,1,9235,-385.78,-1154505.47,3562678.3,2408172.83
15982,1991-09-17,385.5,-0.28,-0.07,396.64,-2.81,True,1,9236,-385.5,-1154890.97,3560478.0,2405587.03
15983,1991-09-18,386.94,1.44,0.37,396.64,-2.45,True,1,9237,-386.94,-1155277.91,3574164.78,2418886.87
15984,1991-09-19,387.56,0.62,0.16,396.64,-2.29,True,1,9238,-387.56,-1155665.47,3580279.28,2424613.81
15985,1991-09-20,387.92,0.36,0.09,396.64,-2.2,True,1,9239,-387.92,-1156053.39,3583992.88,2427939.49
15986,1991-09-23,385.92,-2.0,-0.52,396.64,-2.7,True,1,9240,-385.92,-1156439.31,3565900.8,2409461.49
15987,1991-09-24,387.71,1.79,0.46,396.64,-2.25,True,1,9241,-387.71,-1156827.02,3582828.11,2426001.09
15988,1991-09-25,386.88,-0.83,-0.21,396.64,-2.46,True,1,9242,-386.88,-1157213.9,3575544.96,2418331.06
15989,1991-09-26,386.49,-0.39,-0.1,396.64,-2.56,True,1,9243,-386.49,-1157600.39,3572327.07,2414726.68
15990,1991-09-27,385.9,-0.59,-0.15,396.64,-2.71,True,1,9244,-385.9,-1157986.29,3567259.6,2409273.31
15991,1991-09-30,387.86,1.96,0.51,396.64,-2.21,True,1,9245,-387.86,-1158374.15,3585765.7,2427391.55
15992,1991-10-01,389.2,1.34,0.34,396.64,-1.88,True,1,9246,-389.2,-1158763.35,3598543.2,2439779.85
15993,1991-10-02,388.26,-0.94,-0.24,396.64,-2.11,True,1,9247,-388.26,-1159151.61,3590240.22,2431088.61
15994,1991-10-03,384.47,-3.79,-0.98,396.64,-3.07,True,1,9248,-384.47,-1159536.08,3555578.56,2396042.48
15995,1991-10-04,381.25,-3.22,-0.84,396.64,-3.88,True,1,9249,-381.25,-1159917.33,3526181.25,2366263.92
15996,1991-10-07,379.5,-1.75,-0.46,396.64,-4.32,True,1,9250,-379.5,-1160296.83,3510375.0,2350078.17
15997,1991-10-08,380.67,1.17,0.31,396.64,-4.03,True,1,9251,-380.67,-1160677.5,3521578.17,2360900.67
15998,1991-10-09,376.8,-3.87,-1.02,396.64,-5.0,True,1,9252,-376.8,-1161054.3,3486153.6,2325099.3
15999,1991-10-10,380.55,3.75,1.0,396.64,-4.06,True,1,9253,-380.55,-1161434.85,3521229.15,2359794.3
16000,1991-10-11,381.45,0.9,0.24,396.64,-3.83,True,1,9254,-381.45,-1161816.3,3529938.3,2368122.0
16001,1991-10-14,386.47,5.02,1.32,396.64,-2.56,True,1,9255,-386.47,-1162202.77,3576779.85,2414577.08
16002,1991-10-15,391.01,4.54,1.18,396.64,-1.42,True,1,9256,-391.01,-1162593.78,3619188.56,2456594.78
16003,1991-10-16,392.8,1.79,0.46,396.64,-0.97,True,1,9257,-392.8,-1162986.58,3636149.6,2473163.02
16004,1991-10-17,391.92,-0.88,-0.22,396.64,-1.19,True,1,9258,-391.92,-1163378.5,3628395.36,2465016.86
16005,1991-10-18,392.5,0.58,0.15,396.64,-1.04,True,1,9259,-392.5,-1163771.0,3634157.5,2470386.5
16006,1991-10-21,390.02,-2.48,-0.63,396.64,-1.67,True,1,9260,-390.02,-1164161.02,3611585.2,2447424.18
16007,1991-10-22,387.83,-2.19,-0.56,396.64,-2.22,True,1,9261,-387.83,-1164548.85,3591693.63,2427144.78
16008,1991-10-23,387.94,0.11,0.03,396.64,-2.19,True,1,9262,-387.94,-1164936.79,3593100.28,2428163.49
16009,1991-10-24,385.07,-2.87,-0.74,396.64,-2.92,True,1,9263,-385.07,-1165321.86,3566903.41,2401581.55
16010,1991-10-25,384.2,-0.87,-0.23,396.64,-3.14,True,1,9264,-384.2,-1165706.06,3559228.8,2393522.74
16011,1991-10-28,389.52,5.32,1.38,396.64,-1.8,True,1,9265,-389.52,-1166095.58,3608902.8,2442807.22
16012,1991-10-29,391.48,1.96,0.5,396.64,-1.3,True,1,9266,-391.48,-1166487.06,3627453.68,2460966.62
16013,1991-10-30,392.96,1.48,0.38,396.64,-0.93,True,1,9267,-392.96,-1166880.02,3641560.32,2474680.3
16014,1991-10-31,392.45,-0.51,-0.13,396.64,-1.06,True,1,9268,-392.45,-1167272.47,3637226.6,2469954.13
16015,1991-11-01,391.32,-1.13,-0.29,396.64,-1.34,True,1,9269,-391.32,-1167663.79,3627145.08,2459481.29
16016,1991-11-04,390.28,-1.04,-0.27,396.64,-1.6,True,1,9270,-390.28,-1168054.07,3617895.6,2449841.53
16017,1991-11-05,388.71,-1.57,-0.4,396.64,-2.0,True,1,9271,-388.71,-1168442.78,3603730.41,2435287.63
16018,1991-11-06,389.97,1.26,0.32,396.64,-1.68,True,1,9272,-389.97,-1168832.75,3615801.84,2446969.09
16019,1991-11-07,393.72,3.75,0.96,396.64,-0.74,True,1,9273,-393.72,-1169226.47,3650965.56,2481739.09
16020,1991-11-08,392.89,-0.83,-0.21,396.64,-0.94,True,1,9274,-392.89,-1169619.36,3643661.86,2474042.5
16021,1991-11-11,393.12,0.23,0.06,396.64,-0.89,True,1,9275,-393.12,-1170012.48,3646188.0,2476175.52
16022,1991-11-12,396.74,3.62,0.92,396.74,0.0,True,1,9276,-396.74,-1170409.22,3680160.24,2509751.02
16023,1991-11-13,397.41,0.67,0.17,397.41,0.0,True,1,9277,-397.41,-1170806.63,3686772.57,2515965.94
16024,1991-11-14,397.15,-0.26,-0.06,397.41,-0.06,True,1,9278,-397.15,-1171203.78,3684757.7,2513553.92
16025,1991-11-15,382.62,-14.53,-3.66,397.41,-3.72,True,1,9279,-382.62,-1171586.4,3550330.98,2378744.58
16026,1991-11-18,385.24,2.62,0.68,397.41,-3.06,True,1,9280,-385.24,-1171971.64,3575027.2,2403055.56
16027,1991-11-19,379.42,-5.82,-1.51,397.41,-4.53,True,1,9281,-379.42,-1172351.06,3521397.02,2349045.96
16028,1991-11-20,378.53,-0.89,-0.24,397.41,-4.75,True,1,9282,-378.53,-1172729.59,3513515.46,2340785.87
16029,1991-11-21,380.06,1.53,0.4,397.41,-4.37,True,1,9283,-380.06,-1173109.65,3528096.98,2354987.33
16030,1991-11-22,376.14,-3.92,-1.03,397.41,-5.35,True,1,9284,-376.14,-1173485.79,3492083.76,2318597.97
16031,1991-11-25,375.34,-0.8,-0.21,397.41,-5.55,True,1,9285,-375.34,-1173861.13,3485031.9,2311170.77
16032,1991-11-26,377.96,2.62,0.7,397.41,-4.89,True,1,9286,-377.96,-1174239.09,3509736.56,2335497.47
16033,1991-11-27,376.55,-1.41,-0.37,397.41,-5.25,True,1,9287,-376.55,-1174615.64,3497019.85,2322404.21
16034,1991-11-29,375.22,-1.33,-0.35,397.41,-5.58,True,1,9288,-375.22,-1174990.86,3485043.36,2310052.5
16035,1991-12-02,381.4,6.18,1.65,397.41,-4.03,True,1,9289,-381.4,-1175372.26,3542824.6,2367452.34
16036,1991-12-03,380.96,-0.44,-0.12,397.41,-4.14,True,1,9290,-380.96,-1175753.22,3539118.4,2363365.18
16037,1991-12-04,380.07,-0.89,-0.23,397.41,-4.36,True,1,9291,-380.07,-1176133.29,3531230.37,2355097.08
16038,1991-12-05,377.39,-2.68,-0.7,397.41,-5.04,True,1,9292,-377.39,-1176510.68,3506707.88,2330197.2
16039,1991-12-06,379.1,1.71,0.45,397.41,-4.61,True,1,9293,-379.1,-1176889.78,3522976.3,2346086.52
16040,1991-12-09,378.26,-0.84,-0.22,397.41,-4.82,True,1,9294,-378.26,-1177268.04,3515548.44,2338280.4
16041,1991-12-10,377.9,-0.36,-0.1,397.41,-4.91,True,1,9295,-377.9,-1177645.94,3512580.5,2334934.56
16042,1991-12-11,377.7,-0.2,-0.05,397.41,-4.96,True,1,9296,-377.7,-1178023.64,3511099.2,2333075.56
16043,1991-12-12,381.55,3.85,1.02,397.41,-3.99,True,1,9297,-381.55,-1178405.19,3547270.35,2368865.16
16044,1991-12-13,384.47,2.92,0.76,397.41,-3.26,True,1,9298,-384.47,-1178789.66,3574802.06,2396012.4
16045,1991-12-16,384.46,-0.01,-0.0,397.41,-3.26,True,1,9299,-384.46,-1179174.12,3575093.54,2395919.42
16046,1991-12-17,382.74,-1.72,-0.45,397.41,-3.69,True,1,9300,-382.74,-1179556.86,3559482.0,2379925.14
16047,1991-12-18,383.48,0.74,0.19,397.41,-3.5,True,1,9301,-383.48,-1179940.34,3566747.48,2386807.14
16048,1991-12-19,382.52,-0.96,-0.25,397.41,-3.75,True,1,9302,-382.52,-1180322.86,3558201.04,2377878.18
16049,1991-12-20,387.04,4.52,1.18,397.41,-2.61,True,1,9303,-387.04,-1180709.9,3600633.12,2419923.22
16050,1991-12-23,396.82,9.78,2.53,397.41,-0.15,True,1,9304,-396.82,-1181106.72,3692013.28,2510906.56
16051,1991-12-24,399.33,2.51,0.63,399.33,0.0,True,1,9305,-399.33,-1181506.05,3715765.65,2534259.6
16052,1991-12-26,404.84,5.51,1.38,404.84,0.0,True,1,9306,-404.84,-1181910.89,3767441.04,2585530.15
16053,1991-12-27,406.46,1.62,0.4,406.46,0.0,True,1,9307,-406.46,-1182317.35,3782923.22,2600605.87
16054,1991-12-30,415.14,8.68,2.14,415.14,0.0,True,1,9308,-415.14,-1182732.49,3864123.12,2681390.63
16055,1991-12-31,417.09,1.95,0.47,417.09,0.0,True,1,9309,-417.09,-1183149.58,3882690.81,2699541.23
16056,1992-01-02,417.26,0.17,0.04,417.26,0.0,True,1,9310,-417.26,-1183566.84,3884690.6,2701123.76
16057,1992-01-03,419.34,2.08,0.5,419.34,0.0,True,1,9311,-419.34,-1183986.18,3904474.74,2720488.56
16058,1992-01-06,417.96,-1.38,-0.33,419.34,-0.33,True,1,9312,-417.96,-1184404.14,3892043.52,2707639.38
16059,1992-01-07,417.4,-0.56,-0.13,419.34,-0.46,True,1,9313,-417.4,-1184821.54,3887246.2,2702424.66
16060,1992-01-08,418.1,0.7,0.17,419.34,-0.3,True,1,9314,-418.1,-1185239.64,3894183.4,2708943.76
16061,1992-01-09,417.61,-0.49,-0.12,419.34,-0.41,True,1,9315,-417.61,-1185657.25,3890037.15,2704379.9
16062,1992-01-10,415.1,-2.51,-0.6,419.34,-1.01,True,1,9316,-415.1,-1186072.35,3867071.6,2680999.25
16063,1992-01-13,414.34,-0.76,-0.18,419.34,-1.19,True,1,9317,-414.34,-1186486.69,3860405.78,2673919.09
16064,1992-01-14,420.44,6.1,1.47,420.44,0.0,True,1,9318,-420.44,-1186907.13,3917659.92,2730752.79
16065,1992-01-15,420.77,0.33,0.08,420.77,0.0,True,1,9319,-420.77,-1187327.9,3921155.63,2733827.73
16066,1992-01-16,418.21,-2.56,-0.61,420.77,-0.61,True,1,9320,-418.21,-1187746.11,3897717.2,2709971.09
16067,1992-01-17,418.86,0.65,0.16,420.77,-0.45,True,1,9321,-418.86,-1188164.97,3904194.06,2716029.09
16068,1992-01-20,416.36,-2.5,-0.6,420.77,-1.05,True,1,9322,-416.36,-1188581.33,3881307.92,2692726.59
16069,1992-01-21,412.64,-3.72,-0.89,420.77,-1.93,True,1,9323,-412.64,-1188993.97,3847042.72,2658048.75
16070,1992-01-22,418.13,5.49,1.33,420.77,-0.63,True,1,9324,-418.13,-1189412.1,3898644.12,2709232.02
16071,1992-01-23,414.96,-3.17,-0.76,420.77,-1.38,True,1,9325,-414.96,-1189827.06,3869502.0,2679674.94
16072,1992-01-24,415.48,0.52,0.12,420.77,-1.26,True,1,9326,-415.48,-1190242.54,3874766.48,2684523.94
16073,1992-01-27,414.99,-0.49,-0.12,420.77,-1.37,True,1,9327,-414.99,-1190657.53,3870611.73,2679954.2
16074,1992-01-28,414.96,-0.03,-0.01,420.77,-1.38,True,1,9328,-414.96,-1191072.49,3870746.88,2679674.39
16075,1992-01-29,410.34,-4.62,-1.11,420.77,-2.48,True,1,9329,-410.34,-1191482.83,3828061.86,2636579.03
16076,1992-01-30,411.62,1.28,0.31,420.77,-2.17,True,1,9330,-411.62,-1191894.45,3840414.6,2648520.15
16077,1992-01-31,408.78,-2.84,-0.69,420.77,-2.85,True,1,9331,-408.78,-1192303.23,3814326.18,2622022.95
16078,1992-02-03,409.53,0.75,0.18,420.77,-2.67,True,1,9332,-409.53,-1192712.76,3821733.96,2629021.2
16079,1992-02-04,413.85,4.32,1.06,420.77,-1.64,True,1,9333,-413.85,-1193126.61,3862462.05,2669335.44
16080,1992-02-05,413.84,-0.01,-0.0,420.77,-1.65,True,1,9334,-413.84,-1193540.45,3862782.56,2669242.11
16081,1992-02-06,413.82,-0.02,-0.0,420.77,-1.65,True,1,9335,-413.82,-1193954.27,3863009.7,2669055.43
16082,1992-02-07,411.09,-2.73,-0.66,420.77,-2.3,True,1,9336,-411.09,-1194365.36,3837936.24,2643570.88
16083,1992-02-10,413.77,2.68,0.65,420.77,-1.66,True,1,9337,-413.77,-1194779.13,3863370.49,2668591.36
16084,1992-02-11,413.76,-0.01,-0.0,420.77,-1.67,True,1,9338,-413.76,-1195192.89,3863690.88,2668497.99
16085,1992-02-12,417.13,3.37,0.81,420.77,-0.86,True,1,9339,-417.13,-1195610.02,3895577.07,2699967.05
16086,1992-02-13,413.69,-3.44,-0.82,420.77,-1.68,True,1,9340,-413.69,-1196023.71,3863864.6,2667840.89
16087,1992-02-14,412.48,-1.21,-0.29,420.77,-1.97,True,1,9341,-412.48,-1196436.19,3852975.68,2656539.49
16088,1992-02-18,407.38,-5.1,-1.24,420.77,-3.18,True,1,9342,-407.38,-1196843.57,3805743.96,2608900.39
16089,1992-02-19,408.26,0.88,0.22,420.77,-2.97,True,1,9343,-408.26,-1197251.83,3814373.18,2617121.35
16090,1992-02-20,413.9,5.64,1.38,420.77,-1.63,True,1,9344,-413.9,-1197665.73,3867481.6,2669815.87
16091,1992-02-21,411.43,-2.47,-0.6,420.77,-2.22,True,1,9345,-411.43,-1198077.16,3844813.35,2646736.19
16092,1992-02-24,412.27,0.84,0.2,420.77,-2.02,True,1,9346,-412.27,-1198489.43,3853075.42,2654585.99
16093,1992-02-25,410.45,-1.82,-0.44,420.77,-2.45,True,1,9347,-410.45,-1198899.88,3836476.15,2637576.27
16094,1992-02-26,415.35,4.9,1.19,420.77,-1.29,True,1,9348,-415.35,-1199315.23,3882691.8,2683376.57
16095,1992-02-27,413.86,-1.49,-0.36,420.77,-1.64,True,1,9349,-413.86,-1199729.09,3869177.14,2669448.05
16096,1992-02-28,412.7,-1.16,-0.28,420.77,-1.92,True,1,9350,-412.7,-1200141.79,3858745.0,2658603.21
16097,1992-03-02,412.45,-0.25,-0.06,420.77,-1.98,True,1,9351,-412.45,-1200554.24,3856819.95,2656265.71
16098,1992-03-03,412.85,0.4,0.1,420.77,-1.88,True,1,9352,-412.85,-1200967.09,3860973.2,2660006.11
16099,1992-03-04,409.33,-3.52,-0.85,420.77,-2.72,True,1,9353,-409.33,-1201376.42,3828463.49,2627087.07
16100,1992-03-05,406.51,-2.82,-0.69,420.77,-3.39,True,1,9354,-406.51,-1201782.93,3802494.54,2600711.61
16101,1992-03-06,404.44,-2.07,-0.51,420.77,-3.88,True,1,9355,-404.44,-1202187.37,3783536.2,2581348.83
16102,1992-03-09,405.21,0.77,0.19,420.77,-3.7,True,1,9356,-405.21,-1202592.58,3791144.76,2588552.18
16103,1992-03-10,406.89,1.68,0.42,420.77,-3.3,True,1,9357,-406.89,-1202999.47,3807269.73,2604270.26
16104,1992-03-11,404.03,-2.86,-0.7,420.77,-3.98,True,1,9358,-404.03,-1203403.5,3780912.74,2577509.24
16105,1992-03-12,403.89,-0.14,-0.04,420.77,-4.01,True,1,9359,-403.89,-1203807.39,3780006.51,2576199.12
16106,1992-03-13,405.84,1.95,0.48,420.77,-3.55,True,1,9360,-405.84,-1204213.23,3798662.4,2594449.17
16107,1992-03-16,406.39,0.55,0.14,420.77,-3.42,True,1,9361,-406.39,-1204619.62,3804216.79,2599597.17
16108,1992-03-17,409.58,3.19,0.78,420.77,-2.66,True,1,9362,-409.58,-1205029.2,3834487.96,2629458.76
16109,1992-03-18,409.15,-0.43,-0.1,420.77,-2.76,True,1,9363,-409.15,-1205438.35,3830871.45,2625433.1
16110,1992-03-19,409.8,0.65,0.16,420.77,-2.61,True,1,9364,-409.8,-1205848.15,3837367.2,2631519.05
16111,1992-03-20,411.3,1.5,0.37,420.77,-2.25,True,1,9365,-411.3,-1206259.45,3851824.5,2645565.05
16112,1992-03-23,409.91,-1.39,-0.34,420.77,-2.58,True,1,9366,-409.91,-1206669.36,3839217.06,2632547.7
16113,1992-03-24,408.88,-1.03,-0.25,420.77,-2.83,True,1,9367,-408.88,-1207078.24,3829978.96,2622900.72
16114,1992-03-25,407.52,-1.36,-0.33,420.77,-3.15,True,1,9368,-407.52,-1207485.76,3817647.36,2610161.6
16115,1992-03-26,407.86,0.34,0.08,420.77,-3.07,True,1,9369,-407.86,-1207893.62,3821240.34,2613346.72
16116,1992-03-27,403.5,-4.36,-1.07,420.77,-4.1,True,1,9370,-403.5,-1208297.12,3780795.0,2572497.88
16117,1992-03-30,403.0,-0.5,-0.12,420.77,-4.22,True,1,9371,-403.0,-1208700.12,3776513.0,2567812.88
16118,1992-03-31,403.69,0.69,0.17,420.77,-4.06,True,1,9372,-403.69,-1209103.81,3783382.68,2574278.87
16119,1992-04-01,404.23,0.54,0.13,420.77,-3.93,True,1,9373,-404.23,-1209508.04,3788847.79,2579339.75
16120,1992-04-02,400.5,-3.73,-0.92,420.77,-4.82,True,1,9374,-400.5,-1209908.54,3754287.0,2544378.46
16121,1992-04-03,401.55,1.05,0.26,420.77,-4.57,True,1,9375,-401.55,-1210310.09,3764531.25,2554221.16
16122,1992-04-06,405.59,4.04,1.01,420.77,-3.61,True,1,9376,-405.59,-1210715.68,3802811.84,2592096.16
16123,1992-04-07,398.06,-7.53,-1.86,420.77,-5.4,True,1,9377,-398.06,-1211113.74,3732608.62,2521494.88
16124,1992-04-08,394.5,-3.56,-0.89,420.77,-6.24,True,1,9378,-394.5,-1211508.24,3699621.0,2488112.76
16125,1992-04-09,400.64,6.14,1.56,420.77,-4.78,True,1,9379,-400.64,-1211908.88,3757602.56,2545693.68
16126,1992-04-10,404.29,3.65,0.91,420.77,-3.92,True,1,9380,-404.29,-1212313.17,3792240.2,2579927.03
16127,1992-04-13,406.08,1.79,0.44,420.77,-3.49,True,1,9381,-406.08,-1212719.25,3809436.48,2596717.23
16128,1992-04-14,412.39,6.31,1.55,420.77,-1.99,True,1,9382,-412.39,-1213131.64,3869042.98,2655911.34
16129,1992-04-15,416.28,3.89,0.94,420.77,-1.07,True,1,9383,-416.28,-1213547.92,3905955.24,2692407.32
16130,1992-04-16,416.04,-0.24,-0.06,420.77,-1.12,True,1,9384,-416.04,-1213963.96,3904119.36,2690155.4
16131,1992-04-20,410.18,-5.86,-1.41,420.77,-2.52,True,1,9385,-410.18,-1214374.14,3849539.3,2635165.16
16132,1992-04-21,410.26,0.08,0.02,420.77,-2.5,True,1,9386,-410.26,-1214784.4,3850700.36,2635915.96
16133,1992-04-22,409.81,-0.45,-0.11,420.77,-2.6,True,1,9387,-409.81,-1215194.21,3846886.47,2631692.26
16134,1992-04-23,411.6,1.79,0.44,420.77,-2.18,True,1,9388,-411.6,-1215605.81,3864100.8,2648494.99
16135,1992-04-24,409.02,-2.58,-0.63,420.77,-2.79,True,1,9389,-409.02,-1216014.83,3840288.78,2624273.95
16136,1992-04-27,408.45,-0.57,-0.14,420.77,-2.93,True,1,9390,-408.45,-1216423.28,3835345.5,2618922.22
16137,1992-04-28,409.11,0.66,0.16,420.77,-2.77,True,1,9391,-409.11,-1216832.39,3841952.01,2625119.62
16138,1992-04-29,412.02,2.91,0.71,420.77,-2.08,True,1,9392,-412.02,-1217244.41,3869691.84,2652447.43
16139,1992-04-30,414.95,2.93,0.71,420.77,-1.38,True,1,9393,-414.95,-1217659.36,3897625.35,2679965.99
16140,1992-05-01,412.53,-2.42,-0.58,420.77,-1.96,True,1,9394,-412.53,-1218071.89,3875306.82,2657234.93
16141,1992-05-04,416.91,4.38,1.06,420.77,-0.92,True,1,9395,-416.91,-1218488.8,3916869.45,2698380.65
16142,1992-05-05,416.84,-0.07,-0.02,420.77,-0.93,True,1,9396,-416.84,-1218905.64,3916628.64,2697723.0
16143,1992-05-06,416.79,-0.05,-0.01,420.77,-0.95,True,1,9397,-416.79,-1219322.43,3916575.63,2697253.2
16144,1992-05-07,415.85,-0.94,-0.23,420.77,-1.17,True,1,9398,-415.85,-1219738.28,3908158.3,2688420.02
16145,1992-05-08,416.05,0.2,0.05,420.77,-1.12,True,1,9399,-416.05,-1220154.33,3910453.95,2690299.62
16146,1992-05-11,418.49,2.44,0.59,420.77,-0.54,True,1,9400,-418.49,-1220572.82,3933806.0,2713233.18
16147,1992-05-12,416.29,-2.2,-0.53,420.77,-1.06,True,1,9401,-416.29,-1220989.11,3913542.29,2692553.18
16148,1992-05-13,416.45,0.16,0.04,420.77,-1.03,True,1,9402,-416.45,-1221405.56,3915462.9,2694057.34
16149,1992-05-14,413.14,-3.31,-0.8,420.77,-1.81,True,1,9403,-413.14,-1221818.7,3884755.42,2662936.72
16150,1992-05-15,410.09,-3.05,-0.74,420.77,-2.54,True,1,9404,-410.09,-1222228.79,3856486.36,2634257.57
16151,1992-05-18,412.81,2.72,0.66,420.77,-1.89,True,1,9405,-412.81,-1222641.6,3882478.05,2659836.45
16152,1992-05-19,416.37,3.56,0.86,420.77,-1.05,True,1,9406,-416.37,-1223057.97,3916376.22,2693318.25
16153,1992-05-20,415.39,-0.98,-0.24,420.77,-1.28,True,1,9407,-415.39,-1223473.36,3907573.73,2684100.37
16154,1992-05-21,412.6,-2.79,-0.67,420.77,-1.94,True,1,9408,-412.6,-1223885.96,3881740.8,2657854.84
16155,1992-05-22,414.02,1.42,0.34,420.77,-1.6,True,1,9409,-414.02,-1224299.98,3895514.18,2671214.2
16156,1992-05-26,411.41,-2.61,-0.63,420.77,-2.22,True,1,9410,-411.41,-1224711.39,3871368.1,2646656.71
16157,1992-05-27,412.17,0.76,0.18,420.77,-2.04,True,1,9411,-412.17,-1225123.56,3878931.87,2653808.31
16158,1992-05-28,416.74,4.57,1.11,420.77,-0.96,True,1,9412,-416.74,-1225540.3,3922356.88,2696816.58
16159,1992-05-29,415.35,-1.39,-0.33,420.77,-1.29,True,1,9413,-415.35,-1225955.65,3909689.55,2683733.9
16160,1992-06-01,417.3,1.95,0.47,420.77,-0.82,True,1,9414,-417.3,-1226372.95,3928462.2,2702089.25
16161,1992-06-02,413.5,-3.8,-0.91,420.77,-1.73,True,1,9415,-413.5,-1226786.45,3893102.5,2666316.05
16162,1992-06-03,414.59,1.09,0.26,420.77,-1.47,True,1,9416,-414.59,-1227201.04,3903779.44,2676578.4
16163,1992-06-04,413.26,-1.33,-0.32,420.77,-1.78,True,1,9417,-413.26,-1227614.3,3891669.42,2664055.12
16164,1992-06-05,413.48,0.22,0.05,420.77,-1.73,True,1,9418,-413.48,-1228027.78,3894154.64,2666126.86
16165,1992-06-08,413.36,-0.12,-0.03,420.77,-1.76,True,1,9419,-413.36,-1228441.14,3893437.84,2664996.7
16166,1992-06-09,410.06,-3.3,-0.8,420.77,-2.54,True,1,9420,-410.06,-1228851.2,3862765.2,2633914.0
16167,1992-06-10,407.25,-2.81,-0.68,420.77,-3.21,True,1,9421,-407.25,-1229258.45,3836702.25,2607443.8
16168,1992-06-11,409.05,1.8,0.44,420.77,-2.78,True,1,9422,-409.05,-1229667.5,3854069.1,2624401.6
16169,1992-06-12,409.76,0.71,0.17,420.77,-2.62,True,1,9423,-409.76,-1230077.26,3861168.48,2631091.22
16170,1992-06-15,410.29,0.53,0.13,420.77,-2.49,True,1,9424,-410.29,-1230487.55,3866572.96,2636085.41
16171,1992-06-16,408.32,-1.97,-0.48,420.77,-2.96,True,1,9425,-408.32,-1230895.87,3848416.0,2617520.13
16172,1992-06-17,402.26,-6.06,-1.48,420.77,-4.4,True,1,9426,-402.26,-1231298.13,3791702.76,2560404.63
16173,1992-06-18,400.96,-1.3,-0.32,420.77,-4.71,True,1,9427,-400.96,-1231699.09,3779849.92,2548150.83
16174,1992-06-19,403.67,2.71,0.68,420.77,-4.06,True,1,9428,-403.67,-1232102.76,3805800.76,2573698.0
16175,1992-06-22,403.4,-0.27,-0.07,420.77,-4.13,True,1,9429,-403.4,-1232506.16,3803658.6,2571152.44
16176,1992-06-23,404.04,0.64,0.16,420.77,-3.98,True,1,9430,-404.04,-1232910.2,3810097.2,2577187.0
16177,1992-06-24,403.84,-0.2,-0.05,420.77,-4.02,True,1,9431,-403.84,-1233314.04,3808615.04,2575301.0
16178,1992-06-25,403.12,-0.72,-0.18,420.77,-4.2,True,1,9432,-403.12,-1233717.16,3802227.84,2568510.68
16179,1992-06-26,403.45,0.33,0.08,420.77,-4.12,True,1,9433,-403.45,-1234120.61,3805743.85,2571623.24
16180,1992-06-29,408.94,5.49,1.36,420.77,-2.81,True,1,9434,-408.94,-1234529.55,3857939.96,2623410.41
16181,1992-06-30,408.14,-0.8,-0.2,420.77,-3.0,True,1,9435,-408.14,-1234937.69,3850800.9,2615863.21
16182,1992-07-01,412.88,4.74,1.16,420.77,-1.88,True,1,9436,-412.88,-1235350.57,3895935.68,2660585.11
16183,1992-07-02,411.77,-1.11,-0.27,420.77,-2.14,True,1,9437,-411.77,-1235762.34,3885873.49,2650111.15
16184,1992-07-06,413.84,2.07,0.5,420.77,-1.65,True,1,9438,-413.84,-1236176.18,3905821.92,2669645.74
16185,1992-07-07,409.16,-4.68,-1.13,420.77,-2.76,True,1,9439,-409.16,-1236585.34,3862061.24,2625475.9
16186,1992-07-08,410.28,1.12,0.27,420.77,-2.49,True,1,9440,-410.28,-1236995.62,3873043.2,2636047.58
16187,1992-07-09,414.23,3.95,0.96,420.77,-1.55,True,1,9441,-414.23,-1237409.85,3910745.43,2673335.58
16188,1992-07-10,414.62,0.39,0.09,420.77,-1.46,True,1,9442,-414.62,-1237824.47,3914842.04,2677017.57
16189,1992-07-13,414.87,0.25,0.06,420.77,-1.4,True,1,9443,-414.87,-1238239.34,3917617.41,2679378.07
16190,1992-07-14,417.68,2.81,0.68,420.77,-0.73,True,1,9444,-417.68,-1238657.02,3944569.92,2705912.9
16191,1992-07-15,417.1,-0.58,-0.14,420.77,-0.87,True,1,9445,-417.1,-1239074.12,3939509.5,2700435.38
16192,1992-07-16,417.54,0.44,0.1,420.77,-0.77,True,1,9446,-417.54,-1239491.66,3944082.84,2704591.18
16193,1992-07-17,415.62,-1.92,-0.46,420.77,-1.22,True,1,9447,-415.62,-1239907.28,3926362.14,2686454.86
16194,1992-07-20,413.75,-1.87,-0.45,420.77,-1.67,True,1,9448,-413.75,-1240321.03,3909110.0,2668788.97
16195,1992-07-21,413.76,0.01,0.0,420.77,-1.67,True,1,9449,-413.76,-1240734.79,3909618.24,2668883.45
16196,1992-07-22,410.93,-2.83,-0.68,420.77,-2.34,True,1,9450,-410.93,-1241145.72,3883288.5,2642142.78
16197,1992-07-23,412.08,1.15,0.28,420.77,-2.06,True,1,9451,-412.08,-1241557.8,3894568.08,2653010.28
16198,1992-07-24,411.6,-0.48,-0.12,420.77,-2.18,True,1,9452,-411.6,-1241969.4,3890443.2,2648473.8
16199,1992-07-27,411.54,-0.06,-0.02,420.77,-2.19,True,1,9453,-411.54,-1242380.94,3890287.62,2647906.68
16200,1992-07-28,417.52,5.98,1.45,420.77,-0.77,True,1,9454,-417.52,-1242798.46,3947234.08,2704435.62
16201,1992-07-29,422.23,4.71,1.13,422.23,0.0,True,1,9455,-422.23,-1243220.69,3992184.65,2748963.96
16202,1992-07-30,423.92,1.69,0.4,423.92,0.0,True,1,9456,-423.92,-1243644.61,4008587.52,2764942.91
16203,1992-07-31,424.21,0.29,0.07,424.21,0.0,True,1,9457,-424.21,-1244068.82,4011753.97,2767685.15
16204,1992-08-03,425.09,0.88,0.21,425.09,0.0,True,1,9458,-425.09,-1244493.91,4020501.22,2776007.31
16205,1992-08-04,424.36,-0.73,-0.17,425.09,-0.17,True,1,9459,-424.36,-1244918.27,4014021.24,2769102.97
16206,1992-08-05,422.19,-2.17,-0.51,425.09,-0.68,True,1,9460,-422.19,-1245340.46,3993917.4,2748576.94
16207,1992-08-06,420.59,-1.6,-0.38,425.09,-1.06,True,1,9461,-420.59,-1245761.05,3979201.99,2733440.94
16208,1992-08-07,418.88,-1.71,-0.41,425.09,-1.46,True,1,9462,-418.88,-1246179.93,3963442.56,2717262.63
16209,1992-08-10,419.42,0.54,0.13,425.09,-1.33,True,1,9463,-419.42,-1246599.35,3968971.46,2722372.11
16210,1992-08-11,418.9,-0.52,-0.12,425.09,-1.46,True,1,9464,-418.9,-1247018.25,3964469.6,2717451.35
16211,1992-08-12,417.78,-1.12,-0.27,425.09,-1.72,True,1,9465,-417.78,-1247436.03,3954287.7,2706851.67
16212,1992-08-13,417.73,-0.05,-0.01,425.09,-1.73,True,1,9466,-417.73,-1247853.76,3954232.18,2706378.42
16213,1992-08-14,419.91,2.18,0.52,425.09,-1.22,True,1,9467,-419.91,-1248273.67,3975287.97,2727014.3
16214,1992-08-17,420.74,0.83,0.2,425.09,-1.02,True,1,9468,-420.74,-1248694.41,3983566.32,2734871.91
16215,1992-08-18,421.34,0.6,0.14,425.09,-0.88,True,1,9469,-421.34,-1249115.75,3989668.46,2740552.71
16216,1992-08-19,418.19,-3.15,-0.75,425.09,-1.62,True,1,9470,-418.19,-1249533.94,3960259.3,2710725.36
16217,1992-08-20,418.26,0.07,0.02,425.09,-1.61,True,1,9471,-418.26,-1249952.2,3961340.46,2711388.26
16218,1992-08-21,414.85,-3.41,-0.82,425.09,-2.41,True,1,9472,-414.85,-1250367.05,3929459.2,2679092.15
16219,1992-08-24,410.72,-4.13,-1.0,425.09,-3.38,True,1,9473,-410.72,-1250777.77,3890750.56,2639972.79
16220,1992-08-25,411.61,0.89,0.22,425.09,-3.17,True,1,9474,-411.61,-1251189.38,3899593.14,2648403.76
16221,1992-08-26,413.51,1.9,0.46,425.09,-2.72,True,1,9475,-413.51,-1251602.89,3918007.25,2666404.36
16222,1992-08-27,413.53,0.02,0.0,425.09,-2.72,True,1,9476,-413.53,-1252016.42,3918610.28,2666593.86
16223,1992-08-28,414.84,1.31,0.32,425.09,-2.41,True,1,9477,-414.84,-1252431.26,3931438.68,2679007.42
16224,1992-08-31,414.03,-0.81,-0.2,425.09,-2.6,True,1,9478,-414.03,-1252845.29,3924176.34,2671331.05
16225,1992-09-01,416.07,2.04,0.49,425.09,-2.12,True,1,9479,-416.07,-1253261.36,3943927.53,2690666.17
16226,1992-09-02,417.98,1.91,0.46,425.09,-1.67,True,1,9480,-417.98,-1253679.34,3962450.4,2708771.06
16227,1992-09-03,417.98,0.0,0.0,425.09,-1.67,True,1,9481,-417.98,-1254097.32,3962868.38,2708771.06
16228,1992-09-04,417.08,-0.9,-0.22,425.09,-1.88,True,1,9482,-417.08,-1254514.4,3954752.56,2700238.16
16229,1992-09-08,414.44,-2.64,-0.63,425.09,-2.5,True,1,9483,-414.44,-1254928.84,3930134.52,2675205.68
16230,1992-09-09,416.36,1.92,0.46,425.09,-2.05,True,1,9484,-416.36,-1255345.2,3948758.24,2693413.04
16231,1992-09-10,419.95,3.59,0.86,425.09,-1.21,True,1,9485,-419.95,-1255765.15,3983225.75,2727460.6
16232,1992-09-11,419.58,-0.37,-0.09,425.09,-1.3,True,1,9486,-419.58,-1256184.73,3980135.88,2723951.15
16233,1992-09-14,425.27,5.69,1.36,425.27,0.0,True,1,9487,-425.27,-1256610.0,4034536.49,2777926.49
16234,1992-09-15,419.77,-5.5,-1.29,425.27,-1.29,True,1,9488,-419.77,-1257029.77,3982777.76,2725747.99
16235,1992-09-16,419.92,0.15,0.04,425.27,-1.26,True,1,9489,-419.92,-1257449.69,3984620.88,2727171.19
16236,1992-09-17,419.93,0.01,0.0,425.27,-1.26,True,1,9490,-419.93,-1257869.62,3985135.7,2727266.08
16237,1992-09-18,422.93,3.0,0.71,425.27,-0.55,True,1,9491,-422.93,-1258292.55,4014028.63,2755736.08
16238,1992-09-21,422.14,-0.79,-0.19,425.27,-0.74,True,1,9492,-422.14,-1258714.69,4006952.88,2748238.19
16239,1992-09-22,417.14,-5.0,-1.18,425.27,-1.91,True,1,9493,-417.14,-1259131.83,3959910.02,2700778.19
16240,1992-09-23,417.44,0.3,0.07,425.27,-1.84,True,1,9494,-417.44,-1259549.27,3963175.36,2703626.09
16241,1992-09-24,418.47,1.03,0.25,425.27,-1.6,True,1,9495,-418.47,-1259967.74,3973372.65,2713404.91
16242,1992-09-25,414.35,-4.12,-0.98,425.27,-2.57,True,1,9496,-414.35,-1260382.09,3934667.6,2674285.51
16243,1992-09-28,416.62,2.27,0.55,425.27,-2.03,True,1,9497,-416.62,-1260798.71,3956640.14,2695841.43
16244,1992-09-29,416.8,0.18,0.04,425.27,-1.99,True,1,9498,-416.8,-1261215.51,3958766.4,2697550.89
16245,1992-09-30,417.8,1.0,0.24,425.27,-1.76,True,1,9499,-417.8,-1261633.31,3968682.2,2707048.89
16246,1992-10-01,416.29,-1.51,-0.36,425.27,-2.11,True,1,9500,-416.29,-1262049.6,3954755.0,2692705.4
16247,1992-10-02,410.47,-5.82,-1.4,425.27,-3.48,True,1,9501,-410.47,-1262460.07,3899875.47,2637415.4
16248,1992-10-05,407.57,-2.9,-0.71,425.27,-4.16,True,1,9502,-407.57,-1262867.64,3872730.14,2609862.5
16249,1992-10-06,407.18,-0.39,-0.1,425.27,-4.25,True,1,9503,-407.18,-1263274.82,3869431.54,2606156.72
16250,1992-10-07,404.25,-2.93,-0.72,425.27,-4.94,True,1,9504,-404.25,-1263679.07,3841992.0,2578312.93
16251,1992-10-08,407.75,3.5,0.87,425.27,-4.12,True,1,9505,-407.75,-1264086.82,3875663.75,2611576.93
16252,1992-10-09,402.66,-5.09,-1.25,425.27,-5.32,True,1,9506,-402.66,-1264489.48,3827685.96,2563196.48
16253,1992-10-12,407.44,4.78,1.19,425.27,-4.19,True,1,9507,-407.44,-1264896.92,3873532.08,2608635.16
16254,1992-10-13,409.3,1.86,0.46,425.27,-3.76,True,1,9508,-409.3,-1265306.22,3891624.4,2626318.18
16255,1992-10-14,409.37,0.07,0.02,425.27,-3.74,True,1,9509,-409.37,-1265715.59,3892699.33,2626983.74
16256,1992-10-15,409.6,0.23,0.06,425.27,-3.68,True,1,9510,-409.6,-1266125.19,3895296.0,2629170.81
16257,1992-10-16,411.73,2.13,0.52,425.27,-3.18,True,1,9511,-411.73,-1266536.92,3915964.03,2649427.11
16258,1992-10-19,414.98,3.25,0.79,425.27,-2.42,True,1,9512,-414.98,-1266951.9,3947289.76,2680337.86
16259,1992-10-20,415.48,0.5,0.12,425.27,-2.3,True,1,9513,-415.48,-1267367.38,3952461.24,2685093.86
16260,1992-10-21,415.67,0.19,0.05,425.27,-2.26,True,1,9514,-415.67,-1267783.05,3954684.38,2686901.33
16261,1992-10-22,414.9,-0.77,-0.18,425.27,-2.44,True,1,9515,-414.9,-1268197.95,3947773.5,2679575.55
16262,1992-10-23,414.1,-0.8,-0.19,425.27,-2.63,True,1,9516,-414.1,-1268612.05,3940575.6,2671963.55
16263,1992-10-26,418.16,4.06,0.98,425.27,-1.67,True,1,9517,-418.16,-1269030.21,3979628.72,2710598.51
16264,1992-10-27,418.49,0.33,0.08,425.27,-1.59,True,1,9518,-418.49,-1269448.7,3983187.82,2713739.12
16265,1992-10-28,420.13,1.64,0.39,425.27,-1.21,True,1,9519,-420.13,-1269868.83,3999217.47,2729348.64
16266,1992-10-29,420.86,0.73,0.17,425.27,-1.04,True,1,9520,-420.86,-1270289.69,4006587.2,2736297.51
16267,1992-10-30,418.68,-2.18,-0.52,425.27,-1.55,True,1,9521,-418.68,-1270708.37,3986252.28,2715543.91
16268,1992-11-02,422.75,4.07,0.97,425.27,-0.59,True,1,9522,-422.75,-1271131.12,4025425.5,2754294.38
16269,1992-11-03,419.92,-2.83,-0.67,425.27,-1.26,True,1,9523,-419.92,-1271551.04,3998898.16,2727347.12
16270,1992-11-04,417.11,-2.81,-0.67,425.27,-1.92,True,1,9524,-417.11,-1271968.15,3972555.64,2700587.49
16271,1992-11-05,418.34,1.23,0.3,425.27,-1.63,True,1,9525,-418.34,-1272386.49,3984688.5,2712302.01
16272,1992-11-06,417.58,-0.76,-0.18,425.27,-1.81,True,1,9526,-417.58,-1272804.07,3977867.08,2705063.01
16273,1992-11-09,418.59,1.01,0.24,425.27,-1.57,True,1,9527,-418.59,-1273222.66,3987906.93,2714684.27
16274,1992-11-10,418.62,0.03,0.01,425.27,-1.56,True,1,9528,-418.62,-1273641.28,3988611.36,2714970.08
16275,1992-11-11,422.2,3.58,0.86,425.27,-0.72,True,1,9529,-422.2,-1274063.48,4023143.8,2749080.32
16276,1992-11-12,422.87,0.67,0.16,425.27,-0.56,True,1,9530,-422.87,-1274486.35,4029951.1,2755464.75
16277,1992-11-13,422.43,-0.44,-0.1,425.27,-0.67,True,1,9531,-422.43,-1274908.78,4026180.33,2751271.55
16278,1992-11-16,420.68,-1.75,-0.41,425.27,-1.08,True,1,9532,-420.68,-1275329.46,4009921.76,2734592.3
16279,1992-11-17,419.27,-1.41,-0.34,425.27,-1.41,True,1,9533,-419.27,-1275748.73,3996900.91,2721152.18
16280,1992-11-18,422.85,3.58,0.85,425.27,-0.57,True,1,9534,-422.85,-1276171.58,4031451.9,2755280.32
16281,1992-11-19,423.61,0.76,0.18,425.27,-0.39,True,1,9535,-423.61,-1276595.19,4039121.35,2762526.16
16282,1992-11-20,426.65,3.04,0.72,426.65,0.0,True,1,9536,-426.65,-1277021.84,4068534.4,2791512.56
16283,1992-11-23,425.12,-1.53,-0.36,426.65,-0.36,True,1,9537,-425.12,-1277446.96,4054369.44,2776922.48
16284,1992-11-24,427.59,2.47,0.58,427.59,0.0,True,1,9538,-427.59,-1277874.55,4078353.42,2800478.87
16285,1992-11-25,429.19,1.6,0.37,429.19,0.0,True,1,9539,-429.19,-1278303.74,4094043.41,2815739.67
16286,1992-11-27,430.16,0.97,0.23,430.16,0.0,True,1,9540,-430.16,-1278733.9,4103726.4,2824992.5
16287,1992-11-30,431.35,1.19,0.28,431.35,0.0,True,1,9541,-431.35,-1279165.25,4115510.35,2836345.1
16288,1992-12-01,430.78,-0.57,-0.13,431.35,-0.13,True,1,9542,-430.78,-1279596.03,4110502.76,2830906.73
16289,1992-12-02,429.89,-0.89,-0.21,431.35,-0.34,True,1,9543,-429.89,-1280025.92,4102440.27,2822414.35
16290,1992-12-03,429.91,0.02,0.0,431.35,-0.33,True,1,9544,-429.91,-1280455.83,4103061.04,2822605.21
16291,1992-12-04,432.06,2.15,0.5,432.06,0.0,True,1,9545,-432.06,-1280887.89,4124012.7,2843124.81
16292,1992-12-07,435.31,3.25,0.75,435.31,0.0,True,1,9546,-435.31,-1281323.2,4155469.26,2874146.06
16293,1992-12-08,436.99,1.68,0.39,436.99,0.0,True,1,9547,-436.99,-1281760.19,4171943.53,2890183.34
16294,1992-12-09,435.65,-1.34,-0.31,436.99,-0.31,True,1,9548,-435.65,-1282195.84,4159586.2,2877390.36
16295,1992-12-10,434.64,-1.01,-0.23,436.99,-0.54,True,1,9549,-434.64,-1282630.48,4150377.36,2867746.88
16296,1992-12-11,433.73,-0.91,-0.21,436.99,-0.75,True,1,9550,-433.73,-1283064.21,4142121.5,2859057.29
16297,1992-12-14,432.84,-0.89,-0.2,436.99,-0.95,True,1,9551,-432.84,-1283497.05,4134054.84,2850557.79
16298,1992-12-15,432.57,-0.27,-0.06,436.99,-1.01,True,1,9552,-432.57,-1283929.62,4131908.64,2847979.02
16299,1992-12-16,431.52,-1.05,-0.24,436.99,-1.25,True,1,9553,-431.52,-1284361.14,4122310.56,2837949.42
16300,1992-12-17,435.43,3.91,0.91,436.99,-0.36,True,1,9554,-435.43,-1284796.57,4160098.22,2875301.65
16301,1992-12-18,441.28,5.85,1.34,441.28,0.0,True,1,9555,-441.28,-1285237.85,4216430.4,2931192.55
16302,1992-12-21,440.7,-0.58,-0.13,441.28,-0.13,True,1,9556,-440.7,-1285678.55,4211329.2,2925650.65
16303,1992-12-22,440.31,-0.39,-0.09,441.28,-0.22,True,1,9557,-440.31,-1286118.86,4208042.67,2921923.81
16304,1992-12-23,439.03,-1.28,-0.29,441.28,-0.51,True,1,9558,-439.03,-1286557.89,4196248.74,2909690.85
16305,1992-12-24,439.77,0.74,0.17,441.28,-0.34,True,1,9559,-439.77,-1286997.66,4203761.43,2916763.77
16306,1992-12-28,439.15,-0.62,-0.14,441.28,-0.48,True,1,9560,-439.15,-1287436.81,4198274.0,2910837.19
16307,1992-12-29,437.98,-1.17,-0.27,441.28,-0.75,True,1,9561,-437.98,-1287874.79,4187526.78,2899651.99
16308,1992-12-30,438.82,0.84,0.19,441.28,-0.56,True,1,9562,-438.82,-1288313.61,4195996.84,2907683.23
16309,1992-12-31,435.71,-3.11,-0.71,441.28,-1.26,True,1,9563,-435.71,-1288749.32,4166694.73,2877945.41
16310,1993-01-04,435.38,-0.33,-0.08,441.28,-1.34,True,1,9564,-435.38,-1289184.7,4163974.32,2874789.62
16311,1993-01-05,434.34,-1.04,-0.24,441.28,-1.57,True,1,9565,-434.34,-1289619.04,4154462.1,2864843.06
16312,1993-01-06,434.52,0.18,0.04,441.28,-1.53,True,1,9566,-434.52,-1290053.56,4156618.32,2866564.76
16313,1993-01-07,430.73,-3.79,-0.87,441.28,-2.39,True,1,9567,-430.73,-1290484.29,4120793.91,2830309.62
16314,1993-01-08,429.05,-1.68,-0.39,441.28,-2.77,True,1,9568,-429.05,-1290913.34,4105150.4,2814237.06
16315,1993-01-11,430.95,1.9,0.44,441.28,-2.34,True,1,9569,-430.95,-1291344.29,4123760.55,2832416.26
16316,1993-01-12,431.04,0.09,0.02,441.28,-2.32,True,1,9570,-431.04,-1291775.33,4125052.8,2833277.47
16317,1993-01-13,433.03,1.99,0.46,441.28,-1.87,True,1,9571,-433.03,-1292208.36,4144530.13,2852321.77
16318,1993-01-14,435.94,2.91,0.67,441.28,-1.21,True,1,9572,-435.94,-1292644.3,4172817.68,2880173.38
16319,1993-01-15,437.15,1.21,0.28,441.28,-0.94,True,1,9573,-437.15,-1293081.45,4184836.95,2891755.5
16320,1993-01-18,436.84,-0.31,-0.07,441.28,-1.01,True,1,9574,-436.84,-1293518.29,4182306.16,2888787.87
16321,1993-01-19,435.13,-1.71,-0.39,441.28,-1.39,True,1,9575,-435.13,-1293953.42,4166369.75,2872416.33
16322,1993-01-20,433.37,-1.76,-0.4,441.28,-1.79,True,1,9576,-433.37,-1294386.79,4149951.12,2855564.33
16323,1993-01-21,435.49,2.12,0.49,441.28,-1.31,True,1,9577,-435.49,-1294822.28,4170687.73,2875865.45
16324,1993-01-22,436.11,0.62,0.14,441.28,-1.17,True,1,9578,-436.11,-1295258.39,4177061.58,2881803.19
16325,1993-01-25,440.01,3.9,0.89,441.28,-0.29,True,1,9579,-440.01,-1295698.4,4214855.79,2919157.39
16326,1993-01-26,439.95,-0.06,-0.01,441.28,-0.3,True,1,9580,-439.95,-1296138.35,4214721.0,2918582.65
16327,1993-01-27,438.11,-1.84,-0.42,441.28,-0.72,True,1,9581,-438.11,-1296576.46,4197531.91,2900955.45
16328,1993-01-28,438.66,0.55,0.13,441.28,-0.59,True,1,9582,-438.66,-1297015.12,4203240.12,2906225.0
16329,1993-01-29,438.78,0.12,0.03,441.28,-0.57,True,1,9583,-438.78,-1297453.9,4204828.74,2907374.84
16330,1993-02-01,442.52,3.74,0.85,442.52,0.0,True,1,9584,-442.52,-1297896.42,4241111.68,2943215.26
16331,1993-02-02,442.55,0.03,0.01,442.55,0.0,True,1,9585,-442.55,-1298338.97,4241841.75,2943502.78
16332,1993-02-03,447.2,4.65,1.05,447.2,0.0,True,1,9586,-447.2,-1298786.17,4286859.2,2988073.03
16333,1993-02-04,449.56,2.36,0.53,449.56,0.0,True,1,9587,-449.56,-1299235.73,4309931.72,3010695.99
16334,1993-02-05,448.93,-0.63,-0.14,449.56,-0.14,True,1,9588,-448.93,-1299684.66,4304340.84,3004656.18
16335,1993-02-08,447.85,-1.08,-0.24,449.56,-0.38,True,1,9589,-447.85,-1300132.51,4294433.65,2994301.14
16336,1993-02-09,445.33,-2.52,-0.56,449.56,-0.94,True,1,9590,-445.33,-1300577.84,4270714.7,2970136.86
16337,1993-02-10,446.23,0.9,0.2,449.56,-0.74,True,1,9591,-446.23,-1301024.07,4279791.93,2978767.86
16338,1993-02-11,447.66,1.43,0.32,449.56,-0.42,True,1,9592,-447.66,-1301471.73,4293954.72,2992482.99
16339,1993-02-12,444.58,-3.08,-0.69,449.56,-1.11,True,1,9593,-444.58,-1301916.31,4264855.94,2962939.63
16340,1993-02-16,433.91,-10.67,-2.4,449.56,-3.48,True,1,9594,-433.91,-1302350.22,4162932.54,2860582.32
16341,1993-02-17,433.3,-0.61,-0.14,449.56,-3.62,True,1,9595,-433.3,-1302783.52,4157513.5,2854729.98
16342,1993-02-18,431.9,-1.4,-0.32,449.56,-3.93,True,1,9596,-431.9,-1303215.42,4144512.4,2841296.98
16343,1993-02-19,434.22,2.32,0.54,449.56,-3.41,True,1,9597,-434.22,-1303649.64,4167209.34,2863559.7
16344,1993-02-22,435.24,1.02,0.24,449.56,-3.18,True,1,9598,-435.24,-1304084.88,4177433.52,2873348.64
16345,1993-02-23,434.8,-0.44,-0.1,449.56,-3.28,True,1,9599,-434.8,-1304519.68,4173645.2,2869125.52
16346,1993-02-24,440.87,6.07,1.4,449.56,-1.93,True,1,9600,-440.87,-1304960.55,4232352.0,2927391.45
16347,1993-02-25,442.34,1.47,0.33,449.56,-1.61,True,1,9601,-442.34,-1305402.89,4246906.34,2941503.45
16348,1993-02-26,443.38,1.04,0.24,449.56,-1.38,True,1,9602,-443.38,-1305846.27,4257334.76,2951488.49
16349,1993-03-01,442.01,-1.37,-0.31,449.56,-1.68,True,1,9603,-442.01,-1306288.28,4244622.03,2938333.75
16350,1993-03-02,447.9,5.89,1.33,449.56,-0.37,True,1,9604,-447.9,-1306736.18,4301631.6,2994895.42
16351,1993-03-03,449.26,1.36,0.3,449.56,-0.07,True,1,9605,-449.26,-1307185.44,4315142.3,3007956.86
16352,1993-03-04,447.34,-1.92,-0.43,449.56,-0.49,True,1,9606,-447.34,-1307632.78,4297148.04,2989515.26
16353,1993-03-05,446.11,-1.23,-0.28,449.56,-0.77,True,1,9607,-446.11,-1308078.89,4285778.77,2977699.88
16354,1993-03-08,454.71,8.6,1.93,454.71,0.0,True,1,9608,-454.71,-1308533.6,4368853.68,3060320.08
16355,1993-03-09,454.4,-0.31,-0.07,454.71,-0.07,True,1,9609,-454.4,-1308988.0,4366329.6,3057341.6
16356,1993-03-10,456.33,1.93,0.42,456.33,0.0,True,1,9610,-456.33,-1309444.33,4385331.3,3075886.97
16357,1993-03-11,453.72,-2.61,-0.57,456.33,-0.57,True,1,9611,-453.72,-1309898.05,4360702.92,3050804.87
16358,1993-03-12,449.83,-3.89,-0.86,456.33,-1.42,True,1,9612,-449.83,-1310347.88,4323765.96,3013418.08
16359,1993-03-15,451.43,1.6,0.36,456.33,-1.07,True,1,9613,-451.43,-1310799.31,4339596.59,3028797.28
16360,1993-03-16,451.37,-0.06,-0.01,456.33,-1.09,True,1,9614,-451.37,-1311250.68,4339471.18,3028220.5
16361,1993-03-17,448.31,-3.06,-0.68,456.33,-1.76,True,1,9615,-448.31,-1311698.99,4310500.65,2998801.66
16362,1993-03-18,451.89,3.58,0.8,456.33,-0.97,True,1,9616,-451.89,-1312150.88,4345374.24,3033223.36
16363,1993-03-19,450.18,-1.71,-0.38,456.33,-1.35,True,1,9617,-450.18,-1312601.06,4329381.06,3016780.0
16364,1993-03-22,448.88,-1.3,-0.29,456.33,-1.63,True,1,9618,-448.88,-1313049.94,4317327.84,3004277.9
16365,1993-03-23,448.76,-0.12,-0.03,456.33,-1.66,True,1,9619,-448.76,-1313498.7,4316622.44,3003123.74
16366,1993-03-24,448.07,-0.69,-0.15,456.33,-1.81,True,1,9620,-448.07,-1313946.77,4310433.4,2996486.63
16367,1993-03-25,450.88,2.81,0.63,456.33,-1.19,True,1,9621,-450.88,-1314397.65,4337916.48,3023518.83
16368,1993-03-26,447.78,-3.1,-0.69,456.33,-1.87,True,1,9622,-447.78,-1314845.43,4308539.16,2993693.73
16369,1993-03-29,450.77,2.99,0.67,456.33,-1.22,True,1,9623,-450.77,-1315296.2,4337759.71,3022463.51
16370,1993-03-30,451.97,1.2,0.27,456.33,-0.96,True,1,9624,-451.97,-1315748.17,4349759.28,3034011.11
16371,1993-03-31,451.67,-0.3,-0.07,456.33,-1.02,True,1,9625,-451.67,-1316199.84,4347323.75,3031123.91
16372,1993-04-01,450.3,-1.37,-0.3,456.33,-1.32,True,1,9626,-450.3,-1316650.14,4334587.8,3017937.66
16373,1993-04-02,441.39,-8.91,-1.98,456.33,-3.27,True,1,9627,-441.39,-1317091.53,4249261.53,2932170.0
16374,1993-04-05,442.29,0.9,0.2,456.33,-3.08,True,1,9628,-442.29,-1317533.82,4258368.12,2940834.3
16375,1993-04-06,441.16,-1.13,-0.26,456.33,-3.32,True,1,9629,-441.16,-1317974.98,4247929.64,2929954.66
16376,1993-04-07,442.73,1.57,0.36,456.33,-2.98,True,1,9630,-442.73,-1318417.71,4263489.9,2945072.19
16377,1993-04-08,441.84,-0.89,-0.2,456.33,-3.18,True,1,9631,-441.84,-1318859.55,4255361.04,2936501.49
16378,1993-04-12,448.37,6.53,1.48,456.33,-1.74,True,1,9632,-448.37,-1319307.92,4318699.84,2999391.92
16379,1993-04-13,449.22,0.85,0.19,456.33,-1.56,True,1,9633,-449.22,-1319757.14,4327336.26,3007579.12
16380,1993-04-14,448.66,-0.56,-0.12,456.33,-1.68,True,1,9634,-448.66,-1320205.8,4322390.44,3002184.64
16381,1993-04-15,448.4,-0.26,-0.06,456.33,-1.74,True,1,9635,-448.4,-1320654.2,4320334.0,2999679.8
16382,1993-04-16,448.94,0.54,0.12,456.33,-1.62,True,1,9636,-448.94,-1321103.14,4325985.84,3004882.7
16383,1993-04-19,447.46,-1.48,-0.33,456.33,-1.94,True,1,9637,-447.46,-1321550.6,4312172.02,2990621.42
16384,1993-04-20,445.1,-2.36,-0.53,456.33,-2.46,True,1,9638,-445.1,-1321995.7,4289873.8,2967878.1
16385,1993-04-21,443.63,-1.47,-0.33,456.33,-2.78,True,1,9639,-443.63,-1322439.33,4276149.57,2953710.24
16386,1993-04-22,439.46,-4.17,-0.94,456.33,-3.7,True,1,9640,-439.46,-1322878.79,4236394.4,2913515.61
16387,1993-04-23,437.03,-2.43,-0.55,456.33,-4.23,True,1,9641,-437.03,-1323315.82,4213406.23,2890090.41
16388,1993-04-26,433.54,-3.49,-0.8,456.33,-4.99,True,1,9642,-433.54,-1323749.36,4180192.68,2856443.32
16389,1993-04-27,438.01,4.47,1.03,456.33,-4.01,True,1,9643,-438.01,-1324187.37,4223730.43,2899543.06
16390,1993-04-28,438.02,0.01,0.0,456.33,-4.01,True,1,9644,-438.02,-1324625.39,4224264.88,2899639.49
16391,1993-04-29,438.89,0.87,0.2,456.33,-3.82,True,1,9645,-438.89,-1325064.28,4233094.05,2908029.77
16392,1993-04-30,440.19,1.3,0.3,456.33,-3.54,True,1,9646,-440.19,-1325504.47,4246072.74,2920568.27
16393,1993-05-03,442.46,2.27,0.52,456.33,-3.04,True,1,9647,-442.46,-1325946.93,4268411.62,2942464.69
16394,1993-05-04,444.05,1.59,0.36,456.33,-2.69,True,1,9648,-444.05,-1326390.98,4284194.4,2957803.42
16395,1993-05-05,444.52,0.47,0.11,456.33,-2.59,True,1,9649,-444.52,-1326835.5,4289173.48,2962337.98
16396,1993-05-06,443.26,-1.26,-0.28,456.33,-2.86,True,1,9650,-443.26,-1327278.76,4277459.0,2950180.24
16397,1993-05-07,442.31,-0.95,-0.21,456.33,-3.07,True,1,9651,-442.31,-1327721.07,4268733.81,2941012.74
16398,1993-05-10,442.8,0.49,0.11,456.33,-2.96,True,1,9652,-442.8,-1328163.87,4273905.6,2945741.73
16399,1993-05-11,444.36,1.56,0.35,456.33,-2.62,True,1,9653,-444.36,-1328608.23,4289407.08,2960798.85
16400,1993-05-12,444.8,0.44,0.1,456.33,-2.53,True,1,9654,-444.8,-1329053.03,4294099.2,2965046.17
16401,1993-05-13,439.23,-5.57,-1.25,456.33,-3.75,True,1,9655,-439.23,-1329492.26,4240765.65,2911273.39
16402,1993-05-14,439.56,0.33,0.08,456.33,-3.68,True,1,9656,-439.56,-1329931.82,4244391.36,2914459.54
16403,1993-05-17,440.37,0.81,0.18,456.33,-3.5,True,1,9657,-440.37,-1330372.19,4252653.09,2922280.9
16404,1993-05-18,440.32,-0.05,-0.01,456.33,-3.51,True,1,9658,-440.32,-1330812.51,4252610.56,2921798.05
16405,1993-05-19,447.57,7.25,1.65,456.33,-1.92,True,1,9659,-447.57,-1331260.08,4323078.63,2991818.55
16406,1993-05-20,450.59,3.02,0.68,456.33,-1.26,True,1,9660,-450.59,-1331710.67,4352699.4,3020988.73
16407,1993-05-21,445.84,-4.75,-1.05,456.33,-2.3,True,1,9661,-445.84,-1332156.51,4307260.24,2975103.73
16408,1993-05-24,448.0,2.16,0.48,456.33,-1.82,True,1,9662,-448.0,-1332604.51,4328576.0,2995971.49
16409,1993-05-25,448.85,0.85,0.19,456.33,-1.64,True,1,9663,-448.85,-1333053.36,4337237.55,3004184.19
16410,1993-05-26,453.44,4.59,1.02,456.33,-0.63,True,1,9664,-453.44,-1333506.8,4382044.16,3048537.36
16411,1993-05-27,452.41,-1.03,-0.23,456.33,-0.86,True,1,9665,-452.41,-1333959.21,4372542.65,3038583.44
16412,1993-05-28,450.19,-2.22,-0.49,456.33,-1.35,True,1,9666,-450.19,-1334409.4,4351536.54,3017127.14
16413,1993-06-01,453.83,3.64,0.81,456.33,-0.55,True,1,9667,-453.83,-1334863.23,4387174.61,3052311.38
16414,1993-06-02,453.85,0.02,0.0,456.33,-0.54,True,1,9668,-453.85,-1335317.08,4387821.8,3052504.72
16415,1993-06-03,452.49,-1.36,-0.3,456.33,-0.84,True,1,9669,-452.49,-1335769.57,4375125.81,3039356.24
16416,1993-06-04,450.06,-2.43,-0.54,456.33,-1.37,True,1,9670,-450.06,-1336219.63,4352080.2,3015860.57
16417,1993-06-07,447.69,-2.37,-0.53,456.33,-1.89,True,1,9671,-447.69,-1336667.32,4329609.99,2992942.67
16418,1993-06-08,444.71,-2.98,-0.67,456.33,-2.55,True,1,9672,-444.71,-1337112.03,4301235.12,2964123.09
16419,1993-06-09,445.78,1.07,0.24,456.33,-2.31,True,1,9673,-445.78,-1337557.81,4312029.94,2974472.13
16420,1993-06-10,445.38,-0.4,-0.09,456.33,-2.4,True,1,9674,-445.38,-1338003.19,4308606.12,2970602.93
16421,1993-06-11,447.26,1.88,0.42,456.33,-1.99,True,1,9675,-447.26,-1338450.45,4327240.5,2988790.05
16422,1993-06-14,447.71,0.45,0.1,456.33,-1.89,True,1,9676,-447.71,-1338898.16,4332041.96,2993143.8
16423,1993-06-15,446.27,-1.44,-0.32,456.33,-2.2,True,1,9677,-446.27,-1339344.43,4318554.79,2979210.36
16424,1993-06-16,447.43,1.16,0.26,456.33,-1.95,True,1,9678,-447.43,-1339791.86,4330227.54,2990435.68
16425,1993-06-17,448.54,1.11,0.25,456.33,-1.71,True,1,9679,-448.54,-1340240.4,4341418.66,3001178.26
16426,1993-06-18,443.68,-4.86,-1.08,456.33,-2.77,True,1,9680,-443.68,-1340684.08,4294822.4,2954138.32
16427,1993-06-21,446.22,2.54,0.57,456.33,-2.22,True,1,9681,-446.22,-1341130.3,4319855.82,2978725.52
16428,1993-06-22,445.93,-0.29,-0.06,456.33,-2.28,True,1,9682,-445.93,-1341576.23,4317494.26,2975918.03
16429,1993-06-23,443.19,-2.74,-0.61,456.33,-2.88,True,1,9683,-443.19,-1342019.42,4291408.77,2949389.35
16430,1993-06-24,446.62,3.43,0.77,456.33,-2.13,True,1,9684,-446.62,-1342466.04,4325068.08,2982602.04
16431,1993-06-25,447.6,0.98,0.22,456.33,-1.91,True,1,9685,-447.6,-1342913.64,4335006.0,2992092.36
16432,1993-06-28,451.85,4.25,0.95,456.33,-0.98,True,1,9686,-451.85,-1343365.49,4376619.1,3033253.61
16433,1993-06-29,450.69,-1.16,-0.26,456.33,-1.24,True,1,9687,-450.69,-1343816.18,4365834.03,3022017.85
16434,1993-06-30,450.53,-0.16,-0.04,456.33,-1.27,True,1,9688,-450.53,-1344266.71,4364734.64,3020467.93
16435,1993-07-01,449.02,-1.51,-0.34,456.33,-1.6,True,1,9689,-449.02,-1344715.73,4350554.78,3005839.05
16436,1993-07-02,445.84,-3.18,-0.71,456.33,-2.3,True,1,9690,-445.84,-1345161.57,4320189.6,2975028.03
16437,1993-07-06,441.43,-4.41,-0.99,456.33,-3.26,True,1,9691,-441.43,-1345603.0,4277898.13,2932295.13
16438,1993-07-07,442.83,1.4,0.32,456.33,-2.96,True,1,9692,-442.83,-1346045.83,4291908.36,2945862.53
16439,1993-07-08,448.64,5.81,1.31,456.33,-1.68,True,1,9693,-448.64,-1346494.47,4348667.52,3002173.05
16440,1993-07-09,448.11,-0.53,-0.12,456.33,-1.8,True,1,9694,-448.11,-1346942.58,4343978.34,2997035.76
16441,1993-07-12,448.98,0.87,0.19,456.33,-1.61,True,1,9695,-448.98,-1347391.56,4352861.1,3005469.54
16442,1993-07-13,448.09,-0.89,-0.2,456.33,-1.81,True,1,9696,-448.09,-1347839.65,4344680.64,2996840.99
16443,1993-07-14,450.08,1.99,0.44,456.33,-1.37,True,1,9697,-450.08,-1348289.73,4364425.76,3016136.03
16444,1993-07-15,449.22,-0.86,-0.19,456.33,-1.56,True,1,9698,-449.22,-1348738.95,4356535.56,3007796.61
16445,1993-07-16,445.75,-3.47,-0.77,456.33,-2.32,True,1,9699,-445.75,-1349184.7,4323329.25,2974144.55
16446,1993-07-19,446.03,0.28,0.06,456.33,-2.26,True,1,9700,-446.03,-1349630.73,4326491.0,2976860.27
16447,1993-07-20,447.31,1.28,0.29,456.33,-1.98,True,1,9701,-447.31,-1350078.04,4339354.31,2989276.27
16448,1993-07-21,447.18,-0.13,-0.03,456.33,-2.0,True,1,9702,-447.18,-1350525.22,4338540.36,2988015.14
16449,1993-07-22,444.51,-2.67,-0.6,456.33,-2.59,True,1,9703,-444.51,-1350969.73,4313080.53,2962110.8
16450,1993-07-23,447.1,2.59,0.58,456.33,-2.02,True,1,9704,-447.1,-1351416.83,4338658.4,2987241.57
16451,1993-07-26,449.09,1.99,0.44,456.33,-1.59,True,1,9705,-449.09,-1351865.92,4358418.45,3006552.53
16452,1993-07-27,448.24,-0.85,-0.19,456.33,-1.77,True,1,9706,-448.24,-1352314.16,4350617.44,2998303.28
16453,1993-07-28,447.19,-1.05,-0.23,456.33,-2.0,True,1,9707,-447.19,-1352761.35,4340873.33,2988111.98
16454,1993-07-29,450.24,3.05,0.68,456.33,-1.34,True,1,9708,-450.24,-1353211.59,4370929.92,3017718.33
16455,1993-07-30,448.13,-2.11,-0.47,456.33,-1.8,True,1,9709,-448.13,-1353659.72,4350894.17,2997234.45
16456,1993-08-02,450.15,2.02,0.45,456.33,-1.35,True,1,9710,-450.15,-1354109.87,4370956.5,3016846.63
16457,1993-08-03,449.27,-0.88,-0.2,456.33,-1.55,True,1,9711,-449.27,-1354559.14,4362860.97,3008301.83
16458,1993-08-04,448.54,-0.73,-0.16,456.33,-1.71,True,1,9712,-448.54,-1355007.68,4356220.48,3001212.8
16459,1993-08-05,448.13,-0.41,-0.09,456.33,-1.8,True,1,9713,-448.13,-1355455.81,4352686.69,2997230.88
16460,1993-08-06,448.68,0.55,0.12,456.33,-1.68,True,1,9714,-448.68,-1355904.49,4358477.52,3002573.03
16461,1993-08-09,450.72,2.04,0.46,456.33,-1.23,True,1,9715,-450.72,-1356355.21,4378744.8,3022389.59
16462,1993-08-10,449.45,-1.27,-0.28,456.33,-1.51,True,1,9716,-449.45,-1356804.66,4366856.2,3010051.54
16463,1993-08-11,450.46,1.01,0.22,456.33,-1.29,True,1,9717,-450.46,-1357255.12,4377119.82,3019864.7
16464,1993-08-12,448.96,-1.5,-0.33,456.33,-1.62,True,1,9718,-448.96,-1357704.08,4362993.28,3005289.2
16465,1993-08-13,450.14,1.18,0.26,456.33,-1.36,True,1,9719,-450.14,-1358154.22,4374910.66,3016756.44
16466,1993-08-16,452.38,2.24,0.5,456.33,-0.87,True,1,9720,-452.38,-1358606.6,4397133.6,3038527.0
16467,1993-08-17,453.13,0.75,0.17,456.33,-0.7,True,1,9721,-453.13,-1359059.73,4404876.73,3045817.0
16468,1993-08-18,456.04,2.91,0.64,456.33,-0.06,True,1,9722,-456.04,-1359515.77,4433620.88,3074105.11
16469,1993-08-19,456.43,0.39,0.09,456.43,0.0,True,1,9723,-456.43,-1359972.2,4437868.89,3077896.69
16470,1993-08-20,456.16,-0.27,-0.06,456.43,-0.06,True,1,9724,-456.16,-1360428.36,4435699.84,3075271.48
16471,1993-08-23,455.23,-0.93,-0.2,456.43,-0.26,True,1,9725,-455.23,-1360883.59,4427111.75,3066228.16
16472,1993-08-24,459.77,4.54,1.0,459.77,0.0,True,1,9726,-459.77,-1361343.36,4471723.02,3110379.66
16473,1993-08-25,460.13,0.36,0.08,460.13,0.0,True,1,9727,-460.13,-1361803.49,4475684.51,3113881.02
16474,1993-08-26,461.04,0.91,0.2,461.04,0.0,True,1,9728,-461.04,-1362264.53,4484997.12,3122732.59
16475,1993-08-27,460.54,-0.5,-0.11,461.04,-0.11,True,1,9729,-460.54,-1362725.07,4480593.66,3117868.59
16476,1993-08-30,461.9,1.36,0.3,461.9,0.0,True,1,9730,-461.9,-1363186.97,4494287.0,3131100.03
16477,1993-08-31,463.56,1.66,0.36,463.56,0.0,True,1,9731,-463.56,-1363650.53,4510902.36,3147251.83
16478,1993-09-01,463.15,-0.41,-0.09,463.56,-0.09,True,1,9732,-463.15,-1364113.68,4507375.8,3143262.12
16479,1993-09-02,461.3,-1.85,-0.4,463.56,-0.49,True,1,9733,-461.3,-1364574.98,4489832.9,3125257.92
16480,1993-09-03,461.34,0.04,0.01,463.56,-0.48,True,1,9734,-461.34,-1365036.32,4490683.56,3125647.24
16481,1993-09-07,458.52,-2.82,-0.61,463.56,-1.09,True,1,9735,-458.52,-1365494.84,4463692.2,3098197.36
16482,1993-09-08,456.65,-1.87,-0.41,463.56,-1.49,True,1,9736,-456.65,-1365951.49,4445944.4,3079992.91
16483,1993-09-09,457.5,0.85,0.19,463.56,-1.31,True,1,9737,-457.5,-1366408.99,4454677.5,3088268.51
16484,1993-09-10,461.72,4.22,0.92,463.56,-0.4,True,1,9738,-461.72,-1366870.71,4496229.36,3129358.65
16485,1993-09-13,462.06,0.34,0.07,463.56,-0.32,True,1,9739,-462.06,-1367332.77,4500002.34,3132669.57
16486,1993-09-14,459.9,-2.16,-0.47,463.56,-0.79,True,1,9740,-459.9,-1367792.67,4479426.0,3111633.33
16487,1993-09-15,461.6,1.7,0.37,463.56,-0.42,True,1,9741,-461.6,-1368254.27,4496445.6,3128191.33
16488,1993-09-16,459.43,-2.17,-0.47,463.56,-0.89,True,1,9742,-459.43,-1368713.7,4475767.06,3107053.36
16489,1993-09-17,458.83,-0.6,-0.13,463.56,-1.02,True,1,9743,-458.83,-1369172.53,4470380.69,3101208.16
16490,1993-09-20,455.05,-3.78,-0.82,463.56,-1.84,True,1,9744,-455.05,-1369627.58,4434007.2,3064379.62
16491,1993-09-21,452.95,-2.1,-0.46,463.56,-2.29,True,1,9745,-452.95,-1370080.53,4413997.75,3043917.22
16492,1993-09-22,456.2,3.25,0.72,463.56,-1.59,True,1,9746,-456.2,-1370536.73,4446125.2,3075588.47
16493,1993-09-23,457.74,1.54,0.34,463.56,-1.26,True,1,9747,-457.74,-1370994.47,4461591.78,3090597.31
16494,1993-09-24,457.63,-0.11,-0.02,463.56,-1.28,True,1,9748,-457.63,-1371452.1,4460977.24,3089525.14
16495,1993-09-27,461.8,4.17,0.91,463.56,-0.38,True,1,9749,-461.8,-1371913.9,4502088.2,3130174.3
16496,1993-09-28,461.53,-0.27,-0.06,463.56,-0.44,True,1,9750,-461.53,-1372375.43,4499917.5,3127542.07
16497,1993-09-29,460.11,-1.42,-0.31,463.56,-0.74,True,1,9751,-460.11,-1372835.54,4486532.61,3113697.07
16498,1993-09-30,458.93,-1.18,-0.26,463.56,-1.0,True,1,9752,-458.93,-1373294.47,4475485.36,3102190.89
16499,1993-10-01,461.28,2.35,0.51,463.56,-0.49,True,1,9753,-461.28,-1373755.75,4498863.84,3125108.09
16500,1993-10-04,461.34,0.06,0.01,463.56,-0.48,True,1,9754,-461.34,-1374217.09,4499910.36,3125693.27
16501,1993-10-05,461.2,-0.14,-0.03,463.56,-0.51,True,1,9755,-461.2,-1374678.29,4499006.0,3124327.71
16502,1993-10-06,460.74,-0.46,-0.1,463.56,-0.61,True,1,9756,-460.74,-1375139.03,4494979.44,3119840.41
16503,1993-10-07,459.18,-1.56,-0.34,463.56,-0.94,True,1,9757,-459.18,-1375598.21,4480219.26,3104621.05
16504,1993-10-08,460.31,1.13,0.25,463.56,-0.7,True,1,9758,-460.31,-1376058.52,4491704.98,3115646.46
16505,1993-10-11,460.88,0.57,0.12,463.56,-0.58,True,1,9759,-460.88,-1376519.4,4497727.92,3121208.52
16506,1993-10-12,461.12,0.24,0.05,463.56,-0.53,True,1,9760,-461.12,-1376980.52,4500531.2,3123550.68
16507,1993-10-13,461.49,0.37,0.08,463.56,-0.45,True,1,9761,-461.49,-1377442.01,4504603.89,3127161.88
16508,1993-10-14,466.83,5.34,1.16,466.83,0.0,True,1,9762,-466.83,-1377908.84,4557194.46,3179285.62
16509,1993-10-15,469.5,2.67,0.57,469.5,0.0,True,1,9763,-469.5,-1378378.34,4583728.5,3205350.16
16510,1993-10-18,468.45,-1.05,-0.22,469.5,-0.22,True,1,9764,-468.45,-1378846.79,4573945.8,3195099.01
16511,1993-10-19,466.21,-2.24,-0.48,469.5,-0.7,True,1,9765,-466.21,-1379313.0,4552540.65,3173227.65
16512,1993-10-20,466.07,-0.14,-0.03,469.5,-0.73,True,1,9766,-466.07,-1379779.07,4551639.62,3171860.55
16513,1993-10-21,465.36,-0.71,-0.15,469.5,-0.88,True,1,9767,-465.36,-1380244.43,4545171.12,3164926.69
16514,1993-10-22,463.27,-2.09,-0.45,469.5,-1.33,True,1,9768,-463.27,-1380707.7,4525221.36,3144513.66
16515,1993-10-25,464.2,0.93,0.2,469.5,-1.13,True,1,9769,-464.2,-1381171.9,4534769.8,3153597.9
16516,1993-10-26,464.3,0.1,0.02,469.5,-1.11,True,1,9770,-464.3,-1381636.2,4536211.0,3154574.8
16517,1993-10-27,464.61,0.31,0.07,469.5,-1.04,True,1,9771,-464.61,-1382100.81,4539704.31,3157603.5
16518,1993-10-28,467.73,3.12,0.67,469.5,-0.38,True,1,9772,-467.73,-1382568.54,4570657.56,3188089.02
16519,1993-10-29,467.83,0.1,0.02,469.5,-0.36,True,1,9773,-467.83,-1383036.37,4572102.59,3189066.22
16520,1993-11-01,469.1,1.27,0.27,469.5,-0.08,True,1,9774,-469.1,-1383505.47,4584983.4,3201477.93
16521,1993-11-02,468.44,-0.66,-0.14,469.5,-0.23,True,1,9775,-468.44,-1383973.91,4579001.0,3195027.09
16522,1993-11-03,463.02,-5.42,-1.16,469.5,-1.38,True,1,9776,-463.02,-1384436.93,4526483.52,3142046.59
16523,1993-11-04,457.49,-5.53,-1.19,469.5,-2.56,True,1,9777,-457.49,-1384894.42,4472879.73,3087985.31
16524,1993-11-05,459.57,2.08,0.46,469.5,-2.12,True,1,9778,-459.57,-1385353.99,4493675.46,3108321.47
16525,1993-11-08,460.21,0.64,0.14,469.5,-1.98,True,1,9779,-460.21,-1385814.2,4500393.59,3114579.39
16526,1993-11-09,460.33,0.12,0.03,469.5,-1.95,True,1,9780,-460.33,-1386274.53,4502027.4,3115752.87
16527,1993-11-10,463.72,3.39,0.74,469.5,-1.23,True,1,9781,-463.72,-1386738.25,4535645.32,3148907.07
16528,1993-11-11,462.64,-1.08,-0.23,469.5,-1.46,True,1,9782,-462.64,-1387200.89,4525544.48,3138343.59
16529,1993-11-12,465.39,2.75,0.59,469.5,-0.88,True,1,9783,-465.39,-1387666.28,4552910.37,3165244.09
16530,1993-11-15,463.75,-1.64,-0.35,469.5,-1.23,True,1,9784,-463.75,-1388130.03,4537330.0,3149199.97
16531,1993-11-16,466.74,2.99,0.64,469.5,-0.59,True,1,9785,-466.74,-1388596.77,4567050.9,3178454.13
16532,1993-11-17,464.81,-1.93,-0.41,469.5,-1.0,True,1,9786,-464.81,-1389061.58,4548630.66,3159569.08
16533,1993-11-18,463.62,-1.19,-0.26,469.5,-1.25,True,1,9787,-463.62,-1389525.2,4537448.94,3147923.74
16534,1993-11-19,462.6,-1.02,-0.22,469.5,-1.47,True,1,9788,-462.6,-1389987.8,4527928.8,3137941.0
16535,1993-11-22,459.13,-3.47,-0.75,469.5,-2.21,True,1,9789,-459.13,-1390446.93,4494423.57,3103976.64
16536,1993-11-23,461.03,1.9,0.41,469.5,-1.8,True,1,9790,-461.03,-1390907.96,4513483.7,3122575.74
16537,1993-11-24,462.36,1.33,0.29,469.5,-1.52,True,1,9791,-462.36,-1391370.32,4526966.76,3135596.44
16538,1993-11-26,463.06,0.7,0.15,469.5,-1.37,True,1,9792,-463.06,-1391833.38,4534283.52,3142450.14
16539,1993-11-29,461.9,-1.16,-0.25,469.5,-1.62,True,1,9793,-461.9,-1392295.28,4523386.7,3131091.42
16540,1993-11-30,461.79,-0.11,-0.02,469.5,-1.64,True,1,9794,-461.79,-1392757.07,4522771.26,3130014.19
16541,1993-12-01,461.89,0.1,0.02,469.5,-1.62,True,1,9795,-461.89,-1393218.96,4524212.55,3130993.59
16542,1993-12-02,463.11,1.22,0.26,469.5,-1.36,True,1,9796,-463.11,-1393682.07,4536625.56,3142943.49
16543,1993-12-03,464.89,1.78,0.38,469.5,-0.98,True,1,9797,-464.89,-1394146.96,4554527.33,3160380.37
16544,1993-12-06,466.43,1.54,0.33,469.5,-0.65,True,1,9798,-466.43,-1394613.39,4570081.14,3175467.75
16545,1993-12-07,466.76,0.33,0.07,469.5,-0.58,True,1,9799,-466.76,-1395080.15,4573781.24,3178701.09
16546,1993-12-08,466.29,-0.47,-0.1,469.5,-0.68,True,1,9800,-466.29,-1395546.44,4569642.0,3174095.56
16547,1993-12-09,464.18,-2.11,-0.45,469.5,-1.13,True,1,9801,-464.18,-1396010.62,4549428.18,3153417.56
16548,1993-12-10,463.93,-0.25,-0.05,469.5,-1.19,True,1,9802,-463.93,-1396474.55,4547441.86,3150967.31
16549,1993-12-13,465.7,1.77,0.38,469.5,-0.81,True,1,9803,-465.7,-1396940.25,4565257.1,3168316.85
16550,1993-12-14,463.06,-2.64,-0.57,469.5,-1.37,True,1,9804,-463.06,-1397403.31,4539840.24,3142436.93
16551,1993-12-15,461.84,-1.22,-0.26,469.5,-1.63,True,1,9805,-461.84,-1397865.15,4528341.2,3130476.05
16552,1993-12-16,463.34,1.5,0.32,469.5,-1.31,True,1,9806,-463.34,-1398328.49,4543512.04,3145183.55
16553,1993-12-17,466.38,3.04,0.66,469.5,-0.66,True,1,9807,-466.38,-1398794.87,4573788.66,3174993.79
16554,1993-12-20,465.85,-0.53,-0.11,469.5,-0.78,True,1,9808,-465.85,-1399260.72,4569056.8,3169796.08
16555,1993-12-21,465.3,-0.55,-0.12,469.5,-0.9,True,1,9809,-465.3,-1399726.02,4564127.7,3164401.68
16556,1993-12-22,467.32,2.02,0.43,469.5,-0.46,True,1,9810,-467.32,-1400193.34,4584409.2,3184215.86
16557,1993-12-23,467.38,0.06,0.01,469.5,-0.45,True,1,9811,-467.38,-1400660.72,4585465.18,3184804.46
16558,1993-12-27,470.54,3.16,0.68,470.54,0.0,True,1,9812,-470.54,-1401131.26,4616938.48,3215807.22
16559,1993-12-28,470.94,0.4,0.08,470.94,0.0,True,1,9813,-470.94,-1401602.2,4621334.22,3219732.02
16560,1993-12-29,470.58,-0.36,-0.08,470.94,-0.08,True,1,9814,-470.58,-1402072.78,4618272.12,3216199.34
16561,1993-12-30,468.64,-1.94,-0.41,470.94,-0.49,True,1,9815,-468.64,-1402541.42,4599701.6,3197160.18
16562,1993-12-31,466.45,-2.19,-0.47,470.94,-0.95,True,1,9816,-466.45,-1403007.87,4578673.2,3175665.33
16563,1994-01-03,465.44,-1.01,-0.22,470.94,-1.17,True,1,9817,-465.44,-1403473.31,4569224.48,3165751.17
16564,1994-01-04,466.89,1.45,0.31,470.94,-0.86,True,1,9818,-466.89,-1403940.2,4583926.02,3179985.82
16565,1994-01-05,467.55,0.66,0.14,470.94,-0.72,True,1,9819,-467.55,-1404407.75,4590873.45,3186465.7
16566,1994-01-06,467.12,-0.43,-0.09,470.94,-0.81,True,1,9820,-467.12,-1404874.87,4587118.4,3182243.53
16567,1994-01-07,469.9,2.78,0.6,470.94,-0.22,True,1,9821,-469.9,-1405344.77,4614887.9,3209543.13
16568,1994-01-10,475.27,5.37,1.14,475.27,0.0,True,1,9822,-475.27,-1405820.04,4668101.94,3262281.9
16569,1994-01-11,474.13,-1.14,-0.24,475.27,-0.24,True,1,9823,-474.13,-1406294.17,4657378.99,3251084.82
16570,1994-01-12,474.17,0.04,0.01,475.27,-0.23,True,1,9824,-474.17,-1406768.34,4658246.08,3251477.74
16571,1994-01-13,472.47,-1.7,-0.36,475.27,-0.59,True,1,9825,-472.47,-1407240.81,4642017.75,3234776.94
16572,1994-01-14,474.91,2.44,0.52,475.27,-0.08,True,1,9826,-474.91,-1407715.72,4666465.66,3258749.94
16573,1994-01-17,473.3,-1.61,-0.34,475.27,-0.42,True,1,9827,-473.3,-1408189.02,4651119.1,3242930.08
16574,1994-01-18,474.25,0.95,0.2,475.27,-0.22,True,1,9828,-474.25,-1408663.27,4660929.0,3252265.73
16575,1994-01-19,474.3,0.05,0.01,475.27,-0.2,True,1,9829,-474.3,-1409137.57,4661894.7,3252757.13
16576,1994-01-20,474.98,0.68,0.14,475.27,-0.06,True,1,9830,-474.98,-1409612.55,4669053.4,3259440.85
16577,1994-01-21,474.72,-0.26,-0.06,475.27,-0.12,True,1,9831,-474.72,-1410087.27,4666972.32,3256885.05
16578,1994-01-24,471.97,-2.75,-0.58,475.27,-0.69,True,1,9832,-471.97,-1410559.24,4640409.04,3229849.8
16579,1994-01-25,470.92,-1.05,-0.22,475.27,-0.92,True,1,9833,-470.92,-1411030.16,4630556.36,3219526.2
16580,1994-01-26,473.2,2.28,0.48,475.27,-0.44,True,1,9834,-473.2,-1411503.36,4653448.8,3241945.44
16581,1994-01-27,477.05,3.85,0.81,477.05,0.0,True,1,9835,-477.05,-1411980.41,4691786.75,3279806.34
16582,1994-01-28,478.7,1.65,0.35,478.7,0.0,True,1,9836,-478.7,-1412459.11,4708493.2,3296034.09
16583,1994-01-31,481.61,2.91,0.61,481.61,0.0,True,1,9837,-481.61,-1412940.72,4737597.57,3324656.85
16584,1994-02-01,479.62,-1.99,-0.41,481.61,-0.41,True,1,9838,-479.62,-1413420.34,4718501.56,3305081.22
16585,1994-02-02,482.0,2.38,0.5,482.0,0.0,True,1,9839,-482.0,-1413902.34,4742398.0,3328495.66
16586,1994-02-03,480.71,-1.29,-0.27,482.0,-0.27,True,1,9840,-480.71,-1414383.05,4730186.4,3315803.35
16587,1994-02-04,469.81,-10.9,-2.27,482.0,-2.53,True,1,9841,-469.81,-1414852.86,4623400.21,3208547.35
16588,1994-02-07,471.76,1.95,0.42,482.0,-2.12,True,1,9842,-471.76,-1415324.62,4643061.92,3227737.3
16589,1994-02-08,471.05,-0.71,-0.15,482.0,-2.27,True,1,9843,-471.05,-1415795.67,4636545.15,3220749.48
16590,1994-02-09,472.77,1.72,0.36,482.0,-1.92,True,1,9844,-472.77,-1416268.44,4653947.88,3237679.44
16591,1994-02-10,468.93,-3.84,-0.81,482.0,-2.71,True,1,9845,-468.93,-1416737.37,4616615.85,3199878.48
16592,1994-02-11,470.18,1.25,0.27,482.0,-2.45,True,1,9846,-470.18,-1417207.55,4629392.28,3212184.73
16593,1994-02-14,470.23,0.05,0.01,482.0,-2.44,True,1,9847,-470.23,-1417677.78,4630354.81,3212677.03
16594,1994-02-15,472.52,2.29,0.49,482.0,-1.97,True,1,9848,-472.52,-1418150.3,4653376.96,3235226.66
16595,1994-02-16,472.79,0.27,0.06,482.0,-1.91,True,1,9849,-472.79,-1418623.09,4656508.71,3237885.62
16596,1994-02-17,470.34,-2.45,-0.52,482.0,-2.42,True,1,9850,-470.34,-1419093.43,4632849.0,3213755.57
16597,1994-02-18,467.69,-2.65,-0.56,482.0,-2.97,True,1,9851,-467.69,-1419561.12,4607214.19,3187653.07
16598,1994-02-22,471.46,3.77,0.81,482.0,-2.19,True,1,9852,-471.46,-1420032.58,4644823.92,3224791.34
16599,1994-02-23,470.69,-0.77,-0.16,482.0,-2.35,True,1,9853,-470.69,-1420503.27,4637708.57,3217205.3
16600,1994-02-24,464.26,-6.43,-1.37,482.0,-3.68,True,1,9854,-464.26,-1420967.53,4574818.04,3153850.51
16601,1994-02-25,466.07,1.81,0.39,482.0,-3.3,True,1,9855,-466.07,-1421433.6,4593119.85,3171686.25
16602,1994-02-28,467.14,1.07,0.23,482.0,-3.08,True,1,9856,-467.14,-1421900.74,4604131.84,3182231.1
16603,1994-03-01,464.44,-2.7,-0.58,482.0,-3.64,True,1,9857,-464.44,-1422365.18,4577985.08,3155619.9
16604,1994-03-02,464.81,0.37,0.08,482.0,-3.57,True,1,9858,-464.81,-1422829.99,4582096.98,3159266.99
16605,1994-03-03,463.01,-1.8,-0.39,482.0,-3.94,True,1,9859,-463.01,-1423293.0,4564815.59,3141522.59
16606,1994-03-04,464.74,1.73,0.37,482.0,-3.58,True,1,9860,-464.74,-1423757.74,4582336.4,3158578.66
16607,1994-03-07,466.91,2.17,0.47,482.0,-3.13,True,1,9861,-466.91,-1424224.65,4604199.51,3179974.86
16608,1994-03-08,465.88,-1.03,-0.22,482.0,-3.34,True,1,9862,-465.88,-1424690.53,4594508.56,3169818.03
16609,1994-03-09,467.06,1.18,0.25,482.0,-3.1,True,1,9863,-467.06,-1425157.59,4606612.78,3181455.19
16610,1994-03-10,463.9,-3.16,-0.68,482.0,-3.76,True,1,9864,-463.9,-1425621.49,4575909.6,3150288.11
16611,1994-03-11,466.44,2.54,0.55,482.0,-3.23,True,1,9865,-466.44,-1426087.93,4601430.6,3175342.67
16612,1994-03-14,467.39,0.95,0.2,482.0,-3.03,True,1,9866,-467.39,-1426555.32,4611269.74,3184714.42
16613,1994-03-15,467.01,-0.38,-0.08,482.0,-3.11,True,1,9867,-467.01,-1427022.33,4607987.67,3180965.34
16614,1994-03-16,469.42,2.41,0.52,482.0,-2.61,True,1,9868,-469.42,-1427491.75,4632236.56,3204744.81
16615,1994-03-17,470.9,1.48,0.32,482.0,-2.3,True,1,9869,-470.9,-1427962.65,4647312.1,3219349.45
16616,1994-03-18,471.06,0.16,0.03,482.0,-2.27,True,1,9870,-471.06,-1428433.71,4649362.2,3220928.49
16617,1994-03-21,468.54,-2.52,-0.54,482.0,-2.79,True,1,9871,-468.54,-1428902.25,4624958.34,3196056.09
16618,1994-03-22,468.8,0.26,0.06,482.0,-2.74,True,1,9872,-468.8,-1429371.05,4627993.6,3198622.55
16619,1994-03-23,468.54,-0.26,-0.06,482.0,-2.79,True,1,9873,-468.54,-1429839.59,4625895.42,3196055.83
16620,1994-03-24,464.35,-4.19,-0.89,482.0,-3.66,True,1,9874,-464.35,-1430303.94,4584991.9,3154687.96
16621,1994-03-25,460.58,-3.77,-0.81,482.0,-4.44,True,1,9875,-460.58,-1430764.52,4548227.5,3117462.98
16622,1994-03-28,460.0,-0.58,-0.13,482.0,-4.56,True,1,9876,-460.0,-1431224.52,4542960.0,3111735.48
16623,1994-03-29,452.48,-7.52,-1.64,482.0,-6.12,True,1,9877,-452.48,-1431677.0,4469144.96,3037467.96
16624,1994-03-30,445.55,-6.93,-1.53,482.0,-7.56,True,1,9878,-445.55,-1432122.55,4401142.9,2969020.35
16625,1994-03-31,445.77,0.22,0.05,482.0,-7.52,True,1,9879,-445.77,-1432568.32,4403761.83,2971193.51
16626,1994-04-04,438.92,-6.85,-1.54,482.0,-8.94,True,1,9880,-438.92,-1433007.24,4336529.6,2903522.36
16627,1994-04-05,448.29,9.37,2.13,482.0,-6.99,True,1,9881,-448.29,-1433455.53,4429553.49,2996097.96
16628,1994-04-06,448.05,-0.24,-0.05,482.0,-7.04,True,1,9882,-448.05,-1433903.58,4427630.1,2993726.52
16629,1994-04-07,450.88,2.83,0.63,482.0,-6.46,True,1,9883,-450.88,-1434354.46,4456047.04,3021692.58
16630,1994-04-08,447.1,-3.78,-0.84,482.0,-7.24,True,1,9884,-447.1,-1434801.56,4419136.4,2984334.84
16631,1994-04-11,449.87,2.77,0.62,482.0,-6.67,True,1,9885,-449.87,-1435251.43,4446964.95,3011713.52
16632,1994-04-12,447.57,-2.3,-0.51,482.0,-7.14,True,1,9886,-447.57,-1435699.0,4424677.02,2988978.02
16633,1994-04-13,446.26,-1.31,-0.29,482.0,-7.42,True,1,9887,-446.26,-1436145.26,4412172.62,2976027.36
16634,1994-04-14,446.38,0.12,0.03,482.0,-7.39,True,1,9888,-446.38,-1436591.64,4413805.44,2977213.8
16635,1994-04-15,446.18,-0.2,-0.04,482.0,-7.43,True,1,9889,-446.18,-1437037.82,4412274.02,2975236.2
16636,1994-04-18,442.46,-3.72,-0.83,482.0,-8.2,True,1,9890,-442.46,-1437480.28,4375929.4,2938449.12
16637,1994-04-19,442.54,0.08,0.02,482.0,-8.19,True,1,9891,-442.54,-1437922.82,4377163.14,2939240.32
16638,1994-04-20,441.96,-0.58,-0.13,482.0,-8.31,True,1,9892,-441.96,-1438364.78,4371868.32,2933503.54
16639,1994-04-21,448.73,6.77,1.53,482.0,-6.9,True,1,9893,-448.73,-1438813.51,4439285.89,3000472.38
16640,1994-04-22,447.63,-1.1,-0.24,482.0,-7.13,True,1,9894,-447.63,-1439261.14,4428851.22,2989590.08
16641,1994-04-25,452.71,5.08,1.14,482.0,-6.08,True,1,9895,-452.71,-1439713.85,4479565.45,3039851.6
16642,1994-04-26,451.87,-0.84,-0.19,482.0,-6.25,True,1,9896,-451.87,-1440165.72,4471705.52,3031539.8
16643,1994-04-28,449.1,-2.77,-0.61,482.0,-6.83,True,1,9897,-449.1,-1440614.82,4444742.7,3004127.88
16644,1994-04-29,450.91,1.81,0.4,482.0,-6.45,True,1,9898,-450.91,-1441065.73,4463107.18,3022041.45
16645,1994-05-02,453.02,2.11,0.47,482.0,-6.01,True,1,9899,-453.02,-1441518.75,4484444.98,3042926.23
16646,1994-05-03,453.03,0.01,0.0,482.0,-6.01,True,1,9900,-453.03,-1441971.78,4484997.0,3043025.22
16647,1994-05-04,451.72,-1.31,-0.29,482.0,-6.28,True,1,9901,-451.72,-1442423.5,4472479.72,3030056.22
16648,1994-05-05,451.38,-0.34,-0.08,482.0,-6.35,True,1,9902,-451.38,-1442874.88,4469564.76,3026689.88
16649,1994-05-06,447.82,-3.56,-0.79,482.0,-7.09,True,1,9903,-447.82,-1443322.7,4434761.46,2991438.76
16650,1994-05-09,442.32,-5.5,-1.23,482.0,-8.23,True,1,9904,-442.32,-1443765.02,4380737.28,2936972.26
16651,1994-05-10,446.01,3.69,0.83,482.0,-7.47,True,1,9905,-446.01,-1444211.03,4417729.05,2973518.02
16652,1994-05-11,441.49,-4.52,-1.01,482.0,-8.4,True,1,9906,-441.49,-1444652.52,4373399.94,2928747.42
16653,1994-05-12,443.75,2.26,0.51,482.0,-7.94,True,1,9907,-443.75,-1445096.27,4396231.25,2951134.98
16654,1994-05-13,444.14,0.39,0.09,482.0,-7.86,True,1,9908,-444.14,-1445540.41,4400539.12,2954998.71
16655,1994-05-16,444.49,0.35,0.08,482.0,-7.78,True,1,9909,-444.49,-1445984.9,4404451.41,2958466.51
16656,1994-05-17,449.37,4.88,1.1,482.0,-6.77,True,1,9910,-449.37,-1446434.27,4453256.7,3006822.43
16657,1994-05-18,453.69,4.32,0.96,482.0,-5.87,True,1,9911,-453.69,-1446887.96,4496521.59,3049633.63
16658,1994-05-19,456.48,2.79,0.62,482.0,-5.3,True,1,9912,-456.48,-1447344.44,4524629.76,3077285.32
16659,1994-05-20,454.92,-1.56,-0.34,482.0,-5.62,True,1,9913,-454.92,-1447799.36,4509621.96,3061822.6
16660,1994-05-23,453.2,-1.72,-0.38,482.0,-5.98,True,1,9914,-453.2,-1448252.56,4493024.8,3044772.24
16661,1994-05-24,454.81,1.61,0.36,482.0,-5.64,True,1,9915,-454.81,-1448707.37,4509441.15,3060733.78
16662,1994-05-25,456.34,1.53,0.34,482.0,-5.32,True,1,9916,-456.34,-1449163.71,4525067.44,3075903.73
16663,1994-05-26,457.06,0.72,0.16,482.0,-5.17,True,1,9917,-457.06,-1449620.77,4532664.02,3083043.25
16664,1994-05-27,457.33,0.27,0.06,482.0,-5.12,True,1,9918,-457.33,-1450078.1,4535798.94,3085720.84
16665,1994-05-31,456.5,-0.83,-0.18,482.0,-5.29,True,1,9919,-456.5,-1450534.6,4528023.5,3077488.9
16666,1994-06-01,457.63,1.13,0.25,482.0,-5.06,True,1,9920,-457.63,-1450992.23,4539689.6,3088697.37
16667,1994-06-02,457.65,0.02,0.0,482.0,-5.05,True,1,9921,-457.65,-1451449.88,4540345.65,3088895.77
16668,1994-06-03,460.13,2.48,0.54,482.0,-4.54,True,1,9922,-460.13,-1451910.01,4565409.86,3113499.85
16669,1994-06-06,458.88,-1.25,-0.27,482.0,-4.8,True,1,9923,-458.88,-1452368.89,4553466.24,3101097.35
16670,1994-06-07,458.21,-0.67,-0.15,482.0,-4.94,True,1,9924,-458.21,-1452827.1,4547276.04,3094448.94
16671,1994-06-08,457.06,-1.15,-0.25,482.0,-5.17,True,1,9925,-457.06,-1453284.16,4536320.5,3083036.34
16672,1994-06-09,457.86,0.8,0.18,482.0,-5.01,True,1,9926,-457.86,-1453742.02,4544718.36,3090976.34
16673,1994-06-10,458.67,0.81,0.18,482.0,-4.84,True,1,9927,-458.67,-1454200.69,4553217.09,3099016.4
16674,1994-06-13,459.1,0.43,0.09,482.0,-4.75,True,1,9928,-459.1,-1454659.79,4557944.8,3103285.01
16675,1994-06-14,462.37,3.27,0.71,482.0,-4.07,True,1,9929,-462.37,-1455122.16,4590871.73,3135749.57
16676,1994-06-15,460.61,-1.76,-0.38,482.0,-4.44,True,1,9930,-460.61,-1455582.77,4573857.3,3118274.53
16677,1994-06-16,461.93,1.32,0.29,482.0,-4.16,True,1,9931,-461.93,-1456044.7,4587426.83,3131382.13
16678,1994-06-17,458.45,-3.48,-0.75,482.0,-4.89,True,1,9932,-458.45,-1456503.15,4553325.4,3096822.25
16679,1994-06-20,455.48,-2.97,-0.65,482.0,-5.5,True,1,9933,-455.48,-1456958.63,4524282.84,3067324.21
16680,1994-06-21,451.34,-4.14,-0.91,482.0,-6.36,True,1,9934,-451.34,-1457409.97,4483611.56,3026201.59
16681,1994-06-22,453.09,1.75,0.39,482.0,-6.0,True,1,9935,-453.09,-1457863.06,4501449.15,3043586.09
16682,1994-06-23,449.63,-3.46,-0.76,482.0,-6.72,True,1,9936,-449.63,-1458312.69,4467523.68,3009210.99
16683,1994-06-24,442.8,-6.83,-1.52,482.0,-8.13,True,1,9937,-442.8,-1458755.49,4400103.6,2941348.11
16684,1994-06-27,447.31,4.51,1.02,482.0,-7.2,True,1,9938,-447.31,-1459202.8,4445366.78,2986163.98
16685,1994-06-28,446.07,-1.24,-0.28,482.0,-7.45,True,1,9939,-446.07,-1459648.87,4433489.73,2973840.86
16686,1994-06-29,447.63,1.56,0.35,482.0,-7.13,True,1,9940,-447.63,-1460096.5,4449442.2,2989345.7
16687,1994-06-30,444.27,-3.36,-0.75,482.0,-7.83,True,1,9941,-444.27,-1460540.77,4416488.07,2955947.3
16688,1994-07-01,446.2,1.93,0.43,482.0,-7.43,True,1,9942,-446.2,-1460986.97,4436120.4,2975133.43
16689,1994-07-05,446.37,0.17,0.04,482.0,-7.39,True,1,9943,-446.37,-1461433.34,4438256.91,2976823.57
16690,1994-07-06,446.13,-0.24,-0.05,482.0,-7.44,True,1,9944,-446.13,-1461879.47,4436316.72,2974437.25
16691,1994-07-07,448.38,2.25,0.5,482.0,-6.98,True,1,9945,-448.38,-1462327.85,4459139.1,2996811.25
16692,1994-07-08,449.55,1.17,0.26,482.0,-6.73,True,1,9946,-449.55,-1462777.4,4471224.3,3008446.9
16693,1994-07-11,448.06,-1.49,-0.33,482.0,-7.04,True,1,9947,-448.06,-1463225.46,4456852.82,2993627.36
16694,1994-07-12,447.95,-0.11,-0.02,482.0,-7.06,True,1,9948,-447.95,-1463673.41,4456206.6,2992533.19
16695,1994-07-13,448.73,0.78,0.17,482.0,-6.9,True,1,9949,-448.73,-1464122.14,4464414.77,3000292.63
16696,1994-07-14,453.41,4.68,1.04,482.0,-5.93,True,1,9950,-453.41,-1464575.55,4511429.5,3046853.95
16697,1994-07-15,454.16,0.75,0.16,482.0,-5.78,True,1,9951,-454.16,-1465029.71,4519346.16,3054316.45
16698,1994-07-18,455.22,1.06,0.23,482.0,-5.56,True,1,9952,-455.22,-1465484.93,4530349.44,3064864.51
16699,1994-07-19,453.86,-1.36,-0.3,482.0,-5.84,True,1,9953,-453.86,-1465938.79,4517268.58,3051329.79
16700,1994-07-20,451.6,-2.26,-0.5,482.0,-6.31,True,1,9954,-451.6,-1466390.39,4495226.4,3028836.01
16701,1994-07-21,452.61,1.01,0.22,482.0,-6.1,True,1,9955,-452.61,-1466843.0,4505732.55,3038889.55
16702,1994-07-22,453.11,0.5,0.11,482.0,-5.99,True,1,9956,-453.11,-1467296.11,4511163.16,3043867.05
16703,1994-07-25,454.25,1.14,0.25,482.0,-5.76,True,1,9957,-454.25,-1467750.36,4522967.25,3055216.89
16704,1994-07-26,453.36,-0.89,-0.2,482.0,-5.94,True,1,9958,-453.36,-1468203.72,4514558.88,3046355.16
16705,1994-07-27,452.57,-0.79,-0.17,482.0,-6.11,True,1,9959,-452.57,-1468656.29,4507144.63,3038488.34
16706,1994-07-28,454.24,1.67,0.37,482.0,-5.76,True,1,9960,-454.24,-1469110.53,4524230.4,3055119.87
16707,1994-07-29,458.26,4.02,0.88,482.0,-4.92,True,1,9961,-458.26,-1469568.79,4564727.86,3095159.07
16708,1994-08-01,461.01,2.75,0.6,482.0,-4.36,True,1,9962,-461.01,-1470029.8,4592581.62,3122551.82
16709,1994-08-02,460.56,-0.45,-0.1,482.0,-4.45,True,1,9963,-460.56,-1470490.36,4588559.28,3118068.92
16710,1994-08-03,461.45,0.89,0.19,482.0,-4.26,True,1,9964,-461.45,-1470951.81,4597887.8,3126935.99
16711,1994-08-04,458.4,-3.05,-0.66,482.0,-4.9,True,1,9965,-458.4,-1471410.21,4567956.0,3096545.79
16712,1994-08-05,457.09,-1.31,-0.29,482.0,-5.17,True,1,9966,-457.09,-1471867.3,4555358.94,3083491.64
16713,1994-08-08,457.89,0.8,0.18,482.0,-5.0,True,1,9967,-457.89,-1472325.19,4563789.63,3091464.44
16714,1994-08-09,457.92,0.03,0.01,482.0,-5.0,True,1,9968,-457.92,-1472783.11,4564546.56,3091763.45
16715,1994-08-10,460.3,2.38,0.52,482.0,-4.5,True,1,9969,-460.3,-1473243.41,4588730.7,3115487.29
16716,1994-08-11,458.88,-1.42,-0.31,482.0,-4.8,True,1,9970,-458.88,-1473702.29,4575033.6,3101331.31
16717,1994-08-12,461.94,3.06,0.67,482.0,-4.16,True,1,9971,-461.94,-1474164.23,4606003.74,3131839.51
16718,1994-08-15,461.23,-0.71,-0.15,482.0,-4.31,True,1,9972,-461.23,-1474625.46,4599385.56,3124760.1
16719,1994-08-16,465.01,3.78,0.82,482.0,-3.52,True,1,9973,-465.01,-1475090.47,4637544.73,3162454.26
16720,1994-08-17,465.17,0.16,0.03,482.0,-3.49,True,1,9974,-465.17,-1475555.64,4639605.58,3164049.94
16721,1994-08-18,463.17,-2.0,-0.43,482.0,-3.91,True,1,9975,-463.17,-1476018.81,4620120.75,3144101.94
16722,1994-08-19,463.68,0.51,0.11,482.0,-3.8,True,1,9976,-463.68,-1476482.49,4625671.68,3149189.19
16723,1994-08-22,462.32,-1.36,-0.29,482.0,-4.08,True,1,9977,-462.32,-1476944.81,4612566.64,3135621.83
16724,1994-08-23,464.51,2.19,0.47,482.0,-3.63,True,1,9978,-464.51,-1477409.32,4634880.78,3157471.46
16725,1994-08-24,469.03,4.52,0.97,482.0,-2.69,True,1,9979,-469.03,-1477878.35,4680450.37,3202572.02
16726,1994-08-25,468.08,-0.95,-0.2,482.0,-2.89,True,1,9980,-468.08,-1478346.43,4671438.4,3193091.97
16727,1994-08-26,473.8,5.72,1.22,482.0,-1.7,True,1,9981,-473.8,-1478820.23,4728997.8,3250177.57
16728,1994-08-29,474.59,0.79,0.17,482.0,-1.54,True,1,9982,-474.59,-1479294.82,4737357.38,3258062.56
16729,1994-08-30,476.07,1.48,0.31,482.0,-1.23,True,1,9983,-476.07,-1479770.89,4752606.81,3272835.92
16730,1994-08-31,475.49,-0.58,-0.12,482.0,-1.35,True,1,9984,-475.49,-1480246.38,4747292.16,3267045.78
16731,1994-09-01,473.17,-2.32,-0.49,482.0,-1.83,True,1,9985,-473.17,-1480719.55,4724602.45,3243882.9
16732,1994-09-02,470.99,-2.18,-0.46,482.0,-2.28,True,1,9986,-470.99,-1481190.54,4703306.14,3222115.6
16733,1994-09-06,471.86,0.87,0.18,482.0,-2.1,True,1,9987,-471.86,-1481662.4,4712465.82,3230803.42
16734,1994-09-07,470.99,-0.87,-0.18,482.0,-2.28,True,1,9988,-470.99,-1482133.39,4704248.12,3222114.73
16735,1994-09-08,473.14,2.15,0.46,482.0,-1.84,True,1,9989,-473.14,-1482606.53,4726195.46,3243588.93
16736,1994-09-09,468.18,-4.96,-1.05,482.0,-2.87,True,1,9990,-468.18,-1483074.71,4677118.2,3194043.49
16737,1994-09-12,466.21,-1.97,-0.42,482.0,-3.28,True,1,9991,-466.21,-1483540.92,4657904.11,3174363.19
16738,1994-09-13,467.51,1.3,0.28,482.0,-3.01,True,1,9992,-467.51,-1484008.43,4671359.92,3187351.49
16739,1994-09-14,468.8,1.29,0.28,482.0,-2.74,True,1,9993,-468.8,-1484477.23,4684718.4,3200241.17
16740,1994-09-15,474.81,6.01,1.28,482.0,-1.49,True,1,9994,-474.81,-1484952.04,4745251.14,3260299.1
16741,1994-09-16,471.19,-3.62,-0.76,482.0,-2.24,True,1,9995,-471.19,-1485423.23,4709544.05,3224120.82
16742,1994-09-19,470.85,-0.34,-0.07,482.0,-2.31,True,1,9996,-470.85,-1485894.08,4706616.6,3220722.52
16743,1994-09-20,463.36,-7.49,-1.59,482.0,-3.87,True,1,9997,-463.36,-1486357.44,4632209.92,3145852.48
16744,1994-09-21,461.46,-1.9,-0.41,482.0,-4.26,True,1,9998,-461.46,-1486818.9,4613677.08,3126858.18
16745,1994-09-22,461.27,-0.19,-0.04,482.0,-4.3,True,1,9999,-461.27,-1487280.17,4612238.73,3124958.56
16746,1994-09-23,459.67,-1.6,-0.35,482.0,-4.63,True,1,10000,-459.67,-1487739.84,4596700.0,3108960.16
16747,1994-09-26,460.82,1.15,0.25,482.0,-4.39,True,1,10001,-460.82,-1488200.66,4608660.82,3120460.16
16748,1994-09-27,462.05,1.23,0.27,482.0,-4.14,True,1,10002,-462.05,-1488662.71,4621424.1,3132761.39
16749,1994-09-28,464.84,2.79,0.6,482.0,-3.56,True,1,10003,-464.84,-1489127.55,4649794.52,3160666.97
16750,1994-09-29,462.24,-2.6,-0.56,482.0,-4.1,True,1,10004,-462.24,-1489589.79,4624248.96,3134659.17
16751,1994-09-30,462.71,0.47,0.1,482.0,-4.0,True,1,10005,-462.71,-1490052.5,4629413.55,3139361.05
16752,1994-10-03,461.74,-0.97,-0.21,482.0,-4.2,True,1,10006,-461.74,-1490514.24,4620170.44,3129656.2
16753,1994-10-04,454.59,-7.15,-1.55,482.0,-5.69,True,1,10007,-454.59,-1490968.83,4549082.13,3058113.3
16754,1994-10-05,453.52,-1.07,-0.24,482.0,-5.91,True,1,10008,-453.52,-1491422.35,4538828.16,3047405.81
16755,1994-10-06,452.36,-1.16,-0.26,482.0,-6.15,True,1,10009,-452.36,-1491874.71,4527671.24,3035796.53
16756,1994-10-07,455.1,2.74,0.61,482.0,-5.58,True,1,10010,-455.1,-1492329.81,4555551.0,3063221.19
16757,1994-10-10,459.04,3.94,0.87,482.0,-4.76,True,1,10011,-459.04,-1492788.85,4595449.44,3102660.59
16758,1994-10-11,465.79,6.75,1.47,482.0,-3.36,True,1,10012,-465.79,-1493254.64,4663489.48,3170234.84
16759,1994-10-12,465.47,-0.32,-0.07,482.0,-3.43,True,1,10013,-465.47,-1493720.11,4660751.11,3167031.0
16760,1994-10-13,467.79,2.32,0.5,482.0,-2.95,True,1,10014,-467.79,-1494187.9,4684449.06,3190261.16
16761,1994-10-14,469.1,1.31,0.28,482.0,-2.68,True,1,10015,-469.1,-1494657.0,4698036.5,3203379.5
16762,1994-10-17,468.96,-0.14,-0.03,482.0,-2.7,True,1,10016,-468.96,-1495125.96,4697103.36,3201977.4
16763,1994-10-18,467.66,-1.3,-0.28,482.0,-2.98,True,1,10017,-467.66,-1495593.62,4684550.22,3188956.6
16764,1994-10-19,470.28,2.62,0.56,482.0,-2.43,True,1,10018,-470.28,-1496063.9,4711265.04,3215201.14
16765,1994-10-20,466.85,-3.43,-0.73,482.0,-3.14,True,1,10019,-466.85,-1496530.75,4677370.15,3180839.4
16766,1994-10-21,464.89,-1.96,-0.42,482.0,-3.55,True,1,10020,-464.89,-1496995.64,4658197.8,3161202.16
16767,1994-10-24,460.83,-4.06,-0.87,482.0,-4.39,True,1,10021,-460.83,-1497456.47,4617977.43,3120520.96
16768,1994-10-25,461.53,0.7,0.15,482.0,-4.25,True,1,10022,-461.53,-1497918.0,4625453.66,3127535.66
16769,1994-10-26,462.62,1.09,0.24,482.0,-4.02,True,1,10023,-462.62,-1498380.62,4636840.26,3138459.64
16770,1994-10-27,465.85,3.23,0.7,482.0,-3.35,True,1,10024,-465.85,-1498846.47,4669680.4,3170833.93
16771,1994-10-28,473.77,7.92,1.7,482.0,-1.71,True,1,10025,-473.77,-1499320.24,4749544.25,3250224.01
16772,1994-10-31,472.35,-1.42,-0.3,482.0,-2.0,True,1,10026,-472.35,-1499792.59,4735781.1,3235988.51
16773,1994-11-01,468.42,-3.93,-0.83,482.0,-2.82,True,1,10027,-468.42,-1500261.01,4696847.34,3196586.33
16774,1994-11-02,466.51,-1.91,-0.41,482.0,-3.21,True,1,10028,-466.51,-1500727.52,4678162.28,3177434.76
16775,1994-11-03,467.91,1.4,0.3,482.0,-2.92,True,1,10029,-467.91,-1501195.43,4692669.39,3191473.96
16776,1994-11-04,462.28,-5.63,-1.2,482.0,-4.09,True,1,10030,-462.28,-1501657.71,4636668.4,3135010.69
16777,1994-11-07,463.07,0.79,0.17,482.0,-3.93,True,1,10031,-463.07,-1502120.78,4645055.17,3142934.39
16778,1994-11-08,465.65,2.58,0.56,482.0,-3.39,True,1,10032,-465.65,-1502586.43,4671400.8,3168814.37
16779,1994-11-09,465.4,-0.25,-0.05,482.0,-3.44,True,1,10033,-465.4,-1503051.83,4669358.2,3166306.37
16780,1994-11-10,464.37,-1.03,-0.22,482.0,-3.66,True,1,10034,-464.37,-1503516.2,4659488.58,3155972.38
16781,1994-11-11,462.35,-2.02,-0.44,482.0,-4.08,True,1,10035,-462.35,-1503978.55,4639682.25,3135703.7
16782,1994-11-14,466.04,3.69,0.8,482.0,-3.31,True,1,10036,-466.04,-1504444.59,4677177.44,3172732.85
16783,1994-11-15,465.03,-1.01,-0.22,482.0,-3.52,True,1,10037,-465.03,-1504909.62,4667506.11,3162596.49
16784,1994-11-16,465.62,0.59,0.13,482.0,-3.4,True,1,10038,-465.62,-1505375.24,4673893.56,3168518.32
16785,1994-11-17,463.57,-2.05,-0.44,482.0,-3.82,True,1,10039,-463.57,-1505838.81,4653779.23,3147940.42
16786,1994-11-18,461.47,-2.1,-0.45,482.0,-4.26,True,1,10040,-461.47,-1506300.28,4633158.8,3126858.52
16787,1994-11-21,458.3,-3.17,-0.69,482.0,-4.92,True,1,10041,-458.3,-1506758.58,4601790.3,3095031.72
16788,1994-11-22,450.09,-8.21,-1.79,482.0,-6.62,True,1,10042,-450.09,-1507208.67,4519803.78,3012595.11
16789,1994-11-23,449.93,-0.16,-0.04,482.0,-6.65,True,1,10043,-449.93,-1507658.6,4518646.99,3010988.39
16790,1994-11-25,452.29,2.36,0.52,482.0,-6.16,True,1,10044,-452.29,-1508110.89,4542800.76,3034689.87
16791,1994-11-28,454.16,1.87,0.41,482.0,-5.78,True,1,10045,-454.16,-1508565.05,4562037.2,3053472.15
16792,1994-11-29,455.17,1.01,0.22,482.0,-5.57,True,1,10046,-455.17,-1509020.22,4572637.82,3063617.6
16793,1994-11-30,453.69,-1.48,-0.32,482.0,-5.87,True,1,10047,-453.69,-1509473.91,4558223.43,3048749.52
16794,1994-12-01,448.92,-4.77,-1.05,482.0,-6.86,True,1,10048,-448.92,-1509922.83,4510748.16,3000825.33
16795,1994-12-02,453.3,4.38,0.98,482.0,-5.95,True,1,10049,-453.3,-1510376.13,4555211.7,3044835.57
16796,1994-12-05,453.32,0.02,0.0,482.0,-5.95,True,1,10050,-453.32,-1510829.45,4555866.0,3045036.55
16797,1994-12-06,453.11,-0.21,-0.05,482.0,-5.99,True,1,10051,-453.11,-1511282.56,4554208.61,3042926.05
16798,1994-12-07,451.23,-1.88,-0.42,482.0,-6.38,True,1,10052,-451.23,-1511733.79,4535763.96,3024030.17
16799,1994-12-08,445.45,-5.78,-1.28,482.0,-7.58,True,1,10053,-445.45,-1512179.24,4478108.85,2965929.61
16800,1994-12-09,446.96,1.51,0.34,482.0,-7.27,True,1,10054,-446.96,-1512626.2,4493735.84,2981109.64
16801,1994-12-12,449.47,2.51,0.56,482.0,-6.75,True,1,10055,-449.47,-1513075.67,4519420.85,3006345.18
16802,1994-12-13,450.15,0.68,0.15,482.0,-6.61,True,1,10056,-450.15,-1513525.82,4526708.4,3013182.58
16803,1994-12-14,454.97,4.82,1.07,482.0,-5.61,True,1,10057,-454.97,-1513980.79,4575633.29,3061652.5
16804,1994-12-15,455.34,0.37,0.08,482.0,-5.53,True,1,10058,-455.34,-1514436.13,4579809.72,3065373.59
16805,1994-12-16,458.8,3.46,0.76,482.0,-4.81,True,1,10059,-458.8,-1514894.93,4615069.2,3100174.27
16806,1994-12-19,457.91,-0.89,-0.19,482.0,-5.0,True,1,10060,-457.91,-1515352.84,4606574.6,3091221.76
16807,1994-12-20,457.1,-0.81,-0.18,482.0,-5.17,True,1,10061,-457.1,-1515809.94,4598883.1,3083073.16
16808,1994-12-21,459.61,2.51,0.55,482.0,-4.64,True,1,10062,-459.61,-1516269.55,4624595.82,3108326.27
16809,1994-12-22,459.68,0.07,0.02,482.0,-4.63,True,1,10063,-459.68,-1516729.23,4625759.84,3109030.61
16810,1994-12-23,459.83,0.15,0.03,482.0,-4.6,True,1,10064,-459.83,-1517189.06,4627729.12,3110540.06
16811,1994-12-27,462.47,2.64,0.57,482.0,-4.05,True,1,10065,-462.47,-1517651.53,4654760.55,3137109.02
16812,1994-12-28,460.86,-1.61,-0.35,482.0,-4.39,True,1,10066,-460.86,-1518112.39,4639016.76,3120904.37
16813,1994-12-29,461.17,0.31,0.07,482.0,-4.32,True,1,10067,-461.17,-1518573.56,4642598.39,3124024.83
16814,1994-12-30,459.27,-1.9,-0.41,482.0,-4.72,True,1,10068,-459.27,-1519032.83,4623930.36,3104897.53
16815,1995-01-03,459.11,-0.16,-0.04,482.0,-4.75,True,1,10069,-459.11,-1519491.94,4622778.59,3103286.65
16816,1995-01-04,460.71,1.6,0.35,482.0,-4.42,True,1,10070,-460.71,-1519952.65,4639349.7,3119397.05
16817,1995-01-05,460.34,-0.37,-0.08,482.0,-4.49,True,1,10071,-460.34,-1520412.99,4636084.14,3115671.15
16818,1995-01-06,460.68,0.34,0.07,482.0,-4.42,True,1,10072,-460.68,-1520873.67,4639968.96,3119095.29
16819,1995-01-09,460.83,0.15,0.03,482.0,-4.39,True,1,10073,-460.83,-1521334.5,4641940.59,3120606.09
16820,1995-01-10,461.68,0.85,0.18,482.0,-4.22,True,1,10074,-461.68,-1521796.18,4650964.32,3129168.14
16821,1995-01-11,461.66,-0.02,-0.0,482.0,-4.22,True,1,10075,-461.66,-1522257.84,4651224.5,3128966.66
16822,1995-01-12,461.64,-0.02,-0.0,482.0,-4.22,True,1,10076,-461.64,-1522719.48,4651484.64,3128765.16
16823,1995-01-13,465.97,4.33,0.94,482.0,-3.33,True,1,10077,-465.97,-1523185.45,4695579.69,3172394.24
16824,1995-01-16,469.38,3.41,0.73,482.0,-2.62,True,1,10078,-469.38,-1523654.83,4730411.64,3206756.81
16825,1995-01-17,470.05,0.67,0.14,482.0,-2.48,True,1,10079,-470.05,-1524124.88,4737633.95,3213509.07
16826,1995-01-18,469.71,-0.34,-0.07,482.0,-2.55,True,1,10080,-469.71,-1524594.59,4734676.8,3210082.21
16827,1995-01-19,466.95,-2.76,-0.59,482.0,-3.12,True,1,10081,-466.95,-1525061.54,4707322.95,3182261.41
16828,1995-01-20,464.78,-2.17,-0.46,482.0,-3.57,True,1,10082,-464.78,-1525526.32,4685911.96,3160385.64
16829,1995-01-23,465.82,1.04,0.22,482.0,-3.36,True,1,10083,-465.82,-1525992.14,4696863.06,3170870.92
16830,1995-01-24,465.86,0.04,0.01,482.0,-3.35,True,1,10084,-465.86,-1526458.0,4697732.24,3171274.24
16831,1995-01-25,467.44,1.58,0.34,482.0,-3.02,True,1,10085,-467.44,-1526925.44,4714132.4,3187206.96
16832,1995-01-26,468.32,0.88,0.19,482.0,-2.84,True,1,10086,-468.32,-1527393.76,4723475.52,3196081.76
16833,1995-01-27,470.39,2.07,0.44,482.0,-2.41,True,1,10087,-470.39,-1527864.15,4744823.93,3216959.78
16834,1995-01-30,468.51,-1.88,-0.4,482.0,-2.8,True,1,10088,-468.51,-1528332.66,4726328.88,3197996.22
16835,1995-01-31,470.42,1.91,0.41,482.0,-2.4,True,1,10089,-470.42,-1528803.08,4746067.38,3217264.3
16836,1995-02-01,470.4,-0.02,-0.0,482.0,-2.41,True,1,10090,-470.4,-1529273.48,4746336.0,3217062.52
16837,1995-02-02,472.79,2.39,0.51,482.0,-1.91,True,1,10091,-472.79,-1529746.27,4770923.89,3241177.62
16838,1995-02-03,478.65,5.86,1.24,482.0,-0.7,True,1,10092,-478.65,-1530224.92,4830535.8,3300310.88
16839,1995-02-06,481.14,2.49,0.52,482.0,-0.18,True,1,10093,-481.14,-1530706.06,4856146.02,3325439.96
16840,1995-02-07,480.81,-0.33,-0.07,482.0,-0.25,True,1,10094,-480.81,-1531186.87,4853296.14,3322109.27
16841,1995-02-08,481.19,0.38,0.08,482.0,-0.17,True,1,10095,-481.19,-1531668.06,4857613.05,3325944.99
16842,1995-02-09,480.19,-1.0,-0.21,482.0,-0.38,True,1,10096,-480.19,-1532148.25,4847998.24,3315849.99
16843,1995-02-10,481.46,1.27,0.26,482.0,-0.11,True,1,10097,-481.46,-1532629.71,4861301.62,3328671.91
16844,1995-02-13,481.65,0.19,0.04,482.0,-0.07,True,1,10098,-481.65,-1533111.36,4863701.7,3330590.34
16845,1995-02-14,482.55,0.9,0.19,482.55,0.0,True,1,10099,-482.55,-1533593.91,4873272.45,3339678.54
16846,1995-02-15,484.54,1.99,0.41,484.54,0.0,True,1,10100,-484.54,-1534078.45,4893854.0,3359775.55
16847,1995-02-16,485.22,0.68,0.14,485.22,0.0,True,1,10101,-485.22,-1534563.67,4901207.22,3366643.55
16848,1995-02-17,481.97,-3.25,-0.67,485.22,-0.67,True,1,10102,-481.97,-1535045.64,4868860.94,3333815.3
16849,1995-02-21,482.72,0.75,0.16,485.22,-0.52,True,1,10103,-482.72,-1535528.36,4876920.16,3341391.8
16850,1995-02-22,485.07,2.35,0.49,485.22,-0.03,True,1,10104,-485.07,-1536013.43,4901147.28,3365133.85
16851,1995-02-23,486.91,1.84,0.38,486.91,0.0,True,1,10105,-486.91,-1536500.34,4920225.55,3383725.21
16852,1995-02-24,488.11,1.2,0.25,488.11,0.0,True,1,10106,-488.11,-1536988.45,4932839.66,3395851.21
16853,1995-02-27,483.81,-4.3,-0.88,488.11,-0.88,True,1,10107,-483.81,-1537472.26,4889867.67,3352395.41
16854,1995-02-28,487.39,3.58,0.74,488.11,-0.15,True,1,10108,-487.39,-1537959.65,4926538.12,3388578.47
16855,1995-03-01,485.65,-1.74,-0.36,488.11,-0.5,True,1,10109,-485.65,-1538445.3,4909435.85,3370990.55
16856,1995-03-02,485.13,-0.52,-0.11,488.11,-0.61,True,1,10110,-485.13,-1538930.43,4904664.3,3365733.87
16857,1995-03-03,485.42,0.29,0.06,488.11,-0.55,True,1,10111,-485.42,-1539415.85,4908081.62,3368665.77
16858,1995-03-06,485.63,0.21,0.04,488.11,-0.51,True,1,10112,-485.63,-1539901.48,4910690.56,3370789.08
16859,1995-03-07,482.12,-3.51,-0.72,488.11,-1.23,True,1,10113,-482.12,-1540383.6,4875679.56,3335295.96
16860,1995-03-08,483.14,1.02,0.21,488.11,-1.02,True,1,10114,-483.14,-1540866.74,4886477.96,3345611.22
16861,1995-03-09,483.16,0.02,0.0,488.11,-1.01,True,1,10115,-483.16,-1541349.9,4887163.4,3345813.5
16862,1995-03-10,489.57,6.41,1.33,489.57,0.0,True,1,10116,-489.57,-1541839.47,4952490.12,3410650.65
16863,1995-03-13,490.05,0.48,0.1,490.05,0.0,True,1,10117,-490.05,-1542329.52,4957835.85,3415506.33
16864,1995-03-14,492.89,2.84,0.58,492.89,0.0,True,1,10118,-492.89,-1542822.41,4987061.02,3444238.61
16865,1995-03-15,491.88,-1.01,-0.2,492.89,-0.2,True,1,10119,-491.88,-1543314.29,4977333.72,3434019.43
16866,1995-03-16,495.41,3.53,0.72,495.41,0.0,True,1,10120,-495.41,-1543809.7,5013549.2,3469739.5
16867,1995-03-17,495.52,0.11,0.02,495.52,0.0,True,1,10121,-495.52,-1544305.22,5015157.92,3470852.7
16868,1995-03-20,496.14,0.62,0.12,496.14,0.0,True,1,10122,-496.14,-1544801.36,5021929.08,3477127.72
16869,1995-03-21,495.07,-1.07,-0.22,496.14,-0.22,True,1,10123,-495.07,-1545296.43,5011593.61,3466297.18
16870,1995-03-22,495.67,0.6,0.12,496.14,-0.1,True,1,10124,-495.67,-1545792.1,5018163.08,3472370.98
16871,1995-03-23,495.95,0.28,0.06,496.14,-0.04,True,1,10125,-495.95,-1546288.05,5021493.75,3475205.7
16872,1995-03-24,500.97,5.02,1.01,500.97,0.0,True,1,10126,-500.97,-1546789.02,5072822.22,3526033.2
16873,1995-03-27,503.2,2.23,0.44,503.2,0.0,True,1,10127,-503.2,-1547292.22,5095906.4,3548614.18
16874,1995-03-28,503.9,0.7,0.14,503.9,0.0,True,1,10128,-503.9,-1547796.12,5103499.2,3555703.08
16875,1995-03-29,503.12,-0.78,-0.16,503.9,-0.16,True,1,10129,-503.12,-1548299.24,5096102.48,3547803.24
16876,1995-03-30,502.22,-0.9,-0.18,503.9,-0.33,True,1,10130,-502.22,-1548801.46,5087488.6,3538687.14
16877,1995-03-31,500.71,-1.51,-0.3,503.9,-0.63,True,1,10131,-500.71,-1549302.17,5072693.01,3523390.84
16878,1995-04-03,501.85,1.14,0.23,503.9,-0.41,True,1,10132,-501.85,-1549804.02,5084744.2,3534940.18
16879,1995-04-04,505.24,3.39,0.68,505.24,0.0,True,1,10133,-505.24,-1550309.26,5119596.92,3569287.66
16880,1995-04-05,505.57,0.33,0.06,505.57,0.0,True,1,10134,-505.57,-1550814.83,5123446.38,3572631.55
16881,1995-04-06,506.08,0.51,0.1,506.08,0.0,True,1,10135,-506.08,-1551320.91,5129120.8,3577799.89
16882,1995-04-07,506.42,0.34,0.07,506.42,0.0,True,1,10136,-506.42,-1551827.33,5133073.12,3581245.79
16883,1995-04-10,507.01,0.59,0.12,507.01,0.0,True,1,10137,-507.01,-1552334.34,5139560.37,3587226.03
16884,1995-04-11,505.53,-1.48,-0.29,507.01,-0.29,True,1,10138,-505.53,-1552839.87,5125063.14,3572223.27
16885,1995-04-12,507.17,1.64,0.32,507.17,0.0,True,1,10139,-507.17,-1553347.04,5142196.63,3588849.59
16886,1995-04-13,509.23,2.06,0.41,509.23,0.0,True,1,10140,-509.23,-1553856.27,5163592.2,3609735.93
16887,1995-04-17,506.13,-3.1,-0.61,509.23,-0.61,True,1,10141,-506.13,-1554362.4,5132664.33,3578301.93
16888,1995-04-18,505.37,-0.76,-0.15,509.23,-0.76,True,1,10142,-505.37,-1554867.77,5125462.54,3570594.77
16889,1995-04-19,504.92,-0.45,-0.09,509.23,-0.85,True,1,10143,-504.92,-1555372.69,5121403.56,3566030.87
16890,1995-04-20,505.29,0.37,0.07,509.23,-0.77,True,1,10144,-505.29,-1555877.98,5125661.76,3569783.78
16891,1995-04-21,508.49,3.2,0.63,509.23,-0.14,True,1,10145,-508.49,-1556386.47,5158631.05,3602244.58
16892,1995-04-24,512.89,4.4,0.86,512.89,0.0,True,1,10146,-512.89,-1556899.36,5203781.94,3646882.58
16893,1995-04-25,512.1,-0.79,-0.15,512.89,-0.15,True,1,10147,-512.1,-1557411.46,5196278.7,3638867.24
16894,1995-04-26,512.66,0.56,0.11,512.89,-0.04,True,1,10148,-512.66,-1557924.12,5202473.68,3644549.56
16895,1995-04-27,513.55,0.89,0.17,513.55,0.0,True,1,10149,-513.55,-1558437.67,5212018.95,3653581.28
16896,1995-04-28,514.71,1.16,0.23,514.71,0.0,True,1,10150,-514.71,-1558952.38,5224306.5,3665354.12
16897,1995-05-01,514.26,-0.45,-0.09,514.71,-0.09,True,1,10151,-514.26,-1559466.64,5220253.26,3660786.62
16898,1995-05-02,514.86,0.6,0.12,514.86,0.0,True,1,10152,-514.86,-1559981.5,5226858.72,3666877.22
16899,1995-05-03,520.48,5.62,1.09,520.48,0.0,True,1,10153,-520.48,-1560501.98,5284433.44,3723931.46
16900,1995-05-04,520.54,0.06,0.01,520.54,0.0,True,1,10154,-520.54,-1561022.52,5285563.16,3724540.64
16901,1995-05-05,520.12,-0.42,-0.08,520.54,-0.08,True,1,10155,-520.12,-1561542.64,5281818.6,3720275.96
16902,1995-05-08,523.96,3.84,0.74,523.96,0.0,True,1,10156,-523.96,-1562066.6,5321337.76,3759271.16
16903,1995-05-09,523.56,-0.4,-0.08,523.96,-0.08,True,1,10157,-523.56,-1562590.16,5317798.92,3755208.76
16904,1995-05-10,524.36,0.8,0.15,524.36,0.0,True,1,10158,-524.36,-1563114.52,5326448.88,3763334.36
16905,1995-05-11,524.37,0.01,0.0,524.37,0.0,True,1,10159,-524.37,-1563638.89,5327074.83,3763435.94
16906,1995-05-12,525.55,1.18,0.22,525.55,0.0,True,1,10160,-525.55,-1564164.44,5339588.0,3775423.56
16907,1995-05-15,527.74,2.19,0.42,527.74,0.0,True,1,10161,-527.74,-1564692.18,5362366.14,3797673.96
16908,1995-05-16,528.19,0.45,0.08,528.19,0.0,True,1,10162,-528.19,-1565220.37,5367466.78,3802246.41
16909,1995-05-17,527.07,-1.12,-0.21,528.19,-0.21,True,1,10163,-527.07,-1565747.44,5356612.41,3790864.97
16910,1995-05-18,519.58,-7.49,-1.42,528.19,-1.63,True,1,10164,-519.58,-1566267.02,5281011.12,3714744.1
16911,1995-05-19,519.19,-0.39,-0.08,528.19,-1.7,True,1,10165,-519.19,-1566786.21,5277566.35,3710780.14
16912,1995-05-22,523.65,4.46,0.86,528.19,-0.86,True,1,10166,-523.65,-1567309.86,5323425.9,3756116.04
16913,1995-05-23,528.59,4.94,0.94,528.59,0.0,True,1,10167,-528.59,-1567838.45,5374174.53,3806336.08
16914,1995-05-24,528.61,0.02,0.0,528.61,0.0,True,1,10168,-528.61,-1568367.06,5374906.48,3806539.42
16915,1995-05-25,528.59,-0.02,-0.0,528.61,-0.0,True,1,10169,-528.59,-1568895.65,5375231.71,3806336.06
16916,1995-05-26,523.65,-4.94,-0.94,528.61,-0.94,True,1,10170,-523.65,-1569419.3,5325520.5,3756101.2
16917,1995-05-30,523.58,-0.07,-0.01,528.61,-0.95,True,1,10171,-523.58,-1569942.88,5325332.18,3755389.3
16918,1995-05-31,533.4,9.82,1.88,533.4,0.0,True,1,10172,-533.4,-1570476.28,5425744.8,3855268.52
16919,1995-06-01,533.49,0.09,0.02,533.49,0.0,True,1,10173,-533.49,-1571009.77,5427193.77,3856184.0
16920,1995-06-02,532.51,-0.98,-0.18,533.49,-0.18,True,1,10174,-532.51,-1571542.28,5417756.74,3846214.46
16921,1995-06-05,535.6,3.09,0.58,535.6,0.0,True,1,10175,-535.6,-1572077.88,5449730.0,3877652.12
16922,1995-06-06,535.55,-0.05,-0.01,535.6,-0.01,True,1,10176,-535.55,-1572613.43,5449756.8,3877143.37
16923,1995-06-07,533.13,-2.42,-0.45,535.6,-0.46,True,1,10177,-533.13,-1573146.56,5425664.01,3852517.45
16924,1995-06-08,532.35,-0.78,-0.15,535.6,-0.61,True,1,10178,-532.35,-1573678.91,5418258.3,3844579.39
16925,1995-06-09,527.94,-4.41,-0.83,535.6,-1.43,True,1,10179,-527.94,-1574206.85,5373901.26,3799694.41
16926,1995-06-12,530.88,2.94,0.56,535.6,-0.88,True,1,10180,-530.88,-1574737.73,5404358.4,3829620.67
16927,1995-06-13,536.05,5.17,0.97,536.05,0.0,True,1,10181,-536.05,-1575273.78,5457525.05,3882251.27
16928,1995-06-14,536.47,0.42,0.08,536.47,0.0,True,1,10182,-536.47,-1575810.25,5462337.54,3886527.29
16929,1995-06-15,537.12,0.65,0.12,537.12,0.0,True,1,10183,-537.12,-1576347.37,5469492.96,3893145.59
16930,1995-06-16,539.83,2.71,0.5,539.83,0.0,True,1,10184,-539.83,-1576887.2,5497628.72,3920741.52
16931,1995-06-19,545.22,5.39,1.0,545.22,0.0,True,1,10185,-545.22,-1577432.42,5553065.7,3975633.28
16932,1995-06-20,544.98,-0.24,-0.04,545.22,-0.04,True,1,10186,-544.98,-1577977.4,5551166.28,3973188.88
16933,1995-06-21,543.98,-1.0,-0.18,545.22,-0.23,True,1,10187,-543.98,-1578521.38,5541524.26,3963002.88
16934,1995-06-22,551.07,7.09,1.3,551.07,0.0,True,1,10188,-551.07,-1579072.45,5614301.16,4035228.71
16935,1995-06-23,549.71,-1.36,-0.25,551.07,-0.25,True,1,10189,-549.71,-1579622.16,5600995.19,4021373.03
16936,1995-06-26,544.13,-5.58,-1.01,551.07,-1.26,True,1,10190,-544.13,-1580166.29,5544684.7,3964518.41
16937,1995-06-27,542.43,-1.7,-0.31,551.07,-1.57,True,1,10191,-542.43,-1580708.72,5527904.13,3947195.41
16938,1995-06-28,544.73,2.3,0.42,551.07,-1.15,True,1,10192,-544.73,-1581253.45,5551888.16,3970634.71
16939,1995-06-29,543.87,-0.86,-0.16,551.07,-1.31,True,1,10193,-543.87,-1581797.32,5543666.91,3961869.59
16940,1995-06-30,544.75,0.88,0.16,551.07,-1.15,True,1,10194,-544.75,-1582342.07,5553181.5,3970839.43
16941,1995-07-03,547.09,2.34,0.43,551.07,-0.72,True,1,10195,-547.09,-1582889.16,5577582.55,3994693.39
16942,1995-07-05,547.26,0.17,0.03,551.07,-0.69,True,1,10196,-547.26,-1583436.42,5579862.96,3996426.54
16943,1995-07-06,553.99,6.73,1.23,553.99,0.0,True,1,10197,-553.99,-1583990.41,5649036.03,4065045.62
16944,1995-07-07,556.37,2.38,0.43,556.37,0.0,True,1,10198,-556.37,-1584546.78,5673861.26,4089314.48
16945,1995-07-10,557.19,0.82,0.15,557.19,0.0,True,1,10199,-557.19,-1585103.97,5682780.81,4097676.84
16946,1995-07-11,554.78,-2.41,-0.43,557.19,-0.43,True,1,10200,-554.78,-1585658.75,5658756.0,4073097.25
16947,1995-07-12,560.89,6.11,1.1,560.89,0.0,True,1,10201,-560.89,-1586219.64,5721638.89,4135419.25
16948,1995-07-13,561.0,0.11,0.02,561.0,0.0,True,1,10202,-561.0,-1586780.64,5723322.0,4136541.36
16949,1995-07-14,559.89,-1.11,-0.2,561.0,-0.2,True,1,10203,-559.89,-1587340.53,5712557.67,4125217.14
16950,1995-07-17,562.72,2.83,0.5,562.72,0.0,True,1,10204,-562.72,-1587903.25,5741994.88,4154091.63
16951,1995-07-18,558.46,-4.26,-0.76,562.72,-0.76,True,1,10205,-558.46,-1588461.71,5699084.3,4110622.59
16952,1995-07-19,550.98,-7.48,-1.34,562.72,-2.09,True,1,10206,-550.98,-1589012.69,5623301.88,4034289.19
16953,1995-07-20,553.54,2.56,0.46,562.72,-1.63,True,1,10207,-553.54,-1589566.23,5649982.78,4060416.55
16954,1995-07-21,553.62,0.08,0.01,562.72,-1.62,True,1,10208,-553.62,-1590119.85,5651352.96,4061233.11
16955,1995-07-24,556.63,3.01,0.54,562.72,-1.08,True,1,10209,-556.63,-1590676.48,5682635.67,4091959.19
16956,1995-07-25,561.1,4.47,0.8,562.72,-0.29,True,1,10210,-561.1,-1591237.58,5728831.0,4137593.42
16957,1995-07-26,561.61,0.51,0.09,562.72,-0.2,True,1,10211,-561.61,-1591799.19,5734599.71,4142800.52
16958,1995-07-27,565.22,3.61,0.64,565.22,0.0,True,1,10212,-565.22,-1592364.41,5772026.64,4179662.23
16959,1995-07-28,562.93,-2.29,-0.4,565.22,-0.4,True,1,10213,-562.93,-1592927.34,5749204.09,4156276.75
16960,1995-07-31,562.06,-0.87,-0.16,565.22,-0.56,True,1,10214,-562.06,-1593489.4,5740880.84,4147391.44
16961,1995-08-01,559.64,-2.42,-0.43,565.22,-0.99,True,1,10215,-559.64,-1594049.04,5716722.6,4122673.56
16962,1995-08-02,558.8,-0.84,-0.15,565.22,-1.14,True,1,10216,-558.8,-1594607.84,5708700.8,4114092.96
16963,1995-08-03,558.75,-0.05,-0.01,565.22,-1.14,True,1,10217,-558.75,-1595166.59,5708748.75,4113582.16
16964,1995-08-04,558.94,0.19,0.03,565.22,-1.11,True,1,10218,-558.94,-1595725.53,5711248.92,4115523.39
16965,1995-08-07,560.03,1.09,0.2,565.22,-0.92,True,1,10219,-560.03,-1596285.56,5722946.57,4126661.01
16966,1995-08-08,560.39,0.36,0.06,565.22,-0.86,True,1,10220,-560.39,-1596845.95,5727185.8,4130339.85
16967,1995-08-09,559.71,-0.68,-0.12,565.22,-0.98,True,1,10221,-559.71,-1597405.66,5720795.91,4123390.25
16968,1995-08-10,557.45,-2.26,-0.4,565.22,-1.38,True,1,10222,-557.45,-1597963.11,5698253.9,4100290.79
16969,1995-08-11,555.11,-2.34,-0.42,565.22,-1.79,True,1,10223,-555.11,-1598518.22,5674889.53,4076371.31
16970,1995-08-14,559.74,4.63,0.83,565.22,-0.97,True,1,10224,-559.74,-1599077.96,5722781.76,4123703.8
16971,1995-08-15,558.57,-1.17,-0.21,565.22,-1.18,True,1,10225,-558.57,-1599636.53,5711378.25,4111741.72
16972,1995-08-16,559.97,1.4,0.25,565.22,-0.93,True,1,10226,-559.97,-1600196.5,5726253.22,4126056.72
16973,1995-08-17,559.04,-0.93,-0.17,565.22,-1.09,True,1,10227,-559.04,-1600755.54,5717302.08,4116546.54
16974,1995-08-18,559.21,0.17,0.03,565.22,-1.06,True,1,10228,-559.21,-1601314.75,5719599.88,4118285.13
16975,1995-08-21,558.11,-1.1,-0.2,565.22,-1.26,True,1,10229,-558.11,-1601872.86,5708907.19,4107034.33
16976,1995-08-22,559.52,1.41,0.25,565.22,-1.01,True,1,10230,-559.52,-1602432.38,5723889.6,4121457.22
16977,1995-08-23,557.14,-2.38,-0.42,565.22,-1.43,True,1,10231,-557.14,-1602989.52,5700099.34,4097109.82
16978,1995-08-24,557.46,0.32,0.06,565.22,-1.37,True,1,10232,-557.46,-1603546.98,5703930.72,4100383.74
16979,1995-08-25,560.1,2.64,0.47,565.22,-0.91,True,1,10233,-560.1,-1604107.08,5731503.3,4127396.22
16980,1995-08-28,559.05,-1.05,-0.19,565.22,-1.09,True,1,10234,-559.05,-1604666.13,5721317.7,4116651.57
16981,1995-08-29,560.0,0.95,0.17,565.22,-0.92,True,1,10235,-560.0,-1605226.13,5731600.0,4126373.87
16982,1995-08-30,560.92,0.92,0.16,565.22,-0.76,True,1,10236,-560.92,-1605787.05,5741577.12,4135790.07
16983,1995-08-31,561.88,0.96,0.17,565.22,-0.59,True,1,10237,-561.88,-1606348.93,5751965.56,4145616.63
16984,1995-09-01,563.84,1.96,0.35,565.22,-0.24,True,1,10238,-563.84,-1606912.77,5772593.92,4165681.15
16985,1995-09-05,569.17,5.33,0.94,569.17,0.0,True,1,10239,-569.17,-1607481.94,5827731.63,4220249.69
16986,1995-09-06,570.17,1.0,0.18,570.17,0.0,True,1,10240,-570.17,-1608052.11,5838540.8,4230488.69
16987,1995-09-07,570.29,0.12,0.02,570.29,0.0,True,1,10241,-570.29,-1608622.4,5840339.89,4231717.49
16988,1995-09-08,572.68,2.39,0.42,572.68,0.0,True,1,10242,-572.68,-1609195.08,5865388.56,4256193.48
16989,1995-09-11,573.91,1.23,0.22,573.91,0.0,True,1,10243,-573.91,-1609768.99,5878560.13,4268791.14
16990,1995-09-12,576.51,2.6,0.45,576.51,0.0,True,1,10244,-576.51,-1610345.5,5905768.44,4295422.94
16991,1995-09-13,578.77,2.26,0.39,578.77,0.0,True,1,10245,-578.77,-1610924.27,5929498.65,4318574.38
16992,1995-09-14,583.61,4.84,0.84,583.61,0.0,True,1,10246,-583.61,-1611507.88,5979668.06,4368160.18
16993,1995-09-15,583.35,-0.26,-0.04,583.61,-0.04,True,1,10247,-583.35,-1612091.23,5977587.45,4365496.22
16994,1995-09-18,582.77,-0.58,-0.1,583.61,-0.14,True,1,10248,-582.77,-1612674.0,5972226.96,4359552.96
16995,1995-09-19,584.2,1.43,0.24,584.2,0.0,True,1,10249,-584.2,-1613258.2,5987465.8,4374207.6
16996,1995-09-20,586.77,2.57,0.44,586.77,0.0,True,1,10250,-586.77,-1613844.97,6014392.5,4400547.53
16997,1995-09-21,583.0,-3.77,-0.64,586.77,-0.64,True,1,10251,-583.0,-1614427.97,5976333.0,4361905.03
16998,1995-09-22,581.73,-1.27,-0.22,586.77,-0.86,True,1,10252,-581.73,-1615009.7,5963895.96,4348886.26
16999,1995-09-25,581.81,0.08,0.01,586.77,-0.84,True,1,10253,-581.81,-1615591.51,5965297.93,4349706.42
17000,1995-09-26,581.41,-0.4,-0.07,586.77,-0.91,True,1,10254,-581.41,-1616172.92,5961778.14,4345605.22
17001,1995-09-27,581.04,-0.37,-0.06,586.77,-0.98,True,1,10255,-581.04,-1616753.96,5958565.2,4341811.24
17002,1995-09-28,585.87,4.83,0.83,586.77,-0.15,True,1,10256,-585.87,-1617339.83,6008682.72,4391342.89
17003,1995-09-29,584.41,-1.46,-0.25,586.77,-0.4,True,1,10257,-584.41,-1617924.24,5994293.37,4376369.13
17004,1995-10-02,581.72,-2.69,-0.46,586.77,-0.86,True,1,10258,-581.72,-1618505.96,5967283.76,4348777.8
17005,1995-10-03,582.34,0.62,0.11,586.77,-0.76,True,1,10259,-582.34,-1619088.3,5974226.06,4355137.76
17006,1995-10-04,581.47,-0.87,-0.15,586.77,-0.9,True,1,10260,-581.47,-1619669.77,5965882.2,4346212.43
17007,1995-10-05,582.63,1.16,0.2,586.77,-0.71,True,1,10261,-582.63,-1620252.4,5978366.43,4358114.03
17008,1995-10-06,582.49,-0.14,-0.02,586.77,-0.73,True,1,10262,-582.49,-1620834.89,5977512.38,4356677.49
17009,1995-10-09,578.37,-4.12,-0.71,586.77,-1.43,True,1,10263,-578.37,-1621413.26,5935811.31,4314398.05
17010,1995-10-10,577.52,-0.85,-0.15,586.77,-1.58,True,1,10264,-577.52,-1621990.78,5927665.28,4305674.5
17011,1995-10-11,579.46,1.94,0.34,586.77,-1.25,True,1,10265,-579.46,-1622570.24,5948156.9,4325586.66
17012,1995-10-12,583.1,3.64,0.63,586.77,-0.62,True,1,10266,-583.1,-1623153.34,5986104.6,4362951.26
17013,1995-10-13,584.5,1.4,0.24,586.77,-0.39,True,1,10267,-584.5,-1623737.84,6001061.5,4377323.66
17014,1995-10-16,583.03,-1.47,-0.25,586.77,-0.64,True,1,10268,-583.03,-1624320.87,5986552.04,4362231.17
17015,1995-10-17,586.78,3.75,0.64,586.78,0.0,True,1,10269,-586.78,-1624907.65,6025643.82,4400736.17
17016,1995-10-18,587.44,0.66,0.11,587.44,0.0,True,1,10270,-587.44,-1625495.09,6033008.8,4407513.71
17017,1995-10-19,590.65,3.21,0.55,590.65,0.0,True,1,10271,-590.65,-1626085.74,6066566.15,4440480.41
17018,1995-10-20,587.46,-3.19,-0.54,590.65,-0.54,True,1,10272,-587.46,-1626673.2,6034389.12,4407715.92
17019,1995-10-23,585.06,-2.4,-0.41,590.65,-0.95,True,1,10273,-585.06,-1627258.26,6010321.38,4383063.12
17020,1995-10-24,586.54,1.48,0.25,590.65,-0.7,True,1,10274,-586.54,-1627844.8,6026111.96,4398267.16
17021,1995-10-25,582.47,-4.07,-0.69,590.65,-1.38,True,1,10275,-582.47,-1628427.27,5984879.25,4356451.98
17022,1995-10-26,576.72,-5.75,-0.99,590.65,-2.36,True,1,10276,-576.72,-1629003.99,5926374.72,4297370.73
17023,1995-10-27,579.7,2.98,0.52,590.65,-1.85,True,1,10277,-579.7,-1629583.69,5957576.9,4327993.21
17024,1995-10-30,583.25,3.55,0.61,590.65,-1.25,True,1,10278,-583.25,-1630166.94,5994643.5,4364476.56
17025,1995-10-31,581.5,-1.75,-0.3,590.65,-1.55,True,1,10279,-581.5,-1630748.44,5977238.5,4346490.06
17026,1995-11-01,584.22,2.72,0.47,590.65,-1.09,True,1,10280,-584.22,-1631332.66,6005781.6,4374448.94
17027,1995-11-02,589.72,5.5,0.94,590.65,-0.16,True,1,10281,-589.72,-1631922.38,6062911.32,4430988.94
17028,1995-11-03,590.57,0.85,0.14,590.65,-0.01,True,1,10282,-590.57,-1632512.95,6072240.74,4439727.79
17029,1995-11-06,588.46,-2.11,-0.36,590.65,-0.37,True,1,10283,-588.46,-1633101.41,6051134.18,4418032.77
17030,1995-11-07,586.32,-2.14,-0.36,590.65,-0.73,True,1,10284,-586.32,-1633687.73,6029714.88,4396027.15
17031,1995-11-08,591.71,5.39,0.92,591.71,0.0,True,1,10285,-591.71,-1634279.44,6085737.35,4451457.91
17032,1995-11-09,593.26,1.55,0.26,593.26,0.0,True,1,10286,-593.26,-1634872.7,6102272.36,4467399.66
17033,1995-11-10,592.72,-0.54,-0.09,593.26,-0.09,True,1,10287,-592.72,-1635465.42,6097310.64,4461845.22
17034,1995-11-13,592.3,-0.42,-0.07,593.26,-0.16,True,1,10288,-592.3,-1636057.72,6093582.4,4457524.68
17035,1995-11-14,589.29,-3.01,-0.51,593.26,-0.67,True,1,10289,-589.29,-1636647.01,6063204.81,4426557.8
17036,1995-11-15,593.96,4.67,0.79,593.96,0.0,True,1,10290,-593.96,-1637240.97,6111848.4,4474607.43
17037,1995-11-16,597.34,3.38,0.57,597.34,0.0,True,1,10291,-597.34,-1637838.31,6147225.94,4509387.63
17038,1995-11-17,600.07,2.73,0.46,600.07,0.0,True,1,10292,-600.07,-1638438.38,6175920.44,4537482.06
17039,1995-11-20,596.85,-3.22,-0.54,600.07,-0.54,True,1,10293,-596.85,-1639035.23,6143377.05,4504341.82
17040,1995-11-21,600.24,3.39,0.57,600.24,0.0,True,1,10294,-600.24,-1639635.47,6178870.56,4539235.09
17041,1995-11-22,598.4,-1.84,-0.31,600.24,-0.31,True,1,10295,-598.4,-1640233.87,6160528.0,4520294.13
17042,1995-11-24,599.97,1.57,0.26,600.24,-0.04,True,1,10296,-599.97,-1640833.84,6177291.12,4536457.28
17043,1995-11-27,601.32,1.35,0.22,601.32,0.0,True,1,10297,-601.32,-1641435.16,6191792.04,4550356.88
17044,1995-11-28,606.45,5.13,0.85,606.45,0.0,True,1,10298,-606.45,-1642041.61,6245222.1,4603180.49
17045,1995-11-29,607.64,1.19,0.2,607.64,0.0,True,1,10299,-607.64,-1642649.25,6258084.36,4615435.11
17046,1995-11-30,605.37,-2.27,-0.37,607.64,-0.37,True,1,10300,-605.37,-1643254.62,6235311.0,4592056.38
17047,1995-12-01,606.98,1.61,0.27,607.64,-0.11,True,1,10301,-606.98,-1643861.6,6252500.98,4608639.38
17048,1995-12-04,613.68,6.7,1.1,613.68,0.0,True,1,10302,-613.68,-1644475.28,6322131.36,4677656.08
17049,1995-12-05,617.68,4.0,0.65,617.68,0.0,True,1,10303,-617.68,-1645092.96,6363957.04,4718864.08
17050,1995-12-06,620.18,2.5,0.4,620.18,0.0,True,1,10304,-620.18,-1645713.14,6390334.72,4744621.58
17051,1995-12-07,616.17,-4.01,-0.65,620.18,-0.65,True,1,10305,-616.17,-1646329.31,6349631.85,4703302.54
17052,1995-12-08,617.48,1.31,0.21,620.18,-0.44,True,1,10306,-617.48,-1646946.79,6363748.88,4716802.09
17053,1995-12-11,619.52,2.04,0.33,620.18,-0.11,True,1,10307,-619.52,-1647566.31,6385392.64,4737826.33
17054,1995-12-12,618.78,-0.74,-0.12,620.18,-0.23,True,1,10308,-618.78,-1648185.09,6378384.24,4730199.15
17055,1995-12-13,621.69,2.91,0.47,621.69,0.0,True,1,10309,-621.69,-1648806.78,6409002.21,4760195.43
17056,1995-12-14,616.92,-4.77,-0.77,621.69,-0.77,True,1,10310,-616.92,-1649423.7,6360445.2,4711021.5
17057,1995-12-15,616.34,-0.58,-0.09,621.69,-0.86,True,1,10311,-616.34,-1650040.04,6355081.74,4705041.7
17058,1995-12-18,606.81,-9.53,-1.55,621.69,-2.39,True,1,10312,-606.81,-1650646.85,6257424.72,4606777.87
17059,1995-12-19,611.93,5.12,0.84,621.69,-1.57,True,1,10313,-611.93,-1651258.78,6310834.09,4659575.31
17060,1995-12-20,605.94,-5.99,-0.98,621.69,-2.53,True,1,10314,-605.94,-1651864.72,6249665.16,4597800.44
17061,1995-12-21,610.49,4.55,0.75,621.69,-1.8,True,1,10315,-610.49,-1652475.21,6297204.35,4644729.14
17062,1995-12-22,611.95,1.46,0.24,621.69,-1.57,True,1,10316,-611.95,-1653087.16,6312876.2,4659789.04
17063,1995-12-26,614.3,2.35,0.38,621.69,-1.19,True,1,10317,-614.3,-1653701.46,6337733.1,4684031.64
17064,1995-12-27,614.53,0.23,0.04,621.69,-1.15,True,1,10318,-614.53,-1654315.99,6340720.54,4686404.55
17065,1995-12-28,614.12,-0.41,-0.07,621.69,-1.22,True,1,10319,-614.12,-1654930.11,6337104.28,4682174.17
17066,1995-12-29,615.93,1.81,0.3,621.69,-0.93,True,1,10320,-615.93,-1655546.04,6356397.6,4700851.56
17067,1996-01-02,620.73,4.8,0.78,621.69,-0.15,True,1,10321,-620.73,-1656166.77,6406554.33,4750387.56
17068,1996-01-03,621.32,0.59,0.1,621.69,-0.06,True,1,10322,-621.32,-1656788.09,6413265.04,4756476.95
17069,1996-01-04,617.7,-3.62,-0.58,621.69,-0.64,True,1,10323,-617.7,-1657405.79,6376517.1,4719111.31
17070,1996-01-05,616.71,-0.99,-0.16,621.69,-0.8,True,1,10324,-616.71,-1658022.5,6366914.04,4708891.54
17071,1996-01-08,618.46,1.75,0.28,621.69,-0.52,True,1,10325,-618.46,-1658640.96,6385599.5,4726958.54
17072,1996-01-09,609.45,-9.01,-1.46,621.69,-1.97,True,1,10326,-609.45,-1659250.41,6293180.7,4633930.29
17073,1996-01-10,598.48,-10.97,-1.8,621.69,-3.73,True,1,10327,-598.48,-1659848.89,6180502.96,4520654.07
17074,1996-01-11,602.69,4.21,0.7,621.69,-3.06,True,1,10328,-602.69,-1660451.58,6224582.32,4564130.74
17075,1996-01-12,601.81,-0.88,-0.15,621.69,-3.2,True,1,10329,-601.81,-1661053.39,6216095.49,4555042.1
17076,1996-01-15,599.82,-1.99,-0.33,621.69,-3.52,True,1,10330,-599.82,-1661653.21,6196140.6,4534487.39
17077,1996-01-16,608.44,8.62,1.44,621.69,-2.13,True,1,10331,-608.44,-1662261.65,6285793.64,4623531.99
17078,1996-01-17,606.37,-2.07,-0.34,621.69,-2.46,True,1,10332,-606.37,-1662868.02,6265014.84,4602146.82
17079,1996-01-18,608.24,1.87,0.31,621.69,-2.16,True,1,10333,-608.24,-1663476.26,6284943.92,4621467.66
17080,1996-01-19,611.83,3.59,0.59,621.69,-1.59,True,1,10334,-611.83,-1664088.09,6322651.22,4658563.13
17081,1996-01-22,613.4,1.57,0.26,621.69,-1.33,True,1,10335,-613.4,-1664701.49,6339489.0,4674787.51
17082,1996-01-23,612.79,-0.61,-0.1,621.69,-1.43,True,1,10336,-612.79,-1665314.28,6333797.44,4668483.16
17083,1996-01-24,619.96,7.17,1.17,621.69,-0.28,True,1,10337,-619.96,-1665934.24,6408526.52,4742592.28
17084,1996-01-25,617.03,-2.93,-0.47,621.69,-0.75,True,1,10338,-617.03,-1666551.27,6378856.14,4712304.87
17085,1996-01-26,621.62,4.59,0.74,621.69,-0.01,True,1,10339,-621.62,-1667172.89,6426929.18,4759756.29
17086,1996-01-29,624.22,2.6,0.42,624.22,0.0,True,1,10340,-624.22,-1667797.11,6454434.8,4786637.69
17087,1996-01-30,630.15,5.93,0.95,630.15,0.0,True,1,10341,-630.15,-1668427.26,6516381.15,4847953.89
17088,1996-01-31,636.02,5.87,0.93,636.02,0.0,True,1,10342,-636.02,-1669063.28,6577718.84,4908655.56
17089,1996-02-01,638.46,2.44,0.38,638.46,0.0,True,1,10343,-638.46,-1669701.74,6603591.78,4933890.04
17090,1996-02-02,635.84,-2.62,-0.41,638.46,-0.41,True,1,10344,-635.84,-1670337.58,6577128.96,4906791.38
17091,1996-02-05,641.43,5.59,0.88,641.43,0.0,True,1,10345,-641.43,-1670979.01,6635593.35,4964614.34
17092,1996-02-06,646.33,4.9,0.76,646.33,0.0,True,1,10346,-646.33,-1671625.34,6686930.18,5015304.84
17093,1996-02-07,649.93,3.6,0.56,649.93,0.0,True,1,10347,-649.93,-1672275.27,6724825.71,5052550.44
17094,1996-02-08,656.07,6.14,0.94,656.07,0.0,True,1,10348,-656.07,-1672931.34,6789012.36,5116081.02
17095,1996-02-09,656.37,0.3,0.05,656.37,0.0,True,1,10349,-656.37,-1673587.71,6792773.13,5119185.42
17096,1996-02-12,661.45,5.08,0.77,661.45,0.0,True,1,10350,-661.45,-1674249.16,6846007.5,5171758.34
17097,1996-02-13,660.51,-0.94,-0.14,661.45,-0.14,True,1,10351,-660.51,-1674909.67,6836939.01,5162029.34
17098,1996-02-14,655.58,-4.93,-0.75,661.45,-0.89,True,1,10352,-655.58,-1675565.25,6786564.16,5110998.91
17099,1996-02-15,651.32,-4.26,-0.65,661.45,-1.53,True,1,10353,-651.32,-1676216.57,6743115.96,5066899.39
17100,1996-02-16,647.98,-3.34,-0.51,661.45,-2.04,True,1,10354,-647.98,-1676864.55,6709184.92,5032320.37
17101,1996-02-20,640.65,-7.33,-1.13,661.45,-3.14,True,1,10355,-640.65,-1677505.2,6633930.75,4956425.55
17102,1996-02-21,648.1,7.45,1.16,661.45,-2.02,True,1,10356,-648.1,-1678153.3,6711723.6,5033570.3
17103,1996-02-22,658.86,10.76,1.66,661.45,-0.39,True,1,10357,-658.86,-1678812.16,6823813.02,5145000.86
17104,1996-02-23,659.08,0.22,0.03,661.45,-0.36,True,1,10358,-659.08,-1679471.24,6826750.64,5147279.4
17105,1996-02-26,650.46,-8.62,-1.31,661.45,-1.66,True,1,10359,-650.46,-1680121.7,6738115.14,5057993.44
17106,1996-02-27,647.24,-3.22,-0.5,661.45,-2.15,True,1,10360,-647.24,-1680768.94,6705406.4,5024637.46
17107,1996-02-28,644.75,-2.49,-0.38,661.45,-2.52,True,1,10361,-644.75,-1681413.69,6680254.75,4998841.06
17108,1996-02-29,640.43,-4.32,-0.67,661.45,-3.18,True,1,10362,-640.43,-1682054.12,6636135.66,4954081.54
17109,1996-03-01,644.37,3.94,0.62,661.45,-2.58,True,1,10363,-644.37,-1682698.49,6677606.31,4994907.82
17110,1996-03-04,650.81,6.44,1.0,661.45,-1.61,True,1,10364,-650.81,-1683349.3,6744994.84,5061645.54
17111,1996-03-05,655.79,4.98,0.76,661.45,-0.86,True,1,10365,-655.79,-1684005.09,6797263.35,5113258.26
17112,1996-03-06,652.0,-3.79,-0.58,661.45,-1.43,True,1,10366,-652.0,-1684657.09,6758632.0,5073974.91
17113,1996-03-07,653.65,1.65,0.25,661.45,-1.18,True,1,10367,-653.65,-1685310.74,6776389.55,5091078.81
17114,1996-03-08,633.5,-20.15,-3.08,661.45,-4.23,True,1,10368,-633.5,-1685944.24,6568128.0,4882183.76
17115,1996-03-11,640.02,6.52,1.03,661.45,-3.24,True,1,10369,-640.02,-1686584.26,6636367.38,4949783.12
17116,1996-03-12,637.09,-2.93,-0.46,661.45,-3.68,True,1,10370,-637.09,-1687221.35,6606623.3,4919401.95
17117,1996-03-13,638.55,1.46,0.23,661.45,-3.46,True,1,10371,-638.55,-1687859.9,6622402.05,4934542.15
17118,1996-03-14,640.87,2.32,0.36,661.45,-3.11,True,1,10372,-640.87,-1688500.77,6647103.64,4958602.87
17119,1996-03-15,641.43,0.56,0.09,661.45,-3.03,True,1,10373,-641.43,-1689142.2,6653553.39,4964411.19
17120,1996-03-18,652.65,11.22,1.75,661.45,-1.33,True,1,10374,-652.65,-1689794.85,6770591.1,5080796.25
17121,1996-03-19,651.69,-0.96,-0.15,661.45,-1.48,True,1,10375,-651.69,-1690446.54,6761283.75,5070837.21
17122,1996-03-20,649.98,-1.71,-0.26,661.45,-1.73,True,1,10376,-649.98,-1691096.52,6744192.48,5053095.96
17123,1996-03-21,649.19,-0.79,-0.12,661.45,-1.85,True,1,10377,-649.19,-1691745.71,6736644.63,5044898.92
17124,1996-03-22,650.62,1.43,0.22,661.45,-1.64,True,1,10378,-650.62,-1692396.33,6752134.36,5059738.03
17125,1996-03-25,650.04,-0.58,-0.09,661.45,-1.72,True,1,10379,-650.04,-1693046.37,6746765.16,5053718.79
17126,1996-03-26,652.97,2.93,0.45,661.45,-1.28,True,1,10380,-652.97,-1693699.34,6777828.6,5084129.26
17127,1996-03-27,648.91,-4.06,-0.62,661.45,-1.9,True,1,10381,-648.91,-1694348.25,6736334.71,5041986.46
17128,1996-03-28,648.94,0.03,0.0,661.45,-1.89,True,1,10382,-648.94,-1694997.19,6737295.08,5042297.89
17129,1996-03-29,645.5,-3.44,-0.53,661.45,-2.41,True,1,10383,-645.5,-1695642.69,6702226.5,5006583.81
17130,1996-04-01,653.73,8.23,1.27,661.45,-1.17,True,1,10384,-653.73,-1696296.42,6788332.32,5092035.9
17131,1996-04-02,655.26,1.53,0.23,661.45,-0.94,True,1,10385,-655.26,-1696951.68,6804875.1,5107923.42
17132,1996-04-03,655.88,0.62,0.1,661.45,-0.84,True,1,10386,-655.88,-1697607.56,6811969.68,5114362.12
17133,1996-04-04,655.86,-0.02,-0.0,661.45,-0.84,True,1,10387,-655.86,-1698263.42,6812417.82,5114154.4
17134,1996-04-08,644.24,-11.62,-1.77,661.45,-2.6,True,1,10388,-644.24,-1698907.66,6692365.12,4993457.46
17135,1996-04-09,642.19,-2.05,-0.32,661.45,-2.91,True,1,10389,-642.19,-1699549.85,6671711.91,4972162.06
17136,1996-04-10,633.5,-8.69,-1.35,661.45,-4.23,True,1,10390,-633.5,-1700183.35,6582065.0,4881881.65
17137,1996-04-11,631.18,-2.32,-0.37,661.45,-4.58,True,1,10391,-631.18,-1700814.53,6558591.38,4857776.85
17138,1996-04-12,636.71,5.53,0.88,661.45,-3.74,True,1,10392,-636.71,-1701451.24,6616690.32,4915239.08
17139,1996-04-15,642.49,5.78,0.91,661.45,-2.87,True,1,10393,-642.49,-1702093.73,6677398.57,4975304.84
17140,1996-04-16,645.0,2.51,0.39,661.45,-2.49,True,1,10394,-645.0,-1702738.73,6704130.0,5001391.27
17141,1996-04-17,641.61,-3.39,-0.53,661.45,-3.0,True,1,10395,-641.61,-1703380.34,6669535.95,4966155.61
17142,1996-04-18,643.61,2.0,0.31,661.45,-2.7,True,1,10396,-643.61,-1704023.95,6690969.56,4986945.61
17143,1996-04-19,645.07,1.46,0.23,661.45,-2.48,True,1,10397,-645.07,-1704669.02,6706792.79,5002123.77
17144,1996-04-22,647.89,2.82,0.44,661.45,-2.05,True,1,10398,-647.89,-1705316.91,6736760.22,5031443.31
17145,1996-04-23,651.58,3.69,0.57,661.45,-1.49,True,1,10399,-651.58,-1705968.49,6775780.42,5069811.93
17146,1996-04-24,650.17,-1.41,-0.22,661.45,-1.7,True,1,10400,-650.17,-1706618.66,6761768.0,5055149.34
17147,1996-04-25,652.87,2.7,0.42,661.45,-1.3,True,1,10401,-652.87,-1707271.53,6790500.87,5083229.34
17148,1996-04-26,653.46,0.59,0.09,661.45,-1.21,True,1,10402,-653.46,-1707924.99,6797290.92,5089365.93
17149,1996-04-29,654.16,0.7,0.11,661.45,-1.1,True,1,10403,-654.16,-1708579.15,6805226.48,5096647.33
17150,1996-04-30,654.17,0.01,0.0,661.45,-1.1,True,1,10404,-654.17,-1709233.32,6805984.68,5096751.36
17151,1996-05-01,654.58,0.41,0.06,661.45,-1.04,True,1,10405,-654.58,-1709887.9,6810904.9,5101017.0
17152,1996-05-02,643.38,-11.2,-1.71,661.45,-2.73,True,1,10406,-643.38,-1710531.28,6695012.28,4984481.0
17153,1996-05-03,641.63,-1.75,-0.27,661.45,-3.0,True,1,10407,-641.63,-1711172.91,6677443.41,4966270.5
17154,1996-05-06,640.81,-0.82,-0.13,661.45,-3.12,True,1,10408,-640.81,-1711813.72,6669550.48,4957736.76
17155,1996-05-07,638.26,-2.55,-0.4,661.45,-3.51,True,1,10409,-638.26,-1712451.98,6643648.34,4931196.36
17156,1996-05-08,644.77,6.51,1.02,661.45,-2.52,True,1,10410,-644.77,-1713096.75,6712055.7,4998958.95
17157,1996-05-09,645.44,0.67,0.1,661.45,-2.42,True,1,10411,-645.44,-1713742.19,6719675.84,5005933.65
17158,1996-05-10,652.09,6.65,1.03,661.45,-1.42,True,1,10412,-652.09,-1714394.28,6789561.08,5075166.8
17159,1996-05-13,661.51,9.42,1.44,661.51,0.0,True,1,10413,-661.51,-1715055.79,6888303.63,5173247.84
17160,1996-05-14,665.6,4.09,0.62,665.6,0.0,True,1,10414,-665.6,-1715721.39,6931558.4,5215837.01
17161,1996-05-15,665.42,-0.18,-0.03,665.6,-0.03,True,1,10415,-665.42,-1716386.81,6930349.3,5213962.49
17162,1996-05-16,664.85,-0.57,-0.09,665.6,-0.11,True,1,10416,-664.85,-1717051.66,6925077.6,5208025.94
17163,1996-05-17,668.91,4.06,0.61,668.91,0.0,True,1,10417,-668.91,-1717720.57,6968035.47,5250314.9
17164,1996-05-20,673.15,4.24,0.63,673.15,0.0,True,1,10418,-673.15,-1718393.72,7012876.7,5294482.98
17165,1996-05-21,672.76,-0.39,-0.06,673.15,-0.06,True,1,10419,-672.76,-1719066.48,7009486.44,5290419.96
17166,1996-05-22,678.42,5.66,0.84,678.42,0.0,True,1,10420,-678.42,-1719744.9,7069136.4,5349391.5
17167,1996-05-23,676.0,-2.42,-0.36,678.42,-0.36,True,1,10421,-676.0,-1720420.9,7044596.0,5324175.1
17168,1996-05-24,678.51,2.51,0.37,678.51,0.0,True,1,10422,-678.51,-1721099.41,7071431.22,5350331.81
17169,1996-05-28,672.23,-6.28,-0.93,678.51,-0.93,True,1,10423,-672.23,-1721771.64,7006653.29,5284881.65
17170,1996-05-29,667.93,-4.3,-0.64,678.51,-1.56,True,1,10424,-667.93,-1722439.57,6962502.32,5240062.75
17171,1996-05-30,671.7,3.77,0.56,678.51,-1.0,True,1,10425,-671.7,-1723111.27,7002472.5,5279361.23
17172,1996-05-31,669.12,-2.58,-0.38,678.51,-1.38,True,1,10426,-669.12,-1723780.39,6976245.12,5252464.73
17173,1996-06-03,667.68,-1.44,-0.22,678.51,-1.6,True,1,10427,-667.68,-1724448.07,6961899.36,5237451.29
17174,1996-06-04,672.56,4.88,0.73,678.51,-0.88,True,1,10428,-672.56,-1725120.63,7013455.68,5288335.05
17175,1996-06-05,678.44,5.88,0.87,678.51,-0.01,True,1,10429,-678.44,-1725799.07,7075450.76,5349651.69
17176,1996-06-06,673.03,-5.41,-0.8,678.51,-0.81,True,1,10430,-673.03,-1726472.1,7019702.9,5293230.8
17177,1996-06-07,673.31,0.28,0.04,678.51,-0.77,True,1,10431,-673.31,-1727145.41,7023296.61,5296151.2
17178,1996-06-10,672.16,-1.15,-0.17,678.51,-0.94,True,1,10432,-672.16,-1727817.57,7011973.12,5284155.55
17179,1996-06-11,670.97,-1.19,-0.18,678.51,-1.11,True,1,10433,-670.97,-1728488.54,7000230.01,5271741.47
17180,1996-06-12,669.04,-1.93,-0.29,678.51,-1.4,True,1,10434,-669.04,-1729157.58,6980763.36,5251605.78
17181,1996-06-13,667.92,-1.12,-0.17,678.51,-1.56,True,1,10435,-667.92,-1729825.5,6969745.2,5239919.7
17182,1996-06-14,665.85,-2.07,-0.31,678.51,-1.87,True,1,10436,-665.85,-1730491.35,6948810.6,5218319.25
17183,1996-06-17,665.16,-0.69,-0.1,678.51,-1.97,True,1,10437,-665.16,-1731156.51,6942274.92,5211118.41
17184,1996-06-18,662.06,-3.1,-0.47,678.51,-2.42,True,1,10438,-662.06,-1731818.57,6910582.28,5178763.71
17185,1996-06-19,661.96,-0.1,-0.02,678.51,-2.44,True,1,10439,-661.96,-1732480.53,6910200.44,5177719.91
17186,1996-06-20,662.1,0.14,0.02,678.51,-2.42,True,1,10440,-662.1,-1733142.63,6912324.0,5179181.37
17187,1996-06-21,666.84,4.74,0.72,678.51,-1.72,True,1,10441,-666.84,-1733809.47,6962476.44,5228666.97
17188,1996-06-24,668.85,2.01,0.3,678.51,-1.42,True,1,10442,-668.85,-1734478.32,6984131.7,5249653.38
17189,1996-06-25,668.48,-0.37,-0.06,678.51,-1.48,True,1,10443,-668.48,-1735146.8,6980936.64,5245789.84
17190,1996-06-26,664.39,-4.09,-0.61,678.51,-2.08,True,1,10444,-664.39,-1735811.19,6938889.16,5203077.97
17191,1996-06-27,668.55,4.16,0.63,678.51,-1.47,True,1,10445,-668.55,-1736479.74,6983004.75,5246525.01
17192,1996-06-28,670.63,2.08,0.31,678.51,-1.16,True,1,10446,-670.63,-1737150.37,7005400.98,5268250.61
17193,1996-07-01,675.88,5.25,0.78,678.51,-0.39,True,1,10447,-675.88,-1737826.25,7060918.36,5323092.11
17194,1996-07-02,673.61,-2.27,-0.34,678.51,-0.72,True,1,10448,-673.61,-1738499.86,7037877.28,5299377.42
17195,1996-07-03,672.4,-1.21,-0.18,678.51,-0.9,True,1,10449,-672.4,-1739172.26,7025907.6,5286735.34
17196,1996-07-05,657.44,-14.96,-2.22,678.51,-3.1,True,1,10450,-657.44,-1739829.7,6870248.0,5130418.3
17197,1996-07-08,652.54,-4.9,-0.74,678.51,-3.83,True,1,10451,-652.54,-1740482.24,6819695.54,5079213.3
17198,1996-07-09,654.75,2.21,0.34,678.51,-3.5,True,1,10452,-654.75,-1741136.99,6843447.0,5102310.01
17199,1996-07-10,656.06,1.31,0.2,678.51,-3.31,True,1,10453,-656.06,-1741793.05,6857795.18,5116002.13
17200,1996-07-11,645.67,-10.39,-1.58,678.51,-4.84,True,1,10454,-645.67,-1742438.72,6749834.18,5007395.46
17201,1996-07-12,646.19,0.52,0.08,678.51,-4.76,True,1,10455,-646.19,-1743084.91,6755916.45,5012831.54
17202,1996-07-15,629.8,-16.39,-2.54,678.51,-7.18,True,1,10456,-629.8,-1743714.71,6585188.8,4841474.09
17203,1996-07-16,628.37,-1.43,-0.23,678.51,-7.39,True,1,10457,-628.37,-1744343.08,6570865.09,4826522.01
17204,1996-07-17,634.07,5.7,0.91,678.51,-6.55,True,1,10458,-634.07,-1744977.15,6631104.06,4886126.91
17205,1996-07-18,643.56,9.49,1.5,678.51,-5.15,True,1,10459,-643.56,-1745620.71,6730994.04,4985373.33
17206,1996-07-19,638.73,-4.83,-0.75,678.51,-5.86,True,1,10460,-638.73,-1746259.44,6681115.8,4934856.36
17207,1996-07-22,633.77,-4.96,-0.78,678.51,-6.59,True,1,10461,-633.77,-1746893.21,6629867.97,4882974.76
17208,1996-07-23,626.87,-6.9,-1.09,678.51,-7.61,True,1,10462,-626.87,-1747520.08,6558313.94,4810793.86
17209,1996-07-24,626.65,-0.22,-0.04,678.51,-7.64,True,1,10463,-626.65,-1748146.73,6556638.95,4808492.22
17210,1996-07-25,631.17,4.52,0.72,678.51,-6.98,True,1,10464,-631.17,-1748777.9,6604562.88,4855784.98
17211,1996-07-26,635.9,4.73,0.75,678.51,-6.28,True,1,10465,-635.9,-1749413.8,6654693.5,4905279.7
17212,1996-07-29,630.91,-4.99,-0.78,678.51,-7.02,True,1,10466,-630.91,-1750044.71,6603104.06,4853059.35
17213,1996-07-30,635.26,4.35,0.69,678.51,-6.37,True,1,10467,-635.26,-1750679.97,6649266.42,4898586.45
17214,1996-07-31,639.95,4.69,0.74,678.51,-5.68,True,1,10468,-639.95,-1751319.92,6698996.6,4947676.68
17215,1996-08-01,650.02,10.07,1.57,678.51,-4.2,True,1,10469,-650.02,-1751969.94,6805059.38,5053089.44
17216,1996-08-02,662.49,12.47,1.92,678.51,-2.36,True,1,10470,-662.49,-1752632.43,6936270.3,5183637.87
17217,1996-08-05,660.23,-2.26,-0.34,678.51,-2.69,True,1,10471,-660.23,-1753292.66,6913268.33,5159975.67
17218,1996-08-06,662.38,2.15,0.33,678.51,-2.38,True,1,10472,-662.38,-1753955.04,6936443.36,5182488.32
17219,1996-08-07,664.16,1.78,0.27,678.51,-2.12,True,1,10473,-664.16,-1754619.2,6955747.68,5201128.48
17220,1996-08-08,662.59,-1.57,-0.24,678.51,-2.35,True,1,10474,-662.59,-1755281.79,6939967.66,5184685.87
17221,1996-08-09,662.1,-0.49,-0.07,678.51,-2.42,True,1,10475,-662.1,-1755943.89,6935497.5,5179553.61
17222,1996-08-12,665.77,3.67,0.55,678.51,-1.88,True,1,10476,-665.77,-1756609.66,6974606.52,5217996.86
17223,1996-08-13,660.2,-5.57,-0.84,678.51,-2.7,True,1,10477,-660.2,-1757269.86,6916915.4,5159645.54
17224,1996-08-14,662.05,1.85,0.28,678.51,-2.43,True,1,10478,-662.05,-1757931.91,6936959.9,5179027.99
17225,1996-08-15,662.28,0.23,0.04,678.51,-2.39,True,1,10479,-662.28,-1758594.19,6940032.12,5181437.93
17226,1996-08-16,665.21,2.93,0.44,678.51,-1.96,True,1,10480,-665.21,-1759259.4,6971400.8,5212141.4
17227,1996-08-19,666.58,1.37,0.21,678.51,-1.76,True,1,10481,-666.58,-1759925.98,6986424.98,5226499.0
17228,1996-08-20,665.69,-0.89,-0.13,678.51,-1.89,True,1,10482,-665.69,-1760591.67,6977762.58,5217170.91
17229,1996-08-21,665.07,-0.62,-0.09,678.51,-1.98,True,1,10483,-665.07,-1761256.74,6971928.81,5210672.07
17230,1996-08-22,670.68,5.61,0.84,678.51,-1.15,True,1,10484,-670.68,-1761927.42,7031409.12,5269481.7
17231,1996-08-23,667.03,-3.65,-0.54,678.51,-1.69,True,1,10485,-667.03,-1762594.45,6993809.55,5231215.1
17232,1996-08-26,663.88,-3.15,-0.47,678.51,-2.16,True,1,10486,-663.88,-1763258.33,6961445.68,5198187.35
17233,1996-08-27,666.4,2.52,0.38,678.51,-1.78,True,1,10487,-666.4,-1763924.73,6988536.8,5224612.07
17234,1996-08-28,664.81,-1.59,-0.24,678.51,-2.02,True,1,10488,-664.81,-1764589.54,6972527.28,5207937.74
17235,1996-08-29,657.4,-7.41,-1.12,678.51,-3.11,True,1,10489,-657.4,-1765246.94,6895468.6,5130221.66
17236,1996-08-30,651.99,-5.41,-0.82,678.51,-3.91,True,1,10490,-651.99,-1765898.93,6839375.1,5073476.17
17237,1996-09-03,654.72,2.73,0.42,678.51,-3.51,True,1,10491,-654.72,-1766553.65,6868667.52,5102113.87
17238,1996-09-04,655.61,0.89,0.14,678.51,-3.38,True,1,10492,-655.61,-1767209.26,6878660.12,5111450.86
17239,1996-09-05,649.44,-6.17,-0.94,678.51,-4.28,True,1,10493,-649.44,-1767858.7,6814573.92,5046715.22
17240,1996-09-06,655.68,6.24,0.96,678.51,-3.36,True,1,10494,-655.68,-1768514.38,6880705.92,5112191.54
17241,1996-09-09,663.76,8.08,1.23,678.51,-2.17,True,1,10495,-663.76,-1769178.14,6966161.2,5196983.06
17242,1996-09-10,663.81,0.05,0.01,678.51,-2.17,True,1,10496,-663.81,-1769841.95,6967349.76,5197507.81
17243,1996-09-11,667.28,3.47,0.52,678.51,-1.66,True,1,10497,-667.28,-1770509.23,7004438.16,5233928.93
17244,1996-09-12,671.15,3.87,0.58,678.51,-1.08,True,1,10498,-671.15,-1771180.38,7045732.7,5274552.32
17245,1996-09-13,680.54,9.39,1.4,680.54,0.0,True,1,10499,-680.54,-1771860.92,7144989.46,5373128.54
17246,1996-09-16,683.98,3.44,0.5,683.98,0.0,True,1,10500,-683.98,-1772544.9,7181790.0,5409245.1
17247,1996-09-17,682.94,-1.04,-0.15,683.98,-0.15,True,1,10501,-682.94,-1773227.84,7171552.94,5398325.1
17248,1996-09-18,681.47,-1.47,-0.22,683.98,-0.37,True,1,10502,-681.47,-1773909.31,7156797.94,5382888.63
17249,1996-09-19,683.0,1.53,0.22,683.98,-0.14,True,1,10503,-683.0,-1774592.31,7173549.0,5398956.69
17250,1996-09-20,687.03,4.03,0.59,687.03,0.0,True,1,10504,-687.03,-1775279.34,7216563.12,5441283.78
17251,1996-09-23,686.48,-0.55,-0.08,687.03,-0.08,True,1,10505,-686.48,-1775965.82,7211472.4,5435506.58
17252,1996-09-24,685.61,-0.87,-0.13,687.03,-0.21,True,1,10506,-685.61,-1776651.43,7203018.66,5426367.23
17253,1996-09-25,685.83,0.22,0.03,687.03,-0.18,True,1,10507,-685.83,-1777337.26,7206015.81,5428678.55
17254,1996-09-26,685.86,0.03,0.0,687.03,-0.17,True,1,10508,-685.86,-1778023.12,7207016.88,5428993.76
17255,1996-09-27,686.19,0.33,0.05,687.03,-0.12,True,1,10509,-686.19,-1778709.31,7211170.71,5432461.4
17256,1996-09-30,687.33,1.14,0.17,687.33,0.0,True,1,10510,-687.33,-1779396.64,7223838.3,5444441.66
17257,1996-10-01,689.08,1.75,0.26,689.08,0.0,True,1,10511,-689.08,-1780085.72,7242919.88,5462834.16
17258,1996-10-02,694.01,4.93,0.72,694.01,0.0,True,1,10512,-694.01,-1780779.73,7295433.12,5514653.39
17259,1996-10-03,692.78,-1.23,-0.18,694.01,-0.18,True,1,10513,-692.78,-1781472.51,7283196.14,5501723.63
17260,1996-10-04,701.46,8.68,1.25,701.46,0.0,True,1,10514,-701.46,-1782173.97,7375150.44,5592976.47
17261,1996-10-07,703.34,1.88,0.27,703.34,0.0,True,1,10515,-703.34,-1782877.31,7395620.1,5612742.79
17262,1996-10-08,700.64,-2.7,-0.38,703.34,-0.38,True,1,10516,-700.64,-1783577.95,7367930.24,5584352.29
17263,1996-10-09,696.74,-3.9,-0.56,703.34,-0.94,True,1,10517,-696.74,-1784274.69,7327614.58,5543339.89
17264,1996-10-10,694.61,-2.13,-0.31,703.34,-1.24,True,1,10518,-694.61,-1784969.3,7305907.98,5520938.68
17265,1996-10-11,700.66,6.05,0.87,703.34,-0.38,True,1,10519,-700.66,-1785669.96,7370242.54,5584572.58
17266,1996-10-14,703.54,2.88,0.41,703.54,0.0,True,1,10520,-703.54,-1786373.5,7401240.8,5614867.3
17267,1996-10-15,702.57,-0.97,-0.14,703.54,-0.14,True,1,10521,-702.57,-1787076.07,7391738.97,5604662.9
17268,1996-10-16,704.41,1.84,0.26,704.41,0.0,True,1,10522,-704.41,-1787780.48,7411802.02,5624021.54
17269,1996-10-17,706.99,2.58,0.37,706.99,0.0,True,1,10523,-706.99,-1788487.47,7439655.77,5651168.3
17270,1996-10-18,710.82,3.83,0.54,710.82,0.0,True,1,10524,-710.82,-1789198.29,7480669.68,5691471.39
17271,1996-10-21,709.85,-0.97,-0.14,710.82,-0.14,True,1,10525,-709.85,-1789908.14,7471171.25,5681263.11
17272,1996-10-22,706.57,-3.28,-0.46,710.82,-0.6,True,1,10526,-706.57,-1790614.71,7437355.82,5646741.11
17273,1996-10-23,707.27,0.7,0.1,710.82,-0.5,True,1,10527,-707.27,-1791321.98,7445431.29,5654109.31
17274,1996-10-24,702.29,-4.98,-0.7,710.82,-1.2,True,1,10528,-702.29,-1792024.27,7393709.12,5601684.85
17275,1996-10-25,700.92,-1.37,-0.2,710.82,-1.39,True,1,10529,-700.92,-1792725.19,7379986.68,5587261.49
17276,1996-10-28,697.26,-3.66,-0.52,710.82,-1.91,True,1,10530,-697.26,-1793422.45,7342147.8,5548725.35
17277,1996-10-29,701.5,4.24,0.61,710.82,-1.31,True,1,10531,-701.5,-1794123.95,7387496.5,5593372.55
17278,1996-10-30,700.9,-0.6,-0.09,710.82,-1.4,True,1,10532,-700.9,-1794824.85,7381878.8,5587053.95
17279,1996-10-31,705.27,4.37,0.62,710.82,-0.78,True,1,10533,-705.27,-1795530.12,7428608.91,5633078.79
17280,1996-11-01,703.77,-1.5,-0.21,710.82,-0.99,True,1,10534,-703.77,-1796233.89,7413513.18,5617279.29
17281,1996-11-04,706.73,2.96,0.42,710.82,-0.57,True,1,10535,-706.73,-1796940.62,7445400.55,5648459.93
17282,1996-11-05,714.14,7.41,1.05,714.14,0.0,True,1,10536,-714.14,-1797654.76,7524179.04,5726524.28
17283,1996-11-06,724.59,10.45,1.46,724.59,0.0,True,1,10537,-724.59,-1798379.35,7635004.83,5836625.48
17284,1996-11-07,727.65,3.06,0.42,727.65,0.0,True,1,10538,-727.65,-1799107.0,7667975.7,5868868.7
17285,1996-11-08,730.82,3.17,0.44,730.82,0.0,True,1,10539,-730.82,-1799837.82,7702111.98,5902274.16
17286,1996-11-11,731.87,1.05,0.14,731.87,0.0,True,1,10540,-731.87,-1800569.69,7713909.8,5913340.11
17287,1996-11-12,729.56,-2.31,-0.32,731.87,-0.32,True,1,10541,-729.56,-1801299.25,7690291.96,5888992.71
17288,1996-11-13,731.13,1.57,0.22,731.87,-0.1,True,1,10542,-731.13,-1802030.38,7707572.46,5905542.08
17289,1996-11-14,735.88,4.75,0.65,735.88,0.0,True,1,10543,-735.88,-1802766.26,7758382.84,5955616.58
17290,1996-11-15,737.62,1.74,0.24,737.62,0.0,True,1,10544,-737.62,-1803503.88,7777465.28,5973961.4
17291,1996-11-18,737.02,-0.6,-0.08,737.62,-0.08,True,1,10545,-737.02,-1804240.9,7771875.9,5967635.0
17292,1996-11-19,742.16,5.14,0.7,742.16,0.0,True,1,10546,-742.16,-1804983.06,7826819.36,6021836.3
17293,1996-11-20,743.95,1.79,0.24,743.95,0.0,True,1,10547,-743.95,-1805727.01,7846440.65,6040713.64
17294,1996-11-21,742.75,-1.2,-0.16,743.95,-0.16,True,1,10548,-742.75,-1806469.76,7834527.0,6028057.24
17295,1996-11-22,748.73,5.98,0.8,748.73,0.0,True,1,10549,-748.73,-1807218.49,7898352.77,6091134.28
17296,1996-11-25,757.03,8.3,1.11,757.03,0.0,True,1,10550,-757.03,-1807975.52,7986666.5,6178690.98
17297,1996-11-26,755.96,-1.07,-0.14,757.03,-0.14,True,1,10551,-755.96,-1808731.48,7976133.96,6167402.48
17298,1996-11-27,755.0,-0.96,-0.13,757.03,-0.27,True,1,10552,-755.0,-1809486.48,7966760.0,6157273.52
17299,1996-11-29,757.02,2.02,0.27,757.03,-0.0,True,1,10553,-757.02,-1810243.5,7988832.06,6178588.56
17300,1996-12-02,756.56,-0.46,-0.06,757.03,-0.06,True,1,10554,-756.56,-1811000.06,7984734.24,6173734.18
17301,1996-12-03,748.28,-8.28,-1.09,757.03,-1.16,True,1,10555,-748.28,-1811748.34,7898095.4,6086347.06
17302,1996-12-04,745.1,-3.18,-0.42,757.03,-1.58,True,1,10556,-745.1,-1812493.44,7865275.6,6052782.16
17303,1996-12-05,744.38,-0.72,-0.1,757.03,-1.67,True,1,10557,-744.38,-1813237.82,7858419.66,6045181.84
17304,1996-12-06,739.6,-4.78,-0.64,757.03,-2.3,True,1,10558,-739.6,-1813977.42,7808696.8,5994719.38
17305,1996-12-09,749.76,10.16,1.37,757.03,-0.96,True,1,10559,-749.76,-1814727.18,7916715.84,6101988.66
17306,1996-12-10,747.54,-2.22,-0.3,757.03,-1.25,True,1,10560,-747.54,-1815474.72,7894022.4,6078547.68
17307,1996-12-11,740.73,-6.81,-0.91,757.03,-2.15,True,1,10561,-740.73,-1816215.45,7822849.53,6006634.08
17308,1996-12-12,729.3,-11.43,-1.54,757.03,-3.66,True,1,10562,-729.3,-1816944.75,7702866.6,5885921.85
17309,1996-12-13,728.64,-0.66,-0.09,757.03,-3.75,True,1,10563,-728.64,-1817673.39,7696624.32,5878950.93
17310,1996-12-16,720.98,-7.66,-1.05,757.03,-4.76,True,1,10564,-720.98,-1818394.37,7616432.72,5798038.35
17311,1996-12-17,726.04,5.06,0.7,757.03,-4.09,True,1,10565,-726.04,-1819120.41,7670612.6,5851492.19
17312,1996-12-18,731.54,5.5,0.76,757.03,-3.37,True,1,10566,-731.54,-1819851.95,7729451.64,5909599.69
17313,1996-12-19,745.76,14.22,1.94,757.03,-1.49,True,1,10567,-745.76,-1820597.71,7880445.92,6059848.21
17314,1996-12-20,748.87,3.11,0.42,757.03,-1.08,True,1,10568,-748.87,-1821346.58,7914058.16,6092711.58
17315,1996-12-23,746.92,-1.95,-0.26,757.03,-1.34,True,1,10569,-746.92,-1822093.5,7894197.48,6072103.98
17316,1996-12-24,751.03,4.11,0.55,757.03,-0.79,True,1,10570,-751.03,-1822844.53,7938387.1,6115542.57
17317,1996-12-26,755.82,4.79,0.64,757.03,-0.16,True,1,10571,-755.82,-1823600.35,7989773.22,6166172.87
17318,1996-12-27,756.79,0.97,0.13,757.03,-0.03,True,1,10572,-756.79,-1824357.14,8000783.88,6176426.74
17319,1996-12-30,753.85,-2.94,-0.39,757.03,-0.42,True,1,10573,-753.85,-1825110.99,7970456.05,6145345.06
17320,1996-12-31,740.74,-13.11,-1.74,757.03,-2.15,True,1,10574,-740.74,-1825851.73,7832584.76,6006733.03
17321,1997-01-02,737.01,-3.73,-0.5,757.03,-2.64,True,1,10575,-737.01,-1826588.74,7793880.75,5967292.01
17322,1997-01-03,748.03,11.02,1.5,757.03,-1.19,True,1,10576,-748.03,-1827336.77,7911165.28,6083828.51
17323,1997-01-06,747.65,-0.38,-0.05,757.03,-1.24,True,1,10577,-747.65,-1828084.42,7907894.05,6079809.63
17324,1997-01-07,753.23,5.58,0.75,757.03,-0.5,True,1,10578,-753.23,-1828837.65,7967666.94,6138829.29
17325,1997-01-08,748.41,-4.82,-0.64,757.03,-1.14,True,1,10579,-748.41,-1829586.06,7917429.39,6087843.33
17326,1997-01-09,754.85,6.44,0.86,757.03,-0.29,True,1,10580,-754.85,-1830340.91,7986313.0,6155972.09
17327,1997-01-10,759.5,4.65,0.62,759.5,0.0,True,1,10581,-759.5,-1831100.41,8036269.5,6205169.09
17328,1997-01-13,759.51,0.01,0.0,759.51,0.0,True,1,10582,-759.51,-1831859.92,8037134.82,6205274.9
17329,1997-01-14,768.86,9.35,1.23,768.86,0.0,True,1,10583,-768.86,-1832628.78,8136845.38,6304216.6
17330,1997-01-15,767.2,-1.66,-0.22,768.86,-0.22,True,1,10584,-767.2,-1833395.98,8120044.8,6286648.82
17331,1997-01-16,769.75,2.55,0.33,769.75,0.0,True,1,10585,-769.75,-1834165.73,8147803.75,6313638.02
17332,1997-01-17,776.17,6.42,0.83,776.17,0.0,True,1,10586,-776.17,-1834941.9,8216535.62,6381593.72
17333,1997-01-20,776.7,0.53,0.07,776.7,0.0,True,1,10587,-776.7,-1835718.6,8222922.9,6387204.3
17334,1997-01-21,782.72,6.02,0.78,782.72,0.0,True,1,10588,-782.72,-1836501.32,8287439.36,6450938.04
17335,1997-01-22,786.23,3.51,0.45,786.23,0.0,True,1,10589,-786.23,-1837287.55,8325389.47,6488101.92
17336,1997-01-23,777.56,-8.67,-1.1,786.23,-1.1,True,1,10590,-777.56,-1838065.11,8234360.4,6396295.29
17337,1997-01-24,770.52,-7.04,-0.9,786.23,-2.0,True,1,10591,-770.52,-1838835.63,8160577.32,6321741.69
17338,1997-01-27,765.02,-5.5,-0.71,786.23,-2.7,True,1,10592,-765.02,-1839600.65,8103091.84,6263491.19
17339,1997-01-28,765.02,0.0,0.0,786.23,-2.7,True,1,10593,-765.02,-1840365.67,8103856.86,6263491.19
17340,1997-01-29,772.5,7.48,0.98,786.23,-1.75,True,1,10594,-772.5,-1841138.17,8183865.0,6342726.83
17341,1997-01-30,784.17,11.67,1.51,786.23,-0.26,True,1,10595,-784.17,-1841922.34,8308281.15,6466358.81
17342,1997-01-31,786.16,1.99,0.25,786.23,-0.01,True,1,10596,-786.16,-1842708.5,8330151.36,6487442.86
17343,1997-02-03,786.73,0.57,0.07,786.73,0.0,True,1,10597,-786.73,-1843495.23,8336977.81,6493482.58
17344,1997-02-04,789.26,2.53,0.32,789.26,0.0,True,1,10598,-789.26,-1844284.49,8364577.48,6520292.99
17345,1997-02-05,778.28,-10.98,-1.39,789.26,-1.39,True,1,10599,-778.28,-1845062.77,8248989.72,6403926.95
17346,1997-02-06,780.15,1.87,0.24,789.26,-1.15,True,1,10600,-780.15,-1845842.92,8269590.0,6423747.08
17347,1997-02-07,789.56,9.41,1.21,789.56,0.0,True,1,10601,-789.56,-1846632.48,8370125.56,6523493.08
17348,1997-02-10,785.43,-4.13,-0.52,789.56,-0.52,True,1,10602,-785.43,-1847417.91,8327128.86,6479710.95
17349,1997-02-11,789.59,4.16,0.53,789.59,0.0,True,1,10603,-789.59,-1848207.5,8372022.77,6523815.27
17350,1997-02-12,802.77,13.18,1.67,802.77,0.0,True,1,10604,-802.77,-1849010.27,8512573.08,6663562.81
17351,1997-02-13,811.82,9.05,1.13,811.82,0.0,True,1,10605,-811.82,-1849822.09,8609351.1,6759529.01
17352,1997-02-14,808.48,-3.34,-0.41,811.82,-0.41,True,1,10606,-808.48,-1850630.57,8574738.88,6724108.31
17353,1997-02-18,816.29,7.81,0.97,816.29,0.0,True,1,10607,-816.29,-1851446.86,8658388.03,6806941.17
17354,1997-02-19,812.49,-3.8,-0.47,816.29,-0.47,True,1,10608,-812.49,-1852259.35,8618893.92,6766634.57
17355,1997-02-20,802.8,-9.69,-1.19,816.29,-1.65,True,1,10609,-802.8,-1853062.15,8516905.2,6663843.05
17356,1997-02-21,801.77,-1.03,-0.13,816.29,-1.78,True,1,10610,-801.77,-1853863.92,8506779.7,6652915.78
17357,1997-02-24,810.28,8.51,1.06,816.29,-0.74,True,1,10611,-810.28,-1854674.2,8597881.08,6743206.88
17358,1997-02-25,812.03,1.75,0.22,816.29,-0.52,True,1,10612,-812.03,-1855486.23,8617262.36,6761776.13
17359,1997-02-26,805.68,-6.35,-0.78,816.29,-1.3,True,1,10613,-805.68,-1856291.91,8550681.84,6694389.93
17360,1997-02-27,795.07,-10.61,-1.32,816.29,-2.6,True,1,10614,-795.07,-1857086.98,8438872.98,6581786.0
17361,1997-02-28,790.82,-4.25,-0.54,816.29,-3.12,True,1,10615,-790.82,-1857877.8,8394554.3,6536676.5
17362,1997-03-03,795.31,4.49,0.57,816.29,-2.57,True,1,10616,-795.31,-1858673.11,8443010.96,6584337.85
17363,1997-03-04,790.95,-4.36,-0.55,816.29,-3.1,True,1,10617,-790.95,-1859464.06,8397516.15,6538052.09
17364,1997-03-05,801.99,11.04,1.4,816.29,-1.75,True,1,10618,-801.99,-1860266.05,8515529.82,6655263.77
17365,1997-03-06,798.56,-3.43,-0.43,816.29,-2.17,True,1,10619,-798.56,-1861064.61,8479908.64,6618844.03
17366,1997-03-07,804.97,6.41,0.8,816.29,-1.39,True,1,10620,-804.97,-1861869.58,8548781.4,6686911.82
17367,1997-03-10,813.65,8.68,1.08,816.29,-0.32,True,1,10621,-813.65,-1862683.23,8641776.65,6779093.42
17368,1997-03-11,811.34,-2.31,-0.28,816.29,-0.61,True,1,10622,-811.34,-1863494.57,8618053.48,6754558.91
17369,1997-03-12,804.26,-7.08,-0.87,816.29,-1.47,True,1,10623,-804.26,-1864298.83,8543653.98,6679355.15
17370,1997-03-13,789.56,-14.7,-1.83,816.29,-3.28,True,1,10624,-789.56,-1865088.39,8388285.44,6523197.05
17371,1997-03-14,793.17,3.61,0.46,816.29,-2.83,True,1,10625,-793.17,-1865881.56,8427431.25,6561549.69
17372,1997-03-17,795.71,2.54,0.32,816.29,-2.52,True,1,10626,-795.71,-1866677.27,8455214.46,6588537.19
17373,1997-03-18,789.66,-6.05,-0.76,816.29,-3.26,True,1,10627,-789.66,-1867466.93,8391716.82,6524249.89
17374,1997-03-19,785.77,-3.89,-0.49,816.29,-3.74,True,1,10628,-785.77,-1868252.7,8351163.56,6482910.86
17375,1997-03-20,782.65,-3.12,-0.4,816.29,-4.12,True,1,10629,-782.65,-1869035.35,8318786.85,6449751.5
17376,1997-03-21,784.1,1.45,0.18,816.29,-3.94,True,1,10630,-784.1,-1869819.45,8334983.0,6465163.55
17377,1997-03-24,790.89,6.79,0.87,816.29,-3.11,True,1,10631,-790.89,-1870610.34,8407951.59,6537341.25
17378,1997-03-25,789.07,-1.82,-0.23,816.29,-3.34,True,1,10632,-789.07,-1871399.41,8389392.24,6517992.83
17379,1997-03-26,790.5,1.43,0.18,816.29,-3.16,True,1,10633,-790.5,-1872189.91,8405386.5,6533196.59
17380,1997-03-27,773.88,-16.62,-2.1,816.29,-5.2,True,1,10634,-773.88,-1872963.79,8229439.92,6356476.13
17381,1997-03-31,757.12,-16.76,-2.17,816.29,-7.25,True,1,10635,-757.12,-1873720.91,8051971.2,6178250.29
17382,1997-04-01,759.64,2.52,0.33,816.29,-6.94,True,1,10636,-759.64,-1874480.55,8079531.04,6205050.49
17383,1997-04-02,750.11,-9.53,-1.25,816.29,-8.11,True,1,10637,-750.11,-1875230.66,7978920.07,6103689.41
17384,1997-04-03,750.32,0.21,0.03,816.29,-8.08,True,1,10638,-750.32,-1875980.98,7981904.16,6105923.18
17385,1997-04-04,757.9,7.58,1.01,816.29,-7.15,True,1,10639,-757.9,-1876738.88,8063298.1,6186559.22
17386,1997-04-07,762.13,4.23,0.56,816.29,-6.64,True,1,10640,-762.13,-1877501.01,8109063.2,6231562.19
17387,1997-04-08,766.12,3.99,0.52,816.29,-6.15,True,1,10641,-766.12,-1878267.13,8152282.92,6274015.79
17388,1997-04-09,760.6,-5.52,-0.72,816.29,-6.82,True,1,10642,-760.6,-1879027.73,8094305.2,6215277.47
17389,1997-04-10,758.34,-2.26,-0.3,816.29,-7.1,True,1,10643,-758.34,-1879786.07,8071012.62,6191226.55
17390,1997-04-11,737.65,-20.69,-2.73,816.29,-9.63,True,1,10644,-737.65,-1880523.72,7851546.6,5971022.88
17391,1997-04-14,743.73,6.08,0.82,816.29,-8.89,True,1,10645,-743.73,-1881267.45,7917005.85,6035738.4
17392,1997-04-15,754.72,10.99,1.48,816.29,-7.54,True,1,10646,-754.72,-1882022.17,8034749.12,6152726.95
17393,1997-04-16,763.53,8.81,1.17,816.29,-6.46,True,1,10647,-763.53,-1882785.7,8129303.91,6246518.21
17394,1997-04-17,761.77,-1.76,-0.23,816.29,-6.68,True,1,10648,-761.77,-1883547.47,8111326.96,6227779.49
17395,1997-04-18,766.34,4.57,0.6,816.29,-6.12,True,1,10649,-766.34,-1884313.81,8160754.66,6276440.85
17396,1997-04-21,760.37,-5.97,-0.78,816.29,-6.85,True,1,10650,-760.37,-1885074.18,8097940.5,6212866.32
17397,1997-04-22,774.61,14.24,1.87,816.29,-5.11,True,1,10651,-774.61,-1885848.79,8250371.11,6364522.32
17398,1997-04-23,773.64,-0.97,-0.12,816.29,-5.22,True,1,10652,-773.64,-1886622.43,8240813.28,6354190.85
17399,1997-04-24,771.18,-2.46,-0.32,816.29,-5.53,True,1,10653,-771.18,-1887393.61,8215380.54,6327986.93
17400,1997-04-25,765.37,-5.81,-0.75,816.29,-6.24,True,1,10654,-765.37,-1888158.98,8154251.98,6266093.0
17401,1997-04-28,772.96,7.59,0.99,816.29,-5.31,True,1,10655,-772.96,-1888931.94,8235888.8,6346956.86
17402,1997-04-29,794.05,21.09,2.73,816.29,-2.72,True,1,10656,-794.05,-1889725.99,8461396.8,6571670.81
17403,1997-04-30,801.34,7.29,0.92,816.29,-1.83,True,1,10657,-801.34,-1890527.33,8539880.38,6649353.05
17404,1997-05-01,798.53,-2.81,-0.35,816.29,-2.18,True,1,10658,-798.53,-1891325.86,8510732.74,6619406.88
17405,1997-05-02,812.97,14.44,1.81,816.29,-0.41,True,1,10659,-812.97,-1892138.83,8665447.23,6773308.4
17406,1997-05-05,830.29,17.32,2.13,830.29,0.0,True,1,10660,-830.29,-1892969.12,8850891.4,6957922.28
17407,1997-05-06,827.76,-2.53,-0.3,830.29,-0.3,True,1,10661,-827.76,-1893796.88,8824749.36,6930952.48
17408,1997-05-07,815.62,-12.14,-1.47,830.29,-1.77,True,1,10662,-815.62,-1894612.5,8696140.44,6801527.94
17409,1997-05-08,820.26,4.64,0.57,830.29,-1.21,True,1,10663,-820.26,-1895432.76,8746432.38,6850999.62
17410,1997-05-09,824.78,4.52,0.55,830.29,-0.66,True,1,10664,-824.78,-1896257.54,8795453.92,6899196.38
17411,1997-05-12,837.66,12.88,1.56,837.66,0.0,True,1,10665,-837.66,-1897095.2,8933643.9,7036548.7
17412,1997-05-13,833.13,-4.53,-0.54,837.66,-0.54,True,1,10666,-833.13,-1897928.33,8886164.58,6988236.25
17413,1997-05-14,836.04,2.91,0.35,837.66,-0.19,True,1,10667,-836.04,-1898764.37,8918038.68,7019274.31
17414,1997-05-15,841.88,5.84,0.7,841.88,0.0,True,1,10668,-841.88,-1899606.25,8981175.84,7081569.59
17415,1997-05-16,829.75,-12.13,-1.44,841.88,-1.44,True,1,10669,-829.75,-1900436.0,8852602.75,6952166.75
17416,1997-05-19,833.27,3.52,0.42,841.88,-1.02,True,1,10670,-833.27,-1901269.27,8890990.9,6989721.63
17417,1997-05-20,841.66,8.39,1.01,841.88,-0.03,True,1,10671,-841.66,-1902110.93,8981353.86,7079242.93
17418,1997-05-21,839.35,-2.31,-0.27,841.88,-0.3,True,1,10672,-839.35,-1902950.28,8957543.2,7054592.92
17419,1997-05-22,835.66,-3.69,-0.44,841.88,-0.74,True,1,10673,-835.66,-1903785.94,8918999.18,7015213.24
17420,1997-05-23,847.03,11.37,1.36,847.03,0.0,True,1,10674,-847.03,-1904632.97,9041198.22,7136565.25
17421,1997-05-27,849.71,2.68,0.32,849.71,0.0,True,1,10675,-849.71,-1905482.68,9070654.25,7165171.57
17422,1997-05-28,847.21,-2.5,-0.29,849.71,-0.29,True,1,10676,-847.21,-1906329.89,9044813.96,7138484.07
17423,1997-05-29,844.08,-3.13,-0.37,849.71,-0.66,True,1,10677,-844.08,-1907173.97,9012242.16,7105068.19
17424,1997-05-30,848.28,4.2,0.5,849.71,-0.17,True,1,10678,-848.28,-1908022.25,9057933.84,7149911.59
17425,1997-06-02,846.36,-1.92,-0.23,849.71,-0.39,True,1,10679,-846.36,-1908868.61,9038278.44,7129409.83
17426,1997-06-03,845.48,-0.88,-0.1,849.71,-0.5,True,1,10680,-845.48,-1909714.09,9029726.4,7120012.31
17427,1997-06-04,840.11,-5.37,-0.64,849.71,-1.13,True,1,10681,-840.11,-1910554.2,8973214.91,7062660.71
17428,1997-06-05,843.43,3.32,0.4,849.71,-0.74,True,1,10682,-843.43,-1911397.63,9009519.26,7098121.63
17429,1997-06-06,858.01,14.58,1.73,858.01,0.0,True,1,10683,-858.01,-1912255.64,9166120.83,7253865.19
17430,1997-06-09,862.91,4.9,0.57,862.91,0.0,True,1,10684,-862.91,-1913118.55,9219330.44,7306211.89
17431,1997-06-10,865.27,2.36,0.27,865.27,0.0,True,1,10685,-865.27,-1913983.82,9245409.95,7331426.13
17432,1997-06-11,869.57,4.3,0.5,869.57,0.0,True,1,10686,-869.57,-1914853.39,9292225.02,7377371.63
17433,1997-06-12,883.46,13.89,1.6,883.46,0.0,True,1,10687,-883.46,-1915736.85,9441537.02,7525800.17
17434,1997-06-13,893.27,9.81,1.11,893.27,0.0,True,1,10688,-893.27,-1916630.12,9547269.76,7630639.64
17435,1997-06-16,893.9,0.63,0.07,893.9,0.0,True,1,10689,-893.9,-1917524.02,9554897.1,7637373.08
17436,1997-06-17,894.42,0.52,0.06,894.42,0.0,True,1,10690,-894.42,-1918418.44,9561349.8,7642931.36
17437,1997-06-18,889.06,-5.36,-0.6,894.42,-0.6,True,1,10691,-889.06,-1919307.5,9504940.46,7585632.96
17438,1997-06-19,897.99,8.93,1.0,897.99,0.0,True,1,10692,-897.99,-1920205.49,9601309.08,7681103.59
17439,1997-06-20,898.7,0.71,0.08,898.7,0.0,True,1,10693,-898.7,-1921104.19,9609799.1,7688694.91
17440,1997-06-23,878.62,-20.08,-2.23,898.7,-2.23,True,1,10694,-878.62,-1921982.81,9395962.28,7473979.47
17441,1997-06-24,896.34,17.72,2.02,898.7,-0.26,True,1,10695,-896.34,-1922879.15,9586356.3,7663477.15
17442,1997-06-25,888.99,-7.35,-0.82,898.7,-1.08,True,1,10696,-888.99,-1923768.14,9508637.04,7584868.9
17443,1997-06-26,883.68,-5.31,-0.6,898.7,-1.67,True,1,10697,-883.68,-1924651.82,9452724.96,7528073.14
17444,1997-06-27,887.3,3.62,0.41,898.7,-1.27,True,1,10698,-887.3,-1925539.12,9492335.4,7566796.28
17445,1997-06-30,885.14,-2.16,-0.24,898.7,-1.51,True,1,10699,-885.14,-1926424.26,9470112.86,7543688.6
17446,1997-07-01,891.03,5.89,0.66,898.7,-0.85,True,1,10700,-891.03,-1927315.29,9534021.0,7606705.71
17447,1997-07-02,904.03,13.0,1.46,904.03,0.0,True,1,10701,-904.03,-1928219.32,9674025.03,7745805.71
17448,1997-07-03,916.92,12.89,1.43,916.92,0.0,True,1,10702,-916.92,-1929136.24,9812877.84,7883741.6
17449,1997-07-07,912.2,-4.72,-0.52,916.92,-0.52,True,1,10703,-912.2,-1930048.44,9763276.6,7833228.16
17450,1997-07-08,918.75,6.55,0.72,918.75,0.0,True,1,10704,-918.75,-1930967.19,9834300.0,7903332.81
17451,1997-07-09,907.54,-11.21,-1.22,918.75,-1.22,True,1,10705,-907.54,-1931874.73,9715215.7,7783340.97
17452,1997-07-10,913.78,6.24,0.69,918.75,-0.54,True,1,10706,-913.78,-1932788.51,9782928.68,7850140.17
17453,1997-07-11,916.68,2.9,0.32,918.75,-0.22,True,1,10707,-916.68,-1933705.19,9814892.76,7881187.57
17454,1997-07-14,918.38,1.7,0.18,918.75,-0.04,True,1,10708,-918.38,-1934623.57,9834013.04,7899389.47
17455,1997-07-15,925.76,7.38,0.8,925.76,0.0,True,1,10709,-925.76,-1935549.33,9913963.84,7978414.51
17456,1997-07-16,936.59,10.83,1.17,936.59,0.0,True,1,10710,-936.59,-1936485.92,10030878.9,8094392.98
17457,1997-07-17,931.61,-4.98,-0.53,936.59,-0.53,True,1,10711,-931.61,-1937417.53,9978474.71,8041057.18
17458,1997-07-18,915.3,-16.31,-1.75,936.59,-2.27,True,1,10712,-915.3,-1938332.83,9804693.6,7866360.77
17459,1997-07-21,912.94,-2.36,-0.26,936.59,-2.52,True,1,10713,-912.94,-1939245.77,9780326.22,7841080.45
17460,1997-07-22,933.98,21.04,2.31,936.59,-0.28,True,1,10714,-933.98,-1940179.75,10006661.72,8066481.97
17461,1997-07-23,936.56,2.58,0.28,936.59,-0.0,True,1,10715,-936.56,-1941116.31,10035240.4,8094124.09
17462,1997-07-24,940.3,3.74,0.4,940.3,0.0,True,1,10716,-940.3,-1942056.61,10076254.8,8134198.19
17463,1997-07-25,938.79,-1.51,-0.16,940.3,-0.16,True,1,10717,-938.79,-1942995.4,10061012.43,8118017.03
17464,1997-07-28,936.45,-2.34,-0.25,940.3,-0.41,True,1,10718,-936.45,-1943931.85,10036871.1,8092939.25
17465,1997-07-29,942.29,5.84,0.62,942.29,0.0,True,1,10719,-942.29,-1944874.14,10100406.51,8155532.37
17466,1997-07-30,952.29,10.0,1.06,952.29,0.0,True,1,10720,-952.29,-1945826.43,10208548.8,8262722.37
17467,1997-07-31,954.31,2.02,0.21,954.31,0.0,True,1,10721,-954.31,-1946780.74,10231157.51,8284376.77
17468,1997-08-01,947.14,-7.17,-0.75,954.31,-0.75,True,1,10722,-947.14,-1947727.88,10155235.08,8207507.2
17469,1997-08-04,950.3,3.16,0.33,954.31,-0.42,True,1,10723,-950.3,-1948678.18,10190066.9,8241388.72
17470,1997-08-05,952.37,2.07,0.22,954.31,-0.2,True,1,10724,-952.37,-1949630.55,10213215.88,8263585.33
17471,1997-08-06,960.32,7.95,0.84,960.32,0.0,True,1,10725,-960.32,-1950590.87,10299432.0,8348841.13
17472,1997-08-07,951.19,-9.13,-0.95,960.32,-0.95,True,1,10726,-951.19,-1951542.06,10202463.94,8250921.88
17473,1997-08-08,933.54,-17.65,-1.86,960.32,-2.79,True,1,10727,-933.54,-1952475.6,10014083.58,8061607.98
17474,1997-08-11,937.0,3.46,0.37,960.32,-2.43,True,1,10728,-937.0,-1953412.6,10052136.0,8098723.4
17475,1997-08-12,926.53,-10.47,-1.12,960.32,-3.52,True,1,10729,-926.53,-1954339.13,9940740.37,7986401.24
17476,1997-08-13,922.02,-4.51,-0.49,960.32,-3.99,True,1,10730,-922.02,-1955261.15,9893274.6,7938013.45
17477,1997-08-14,924.77,2.75,0.3,960.32,-3.7,True,1,10731,-924.77,-1956185.92,9923706.87,7967520.95
17478,1997-08-15,900.81,-23.96,-2.59,960.32,-6.2,True,1,10732,-900.81,-1957086.73,9667492.92,7710406.19
17479,1997-08-18,912.49,11.68,1.3,960.32,-4.98,True,1,10733,-912.49,-1957999.22,9793755.17,7835755.95
17480,1997-08-19,926.01,13.52,1.48,960.32,-3.57,True,1,10734,-926.01,-1958925.23,9939791.34,7980866.11
17481,1997-08-20,939.35,13.34,1.44,960.32,-2.18,True,1,10735,-939.35,-1959864.58,10083922.25,8124057.67
17482,1997-08-21,925.05,-14.3,-1.52,960.32,-3.67,True,1,10736,-925.05,-1960789.63,9931336.8,7970547.17
17483,1997-08-22,923.54,-1.51,-0.16,960.32,-3.83,True,1,10737,-923.54,-1961713.17,9916048.98,7954335.81
17484,1997-08-25,920.16,-3.38,-0.37,960.32,-4.18,True,1,10738,-920.16,-1962633.33,9880678.08,7918044.75
17485,1997-08-26,913.02,-7.14,-0.78,960.32,-4.92,True,1,10739,-913.02,-1963546.35,9804921.78,7841375.43
17486,1997-08-27,913.7,0.68,0.07,960.32,-4.86,True,1,10740,-913.7,-1964460.05,9813138.0,7848677.95
17487,1997-08-28,903.67,-10.03,-1.1,960.32,-5.9,True,1,10741,-903.67,-1965363.72,9706319.47,7740955.75
17488,1997-08-29,899.47,-4.2,-0.46,960.32,-6.34,True,1,10742,-899.47,-1966263.19,9662106.74,7695843.55
17489,1997-09-02,927.58,28.11,3.12,960.32,-3.41,True,1,10743,-927.58,-1967190.77,9964991.94,7997801.17
17490,1997-09-03,927.86,0.28,0.03,960.32,-3.38,True,1,10744,-927.86,-1968118.63,9968927.84,8000809.21
17491,1997-09-04,930.87,3.01,0.32,960.32,-3.07,True,1,10745,-930.87,-1969049.5,10002198.15,8033148.65
17492,1997-09-05,929.05,-1.82,-0.2,960.32,-3.26,True,1,10746,-929.05,-1969978.55,9983571.3,8013592.75
17493,1997-09-08,931.2,2.15,0.23,960.32,-3.03,True,1,10747,-931.2,-1970909.75,10007606.4,8036696.65
17494,1997-09-09,933.62,2.42,0.26,960.32,-2.78,True,1,10748,-933.62,-1971843.37,10034547.76,8062704.39
17495,1997-09-10,919.03,-14.59,-1.56,960.32,-4.3,True,1,10749,-919.03,-1972762.4,9878653.47,7905891.07
17496,1997-09-11,912.59,-6.44,-0.7,960.32,-4.97,True,1,10750,-912.59,-1973674.99,9810342.5,7836667.51
17497,1997-09-12,923.91,11.32,1.24,960.32,-3.79,True,1,10751,-923.91,-1974598.9,9932956.41,7958357.51
17498,1997-09-15,919.77,-4.14,-0.45,960.32,-4.22,True,1,10752,-919.77,-1975518.67,9889367.04,7913848.37
17499,1997-09-16,945.64,25.87,2.81,960.32,-1.53,True,1,10753,-945.64,-1976464.31,10168466.92,8192002.61
17500,1997-09-17,943.0,-2.64,-0.28,960.32,-1.8,True,1,10754,-943.0,-1977407.31,10141022.0,8163614.69
17501,1997-09-18,947.29,4.29,0.46,960.32,-1.36,True,1,10755,-947.29,-1978354.6,10188103.95,8209749.35
17502,1997-09-19,950.51,3.22,0.34,960.32,-1.02,True,1,10756,-950.51,-1979305.11,10223685.56,8244380.45
17503,1997-09-22,955.43,4.92,0.52,960.32,-0.51,True,1,10757,-955.43,-1980260.54,10277560.51,8297299.97
17504,1997-09-23,951.93,-3.5,-0.37,960.32,-0.87,True,1,10758,-951.93,-1981212.47,10240862.94,8259650.47
17505,1997-09-24,944.48,-7.45,-0.78,960.32,-1.65,True,1,10759,-944.48,-1982156.95,10161660.32,8179503.37
17506,1997-09-25,937.91,-6.57,-0.7,960.32,-2.33,True,1,10760,-937.91,-1983094.86,10091911.6,8108816.74
17507,1997-09-26,945.22,7.31,0.78,960.32,-1.57,True,1,10761,-945.22,-1984040.08,10171512.42,8187472.34
17508,1997-09-29,953.34,8.12,0.86,960.32,-0.73,True,1,10762,-953.34,-1984993.42,10259845.08,8274851.66
17509,1997-09-30,947.28,-6.06,-0.64,960.32,-1.36,True,1,10763,-947.28,-1985940.7,10195574.64,8209633.94
17510,1997-10-01,955.41,8.13,0.86,960.32,-0.51,True,1,10764,-955.41,-1986896.11,10284033.24,8297137.13
17511,1997-10-02,960.46,5.05,0.53,960.46,0.0,True,1,10765,-960.46,-1987856.57,10339351.9,8351495.33
17512,1997-10-03,965.03,4.57,0.48,965.03,0.0,True,1,10766,-965.03,-1988821.6,10389512.98,8400691.38
17513,1997-10-06,972.69,7.66,0.79,972.69,0.0,True,1,10767,-972.69,-1989794.29,10472953.23,8483158.94
17514,1997-10-07,983.12,10.43,1.07,983.12,0.0,True,1,10768,-983.12,-1990777.41,10586236.16,8595458.75
17515,1997-10-08,973.84,-9.28,-0.94,983.12,-0.94,True,1,10769,-973.84,-1991751.25,10487282.96,8495531.71
17516,1997-10-09,970.62,-3.22,-0.33,983.12,-1.27,True,1,10770,-970.62,-1992721.87,10453577.4,8460855.53
17517,1997-10-10,966.98,-3.64,-0.38,983.12,-1.64,True,1,10771,-966.98,-1993688.85,10415341.58,8421652.73
17518,1997-10-13,968.1,1.12,0.12,983.12,-1.53,True,1,10772,-968.1,-1994656.95,10428373.2,8433716.25
17519,1997-10-14,970.28,2.18,0.22,983.12,-1.31,True,1,10773,-970.28,-1995627.23,10452826.44,8457199.21
17520,1997-10-15,965.72,-4.56,-0.47,983.12,-1.77,True,1,10774,-965.72,-1996592.95,10404667.28,8408074.33
17521,1997-10-16,955.25,-10.47,-1.08,983.12,-2.84,True,1,10775,-955.25,-1997548.2,10292818.75,8295270.55
17522,1997-10-17,944.16,-11.09,-1.16,983.12,-3.96,True,1,10776,-944.16,-1998492.36,10174268.16,8175775.8
17523,1997-10-20,955.61,11.45,1.21,983.12,-2.8,True,1,10777,-955.61,-1999447.97,10298608.97,8299161.0
17524,1997-10-21,972.28,16.67,1.74,983.12,-1.1,True,1,10778,-972.28,-2000420.25,10479233.84,8478813.59
17525,1997-10-22,968.49,-3.79,-0.39,983.12,-1.49,True,1,10779,-968.49,-2001388.74,10439353.71,8437964.97
17526,1997-10-23,950.69,-17.8,-1.84,983.12,-3.3,True,1,10780,-950.69,-2002339.43,10248438.2,8246098.77
17527,1997-10-24,941.64,-9.05,-0.95,983.12,-4.22,True,1,10781,-941.64,-2003281.07,10151820.84,8148539.77
17528,1997-10-27,876.99,-64.65,-6.87,983.12,-10.8,True,1,10782,-876.99,-2004158.06,9455706.18,7451548.12
17529,1997-10-28,921.85,44.86,5.12,983.12,-6.23,True,1,10783,-921.85,-2005079.91,9940308.55,7935228.64
17530,1997-10-29,919.16,-2.69,-0.29,983.12,-6.51,True,1,10784,-919.16,-2005999.07,9912221.44,7906222.37
17531,1997-10-30,903.68,-15.48,-1.68,983.12,-8.08,True,1,10785,-903.68,-2006902.75,9746188.8,7739286.05
17532,1997-10-31,914.62,10.94,1.21,983.12,-6.97,True,1,10786,-914.62,-2007817.37,9865091.32,7857273.95
17533,1997-11-03,938.99,24.37,2.66,983.12,-4.49,True,1,10787,-938.99,-2008756.36,10128885.13,8120128.77
17534,1997-11-04,940.76,1.77,0.19,983.12,-4.31,True,1,10788,-940.76,-2009697.12,10148918.88,8139221.76
17535,1997-11-05,942.76,2.0,0.21,983.12,-4.11,True,1,10789,-942.76,-2010639.88,10171437.64,8160797.76
17536,1997-11-06,938.03,-4.73,-0.5,983.12,-4.59,True,1,10790,-938.03,-2011577.91,10121343.7,8109765.79
17537,1997-11-07,927.51,-10.52,-1.12,983.12,-5.66,True,1,10791,-927.51,-2012505.42,10008760.41,7996254.99
17538,1997-11-10,921.13,-6.38,-0.69,983.12,-6.3,True,1,10792,-921.13,-2013426.55,9940834.96,7927408.41
17539,1997-11-11,923.78,2.65,0.29,983.12,-6.04,True,1,10793,-923.78,-2014350.33,9970357.54,7956007.21
17540,1997-11-12,905.96,-17.82,-1.93,983.12,-7.85,True,1,10794,-905.96,-2015256.29,9778932.24,7763675.95
17541,1997-11-13,916.66,10.7,1.18,983.12,-6.76,True,1,10795,-916.66,-2016172.95,9895344.7,7879171.75
17542,1997-11-14,928.35,11.69,1.27,983.12,-5.57,True,1,10796,-928.35,-2017101.3,10022466.6,8005365.3
17543,1997-11-17,946.2,17.85,1.92,983.12,-3.76,True,1,10797,-946.2,-2018047.5,10216121.4,8198073.9
17544,1997-11-18,938.23,-7.97,-0.84,983.12,-4.57,True,1,10798,-938.23,-2018985.73,10131007.54,8112021.81
17545,1997-11-19,944.59,6.36,0.68,983.12,-3.92,True,1,10799,-944.59,-2019930.32,10200627.41,8180697.09
17546,1997-11-20,958.98,14.39,1.52,983.12,-2.46,True,1,10800,-958.98,-2020889.3,10356984.0,8336094.7
17547,1997-11-21,963.09,4.11,0.43,983.12,-2.04,True,1,10801,-963.09,-2021852.39,10402335.09,8380482.7
17548,1997-11-24,946.67,-16.42,-1.7,983.12,-3.71,True,1,10802,-946.67,-2022799.06,10225929.34,8203130.28
17549,1997-11-25,950.82,4.15,0.44,983.12,-3.28,True,1,10803,-950.82,-2023749.88,10271708.46,8247958.58
17550,1997-11-26,951.64,0.82,0.09,983.12,-3.2,True,1,10804,-951.64,-2024701.52,10281518.56,8256817.04
17551,1997-11-28,955.4,3.76,0.4,983.12,-2.82,True,1,10805,-955.4,-2025656.92,10323097.0,8297440.08
17552,1997-12-01,974.77,19.37,2.03,983.12,-0.85,True,1,10806,-974.77,-2026631.69,10533364.62,8506732.93
17553,1997-12-02,971.68,-3.09,-0.32,983.12,-1.16,True,1,10807,-971.68,-2027603.37,10500945.76,8473342.39
17554,1997-12-03,976.77,5.09,0.52,983.12,-0.65,True,1,10808,-976.77,-2028580.14,10556930.16,8528350.02
17555,1997-12-04,973.1,-3.67,-0.38,983.12,-1.02,True,1,10809,-973.1,-2029553.24,10518237.9,8488684.66
17556,1997-12-05,983.79,10.69,1.1,983.79,0.0,True,1,10810,-983.79,-2030537.03,10634769.9,8604232.87
17557,1997-12-08,982.37,-1.42,-0.14,983.79,-0.14,True,1,10811,-982.37,-2031519.4,10620402.07,8588882.67
17558,1997-12-09,975.78,-6.59,-0.67,983.79,-0.81,True,1,10812,-975.78,-2032495.18,10550133.36,8517638.18
17559,1997-12-10,969.79,-5.99,-0.61,983.79,-1.42,True,1,10813,-969.79,-2033464.97,10486339.27,8452874.3
17560,1997-12-11,954.94,-14.85,-1.53,983.79,-2.93,True,1,10814,-954.94,-2034419.91,10326721.16,8292301.25
17561,1997-12-12,953.39,-1.55,-0.16,983.79,-3.09,True,1,10815,-953.39,-2035373.3,10310912.85,8275539.55
17562,1997-12-15,963.39,10.0,1.05,983.79,-2.07,True,1,10816,-963.39,-2036336.69,10420026.24,8383689.55
17563,1997-12-16,968.04,4.65,0.48,983.79,-1.6,True,1,10817,-968.04,-2037304.73,10471288.68,8433983.95
17564,1997-12-17,965.54,-2.5,-0.26,983.79,-1.86,True,1,10818,-965.54,-2038270.27,10445211.72,8406941.45
17565,1997-12-18,955.3,-10.24,-1.06,983.79,-2.9,True,1,10819,-955.3,-2039225.57,10335390.7,8296165.13
17566,1997-12-19,946.78,-8.52,-0.89,983.79,-3.76,True,1,10820,-946.78,-2040172.35,10244159.6,8203987.25
17567,1997-12-22,953.7,6.92,0.73,983.79,-3.06,True,1,10821,-953.7,-2041126.05,10319987.7,8278861.65
17568,1997-12-23,939.13,-14.57,-1.53,983.79,-4.54,True,1,10822,-939.13,-2042065.18,10163264.86,8121199.68
17569,1997-12-24,932.7,-6.43,-0.68,983.79,-5.19,True,1,10823,-932.7,-2042997.88,10094612.1,8051614.22
17570,1997-12-26,936.46,3.76,0.4,983.79,-4.81,True,1,10824,-936.46,-2043934.34,10136243.04,8092308.7
17571,1997-12-29,953.35,16.89,1.8,983.79,-3.09,True,1,10825,-953.35,-2044887.69,10320013.75,8275126.06
17572,1997-12-30,970.84,17.49,1.84,983.79,-1.32,True,1,10826,-970.84,-2045858.53,10510313.84,8464455.31
17573,1997-12-31,970.43,-0.41,-0.04,983.79,-1.36,True,1,10827,-970.43,-2046828.96,10506845.61,8460016.65
17574,1998-01-02,975.04,4.61,0.48,983.79,-0.89,True,1,10828,-975.04,-2047804.0,10557733.12,8509929.12
17575,1998-01-05,977.07,2.03,0.21,983.79,-0.68,True,1,10829,-977.07,-2048781.07,10580691.03,8531909.96
17576,1998-01-06,966.58,-10.49,-1.07,983.79,-1.75,True,1,10830,-966.58,-2049747.65,10468061.4,8418313.75
17577,1998-01-07,964.0,-2.58,-0.27,983.79,-2.01,True,1,10831,-964.0,-2050711.65,10441084.0,8390372.35
17578,1998-01-08,956.05,-7.95,-0.82,983.79,-2.82,True,1,10832,-956.05,-2051667.7,10355933.6,8304265.9
17579,1998-01-09,927.69,-28.36,-2.97,983.79,-5.7,True,1,10833,-927.69,-2052595.39,10049665.77,7997070.38
17580,1998-01-12,939.21,11.52,1.24,983.79,-4.53,True,1,10834,-939.21,-2053534.6,10175401.14,8121866.54
17581,1998-01-13,952.12,12.91,1.38,983.79,-3.22,True,1,10835,-952.12,-2054486.72,10316220.2,8261733.48
17582,1998-01-14,957.94,5.82,0.61,983.79,-2.63,True,1,10836,-957.94,-2055444.66,10380237.84,8324793.18
17583,1998-01-15,950.73,-7.21,-0.75,983.79,-3.36,True,1,10837,-950.73,-2056395.39,10303061.01,8246665.62
17584,1998-01-16,961.51,10.78,1.13,983.79,-2.26,True,1,10838,-961.51,-2057356.9,10420845.38,8363488.48
17585,1998-01-20,978.6,17.09,1.78,983.79,-0.53,True,1,10839,-978.6,-2058335.5,10607045.4,8548709.9
17586,1998-01-21,970.81,-7.79,-0.8,983.79,-1.32,True,1,10840,-970.81,-2059306.31,10523580.4,8464274.09
17587,1998-01-22,963.04,-7.77,-0.8,983.79,-2.11,True,1,10841,-963.04,-2060269.35,10440316.64,8380047.29
17588,1998-01-23,957.59,-5.45,-0.57,983.79,-2.66,True,1,10842,-957.59,-2061226.94,10382190.78,8320963.84
17589,1998-01-26,956.95,-0.64,-0.07,983.79,-2.73,True,1,10843,-956.95,-2062183.89,10376208.85,8314024.96
17590,1998-01-27,969.02,12.07,1.26,983.79,-1.5,True,1,10844,-969.02,-2063152.91,10508052.88,8444899.97
17591,1998-01-28,977.46,8.44,0.87,983.79,-0.64,True,1,10845,-977.46,-2064130.37,10600553.7,8536423.33
17592,1998-01-29,985.49,8.03,0.82,985.49,0.0,True,1,10846,-985.49,-2065115.86,10688624.54,8623508.68
17593,1998-01-30,980.28,-5.21,-0.53,985.49,-0.53,True,1,10847,-980.28,-2066096.14,10633097.16,8567001.02
17594,1998-02-02,1001.27,20.99,2.14,1001.27,0.0,True,1,10848,-1001.27,-2067097.41,10861776.96,8794679.55
17595,1998-02-03,1006.0,4.73,0.47,1006.0,0.0,True,1,10849,-1006.0,-2068103.41,10914094.0,8845990.59
17596,1998-02-04,1006.9,0.9,0.09,1006.9,0.0,True,1,10850,-1006.9,-2069110.31,10924865.0,8855754.69
17597,1998-02-05,1003.54,-3.36,-0.33,1006.9,-0.33,True,1,10851,-1003.54,-2070113.85,10889412.54,8819298.69
17598,1998-02-06,1012.46,8.92,0.89,1012.46,0.0,True,1,10852,-1012.46,-2071126.31,10987215.92,8916089.61
17599,1998-02-09,1010.74,-1.72,-0.17,1012.46,-0.17,True,1,10853,-1010.74,-2072137.05,10969561.22,8897424.17
17600,1998-02-10,1019.01,8.27,0.82,1019.01,0.0,True,1,10854,-1019.01,-2073156.06,11060334.54,8987178.48
17601,1998-02-11,1020.01,1.0,0.1,1020.01,0.0,True,1,10855,-1020.01,-2074176.07,11072208.55,8998032.48
17602,1998-02-12,1024.14,4.13,0.4,1024.14,0.0,True,1,10856,-1024.14,-2075200.21,11118063.84,9042863.63
17603,1998-02-13,1020.09,-4.05,-0.4,1024.14,-0.4,True,1,10857,-1020.09,-2076220.3,11075117.13,8998896.83
17604,1998-02-17,1022.76,2.67,0.26,1024.14,-0.14,True,1,10858,-1022.76,-2077243.06,11105128.08,9027885.02
17605,1998-02-18,1032.08,9.32,0.91,1032.08,0.0,True,1,10859,-1032.08,-2078275.14,11207356.72,9129081.58
17606,1998-02-19,1028.28,-3.8,-0.37,1032.08,-0.37,True,1,10860,-1028.28,-2079303.42,11167120.8,9087817.38
17607,1998-02-20,1034.21,5.93,0.58,1034.21,0.0,True,1,10861,-1034.21,-2080337.63,11232554.81,9152217.18
17608,1998-02-23,1038.14,3.93,0.38,1038.14,0.0,True,1,10862,-1038.14,-2081375.77,11276276.68,9194900.91
17609,1998-02-24,1030.56,-7.58,-0.73,1038.14,-0.73,True,1,10863,-1030.56,-2082406.33,11194973.28,9112566.95
17610,1998-02-25,1042.9,12.34,1.2,1042.9,0.0,True,1,10864,-1042.9,-2083449.23,11330065.6,9246616.37
17611,1998-02-26,1048.67,5.77,0.55,1048.67,0.0,True,1,10865,-1048.67,-2084497.9,11393799.55,9309301.65
17612,1998-02-27,1049.34,0.67,0.06,1049.34,0.0,True,1,10866,-1049.34,-2085547.24,11402128.44,9316581.2
17613,1998-03-02,1047.7,-1.64,-0.16,1049.34,-0.16,True,1,10867,-1047.7,-2086594.94,11385355.9,9298760.96
17614,1998-03-03,1052.02,4.32,0.41,1052.02,0.0,True,1,10868,-1052.02,-2087646.96,11433353.36,9345706.4
17615,1998-03-04,1047.33,-4.69,-0.45,1052.02,-0.45,True,1,10869,-1047.33,-2088694.29,11383429.77,9294735.48
17616,1998-03-05,1035.05,-12.28,-1.17,1052.02,-1.61,True,1,10870,-1035.05,-2089729.34,11250993.5,9161264.16
17617,1998-03-06,1055.69,20.64,1.99,1055.69,0.0,True,1,10871,-1055.69,-2090785.03,11476405.99,9385620.96
17618,1998-03-09,1052.31,-3.38,-0.32,1055.69,-0.32,True,1,10872,-1052.31,-2091837.34,11440714.32,9348876.98
17619,1998-03-10,1064.25,11.94,1.14,1064.25,0.0,True,1,10873,-1064.25,-2092901.59,11571590.25,9478688.66
17620,1998-03-11,1068.47,4.22,0.4,1068.47,0.0,True,1,10874,-1068.47,-2093970.06,11618542.78,9524572.72
17621,1998-03-12,1069.92,1.45,0.14,1069.92,0.0,True,1,10875,-1069.92,-2095039.98,11635380.0,9540340.02
17622,1998-03-13,1068.61,-1.31,-0.12,1069.92,-0.12,True,1,10876,-1068.61,-2096108.59,11622202.36,9526093.77
17623,1998-03-16,1079.27,10.66,1.0,1079.27,0.0,True,1,10877,-1079.27,-2097187.86,11739219.79,9642031.93
17624,1998-03-17,1080.45,1.18,0.11,1080.45,0.0,True,1,10878,-1080.45,-2098268.31,11753135.1,9654866.79
17625,1998-03-18,1085.52,5.07,0.47,1085.52,0.0,True,1,10879,-1085.52,-2099353.83,11809372.08,9710018.25
17626,1998-03-19,1089.74,4.22,0.39,1089.74,0.0,True,1,10880,-1089.74,-2100443.57,11856371.2,9755927.63
17627,1998-03-20,1099.16,9.42,0.86,1099.16,0.0,True,1,10881,-1099.16,-2101542.73,11959959.96,9858417.23
17628,1998-03-23,1095.55,-3.61,-0.33,1099.16,-0.33,True,1,10882,-1095.55,-2102638.28,11921775.1,9819136.82
17629,1998-03-24,1105.65,10.1,0.92,1105.65,0.0,True,1,10883,-1105.65,-2103743.93,12032788.95,9929045.02
17630,1998-03-25,1101.93,-3.72,-0.34,1105.65,-0.34,True,1,10884,-1101.93,-2104845.86,11993406.12,9888560.26
17631,1998-03-26,1100.8,-1.13,-0.1,1105.65,-0.44,True,1,10885,-1100.8,-2105946.66,11982208.0,9876261.34
17632,1998-03-27,1095.44,-5.36,-0.49,1105.65,-0.92,True,1,10886,-1095.44,-2107042.1,11924959.84,9817917.74
17633,1998-03-30,1093.6,-1.84,-0.17,1105.65,-1.09,True,1,10887,-1093.6,-2108135.7,11906023.2,9797887.5
17634,1998-03-31,1101.75,8.15,0.74,1105.65,-0.35,True,1,10888,-1101.75,-2109237.45,11995854.0,9886616.55
17635,1998-04-01,1108.15,6.4,0.58,1108.15,0.0,True,1,10889,-1108.15,-2110345.6,12066645.35,9956299.75
17636,1998-04-02,1120.01,11.86,1.07,1120.01,0.0,True,1,10890,-1120.01,-2111465.61,12196908.9,10085443.29
17637,1998-04-03,1122.7,2.69,0.24,1122.7,0.0,True,1,10891,-1122.7,-2112588.31,12227325.7,10114737.39
17638,1998-04-06,1121.38,-1.32,-0.12,1122.7,-0.12,True,1,10892,-1121.38,-2113709.69,12214070.96,10100361.27
17639,1998-04-07,1109.55,-11.83,-1.06,1122.7,-1.17,True,1,10893,-1109.55,-2114819.24,12086328.15,9971508.91
17640,1998-04-08,1101.65,-7.9,-0.71,1122.7,-1.88,True,1,10894,-1101.65,-2115920.89,12001375.1,9885454.21
17641,1998-04-09,1110.67,9.02,0.82,1122.7,-1.07,True,1,10895,-1110.67,-2117031.56,12100749.65,9983718.09
17642,1998-04-13,1109.69,-0.98,-0.09,1122.7,-1.16,True,1,10896,-1109.69,-2118141.25,12091182.24,9973040.99
17643,1998-04-14,1115.75,6.06,0.55,1122.7,-0.62,True,1,10897,-1115.75,-2119257.0,12158327.75,10039070.75
17644,1998-04-15,1119.32,3.57,0.32,1122.7,-0.3,True,1,10898,-1119.32,-2120376.32,12198349.36,10077973.04
17645,1998-04-16,1108.17,-11.15,-1.0,1122.7,-1.29,True,1,10899,-1108.17,-2121484.49,12077944.83,9956460.34
17646,1998-04-17,1122.72,14.55,1.31,1122.72,0.0,True,1,10900,-1122.72,-2122607.21,12237648.0,10115040.79
17647,1998-04-20,1123.65,0.93,0.08,1123.65,0.0,True,1,10901,-1123.65,-2123730.86,12248908.65,10125177.79
17648,1998-04-21,1126.67,3.02,0.27,1126.67,0.0,True,1,10902,-1126.67,-2124857.53,12282956.34,10158098.81
17649,1998-04-22,1130.54,3.87,0.34,1130.54,0.0,True,1,10903,-1130.54,-2125988.07,12326277.62,10200289.55
17650,1998-04-23,1119.58,-10.96,-0.97,1130.54,-0.97,True,1,10904,-1119.58,-2127107.65,12207900.32,10080792.67
17651,1998-04-24,1107.9,-11.68,-1.04,1130.54,-2.0,True,1,10905,-1107.9,-2128215.55,12081649.5,9953433.95
17652,1998-04-27,1086.54,-21.36,-1.93,1130.54,-3.89,True,1,10906,-1086.54,-2129302.09,11849805.24,9720503.15
17653,1998-04-28,1085.11,-1.43,-0.13,1130.54,-4.02,True,1,10907,-1085.11,-2130387.2,11835294.77,9704907.57
17654,1998-04-29,1094.62,9.51,0.88,1130.54,-3.18,True,1,10908,-1094.62,-2131481.82,11940114.96,9808633.14
17655,1998-04-30,1111.75,17.13,1.56,1130.54,-1.66,True,1,10909,-1111.75,-2132593.57,12128080.75,9995487.18
17656,1998-05-01,1121.0,9.25,0.83,1130.54,-0.84,True,1,10910,-1121.0,-2133714.57,12230110.0,10096395.43
17657,1998-05-04,1122.07,1.07,0.1,1130.54,-0.75,True,1,10911,-1122.07,-2134836.64,12242905.77,10108069.13
17658,1998-05-05,1115.5,-6.57,-0.59,1130.54,-1.33,True,1,10912,-1115.5,-2135952.14,12172336.0,10036383.86
17659,1998-05-06,1104.92,-10.58,-0.95,1130.54,-2.27,True,1,10913,-1104.92,-2137057.06,12057991.96,9920934.9
17660,1998-05-07,1095.14,-9.78,-0.88,1130.54,-3.13,True,1,10914,-1095.14,-2138152.2,11952357.96,9814205.76
17661,1998-05-08,1108.14,13.0,1.19,1130.54,-1.98,True,1,10915,-1108.14,-2139260.34,12095348.1,9956087.76
17662,1998-05-11,1106.64,-1.5,-0.14,1130.54,-2.11,True,1,10916,-1106.64,-2140366.98,12080082.24,9939715.26
17663,1998-05-12,1115.79,9.15,0.83,1130.54,-1.3,True,1,10917,-1115.79,-2141482.77,12181079.43,10039596.66
17664,1998-05-13,1118.86,3.07,0.28,1130.54,-1.03,True,1,10918,-1118.86,-2142601.63,12215713.48,10073111.85
17665,1998-05-14,1117.37,-1.49,-0.13,1130.54,-1.16,True,1,10919,-1117.37,-2143719.0,12200563.03,10056844.03
17666,1998-05-15,1108.73,-8.64,-0.77,1130.54,-1.93,True,1,10920,-1108.73,-2144827.73,12107331.6,9962503.87
17667,1998-05-18,1105.82,-2.91,-0.26,1130.54,-2.19,True,1,10921,-1105.82,-2145933.55,12076660.22,9930726.67
17668,1998-05-19,1109.52,3.7,0.34,1130.54,-1.86,True,1,10922,-1109.52,-2147043.07,12118177.44,9971134.37
17669,1998-05-20,1119.06,9.54,0.86,1130.54,-1.01,True,1,10923,-1119.06,-2148162.13,12223492.38,10075330.25
17670,1998-05-21,1114.64,-4.42,-0.4,1130.54,-1.41,True,1,10924,-1114.64,-2149276.77,12176327.36,10027050.59
17671,1998-05-22,1110.47,-4.17,-0.37,1130.54,-1.78,True,1,10925,-1110.47,-2150387.24,12131884.75,9981497.51
17672,1998-05-26,1094.02,-16.45,-1.48,1130.54,-3.23,True,1,10926,-1094.02,-2151481.26,11953262.52,9801781.26
17673,1998-05-27,1092.23,-1.79,-0.16,1130.54,-3.39,True,1,10927,-1092.23,-2152573.49,11934797.21,9782223.72
17674,1998-05-28,1097.6,5.37,0.49,1130.54,-2.91,True,1,10928,-1097.6,-2153671.09,11994572.8,9840901.71
17675,1998-05-29,1090.82,-6.78,-0.62,1130.54,-3.51,True,1,10929,-1090.82,-2154761.91,11921571.78,9766809.87
17676,1998-06-01,1090.98,0.16,0.02,1130.54,-3.5,True,1,10930,-1090.98,-2155852.89,11924411.4,9768558.51
17677,1998-06-02,1093.22,2.24,0.2,1130.54,-3.3,True,1,10931,-1093.22,-2156946.11,11949987.82,9793041.71
17678,1998-06-03,1082.73,-10.49,-0.96,1130.54,-4.23,True,1,10932,-1082.73,-2158028.84,11836404.36,9678375.52
17679,1998-06-04,1094.83,12.1,1.12,1130.54,-3.16,True,1,10933,-1094.83,-2159123.67,11969776.39,9810652.72
17680,1998-06-05,1113.86,19.03,1.74,1130.54,-1.48,True,1,10934,-1113.86,-2160237.53,12178945.24,10018707.71
17681,1998-06-08,1115.72,1.86,0.17,1130.54,-1.31,True,1,10935,-1115.72,-2161353.25,12200398.2,10039044.95
17682,1998-06-09,1118.41,2.69,0.24,1130.54,-1.07,True,1,10936,-1118.41,-2162471.66,12230931.76,10068460.1
17683,1998-06-10,1112.28,-6.13,-0.55,1130.54,-1.62,True,1,10937,-1112.28,-2163583.94,12165006.36,10001422.42
17684,1998-06-11,1094.58,-17.7,-1.59,1130.54,-3.18,True,1,10938,-1094.58,-2164678.52,11972516.04,9807837.52
17685,1998-06-12,1098.84,4.26,0.39,1130.54,-2.8,True,1,10939,-1098.84,-2165777.36,12020210.76,9854433.4
17686,1998-06-15,1077.01,-21.83,-1.99,1130.54,-4.74,True,1,10940,-1077.01,-2166854.37,11782489.4,9615635.03
17687,1998-06-16,1087.59,10.58,0.98,1130.54,-3.8,True,1,10941,-1087.59,-2167941.96,11899322.19,9731380.23
17688,1998-06-17,1107.11,19.52,1.8,1130.54,-2.07,True,1,10942,-1107.11,-2169049.07,12113997.62,9944948.55
17689,1998-06-18,1106.37,-0.74,-0.07,1130.54,-2.14,True,1,10943,-1106.37,-2170155.44,12107006.91,9936851.47
17690,1998-06-19,1100.65,-5.72,-0.52,1130.54,-2.64,True,1,10944,-1100.65,-2171256.09,12045513.6,9874257.51
17691,1998-06-22,1103.21,2.56,0.23,1130.54,-2.42,True,1,10945,-1103.21,-2172359.3,12074633.45,9902274.15
17692,1998-06-23,1119.49,16.28,1.48,1130.54,-0.98,True,1,10946,-1119.49,-2173478.79,12253937.54,10080458.75
17693,1998-06-24,1132.88,13.39,1.2,1132.88,0.0,True,1,10947,-1132.88,-2174611.67,12401637.36,10227025.69
17694,1998-06-25,1129.28,-3.6,-0.32,1132.88,-0.32,True,1,10948,-1129.28,-2175740.95,12363357.44,10187616.49
17695,1998-06-26,1133.2,3.92,0.35,1133.2,0.0,True,1,10949,-1133.2,-2176874.15,12407406.8,10230532.65
17696,1998-06-29,1138.49,5.29,0.47,1138.49,0.0,True,1,10950,-1138.49,-2178012.64,12466465.5,10288452.86
17697,1998-06-30,1133.84,-4.65,-0.41,1138.49,-0.41,True,1,10951,-1133.84,-2179146.48,12416681.84,10237535.36
17698,1998-07-01,1148.56,14.72,1.3,1148.56,0.0,True,1,10952,-1148.56,-2180295.04,12579029.12,10398734.08
17699,1998-07-02,1146.42,-2.14,-0.19,1148.56,-0.19,True,1,10953,-1146.42,-2181441.46,12556738.26,10375296.8
17700,1998-07-06,1157.33,10.91,0.95,1157.33,0.0,True,1,10954,-1157.33,-2182598.79,12677392.82,10494794.03
17701,1998-07-07,1154.66,-2.67,-0.23,1157.33,-0.23,True,1,10955,-1154.66,-2183753.45,12649300.3,10465546.85
17702,1998-07-08,1166.38,11.72,1.01,1166.38,0.0,True,1,10956,-1166.38,-2184919.83,12778859.28,10593939.45
17703,1998-07-09,1158.56,-7.82,-0.67,1166.38,-0.67,True,1,10957,-1158.56,-2186078.39,12694341.92,10508263.53
17704,1998-07-10,1164.33,5.77,0.5,1166.38,-0.18,True,1,10958,-1164.33,-2187242.72,12758728.14,10571485.42
17705,1998-07-13,1165.19,0.86,0.07,1166.38,-0.1,True,1,10959,-1165.19,-2188407.91,12769317.21,10580909.3
17706,1998-07-14,1177.58,12.39,1.06,1177.58,0.0,True,1,10960,-1177.58,-2189585.49,12906276.8,10716691.31
17707,1998-07-15,1174.81,-2.77,-0.24,1177.58,-0.24,True,1,10961,-1174.81,-2190760.3,12877092.41,10686332.11
17708,1998-07-16,1183.99,9.18,0.78,1183.99,0.0,True,1,10962,-1183.99,-2191944.29,12978898.38,10786954.09
17709,1998-07-17,1186.75,2.76,0.23,1186.75,0.0,True,1,10963,-1186.75,-2193131.04,13010340.25,10817209.21
17710,1998-07-20,1184.1,-2.65,-0.22,1186.75,-0.22,True,1,10964,-1184.1,-2194315.14,12982472.4,10788157.26
17711,1998-07-21,1165.07,-19.03,-1.61,1186.75,-1.83,True,1,10965,-1165.07,-2195480.21,12774992.55,10579512.34
17712,1998-07-22,1164.08,-0.99,-0.08,1186.75,-1.91,True,1,10966,-1164.08,-2196644.29,12765301.28,10568656.99
17713,1998-07-23,1139.75,-24.33,-2.09,1186.75,-3.96,True,1,10967,-1139.75,-2197784.04,12499638.25,10301854.21
17714,1998-07-24,1140.8,1.05,0.09,1186.75,-3.87,True,1,10968,-1140.8,-2198924.84,12512294.4,10313369.56
17715,1998-07-27,1147.27,6.47,0.57,1186.75,-3.33,True,1,10969,-1147.27,-2200072.11,12584404.63,10384332.52
17716,1998-07-28,1130.24,-17.03,-1.48,1186.75,-4.76,True,1,10970,-1130.24,-2201202.35,12398732.8,10197530.45
17717,1998-07-29,1125.21,-5.03,-0.44,1186.75,-5.19,True,1,10971,-1125.21,-2202327.56,12344678.91,10142351.35
17718,1998-07-30,1142.95,17.74,1.58,1186.75,-3.69,True,1,10972,-1142.95,-2203470.51,12540447.4,10336976.89
17719,1998-07-31,1120.67,-22.28,-1.95,1186.75,-5.57,True,1,10973,-1120.67,-2204591.18,12297111.91,10092520.73
17720,1998-08-03,1112.44,-8.23,-0.73,1186.75,-6.26,True,1,10974,-1112.44,-2205703.62,12207916.56,10002212.94
17721,1998-08-04,1072.12,-40.32,-3.62,1186.75,-9.66,True,1,10975,-1072.12,-2206775.74,11766517.0,9559741.26
17722,1998-08-05,1081.43,9.31,0.87,1186.75,-8.88,True,1,10976,-1081.43,-2207857.17,11869775.68,9661918.51
17723,1998-08-06,1089.63,8.2,0.76,1186.75,-8.18,True,1,10977,-1089.63,-2208946.8,11960868.51,9751921.71
17724,1998-08-07,1089.45,-0.18,-0.02,1186.75,-8.2,True,1,10978,-1089.45,-2210036.25,11959982.1,9749945.85
17725,1998-08-10,1083.14,-6.31,-0.58,1186.75,-8.73,True,1,10979,-1083.14,-2211119.39,11891794.06,9680674.67
17726,1998-08-11,1068.98,-14.16,-1.31,1186.75,-9.92,True,1,10980,-1068.98,-2212188.37,11737400.4,9525212.03
17727,1998-08-12,1084.22,15.24,1.43,1186.75,-8.64,True,1,10981,-1084.22,-2213272.59,11905819.82,9692547.23
17728,1998-08-13,1074.91,-9.31,-0.86,1186.75,-9.42,True,1,10982,-1074.91,-2214347.5,11804661.62,9590314.12
17729,1998-08-14,1062.75,-12.16,-1.13,1186.75,-10.45,True,1,10983,-1062.75,-2215410.25,11672183.25,9456773.0
17730,1998-08-17,1083.67,20.92,1.97,1186.75,-8.69,True,1,10984,-1083.67,-2216493.92,11903031.28,9686537.36
17731,1998-08-18,1101.2,17.53,1.62,1186.75,-7.21,True,1,10985,-1101.2,-2217595.12,12096682.0,9879086.88
17732,1998-08-19,1098.06,-3.14,-0.28,1186.75,-7.47,True,1,10986,-1098.06,-2218693.18,12063287.16,9844593.98
17733,1998-08-20,1091.6,-6.46,-0.59,1186.75,-8.02,True,1,10987,-1091.6,-2219784.78,11993409.2,9773624.42
17734,1998-08-21,1081.24,-10.36,-0.95,1186.75,-8.89,True,1,10988,-1081.24,-2220866.02,11880665.12,9659799.1
17735,1998-08-24,1088.14,6.9,0.64,1186.75,-8.31,True,1,10989,-1088.14,-2221954.16,11957570.46,9735616.3
17736,1998-08-25,1092.85,4.71,0.43,1186.75,-7.91,True,1,10990,-1092.85,-2223047.01,12010421.5,9787374.49
17737,1998-08-26,1084.19,-8.66,-0.79,1186.75,-8.64,True,1,10991,-1084.19,-2224131.2,11916332.29,9692201.09
17738,1998-08-27,1042.59,-41.6,-3.84,1186.75,-12.15,True,1,10992,-1042.59,-2225173.79,11460149.28,9234975.49
17739,1998-08-28,1027.14,-15.45,-1.48,1186.75,-13.45,True,1,10993,-1027.14,-2226200.93,11291350.02,9065149.09
17740,1998-08-31,957.28,-69.86,-6.8,1186.75,-19.34,True,1,10994,-957.28,-2227158.21,10524336.32,8297178.11
17741,1998-09-01,994.26,36.98,3.86,1186.75,-16.22,True,1,10995,-994.26,-2228152.47,10931888.7,8703736.23
17742,1998-09-02,990.48,-3.78,-0.38,1186.75,-16.54,True,1,10996,-990.48,-2229142.95,10891318.08,8662175.13
17743,1998-09-03,982.26,-8.22,-0.83,1186.75,-17.23,True,1,10997,-982.26,-2230125.21,10801913.22,8571788.01
17744,1998-09-04,973.89,-8.37,-0.85,1186.75,-17.94,True,1,10998,-973.89,-2231099.1,10710842.22,8479743.12
17745,1998-09-08,1023.46,49.57,5.09,1186.75,-13.76,True,1,10999,-1023.46,-2232122.56,11257036.54,9024913.98
17746,1998-09-09,1006.2,-17.26,-1.69,1186.75,-15.21,True,1,11000,-1006.2,-2233128.76,11068200.0,8835071.24
17747,1998-09-10,980.19,-26.01,-2.58,1186.75,-17.41,True,1,11001,-980.19,-2234108.95,10783070.19,8548961.24
17748,1998-09-11,1009.06,28.87,2.94,1186.75,-14.97,True,1,11002,-1009.06,-2235118.01,11101678.12,8866560.11
17749,1998-09-14,1029.72,20.66,2.05,1186.75,-13.23,True,1,11003,-1029.72,-2236147.73,11330009.16,9093861.43
17750,1998-09-15,1037.68,7.96,0.77,1186.75,-12.56,True,1,11004,-1037.68,-2237185.41,11418630.72,9181445.31
17751,1998-09-16,1045.48,7.8,0.75,1186.75,-11.9,True,1,11005,-1045.48,-2238230.89,11505507.4,9267276.51
17752,1998-09-17,1018.87,-26.61,-2.54,1186.75,-14.15,True,1,11006,-1018.87,-2239249.76,11213683.22,8974433.46
17753,1998-09-18,1020.09,1.22,0.12,1186.75,-14.04,True,1,11007,-1020.09,-2240269.85,11228130.63,8987860.78
17754,1998-09-21,1023.89,3.8,0.37,1186.75,-13.72,True,1,11008,-1023.89,-2241293.74,11270981.12,9029687.38
17755,1998-09-22,1029.63,5.74,0.56,1186.75,-13.24,True,1,11009,-1029.63,-2242323.37,11335196.67,9092873.3
17756,1998-09-23,1066.09,36.46,3.54,1186.75,-10.17,True,1,11010,-1066.09,-2243389.46,11737650.9,9494261.44
17757,1998-09-24,1042.72,-23.37,-2.19,1186.75,-12.14,True,1,11011,-1042.72,-2244432.18,11481389.92,9236957.74
17758,1998-09-25,1044.75,2.03,0.2,1186.75,-11.96,True,1,11012,-1044.75,-2245476.93,11504787.0,9259310.07
17759,1998-09-28,1048.69,3.94,0.38,1186.75,-11.63,True,1,11013,-1048.69,-2246525.62,11549222.97,9302697.35
17760,1998-09-29,1049.02,0.33,0.03,1186.75,-11.61,True,1,11014,-1049.02,-2247574.64,11553906.28,9306331.64
17761,1998-09-30,1017.01,-32.01,-3.05,1186.75,-14.3,True,1,11015,-1017.01,-2248591.65,11202365.15,8953773.5
17762,1998-10-01,986.39,-30.62,-3.01,1186.75,-16.88,True,1,11016,-986.39,-2249578.04,10866072.24,8616494.2
17763,1998-10-02,1002.6,16.21,1.64,1186.75,-15.52,True,1,11017,-1002.6,-2250580.64,11045644.2,8795063.56
17764,1998-10-05,988.56,-14.04,-1.4,1186.75,-16.7,True,1,11018,-988.56,-2251569.2,10891954.08,8640384.88
17765,1998-10-06,984.59,-3.97,-0.4,1186.75,-17.04,True,1,11019,-984.59,-2252553.79,10849197.21,8596643.42
17766,1998-10-07,970.68,-13.91,-1.41,1186.75,-18.21,True,1,11020,-970.68,-2253524.47,10696893.6,8443369.13
17767,1998-10-08,959.44,-11.24,-1.16,1186.75,-19.15,True,1,11021,-959.44,-2254483.91,10573988.24,8319504.33
17768,1998-10-09,984.39,24.95,2.6,1186.75,-17.05,True,1,11022,-984.39,-2255468.3,10849946.58,8594478.28
17769,1998-10-12,997.71,13.32,1.35,1186.75,-15.93,True,1,11023,-997.71,-2256466.01,10997757.33,8741291.32
17770,1998-10-13,994.8,-2.91,-0.29,1186.75,-16.17,True,1,11024,-994.8,-2257460.81,10966675.2,8709214.39
17771,1998-10-14,1005.53,10.73,1.08,1186.75,-15.27,True,1,11025,-1005.53,-2258466.34,11085968.25,8827501.91
17772,1998-10-15,1047.49,41.96,4.17,1186.75,-11.74,True,1,11026,-1047.49,-2259513.83,11549624.74,9290110.91
17773,1998-10-16,1056.42,8.93,0.85,1186.75,-10.98,True,1,11027,-1056.42,-2260570.25,11649143.34,9388573.09
17774,1998-10-19,1062.39,5.97,0.56,1186.75,-10.48,True,1,11028,-1062.39,-2261632.64,11716036.92,9454404.28
17775,1998-10-20,1063.93,1.54,0.14,1186.75,-10.35,True,1,11029,-1063.93,-2262696.57,11734083.97,9471387.4
17776,1998-10-21,1069.92,5.99,0.56,1186.75,-9.85,True,1,11030,-1069.92,-2263766.49,11801217.6,9537451.11
17777,1998-10-22,1078.48,8.56,0.8,1186.75,-9.12,True,1,11031,-1078.48,-2264844.97,11896712.88,9631867.91
17778,1998-10-23,1070.67,-7.81,-0.72,1186.75,-9.78,True,1,11032,-1070.67,-2265915.64,11811631.44,9545715.8
17779,1998-10-26,1072.32,1.65,0.15,1186.75,-9.64,True,1,11033,-1072.32,-2266987.96,11830906.56,9563918.6
17780,1998-10-27,1065.34,-6.98,-0.65,1186.75,-10.23,True,1,11034,-1065.34,-2268053.3,11754961.56,9486908.26
17781,1998-10-28,1068.09,2.75,0.26,1186.75,-10.0,True,1,11035,-1068.09,-2269121.39,11786373.15,9517251.76
17782,1998-10-29,1085.93,17.84,1.67,1186.75,-8.49,True,1,11036,-1085.93,-2270207.32,11984323.48,9714116.16
17783,1998-10-30,1098.67,12.74,1.17,1186.75,-7.42,True,1,11037,-1098.67,-2271305.99,12126020.79,9854714.8
17784,1998-11-02,1111.6,12.93,1.18,1186.75,-6.33,True,1,11038,-1111.6,-2272417.59,12269840.8,9997423.21
17785,1998-11-03,1110.84,-0.76,-0.07,1186.75,-6.4,True,1,11039,-1110.84,-2273528.43,12262562.76,9989034.33
17786,1998-11-04,1118.67,7.83,0.7,1186.75,-5.74,True,1,11040,-1118.67,-2274647.1,12350116.8,10075469.7
17787,1998-11-05,1133.85,15.18,1.36,1186.75,-4.46,True,1,11041,-1133.85,-2275780.95,12518837.85,10243056.9
17788,1998-11-06,1141.01,7.16,0.63,1186.75,-3.85,True,1,11042,-1141.01,-2276921.96,12599032.42,10322110.46
17789,1998-11-09,1130.2,-10.81,-0.95,1186.75,-4.76,True,1,11043,-1130.2,-2278052.16,12480798.6,10202746.44
17790,1998-11-10,1128.26,-1.94,-0.17,1186.75,-4.93,True,1,11044,-1128.26,-2279180.42,12460503.44,10181323.02
17791,1998-11-11,1120.97,-7.29,-0.65,1186.75,-5.54,True,1,11045,-1120.97,-2280301.39,12381113.65,10100812.26
17792,1998-11-12,1117.69,-3.28,-0.29,1186.75,-5.82,True,1,11046,-1117.69,-2281419.08,12346003.74,10064584.66
17793,1998-11-13,1125.72,8.03,0.72,1186.75,-5.14,True,1,11047,-1125.72,-2282544.8,12435828.84,10153284.04
17794,1998-11-16,1135.87,10.15,0.9,1186.75,-4.29,True,1,11048,-1135.87,-2283680.67,12549091.76,10265411.09
17795,1998-11-17,1139.32,3.45,0.3,1186.75,-4.0,True,1,11049,-1139.32,-2284819.99,12588346.68,10303526.69
17796,1998-11-18,1144.48,5.16,0.45,1186.75,-3.56,True,1,11050,-1144.48,-2285964.47,12646504.0,10360539.53
17797,1998-11-19,1152.61,8.13,0.71,1186.75,-2.88,True,1,11051,-1152.61,-2287117.08,12737493.11,10450376.03
17798,1998-11-20,1163.55,10.94,0.95,1186.75,-1.96,True,1,11052,-1163.55,-2288280.63,12859554.6,10571273.97
17799,1998-11-23,1188.21,24.66,2.12,1188.21,0.0,True,1,11053,-1188.21,-2289468.84,13133285.13,10843816.29
17800,1998-11-24,1182.99,-5.22,-0.44,1188.21,-0.44,True,1,11054,-1182.99,-2290651.83,13076771.46,10786119.63
17801,1998-11-25,1186.87,3.88,0.33,1188.21,-0.11,True,1,11055,-1186.87,-2291838.7,13120847.85,10829009.15
17802,1998-11-27,1192.33,5.46,0.46,1192.33,0.0,True,1,11056,-1192.33,-2293031.03,13182400.48,10889369.45
17803,1998-11-30,1163.63,-28.7,-2.41,1192.33,-2.41,True,1,11057,-1163.63,-2294194.66,12866256.91,10572062.25
17804,1998-12-01,1175.28,11.65,1.0,1192.33,-1.43,True,1,11058,-1175.28,-2295369.94,12996246.24,10700876.3
17805,1998-12-02,1171.25,-4.03,-0.34,1192.33,-1.77,True,1,11059,-1171.25,-2296541.19,12952853.75,10656312.56
17806,1998-12-03,1150.14,-21.11,-1.8,1192.33,-3.54,True,1,11060,-1150.14,-2297691.33,12720548.4,10422857.07
17807,1998-12-04,1176.74,26.6,2.31,1192.33,-1.31,True,1,11061,-1176.74,-2298868.07,13015921.14,10717053.07
17808,1998-12-07,1187.7,10.96,0.93,1192.33,-0.39,True,1,11062,-1187.7,-2300055.77,13138337.4,10838281.63
17809,1998-12-08,1181.38,-6.32,-0.53,1192.33,-0.92,True,1,11063,-1181.38,-2301237.15,13069606.94,10768369.79
17810,1998-12-09,1183.49,2.11,0.18,1192.33,-0.74,True,1,11064,-1183.49,-2302420.64,13094133.36,10791712.72
17811,1998-12-10,1165.02,-18.47,-1.56,1192.33,-2.29,True,1,11065,-1165.02,-2303585.66,12890946.3,10587360.64
17812,1998-12-11,1166.46,1.44,0.12,1192.33,-2.17,True,1,11066,-1166.46,-2304752.12,12908046.36,10603294.24
17813,1998-12-14,1141.2,-25.26,-2.17,1192.33,-4.29,True,1,11067,-1141.2,-2305893.32,12629660.4,10323767.08
17814,1998-12-15,1162.83,21.63,1.9,1192.33,-2.47,True,1,11068,-1162.83,-2307056.15,12870202.44,10563146.29
17815,1998-12-16,1161.94,-0.89,-0.08,1192.33,-2.55,True,1,11069,-1161.94,-2308218.09,12861513.86,10553295.77
17816,1998-12-17,1179.98,18.04,1.55,1192.33,-1.04,True,1,11070,-1179.98,-2309398.07,13062378.6,10752980.53
17817,1998-12-18,1188.03,8.05,0.68,1192.33,-0.36,True,1,11071,-1188.03,-2310586.1,13152680.13,10842094.03
17818,1998-12-21,1202.84,14.81,1.25,1202.84,0.0,True,1,11072,-1202.84,-2311788.94,13317844.48,11006055.54
17819,1998-12-22,1203.57,0.73,0.06,1203.57,0.0,True,1,11073,-1203.57,-2312992.51,13327130.61,11014138.1
17820,1998-12-23,1228.54,24.97,2.08,1228.54,0.0,True,1,11074,-1228.54,-2314221.05,13604851.96,11290630.91
17821,1998-12-24,1226.27,-2.27,-0.18,1228.54,-0.18,True,1,11075,-1226.27,-2315447.32,13580940.25,11265492.93
17822,1998-12-28,1225.49,-0.78,-0.06,1228.54,-0.25,True,1,11076,-1225.49,-2316672.81,13573527.24,11256854.43
17823,1998-12-29,1241.81,16.32,1.33,1241.81,0.0,True,1,11077,-1241.81,-2317914.62,13755529.37,11437614.75
17824,1998-12-30,1231.93,-9.88,-0.8,1241.81,-0.8,True,1,11078,-1231.93,-2319146.55,13647320.54,11328173.99
17825,1998-12-31,1229.23,-2.7,-0.22,1241.81,-1.01,True,1,11079,-1229.23,-2320375.78,13618639.17,11298263.39
17826,1999-01-04,1228.1,-1.13,-0.09,1241.81,-1.1,True,1,11080,-1228.1,-2321603.88,13607348.0,11285744.12
17827,1999-01-05,1244.78,16.68,1.36,1244.78,0.0,True,1,11081,-1244.78,-2322848.66,13793407.18,11470558.52
17828,1999-01-06,1272.34,27.56,2.21,1272.34,0.0,True,1,11082,-1272.34,-2324121.0,14100071.88,11775950.88
17829,1999-01-07,1269.73,-2.61,-0.2,1272.34,-0.2,True,1,11083,-1269.73,-2325390.73,14072417.59,11747026.86
17830,1999-01-08,1275.09,5.36,0.42,1275.09,0.0,True,1,11084,-1275.09,-2326665.82,14133097.56,11806431.74
17831,1999-01-11,1263.88,-11.21,-0.88,1275.09,-0.88,True,1,11085,-1263.88,-2327929.7,14010109.8,11682180.1
17832,1999-01-12,1239.51,-24.37,-1.93,1275.09,-2.79,True,1,11086,-1239.51,-2329169.21,13741207.86,11412038.65
17833,1999-01-13,1234.4,-5.11,-0.41,1275.09,-3.19,True,1,11087,-1234.4,-2330403.61,13685792.8,11355389.19
17834,1999-01-14,1212.19,-22.21,-1.8,1275.09,-4.93,True,1,11088,-1212.19,-2331615.8,13440762.72,11109146.92
17835,1999-01-15,1243.26,31.07,2.56,1275.09,-2.5,True,1,11089,-1243.26,-2332859.06,13786510.14,11453651.08
17836,1999-01-19,1252.0,8.74,0.7,1275.09,-1.81,True,1,11090,-1252.0,-2334111.06,13884680.0,11550568.94
17837,1999-01-20,1256.62,4.62,0.37,1275.09,-1.45,True,1,11091,-1256.62,-2335367.68,13937172.42,11601804.74
17838,1999-01-21,1235.16,-21.46,-1.71,1275.09,-3.13,True,1,11092,-1235.16,-2336602.84,13700394.72,11363791.88
17839,1999-01-22,1225.19,-9.97,-0.81,1275.09,-3.91,True,1,11093,-1225.19,-2337828.03,13591032.67,11253204.64
17840,1999-01-25,1233.98,8.79,0.72,1275.09,-3.22,True,1,11094,-1233.98,-2339062.01,13689774.12,11350712.11
17841,1999-01-26,1252.31,18.33,1.48,1275.09,-1.79,True,1,11095,-1252.31,-2340314.32,13894379.45,11554065.13
17842,1999-01-27,1243.17,-9.14,-0.73,1275.09,-2.5,True,1,11096,-1243.17,-2341557.49,13794214.32,11452656.83
17843,1999-01-28,1265.37,22.2,1.79,1275.09,-0.76,True,1,11097,-1265.37,-2342822.86,14041810.89,11698988.03
17844,1999-01-29,1279.64,14.27,1.13,1279.64,0.0,True,1,11098,-1279.64,-2344102.5,14201444.72,11857342.22
17845,1999-02-01,1273.0,-6.64,-0.52,1279.64,-0.52,True,1,11099,-1273.0,-2345375.5,14129027.0,11783651.5
17846,1999-02-02,1261.99,-11.01,-0.86,1279.64,-1.38,True,1,11100,-1261.99,-2346637.49,14008089.0,11661451.51
17847,1999-02-03,1272.07,10.08,0.8,1279.64,-0.59,True,1,11101,-1272.07,-2347909.56,14121249.07,11773339.51
17848,1999-02-04,1248.49,-23.58,-1.85,1279.64,-2.43,True,1,11102,-1248.49,-2349158.05,13860735.98,11511577.93
17849,1999-02-05,1239.4,-9.09,-0.73,1279.64,-3.14,True,1,11103,-1239.4,-2350397.45,13761058.2,11410660.75
17850,1999-02-08,1243.77,4.37,0.35,1279.64,-2.8,True,1,11104,-1243.77,-2351641.22,13810822.08,11459180.86
17851,1999-02-09,1216.14,-27.63,-2.22,1279.64,-4.96,True,1,11105,-1216.14,-2352857.36,13505234.7,11152377.34
17852,1999-02-10,1223.55,7.41,0.61,1279.64,-4.38,True,1,11106,-1223.55,-2354080.91,13588746.3,11234665.39
17853,1999-02-11,1254.04,30.49,2.49,1279.64,-2.0,True,1,11107,-1254.04,-2355334.95,13928622.28,11573287.33
17854,1999-02-12,1230.13,-23.91,-1.91,1279.64,-3.87,True,1,11108,-1230.13,-2356565.08,13664284.04,11307718.96
17855,1999-02-16,1241.87,11.74,0.95,1279.64,-2.95,True,1,11109,-1241.87,-2357806.95,13795933.83,11438126.88
17856,1999-02-17,1224.03,-17.84,-1.44,1279.64,-4.35,True,1,11110,-1224.03,-2359030.98,13598973.3,11239942.32
17857,1999-02-18,1237.28,13.25,1.08,1279.64,-3.31,True,1,11111,-1237.28,-2360268.26,13747418.08,11387149.82
17858,1999-02-19,1239.22,1.94,0.16,1279.64,-3.16,True,1,11112,-1239.22,-2361507.48,13770212.64,11408705.16
17859,1999-02-22,1272.14,32.92,2.66,1279.64,-0.59,True,1,11113,-1272.14,-2362779.62,14137291.82,11774512.2
17860,1999-02-23,1271.18,-0.96,-0.08,1279.64,-0.66,True,1,11114,-1271.18,-2364050.8,14127894.52,11763843.72
17861,1999-02-24,1253.41,-17.77,-1.4,1279.64,-2.05,True,1,11115,-1253.41,-2365304.21,13931652.15,11566347.94
17862,1999-02-25,1245.02,-8.39,-0.67,1279.64,-2.7,True,1,11116,-1245.02,-2366549.23,13839642.32,11473093.09
17863,1999-02-26,1238.33,-6.69,-0.54,1279.64,-3.23,True,1,11117,-1238.33,-2367787.56,13766514.61,11398727.05
17864,1999-03-01,1236.16,-2.17,-0.18,1279.64,-3.4,True,1,11118,-1236.16,-2369023.72,13743626.88,11374603.16
17865,1999-03-02,1225.5,-10.66,-0.86,1279.64,-4.23,True,1,11119,-1225.5,-2370249.22,13626334.5,11256085.28
17866,1999-03-03,1227.7,2.2,0.18,1279.64,-4.06,True,1,11120,-1227.7,-2371476.92,13652024.0,11280547.08
17867,1999-03-04,1246.64,18.94,1.54,1279.64,-2.58,True,1,11121,-1246.64,-2372723.56,13863883.44,11491159.88
17868,1999-03-05,1275.47,28.83,2.31,1279.64,-0.33,True,1,11122,-1275.47,-2373999.03,14185777.34,11811778.31
17869,1999-03-08,1282.73,7.26,0.57,1282.73,0.0,True,1,11123,-1282.73,-2375281.76,14267805.79,11892524.03
17870,1999-03-09,1279.84,-2.89,-0.22,1282.73,-0.22,True,1,11124,-1279.84,-2376561.6,14236940.16,11860378.56
17871,1999-03-10,1286.84,7.0,0.55,1286.84,0.0,True,1,11125,-1286.84,-2377848.44,14316095.0,11938246.56
17872,1999-03-11,1297.68,10.84,0.84,1297.68,0.0,True,1,11126,-1297.68,-2379146.12,14437987.68,12058841.56
17873,1999-03-12,1294.59,-3.09,-0.24,1297.68,-0.24,True,1,11127,-1294.59,-2380440.71,14404902.93,12024462.22
17874,1999-03-15,1307.26,12.67,0.98,1307.26,0.0,True,1,11128,-1307.26,-2381747.97,14547189.28,12165441.31
17875,1999-03-16,1306.38,-0.88,-0.07,1307.26,-0.07,True,1,11129,-1306.38,-2383054.35,14538703.02,12155648.67
17876,1999-03-17,1297.82,-8.56,-0.66,1307.26,-0.72,True,1,11130,-1297.82,-2384352.17,14444736.6,12060384.43
17877,1999-03-18,1316.55,18.73,1.44,1316.55,0.0,True,1,11131,-1316.55,-2385668.72,14654518.05,12268849.33
17878,1999-03-19,1299.29,-17.26,-1.31,1316.55,-1.31,True,1,11132,-1299.29,-2386968.01,14463696.28,12076728.27
17879,1999-03-22,1297.01,-2.28,-0.18,1316.55,-1.48,True,1,11133,-1297.01,-2388265.02,14439612.33,12051347.31
17880,1999-03-23,1262.14,-34.87,-2.69,1316.55,-4.13,True,1,11134,-1262.14,-2389527.16,14052666.76,11663139.6
17881,1999-03-24,1268.59,6.45,0.51,1316.55,-3.64,True,1,11135,-1268.59,-2390795.75,14125749.65,11734953.9
17882,1999-03-25,1289.99,21.4,1.69,1316.55,-2.02,True,1,11136,-1289.99,-2392085.74,14365328.64,11973242.9
17883,1999-03-26,1282.8,-7.19,-0.56,1316.55,-2.56,True,1,11137,-1282.8,-2393368.54,14286543.6,11893175.06
17884,1999-03-29,1310.17,27.37,2.13,1316.55,-0.48,True,1,11138,-1310.17,-2394678.71,14592673.46,12197994.75
17885,1999-03-30,1300.75,-9.42,-0.72,1316.55,-1.2,True,1,11139,-1300.75,-2395979.46,14489054.25,12093074.79
17886,1999-03-31,1286.37,-14.38,-1.11,1316.55,-2.29,True,1,11140,-1286.37,-2397265.83,14330161.8,11932895.97
17887,1999-04-01,1293.72,7.35,0.57,1316.55,-1.73,True,1,11141,-1293.72,-2398559.55,14413334.52,12014774.97
17888,1999-04-05,1321.12,27.4,2.12,1321.12,0.0,True,1,11142,-1321.12,-2399880.67,14719919.04,12320038.37
17889,1999-04-06,1317.89,-3.23,-0.24,1321.12,-0.24,True,1,11143,-1317.89,-2401198.56,14685248.27,12284049.71
17890,1999-04-07,1326.89,9.0,0.68,1326.89,0.0,True,1,11144,-1326.89,-2402525.45,14786862.16,12384336.71
17891,1999-04-08,1343.98,17.09,1.29,1343.98,0.0,True,1,11145,-1343.98,-2403869.43,14978657.1,12574787.67
17892,1999-04-09,1348.35,4.37,0.32,1348.35,0.0,True,1,11146,-1348.35,-2405217.78,15028709.1,12623491.32
17893,1999-04-12,1358.63,10.28,0.76,1358.63,0.0,True,1,11147,-1358.63,-2406576.41,15144648.61,12738072.2
17894,1999-04-13,1349.82,-8.81,-0.65,1358.63,-0.65,True,1,11148,-1349.82,-2407926.23,15047793.36,12639867.13
17895,1999-04-14,1328.44,-21.38,-1.58,1358.63,-2.22,True,1,11149,-1328.44,-2409254.67,14810777.56,12401522.89
17896,1999-04-15,1322.85,-5.59,-0.42,1358.63,-2.63,True,1,11150,-1322.85,-2410577.52,14749777.5,12339199.98
17897,1999-04-16,1319.0,-3.85,-0.29,1358.63,-2.92,True,1,11151,-1319.0,-2411896.52,14708169.0,12296272.48
17898,1999-04-19,1289.48,-29.52,-2.24,1358.63,-5.09,True,1,11152,-1289.48,-2413186.0,14380280.96,11967094.96
17899,1999-04-20,1306.17,16.69,1.29,1358.63,-3.86,True,1,11153,-1306.17,-2414492.17,14567714.01,12153221.84
17900,1999-04-21,1336.12,29.95,2.29,1358.63,-1.66,True,1,11154,-1336.12,-2415828.29,14903082.48,12487254.19
17901,1999-04-22,1358.82,22.7,1.7,1358.82,0.0,True,1,11155,-1358.82,-2417187.11,15157637.1,12740449.99
17902,1999-04-23,1356.85,-1.97,-0.14,1358.82,-0.14,True,1,11156,-1356.85,-2418543.96,15137018.6,12718474.64
17903,1999-04-26,1360.04,3.19,0.24,1360.04,0.0,True,1,11157,-1360.04,-2419904.0,15173966.28,12754062.28
17904,1999-04-27,1362.8,2.76,0.2,1362.8,0.0,True,1,11158,-1362.8,-2421266.8,15206122.4,12784855.6
17905,1999-04-28,1350.91,-11.89,-0.87,1362.8,-0.87,True,1,11159,-1350.91,-2422617.71,15074804.69,12652186.98
17906,1999-04-29,1342.83,-8.08,-0.6,1362.8,-1.46,True,1,11160,-1342.83,-2423960.54,14985982.8,12562022.26
17907,1999-04-30,1335.18,-7.65,-0.57,1362.8,-2.03,True,1,11161,-1335.18,-2425295.72,14901943.98,12476648.26
17908,1999-05-03,1354.63,19.45,1.46,1362.8,-0.6,True,1,11162,-1354.63,-2426650.35,15120380.06,12693729.71
17909,1999-05-04,1332.0,-22.63,-1.67,1362.8,-2.26,True,1,11163,-1332.0,-2427982.35,14869116.0,12441133.65
17910,1999-05-05,1347.31,15.31,1.15,1362.8,-1.14,True,1,11164,-1347.31,-2429329.66,15041368.84,12612039.18
17911,1999-05-06,1332.05,-15.26,-1.13,1362.8,-2.26,True,1,11165,-1332.05,-2430661.71,14872338.25,12441676.54
17912,1999-05-07,1345.0,12.95,0.97,1362.8,-1.31,True,1,11166,-1345.0,-2432006.71,15018270.0,12586263.29
17913,1999-05-10,1340.3,-4.7,-0.35,1362.8,-1.65,True,1,11167,-1340.3,-2433347.01,14967130.1,12533783.09
17914,1999-05-11,1355.61,15.31,1.14,1362.8,-0.53,True,1,11168,-1355.61,-2434702.62,15139452.48,12704749.86
17915,1999-05-12,1364.0,8.39,0.62,1364.0,0.0,True,1,11169,-1364.0,-2436066.62,15234516.0,12798449.38
17916,1999-05-13,1367.56,3.56,0.26,1367.56,0.0,True,1,11170,-1367.56,-2437434.18,15275645.2,12838211.02
17917,1999-05-14,1337.8,-29.76,-2.18,1367.56,-2.18,True,1,11171,-1337.8,-2438771.98,14944563.8,12505791.82
17918,1999-05-17,1339.49,1.69,0.13,1367.56,-2.05,True,1,11172,-1339.49,-2440111.47,14964782.28,12524670.81
17919,1999-05-18,1333.32,-6.17,-0.46,1367.56,-2.5,True,1,11173,-1333.32,-2441444.79,14897184.36,12455739.57
17920,1999-05-19,1344.23,10.91,0.82,1367.56,-1.71,True,1,11174,-1344.23,-2442789.02,15020426.02,12577637.0
17921,1999-05-20,1338.83,-5.4,-0.4,1367.56,-2.1,True,1,11175,-1338.83,-2444127.85,14961425.25,12517297.4
17922,1999-05-21,1330.29,-8.54,-0.64,1367.56,-2.72,True,1,11176,-1330.29,-2445458.14,14867321.04,12421862.9
17923,1999-05-24,1306.65,-23.64,-1.78,1367.56,-4.45,True,1,11177,-1306.65,-2446764.79,14604427.05,12157662.26
17924,1999-05-25,1284.4,-22.25,-1.7,1367.56,-6.08,True,1,11178,-1284.4,-2448049.19,14357023.2,11908974.01
17925,1999-05-26,1304.76,20.36,1.58,1367.56,-4.59,True,1,11179,-1304.76,-2449353.95,14585912.04,12136558.09
17926,1999-05-27,1281.41,-23.35,-1.79,1367.56,-6.3,True,1,11180,-1281.41,-2450635.36,14326163.8,11875528.44
17927,1999-05-28,1301.84,20.43,1.59,1367.56,-4.81,True,1,11181,-1301.84,-2451937.2,14555873.04,12103935.84
17928,1999-06-01,1294.26,-7.58,-0.58,1367.56,-5.36,True,1,11182,-1294.26,-2453231.46,14472415.32,12019183.86
17929,1999-06-02,1294.81,0.55,0.04,1367.56,-5.32,True,1,11183,-1294.81,-2454526.27,14479860.23,12025333.96
17930,1999-06-03,1299.54,4.73,0.36,1367.56,-4.97,True,1,11184,-1299.54,-2455825.81,14534055.36,12078229.55
17931,1999-06-04,1327.75,28.21,2.17,1367.56,-2.91,True,1,11185,-1327.75,-2457153.56,14850883.75,12393730.19
17932,1999-06-07,1334.52,6.77,0.51,1367.56,-2.42,True,1,11186,-1334.52,-2458488.08,14927940.72,12469452.64
17933,1999-06-08,1317.33,-17.19,-1.29,1367.56,-3.67,True,1,11187,-1317.33,-2459805.41,14736970.71,12277165.3
17934,1999-06-09,1318.64,1.31,0.1,1367.56,-3.58,True,1,11188,-1318.64,-2461124.05,14752944.32,12291820.27
17935,1999-06-10,1302.82,-15.82,-1.2,1367.56,-4.73,True,1,11189,-1302.82,-2462426.87,14577252.98,12114826.11
17936,1999-06-11,1293.64,-9.18,-0.7,1367.56,-5.4,True,1,11190,-1293.64,-2463720.51,14475831.6,12012111.09
17937,1999-06-14,1294.0,0.36,0.03,1367.56,-5.38,True,1,11191,-1294.0,-2465014.51,14481154.0,12016139.49
17938,1999-06-15,1301.16,7.16,0.55,1367.56,-4.86,True,1,11192,-1301.16,-2466315.67,14562582.72,12096267.05
17939,1999-06-16,1330.41,29.25,2.25,1367.56,-2.72,True,1,11193,-1330.41,-2467646.08,14891279.13,12423633.05
17940,1999-06-17,1339.9,9.49,0.71,1367.56,-2.02,True,1,11194,-1339.9,-2468985.98,14998840.6,12529854.62
17941,1999-06-18,1342.84,2.94,0.22,1367.56,-1.81,True,1,11195,-1342.84,-2470328.82,15033093.8,12562764.98
17942,1999-06-21,1349.0,6.16,0.46,1367.56,-1.36,True,1,11196,-1349.0,-2471677.82,15103404.0,12631726.18
17943,1999-06-22,1335.88,-13.12,-0.97,1367.56,-2.32,True,1,11197,-1335.88,-2473013.7,14957848.36,12484834.66
17944,1999-06-23,1333.06,-2.82,-0.21,1367.56,-2.52,True,1,11198,-1333.06,-2474346.76,14927605.88,12453259.12
17945,1999-06-24,1315.78,-17.28,-1.3,1367.56,-3.79,True,1,11199,-1315.78,-2475662.54,14735420.22,12259757.68
17946,1999-06-25,1315.31,-0.47,-0.04,1367.56,-3.82,True,1,11200,-1315.31,-2476977.85,14731472.0,12254494.15
17947,1999-06-28,1331.35,16.04,1.22,1367.56,-2.65,True,1,11201,-1331.35,-2478309.2,14912451.35,12434142.15
17948,1999-06-29,1351.45,20.1,1.51,1367.56,-1.18,True,1,11202,-1351.45,-2479660.65,15138942.9,12659282.25
17949,1999-06-30,1372.71,21.26,1.57,1372.71,0.0,True,1,11203,-1372.71,-2481033.36,15378470.13,12897436.77
17950,1999-07-01,1380.96,8.25,0.6,1380.96,0.0,True,1,11204,-1380.96,-2482414.32,15472275.84,12989861.52
17951,1999-07-02,1391.22,10.26,0.74,1391.22,0.0,True,1,11205,-1391.22,-2483805.54,15588620.1,13104814.56
17952,1999-07-06,1388.12,-3.1,-0.22,1391.22,-0.22,True,1,11206,-1388.12,-2485193.66,15555272.72,13070079.06
17953,1999-07-07,1395.86,7.74,0.56,1395.86,0.0,True,1,11207,-1395.86,-2486589.52,15643403.02,13156813.5
17954,1999-07-08,1394.42,-1.44,-0.1,1395.86,-0.1,True,1,11208,-1394.42,-2487983.94,15628659.36,13140675.42
17955,1999-07-09,1403.28,8.86,0.64,1403.28,0.0,True,1,11209,-1403.28,-2489387.22,15729365.52,13239978.3
17956,1999-07-12,1399.1,-4.18,-0.3,1403.28,-0.3,True,1,11210,-1399.1,-2490786.32,15683911.0,13193124.68
17957,1999-07-13,1393.56,-5.54,-0.4,1403.28,-0.69,True,1,11211,-1393.56,-2492179.88,15623201.16,13131021.28
17958,1999-07-14,1398.17,4.61,0.33,1403.28,-0.36,True,1,11212,-1398.17,-2493578.05,15676282.04,13182703.99
17959,1999-07-15,1409.62,11.45,0.82,1409.62,0.0,True,1,11213,-1409.62,-2494987.67,15806069.06,13311081.39
17960,1999-07-16,1418.78,9.16,0.65,1418.78,0.0,True,1,11214,-1418.78,-2496406.45,15910198.92,13413792.47
17961,1999-07-19,1407.65,-11.13,-0.78,1418.78,-0.78,True,1,11215,-1407.65,-2497814.1,15786794.75,13288980.65
17962,1999-07-20,1377.1,-30.55,-2.17,1418.78,-2.94,True,1,11216,-1377.1,-2499191.2,15445553.6,12946362.4
17963,1999-07-21,1379.29,2.19,0.16,1418.78,-2.78,True,1,11217,-1379.29,-2500570.49,15471495.93,12970925.44
17964,1999-07-22,1360.97,-18.32,-1.33,1418.78,-4.08,True,1,11218,-1360.97,-2501931.46,15267361.46,12765430.0
17965,1999-07-23,1356.94,-4.03,-0.3,1418.78,-4.36,True,1,11219,-1356.94,-2503288.4,15223509.86,12720221.46
17966,1999-07-26,1347.76,-9.18,-0.68,1418.78,-5.01,True,1,11220,-1347.76,-2504636.16,15121867.2,12617231.04
17967,1999-07-27,1362.84,15.08,1.12,1418.78,-3.94,True,1,11221,-1362.84,-2505999.0,15292427.64,12786428.64
17968,1999-07-28,1365.4,2.56,0.19,1418.78,-3.76,True,1,11222,-1365.4,-2507364.4,15322518.8,12815154.4
17969,1999-07-29,1341.03,-24.37,-1.78,1418.78,-5.48,True,1,11223,-1341.03,-2508705.43,15050379.69,12541674.26
17970,1999-07-30,1328.72,-12.31,-0.92,1418.78,-6.35,True,1,11224,-1328.72,-2510034.15,14913553.28,12403519.13
17971,1999-08-02,1328.05,-0.67,-0.05,1418.78,-6.4,True,1,11225,-1328.05,-2511362.2,14907361.25,12395999.05
17972,1999-08-03,1322.18,-5.87,-0.44,1418.78,-6.81,True,1,11226,-1322.18,-2512684.38,14842792.68,12330108.3
17973,1999-08-04,1305.33,-16.85,-1.27,1418.78,-8.0,True,1,11227,-1305.33,-2513989.71,14654939.91,12140950.2
17974,1999-08-05,1313.71,8.38,0.64,1418.78,-7.41,True,1,11228,-1313.71,-2515303.42,14750335.88,12235032.46
17975,1999-08-06,1300.29,-13.42,-1.02,1418.78,-8.35,True,1,11229,-1300.29,-2516603.71,14600956.41,12084352.7
17976,1999-08-09,1297.8,-2.49,-0.19,1418.78,-8.53,True,1,11230,-1297.8,-2517901.51,14574294.0,12056392.49
17977,1999-08-10,1281.43,-16.37,-1.26,1418.78,-9.68,True,1,11231,-1281.43,-2519182.94,14391740.33,11872557.39
17978,1999-08-11,1301.93,20.5,1.6,1418.78,-8.24,True,1,11232,-1301.93,-2520484.87,14623277.76,12102792.89
17979,1999-08-12,1298.16,-3.77,-0.29,1418.78,-8.5,True,1,11233,-1298.16,-2521783.03,14582231.28,12060448.25
17980,1999-08-13,1327.68,29.52,2.27,1418.78,-6.42,True,1,11234,-1327.68,-2523110.71,14915157.12,12392046.41
17981,1999-08-16,1330.77,3.09,0.23,1418.78,-6.2,True,1,11235,-1330.77,-2524441.48,14951200.95,12426759.47
17982,1999-08-17,1344.16,13.39,1.01,1418.78,-5.26,True,1,11236,-1344.16,-2525785.64,15102981.76,12577196.12
17983,1999-08-18,1332.84,-11.32,-0.84,1418.78,-6.06,True,1,11237,-1332.84,-2527118.48,14977123.08,12450004.6
17984,1999-08-19,1323.59,-9.25,-0.69,1418.78,-6.71,True,1,11238,-1323.59,-2528442.07,14874504.42,12346062.35
17985,1999-08-20,1336.61,13.02,0.98,1418.78,-5.79,True,1,11239,-1336.61,-2529778.68,15022159.79,12492381.11
17986,1999-08-23,1360.22,23.61,1.77,1418.78,-4.13,True,1,11240,-1360.22,-2531138.9,15288872.8,12757733.9
17987,1999-08-24,1363.5,3.28,0.24,1418.78,-3.9,True,1,11241,-1363.5,-2532502.4,15327103.5,12794601.1
17988,1999-08-25,1381.79,18.29,1.34,1418.78,-2.61,True,1,11242,-1381.79,-2533884.19,15534083.18,13000198.99
17989,1999-08-26,1362.01,-19.78,-1.43,1418.78,-4.0,True,1,11243,-1362.01,-2535246.2,15313078.43,12777832.23
17990,1999-08-27,1348.27,-13.74,-1.01,1418.78,-4.97,True,1,11244,-1348.27,-2536594.47,15159947.88,12623353.41
17991,1999-08-30,1324.02,-24.25,-1.8,1418.78,-6.68,True,1,11245,-1324.02,-2537918.49,14888604.9,12350686.41
17992,1999-08-31,1320.41,-3.61,-0.27,1418.78,-6.93,True,1,11246,-1320.41,-2539238.9,14849330.86,12310091.96
17993,1999-09-01,1331.07,10.66,0.81,1418.78,-6.18,True,1,11247,-1331.07,-2540569.97,14970544.29,12429974.32
17994,1999-09-02,1319.11,-11.96,-0.9,1418.78,-7.02,True,1,11248,-1319.11,-2541889.08,14837349.28,12295460.2
17995,1999-09-03,1357.24,38.13,2.89,1418.78,-4.34,True,1,11249,-1357.24,-2543246.32,15267592.76,12724346.44
17996,1999-09-07,1350.45,-6.79,-0.5,1418.78,-4.82,True,1,11250,-1350.45,-2544596.77,15192562.5,12647965.73
17997,1999-09-08,1344.15,-6.3,-0.47,1418.78,-5.26,True,1,11251,-1344.15,-2545940.92,15123031.65,12577090.73
17998,1999-09-09,1347.66,3.51,0.26,1418.78,-5.01,True,1,11252,-1347.66,-2547288.58,15163870.32,12616581.74
17999,1999-09-10,1351.66,4.0,0.3,1418.78,-4.73,True,1,11253,-1351.66,-2548640.24,15210229.98,12661589.74
18000,1999-09-13,1344.13,-7.53,-0.56,1418.78,-5.26,True,1,11254,-1344.13,-2549984.37,15126839.02,12576854.65
18001,1999-09-14,1336.29,-7.84,-0.58,1418.78,-5.81,True,1,11255,-1336.29,-2551320.66,15039943.95,12488623.29
18002,1999-09-15,1317.97,-18.32,-1.37,1418.78,-7.1,True,1,11256,-1317.97,-2552638.63,14835070.32,12282431.69
18003,1999-09-16,1318.48,0.51,0.04,1418.78,-7.07,True,1,11257,-1318.48,-2553957.11,14842129.36,12288172.25
18004,1999-09-17,1335.42,16.94,1.28,1418.78,-5.88,True,1,11258,-1335.42,-2555292.53,15034158.36,12478865.83
18005,1999-09-20,1335.53,0.11,0.01,1418.78,-5.87,True,1,11259,-1335.53,-2556628.06,15036732.27,12480104.21
18006,1999-09-21,1307.58,-27.95,-2.09,1418.78,-7.84,True,1,11260,-1307.58,-2557935.64,14723350.8,12165415.16
18007,1999-09-22,1310.51,2.93,0.22,1418.78,-7.63,True,1,11261,-1310.51,-2559246.15,14757653.11,12198406.96
18008,1999-09-23,1280.41,-30.1,-2.3,1418.78,-9.75,True,1,11262,-1280.41,-2560526.56,14419977.42,11859450.86
18009,1999-09-24,1277.36,-3.05,-0.24,1418.78,-9.97,True,1,11263,-1277.36,-2561803.92,14386905.68,11825101.76
18010,1999-09-27,1283.31,5.95,0.47,1418.78,-9.55,True,1,11264,-1283.31,-2563087.23,14455203.84,11892116.61
18011,1999-09-28,1282.2,-1.11,-0.09,1418.78,-9.63,True,1,11265,-1282.2,-2564369.43,14443983.0,11879613.57
18012,1999-09-29,1268.37,-13.83,-1.08,1418.78,-10.6,True,1,11266,-1268.37,-2565637.8,14289456.42,11723818.62
18013,1999-09-30,1282.71,14.34,1.13,1418.78,-9.59,True,1,11267,-1282.71,-2566920.51,14452293.57,11885373.06
18014,1999-10-01,1282.81,0.1,0.01,1418.78,-9.58,True,1,11268,-1282.81,-2568203.32,14454703.08,11886499.76
18015,1999-10-04,1304.6,21.79,1.7,1418.78,-8.05,True,1,11269,-1304.6,-2569507.92,14701537.4,12132029.48
18016,1999-10-05,1301.35,-3.25,-0.25,1418.78,-8.28,True,1,11270,-1301.35,-2570809.27,14666214.5,12095405.23
18017,1999-10-06,1325.4,24.05,1.85,1418.78,-6.58,True,1,11271,-1325.4,-2572134.67,14938583.4,12366448.73
18018,1999-10-07,1317.64,-7.76,-0.58,1418.78,-7.13,True,1,11272,-1317.64,-2573452.31,14852438.08,12278985.77
18019,1999-10-08,1336.02,18.38,1.4,1418.78,-5.83,True,1,11273,-1336.02,-2574788.33,15060953.46,12486165.13
18020,1999-10-11,1335.21,-0.81,-0.06,1418.78,-5.89,True,1,11274,-1335.21,-2576123.54,15053157.54,12477034.0
18021,1999-10-12,1313.04,-22.17,-1.66,1418.78,-7.45,True,1,11275,-1313.04,-2577436.58,14804526.0,12227089.42
18022,1999-10-13,1285.55,-27.49,-2.09,1418.78,-9.39,True,1,11276,-1285.55,-2578722.13,14495861.8,11917139.67
18023,1999-10-14,1283.42,-2.13,-0.17,1418.78,-9.54,True,1,11277,-1283.42,-2580005.55,14473127.34,11893121.79
18024,1999-10-15,1247.41,-36.01,-2.81,1418.78,-12.08,True,1,11278,-1247.41,-2581252.96,14068289.98,11487037.02
18025,1999-10-18,1254.13,6.72,0.54,1418.78,-11.6,True,1,11279,-1254.13,-2582507.09,14145332.27,11562825.18
18026,1999-10-19,1261.32,7.19,0.57,1418.78,-11.1,True,1,11280,-1261.32,-2583768.41,14227689.6,11643921.19
18027,1999-10-20,1289.43,28.11,2.23,1418.78,-9.12,True,1,11281,-1289.43,-2585057.84,14546059.83,11961001.99
18028,1999-10-21,1283.61,-5.82,-0.45,1418.78,-9.53,True,1,11282,-1283.61,-2586341.45,14481688.02,11895346.57
18029,1999-10-22,1301.65,18.04,1.4,1418.78,-8.26,True,1,11283,-1301.65,-2587643.1,14686516.95,12098873.85
18030,1999-10-25,1293.63,-8.02,-0.62,1418.78,-8.82,True,1,11284,-1293.63,-2588936.73,14597320.92,12008384.19
18031,1999-10-26,1281.91,-11.72,-0.91,1418.78,-9.65,True,1,11285,-1281.91,-2590218.64,14466354.35,11876135.71
18032,1999-10-27,1296.71,14.8,1.16,1418.78,-8.6,True,1,11286,-1296.71,-2591515.35,14634669.06,12043153.71
18033,1999-10-28,1342.44,45.73,3.53,1418.78,-5.38,True,1,11287,-1342.44,-2592857.79,15152120.28,12559262.49
18034,1999-10-29,1362.93,20.49,1.53,1418.78,-3.94,True,1,11288,-1362.93,-2594220.72,15384753.84,12790533.12
18035,1999-11-01,1354.12,-8.81,-0.65,1418.78,-4.56,True,1,11289,-1354.12,-2595574.84,15286660.68,12691085.84
18036,1999-11-02,1347.74,-6.38,-0.47,1418.78,-5.01,True,1,11290,-1347.74,-2596922.58,15215984.6,12619062.02
18037,1999-11-03,1354.93,7.19,0.53,1418.78,-4.5,True,1,11291,-1354.93,-2598277.51,15298514.63,12700237.12
18038,1999-11-04,1362.64,7.71,0.57,1418.78,-3.96,True,1,11292,-1362.64,-2599640.15,15386930.88,12787290.73
18039,1999-11-05,1370.23,7.59,0.56,1418.78,-3.42,True,1,11293,-1370.23,-2601010.38,15474007.39,12872997.01
18040,1999-11-08,1377.01,6.78,0.5,1418.78,-2.94,True,1,11294,-1377.01,-2602387.39,15551950.94,12949563.55
18041,1999-11-09,1365.28,-11.73,-0.85,1418.78,-3.77,True,1,11295,-1365.28,-2603752.67,15420837.6,12817084.93
18042,1999-11-10,1373.46,8.18,0.6,1418.78,-3.19,True,1,11296,-1373.46,-2605126.13,15514604.16,12909478.03
18043,1999-11-11,1381.46,8.0,0.58,1418.78,-2.63,True,1,11297,-1381.46,-2606507.59,15606353.62,12999846.03
18044,1999-11-12,1396.06,14.6,1.06,1418.78,-1.6,True,1,11298,-1396.06,-2607903.65,15772685.88,13164782.23
18045,1999-11-15,1394.39,-1.67,-0.12,1418.78,-1.72,True,1,11299,-1394.39,-2609298.04,15755212.61,13145914.57
18046,1999-11-16,1420.07,25.68,1.84,1420.07,0.0,True,1,11300,-1420.07,-2610718.11,16046791.0,13436072.89
18047,1999-11-17,1410.71,-9.36,-0.66,1420.07,-0.66,True,1,11301,-1410.71,-2612128.82,15942433.71,13330304.89
18048,1999-11-18,1424.94,14.23,1.01,1424.94,0.0,True,1,11302,-1424.94,-2613553.76,16104671.88,13491118.12
18049,1999-11-19,1422.0,-2.94,-0.21,1424.94,-0.21,True,1,11303,-1422.0,-2614975.76,16072866.0,13457890.24
18050,1999-11-22,1420.94,-1.06,-0.08,1424.94,-0.28,True,1,11304,-1420.94,-2616396.7,16062305.76,13445909.06
18051,1999-11-23,1404.64,-16.3,-1.15,1424.94,-1.42,True,1,11305,-1404.64,-2617801.34,15879455.2,13261653.86
18052,1999-11-24,1417.08,12.44,0.89,1424.94,-0.55,True,1,11306,-1417.08,-2619218.42,16021506.48,13402288.06
18053,1999-11-26,1416.62,-0.46,-0.03,1424.94,-0.58,True,1,11307,-1416.62,-2620635.04,16017722.34,13397087.3
18054,1999-11-29,1407.83,-8.79,-0.62,1424.94,-1.2,True,1,11308,-1407.83,-2622042.87,15919741.64,13297698.77
18055,1999-11-30,1388.91,-18.92,-1.34,1424.94,-2.53,True,1,11309,-1388.91,-2623431.78,15707183.19,13083751.41
18056,1999-12-01,1397.72,8.81,0.63,1424.94,-1.91,True,1,11310,-1397.72,-2624829.5,15808213.2,13183383.7
18057,1999-12-02,1409.04,11.32,0.81,1424.94,-1.12,True,1,11311,-1409.04,-2626238.54,15937651.44,13311412.9
18058,1999-12-03,1433.3,24.26,1.72,1433.3,0.0,True,1,11312,-1433.3,-2627671.84,16213489.6,13585817.76
18059,1999-12-06,1423.33,-9.97,-0.7,1433.3,-0.7,True,1,11313,-1423.33,-2629095.17,16102132.29,13473037.12
18060,1999-12-07,1409.17,-14.16,-1.0,1433.3,-1.68,True,1,11314,-1409.17,-2630504.34,15943349.38,13312845.04
18061,1999-12-08,1403.88,-5.29,-0.38,1433.3,-2.05,True,1,11315,-1403.88,-2631908.22,15884902.2,13252993.98
18062,1999-12-09,1408.11,4.23,0.3,1433.3,-1.76,True,1,11316,-1408.11,-2633316.33,15934172.76,13300856.43
18063,1999-12-10,1417.04,8.93,0.63,1433.3,-1.13,True,1,11317,-1417.04,-2634733.37,16036641.68,13401908.31
18064,1999-12-13,1415.22,-1.82,-0.13,1433.3,-1.26,True,1,11318,-1415.22,-2636148.59,16017459.96,13381311.37
18065,1999-12-14,1403.17,-12.05,-0.85,1433.3,-2.1,True,1,11319,-1403.17,-2637551.76,15882481.23,13244929.47
18066,1999-12-15,1413.33,10.16,0.72,1433.3,-1.39,True,1,11320,-1413.33,-2638965.09,15998895.6,13359930.51
18067,1999-12-16,1418.78,5.45,0.39,1433.3,-1.01,True,1,11321,-1418.78,-2640383.87,16062008.38,13421624.51
18068,1999-12-17,1421.03,2.25,0.16,1433.3,-0.86,True,1,11322,-1421.03,-2641804.9,16088901.66,13447096.76
18069,1999-12-20,1418.09,-2.94,-0.21,1433.3,-1.06,True,1,11323,-1418.09,-2643222.99,16057033.07,13413810.08
18070,1999-12-21,1433.43,15.34,1.08,1433.43,0.0,True,1,11324,-1433.43,-2644656.42,16232161.32,13587504.9
18071,1999-12-22,1436.13,2.7,0.19,1436.13,0.0,True,1,11325,-1436.13,-2646092.55,16264172.25,13618079.7
18072,1999-12-23,1458.34,22.21,1.55,1458.34,0.0,True,1,11326,-1458.34,-2647550.89,16517158.84,13869607.95
18073,1999-12-27,1457.1,-1.24,-0.08,1458.34,-0.08,True,1,11327,-1457.1,-2649007.99,16504571.7,13855563.71
18074,1999-12-28,1457.66,0.56,0.04,1458.34,-0.05,True,1,11328,-1457.66,-2650465.65,16512372.48,13861906.83
18075,1999-12-29,1463.46,5.8,0.4,1463.46,0.0,True,1,11329,-1463.46,-2651929.11,16579538.34,13927609.23
18076,1999-12-30,1464.47,1.01,0.07,1464.47,0.0,True,1,11330,-1464.47,-2653393.58,16592445.1,13939051.52
18077,1999-12-31,1469.25,4.78,0.33,1469.25,0.0,True,1,11331,-1469.25,-2654862.83,16648071.75,13993208.92
18078,2000-01-03,1455.22,-14.03,-0.96,1469.25,-0.96,True,1,11332,-1455.22,-2656318.05,16490553.04,13834234.99
18079,2000-01-04,1399.42,-55.8,-3.83,1469.25,-4.75,True,1,11333,-1399.42,-2657717.47,15859626.86,13201909.39
18080,2000-01-05,1402.11,2.69,0.19,1469.25,-4.57,True,1,11334,-1402.11,-2659119.58,15891514.74,13232395.16
18081,2000-01-06,1403.45,1.34,0.1,1469.25,-4.48,True,1,11335,-1403.45,-2660523.03,15908105.75,13247582.72
18082,2000-01-07,1441.47,38.02,2.71,1469.25,-1.89,True,1,11336,-1441.47,-2661964.5,16340503.92,13678539.42
18083,2000-01-10,1457.6,16.13,1.12,1469.25,-0.79,True,1,11337,-1457.6,-2663422.1,16524811.2,13861389.1
18084,2000-01-11,1438.56,-19.04,-1.31,1469.25,-2.09,True,1,11338,-1438.56,-2664860.66,16310393.28,13645532.62
18085,2000-01-12,1432.25,-6.31,-0.44,1469.25,-2.52,True,1,11339,-1432.25,-2666292.91,16240282.75,13573989.84
18086,2000-01-13,1449.68,17.43,1.22,1469.25,-1.33,True,1,11340,-1449.68,-2667742.59,16439371.2,13771628.61
18087,2000-01-14,1465.15,15.47,1.07,1469.25,-0.28,True,1,11341,-1465.15,-2669207.74,16616266.15,13947058.41
18088,2000-01-18,1455.14,-10.01,-0.68,1469.25,-0.96,True,1,11342,-1455.14,-2670662.88,16504197.88,13833535.0
18089,2000-01-19,1455.9,0.76,0.05,1469.25,-0.91,True,1,11343,-1455.9,-2672118.78,16514273.7,13842154.92
18090,2000-01-20,1445.57,-10.33,-0.71,1469.25,-1.61,True,1,11344,-1445.57,-2673564.35,16398546.08,13724981.73
18091,2000-01-21,1441.36,-4.21,-0.29,1469.25,-1.9,True,1,11345,-1441.36,-2675005.71,16352229.2,13677223.49
18092,2000-01-24,1401.53,-39.83,-2.76,1469.25,-4.61,True,1,11346,-1401.53,-2676407.24,15901759.38,13225352.14
18093,2000-01-25,1410.03,8.5,0.61,1469.25,-4.03,True,1,11347,-1410.03,-2677817.27,15999610.41,13321793.14
18094,2000-01-26,1404.09,-5.94,-0.42,1469.25,-4.43,True,1,11348,-1404.09,-2679221.36,15933613.32,13254391.96
18095,2000-01-27,1398.56,-5.53,-0.39,1469.25,-4.81,True,1,11349,-1398.56,-2680619.92,15872257.44,13191637.52
18096,2000-01-28,1360.16,-38.4,-2.75,1469.25,-7.42,True,1,11350,-1360.16,-2681980.08,15437816.0,12755835.92
18097,2000-01-31,1394.46,34.3,2.52,1469.25,-5.09,True,1,11351,-1394.46,-2683374.54,15828515.46,13145140.92
18098,2000-02-01,1409.28,14.82,1.06,1469.25,-4.08,True,1,11352,-1409.28,-2684783.82,15998146.56,13313362.74
18099,2000-02-02,1409.12,-0.16,-0.01,1469.25,-4.09,True,1,11353,-1409.12,-2686192.94,15997739.36,13311546.42
18100,2000-02-03,1424.97,15.85,1.12,1469.25,-3.01,True,1,11354,-1424.97,-2687617.91,16179109.38,13491491.47
18101,2000-02-04,1424.37,-0.6,-0.04,1469.25,-3.06,True,1,11355,-1424.37,-2689042.28,16173721.35,13484679.07
18102,2000-02-07,1424.24,-0.13,-0.01,1469.25,-3.06,True,1,11356,-1424.24,-2690466.52,16173669.44,13483202.92
18103,2000-02-08,1441.72,17.48,1.23,1469.25,-1.87,True,1,11357,-1441.72,-2691908.24,16373614.04,13681705.8
18104,2000-02-09,1411.71,-30.01,-2.08,1469.25,-3.92,True,1,11358,-1411.71,-2693319.95,16034202.18,13340882.23
18105,2000-02-10,1416.83,5.12,0.36,1469.25,-3.57,True,1,11359,-1416.83,-2694736.78,16093771.97,13399035.19
18106,2000-02-11,1387.12,-29.71,-2.1,1469.25,-5.59,True,1,11360,-1387.12,-2696123.9,15757683.2,13061559.3
18107,2000-02-14,1389.94,2.82,0.2,1469.25,-5.4,True,1,11361,-1389.94,-2697513.84,15791108.34,13093594.5
18108,2000-02-15,1402.05,12.11,0.87,1469.25,-4.57,True,1,11362,-1402.05,-2698915.89,15930092.1,13231176.21
18109,2000-02-16,1387.67,-14.38,-1.03,1469.25,-5.55,True,1,11363,-1387.67,-2700303.56,15768094.21,13067790.65
18110,2000-02-17,1388.26,0.59,0.04,1469.25,-5.51,True,1,11364,-1388.26,-2701691.82,15776186.64,13074494.82
18111,2000-02-18,1346.09,-42.17,-3.04,1469.25,-8.38,True,1,11365,-1346.09,-2703037.91,15298312.85,12595274.94
18112,2000-02-22,1352.17,6.08,0.45,1469.25,-7.97,True,1,11366,-1352.17,-2704390.08,15368764.22,12664374.14
18113,2000-02-23,1360.69,8.52,0.63,1469.25,-7.39,True,1,11367,-1360.69,-2705750.77,15466963.23,12761212.46
18114,2000-02-24,1353.43,-7.26,-0.53,1469.25,-7.88,True,1,11368,-1353.43,-2707104.2,15385792.24,12678688.04
18115,2000-02-25,1333.36,-20.07,-1.48,1469.25,-9.25,True,1,11369,-1333.36,-2708437.56,15158969.84,12450532.28
18116,2000-02-28,1348.05,14.69,1.1,1469.25,-8.25,True,1,11370,-1348.05,-2709785.61,15327328.5,12617542.89
18117,2000-02-29,1366.42,18.37,1.36,1469.25,-7.0,True,1,11371,-1366.42,-2711152.03,15537561.82,12826409.79
18118,2000-03-01,1379.19,12.77,0.94,1469.25,-6.13,True,1,11372,-1379.19,-2712531.22,15684148.68,12971617.46
18119,2000-03-02,1381.76,2.57,0.19,1469.25,-5.96,True,1,11373,-1381.76,-2713912.98,15714756.48,13000843.5
18120,2000-03-03,1409.17,27.41,1.98,1469.25,-4.09,True,1,11374,-1409.17,-2715322.15,16027899.58,13312577.43
18121,2000-03-06,1391.28,-17.89,-1.27,1469.25,-5.31,True,1,11375,-1391.28,-2716713.43,15825810.0,13109096.57
18122,2000-03-07,1355.62,-35.66,-2.56,1469.25,-7.73,True,1,11376,-1355.62,-2718069.05,15421533.12,12703464.07
18123,2000-03-08,1366.7,11.08,0.82,1469.25,-6.98,True,1,11377,-1366.7,-2719435.75,15548945.9,12829510.15
18124,2000-03-09,1401.69,34.99,2.56,1469.25,-4.6,True,1,11378,-1401.69,-2720837.44,15948428.82,13227591.38
18125,2000-03-10,1395.07,-6.62,-0.47,1469.25,-5.05,True,1,11379,-1395.07,-2722232.51,15874501.53,13152269.02
18126,2000-03-13,1383.62,-11.45,-0.82,1469.25,-5.83,True,1,11380,-1383.62,-2723616.13,15745595.6,13021979.47
18127,2000-03-14,1359.15,-24.47,-1.77,1469.25,-7.49,True,1,11381,-1359.15,-2724975.28,15468486.15,12743510.87
18128,2000-03-15,1392.14,32.99,2.43,1469.25,-5.25,True,1,11382,-1392.14,-2726367.42,15845337.48,13118970.06
18129,2000-03-16,1458.47,66.33,4.76,1469.25,-0.73,True,1,11383,-1458.47,-2727825.89,16601764.01,13873938.12
18130,2000-03-17,1464.47,6.0,0.41,1469.25,-0.32,True,1,11384,-1464.47,-2729290.36,16671526.48,13942236.12
18131,2000-03-20,1456.63,-7.84,-0.54,1469.25,-0.86,True,1,11385,-1456.63,-2730746.99,16583732.55,13852985.56
18132,2000-03-21,1493.87,37.24,2.56,1493.87,0.0,True,1,11386,-1493.87,-2732240.86,17009203.82,14276962.96
18133,2000-03-22,1500.64,6.77,0.45,1500.64,0.0,True,1,11387,-1500.64,-2733741.5,17087787.68,14354046.18
18134,2000-03-23,1527.35,26.71,1.78,1527.35,0.0,True,1,11388,-1527.35,-2735268.85,17393461.8,14658192.95
18135,2000-03-24,1527.46,0.11,0.01,1527.46,0.0,True,1,11389,-1527.46,-2736796.31,17396241.94,14659445.63
18136,2000-03-27,1523.86,-3.6,-0.24,1527.46,-0.24,True,1,11390,-1523.86,-2738320.17,17356765.4,14618445.23
18137,2000-03-28,1507.73,-16.13,-1.06,1527.46,-1.29,True,1,11391,-1507.73,-2739827.9,17174552.43,14434724.53
18138,2000-03-29,1508.52,0.79,0.05,1527.46,-1.24,True,1,11392,-1508.52,-2741336.42,17185059.84,14443723.42
18139,2000-03-30,1487.92,-20.6,-1.37,1527.46,-2.59,True,1,11393,-1487.92,-2742824.34,16951872.56,14209048.22
18140,2000-03-31,1498.58,10.66,0.72,1527.46,-1.89,True,1,11394,-1498.58,-2744322.92,17074820.52,14330497.6
18141,2000-04-03,1505.97,7.39,0.49,1527.46,-1.41,True,1,11395,-1505.97,-2745828.89,17160528.15,14414699.26
18142,2000-04-04,1494.73,-11.24,-0.75,1527.46,-2.14,True,1,11396,-1494.73,-2747323.62,17033943.08,14286619.46
18143,2000-04-05,1487.37,-7.36,-0.49,1527.46,-2.62,True,1,11397,-1487.37,-2748810.99,16951555.89,14202744.9
18144,2000-04-06,1501.34,13.97,0.94,1527.46,-1.71,True,1,11398,-1501.34,-2750312.33,17112273.32,14361960.99
18145,2000-04-07,1516.35,15.01,1.0,1527.46,-0.73,True,1,11399,-1516.35,-2751828.68,17284873.65,14533044.97
18146,2000-04-10,1504.46,-11.89,-0.78,1527.46,-1.51,True,1,11400,-1504.46,-2753333.14,17150844.0,14397510.86
18147,2000-04-11,1500.59,-3.87,-0.26,1527.46,-1.76,True,1,11401,-1500.59,-2754833.73,17108226.59,14353392.86
18148,2000-04-12,1467.17,-33.42,-2.23,1527.46,-3.95,True,1,11402,-1467.17,-2756300.9,16728672.34,13972371.44
18149,2000-04-13,1440.51,-26.66,-1.82,1527.46,-5.69,True,1,11403,-1440.51,-2757741.41,16426135.53,13668394.12
18150,2000-04-14,1356.56,-83.95,-5.83,1527.46,-11.19,True,1,11404,-1356.56,-2759097.97,15470210.24,12711112.27
18151,2000-04-17,1401.44,44.88,3.31,1527.46,-8.25,True,1,11405,-1401.44,-2760499.41,15983423.2,13222923.79
18152,2000-04-18,1441.61,40.17,2.87,1527.46,-5.62,True,1,11406,-1441.61,-2761941.02,16443003.66,13681062.64
18153,2000-04-19,1427.47,-14.14,-0.98,1527.46,-6.55,True,1,11407,-1427.47,-2763368.49,16283150.29,13519781.8
18154,2000-04-20,1434.54,7.07,0.5,1527.46,-6.08,True,1,11408,-1434.54,-2764803.03,16365232.32,13600429.29
18155,2000-04-24,1429.86,-4.68,-0.33,1527.46,-6.39,True,1,11409,-1429.86,-2766232.89,16313272.74,13547039.85
18156,2000-04-25,1477.44,47.58,3.33,1527.46,-3.28,True,1,11410,-1477.44,-2767710.33,16857590.4,14089880.07
18157,2000-04-26,1460.99,-16.45,-1.11,1527.46,-4.35,True,1,11411,-1460.99,-2769171.32,16671356.89,13902185.57
18158,2000-04-27,1464.92,3.93,0.27,1527.46,-4.09,True,1,11412,-1464.92,-2770636.24,16717667.04,13947030.8
18159,2000-04-28,1452.43,-12.49,-0.85,1527.46,-4.91,True,1,11413,-1452.43,-2772088.67,16576583.59,13804494.92
18160,2000-05-01,1468.25,15.82,1.09,1527.46,-3.88,True,1,11414,-1468.25,-2773556.92,16758605.5,13985048.58
18161,2000-05-02,1446.29,-21.96,-1.5,1527.46,-5.31,True,1,11415,-1446.29,-2775003.21,16509400.35,13734397.14
18162,2000-05-03,1415.1,-31.19,-2.16,1527.46,-7.36,True,1,11416,-1415.1,-2776418.31,16154781.6,13378363.29
18163,2000-05-04,1409.57,-5.53,-0.39,1527.46,-7.72,True,1,11417,-1409.57,-2777827.88,16093060.69,13315232.81
18164,2000-05-05,1432.63,23.06,1.64,1527.46,-6.21,True,1,11418,-1432.63,-2779260.51,16357769.34,13578508.83
18165,2000-05-08,1424.17,-8.46,-0.59,1527.46,-6.76,True,1,11419,-1424.17,-2780684.68,16262597.23,13481912.55
18166,2000-05-09,1412.14,-12.03,-0.84,1527.46,-7.55,True,1,11420,-1412.14,-2782096.82,16126638.8,13344541.98
18167,2000-05-10,1383.05,-29.09,-2.06,1527.46,-9.45,True,1,11421,-1383.05,-2783479.87,15795814.05,13012334.18
18168,2000-05-11,1407.81,24.76,1.79,1527.46,-7.83,True,1,11422,-1407.81,-2784887.68,16080005.82,13295118.14
18169,2000-05-12,1420.96,13.15,0.93,1527.46,-6.97,True,1,11423,-1420.96,-2786308.64,16231626.08,13445317.44
18170,2000-05-15,1452.36,31.4,2.21,1527.46,-4.92,True,1,11424,-1452.36,-2787761.0,16591760.64,13803999.64
18171,2000-05-16,1466.04,13.68,0.94,1527.46,-4.02,True,1,11425,-1466.04,-2789227.04,16749507.0,13960279.96
18172,2000-05-17,1447.8,-18.24,-1.24,1527.46,-5.22,True,1,11426,-1447.8,-2790674.84,16542562.8,13751887.96
18173,2000-05-18,1437.21,-10.59,-0.73,1527.46,-5.91,True,1,11427,-1437.21,-2792112.05,16422998.67,13630886.62
18174,2000-05-19,1406.95,-30.26,-2.1,1527.46,-7.89,True,1,11428,-1406.95,-2793519.0,16078624.6,13285105.6
18175,2000-05-22,1400.72,-6.23,-0.44,1527.46,-8.3,True,1,11429,-1400.72,-2794919.72,16008828.88,13213909.16
18176,2000-05-23,1373.86,-26.86,-1.92,1527.46,-10.06,True,1,11430,-1373.86,-2796293.58,15703219.8,12906926.22
18177,2000-05-24,1399.05,25.19,1.83,1527.46,-8.41,True,1,11431,-1399.05,-2797692.63,15992540.55,13194847.92
18178,2000-05-25,1381.52,-17.53,-1.25,1527.46,-9.55,True,1,11432,-1381.52,-2799074.15,15793536.64,12994462.49
18179,2000-05-26,1378.02,-3.5,-0.25,1527.46,-9.78,True,1,11433,-1378.02,-2800452.17,15754902.66,12954450.49
18180,2000-05-30,1422.45,44.43,3.22,1527.46,-6.88,True,1,11434,-1422.45,-2801874.62,16264293.3,13462418.68
18181,2000-05-31,1420.6,-1.85,-0.13,1527.46,-7.0,True,1,11435,-1420.6,-2803295.22,16244561.0,13441265.78
18182,2000-06-01,1448.81,28.21,1.99,1527.46,-5.15,True,1,11436,-1448.81,-2804744.03,16568591.16,13763847.13
18183,2000-06-02,1477.26,28.45,1.96,1527.46,-3.29,True,1,11437,-1477.26,-2806221.29,16895422.62,14089201.33
18184,2000-06-05,1467.63,-9.63,-0.65,1527.46,-3.92,True,1,11438,-1467.63,-2807688.92,16786751.94,13979063.02
18185,2000-06-06,1457.84,-9.79,-0.67,1527.46,-4.56,True,1,11439,-1457.84,-2809146.76,16676231.76,13867085.0
18186,2000-06-07,1471.36,13.52,0.93,1527.46,-3.67,True,1,11440,-1471.36,-2810618.12,16832358.4,14021740.28
18187,2000-06-08,1461.67,-9.69,-0.66,1527.46,-4.31,True,1,11441,-1461.67,-2812079.79,16722966.47,13910886.68
18188,2000-06-09,1456.95,-4.72,-0.32,1527.46,-4.62,True,1,11442,-1456.95,-2813536.74,16670421.9,13856885.16
18189,2000-06-12,1446.0,-10.95,-0.75,1527.46,-5.33,True,1,11443,-1446.0,-2814982.74,16546578.0,13731595.26
18190,2000-06-13,1469.44,23.44,1.62,1527.46,-3.8,True,1,11444,-1469.44,-2816452.18,16816271.36,13999819.18
18191,2000-06-14,1470.54,1.1,0.08,1527.46,-3.73,True,1,11445,-1470.54,-2817922.72,16830330.3,14012407.58
18192,2000-06-15,1478.73,8.19,0.56,1527.46,-3.19,True,1,11446,-1478.73,-2819401.45,16925543.58,14106142.13
18193,2000-06-16,1464.46,-14.27,-0.96,1527.46,-4.12,True,1,11447,-1464.46,-2820865.91,16763673.62,13942807.71
18194,2000-06-19,1486.0,21.54,1.47,1527.46,-2.71,True,1,11448,-1486.0,-2822351.91,17011728.0,14189376.09
18195,2000-06-20,1475.95,-10.05,-0.68,1527.46,-3.37,True,1,11449,-1475.95,-2823827.86,16898151.55,14074323.69
18196,2000-06-21,1479.13,3.18,0.22,1527.46,-3.16,True,1,11450,-1479.13,-2825306.99,16936038.5,14110731.51
18197,2000-06-22,1452.18,-26.95,-1.82,1527.46,-4.93,True,1,11451,-1452.18,-2826759.17,16628913.18,13802154.01
18198,2000-06-23,1441.48,-10.7,-0.74,1527.46,-5.63,True,1,11452,-1441.48,-2828200.65,16507828.96,13679628.31
18199,2000-06-26,1455.31,13.83,0.96,1527.46,-4.72,True,1,11453,-1455.31,-2829655.96,16667665.43,13838009.47
18200,2000-06-27,1450.55,-4.76,-0.33,1527.46,-5.04,True,1,11454,-1450.55,-2831106.51,16614599.7,13783493.19
18201,2000-06-28,1454.82,4.27,0.29,1527.46,-4.76,True,1,11455,-1454.82,-2832561.33,16664963.1,13832401.77
18202,2000-06-29,1442.39,-12.43,-0.85,1527.46,-5.57,True,1,11456,-1442.39,-2834003.72,16524019.84,13690016.12
18203,2000-06-30,1454.6,12.21,0.85,1527.46,-4.77,True,1,11457,-1454.6,-2835458.32,16665352.2,13829893.88
18204,2000-07-03,1469.54,14.94,1.03,1527.46,-3.79,True,1,11458,-1469.54,-2836927.86,16837989.32,14001061.46
18205,2000-07-05,1446.23,-23.31,-1.59,1527.46,-5.32,True,1,11459,-1446.23,-2838374.09,16572349.57,13733975.48
18206,2000-07-06,1456.67,10.44,0.72,1527.46,-4.63,True,1,11460,-1456.67,-2839830.76,16693438.2,13853607.44
18207,2000-07-07,1478.9,22.23,1.53,1527.46,-3.18,True,1,11461,-1478.9,-2841309.66,16949672.9,14108363.24
18208,2000-07-10,1475.62,-3.28,-0.22,1527.46,-3.39,True,1,11462,-1475.62,-2842785.28,16913556.44,14070771.16
18209,2000-07-11,1480.88,5.26,0.36,1527.46,-3.05,True,1,11463,-1480.88,-2844266.16,16975327.44,14131061.28
18210,2000-07-12,1492.92,12.04,0.81,1527.46,-2.26,True,1,11464,-1492.92,-2845759.08,17114834.88,14269075.8
18211,2000-07-13,1495.84,2.92,0.2,1527.46,-2.07,True,1,11465,-1495.84,-2847254.92,17149805.6,14302550.68
18212,2000-07-14,1509.98,14.14,0.94,1527.46,-1.14,True,1,11466,-1509.98,-2848764.9,17313430.68,14464665.78
18213,2000-07-17,1510.49,0.51,0.03,1527.46,-1.11,True,1,11467,-1510.49,-2850275.39,17320788.83,14470513.44
18214,2000-07-18,1493.74,-16.75,-1.11,1527.46,-2.21,True,1,11468,-1493.74,-2851769.13,17130210.32,14278441.19
18215,2000-07-19,1481.96,-11.78,-0.79,1527.46,-2.98,True,1,11469,-1481.96,-2853251.09,16996599.24,14143348.15
18216,2000-07-20,1495.57,13.61,0.92,1527.46,-2.09,True,1,11470,-1495.57,-2854746.66,17154187.9,14299441.24
18217,2000-07-21,1480.19,-15.38,-1.03,1527.46,-3.1,True,1,11471,-1480.19,-2856226.85,16979259.49,14123032.64
18218,2000-07-24,1464.29,-15.9,-1.07,1527.46,-4.14,True,1,11472,-1464.29,-2857691.14,16798334.88,13940643.74
18219,2000-07-25,1474.47,10.18,0.7,1527.46,-3.47,True,1,11473,-1474.47,-2859165.61,16916594.31,14057428.7
18220,2000-07-26,1452.42,-22.05,-1.5,1527.46,-4.91,True,1,11474,-1452.42,-2860618.03,16665067.08,13804449.05
18221,2000-07-27,1449.62,-2.8,-0.19,1527.46,-5.1,True,1,11475,-1449.62,-2862067.65,16634389.5,13772321.85
18222,2000-07-28,1419.89,-29.73,-2.05,1527.46,-7.04,True,1,11476,-1419.89,-2863487.54,16294657.64,13431170.1
18223,2000-07-31,1430.83,10.94,0.77,1527.46,-6.33,True,1,11477,-1430.83,-2864918.37,16421635.91,13556717.54
18224,2000-08-01,1438.1,7.27,0.51,1527.46,-5.85,True,1,11478,-1438.1,-2866356.47,16506511.8,13640155.33
18225,2000-08-02,1438.7,0.6,0.04,1527.46,-5.81,True,1,11479,-1438.7,-2867795.17,16514837.3,13647042.13
18226,2000-08-03,1452.56,13.86,0.96,1527.46,-4.9,True,1,11480,-1452.56,-2869247.73,16675388.8,13806141.07
18227,2000-08-04,1462.93,10.37,0.71,1527.46,-4.22,True,1,11481,-1462.93,-2870710.66,16795899.33,13925188.67
18228,2000-08-07,1479.32,16.39,1.12,1527.46,-3.15,True,1,11482,-1479.32,-2872189.98,16985552.24,14113362.26
18229,2000-08-08,1482.8,3.48,0.24,1527.46,-2.92,True,1,11483,-1482.8,-2873672.78,17026992.4,14153319.62
18230,2000-08-09,1472.87,-9.93,-0.67,1527.46,-3.57,True,1,11484,-1472.87,-2875145.65,16914439.08,14039293.43
18231,2000-08-10,1460.25,-12.62,-0.86,1527.46,-4.4,True,1,11485,-1460.25,-2876605.9,16770971.25,13894365.35
18232,2000-08-11,1471.84,11.59,0.79,1527.46,-3.64,True,1,11486,-1471.84,-2878077.74,16905554.24,14027476.5
18233,2000-08-14,1491.56,19.72,1.34,1527.46,-2.35,True,1,11487,-1491.56,-2879569.3,17133549.72,14253980.42
18234,2000-08-15,1484.43,-7.13,-0.48,1527.46,-2.82,True,1,11488,-1484.43,-2881053.73,17053131.84,14172078.11
18235,2000-08-16,1479.85,-4.58,-0.31,1527.46,-3.12,True,1,11489,-1479.85,-2882533.58,17001996.65,14119463.07
18236,2000-08-17,1496.07,16.22,1.1,1527.46,-2.06,True,1,11490,-1496.07,-2884029.65,17189844.3,14305814.65
18237,2000-08-18,1491.72,-4.35,-0.29,1527.46,-2.34,True,1,11491,-1491.72,-2885521.37,17141354.52,14255833.15
18238,2000-08-21,1499.48,7.76,0.52,1527.46,-1.83,True,1,11492,-1499.48,-2887020.85,17232024.16,14345003.31
18239,2000-08-22,1498.13,-1.35,-0.09,1527.46,-1.92,True,1,11493,-1498.13,-2888518.98,17218008.09,14329489.11
18240,2000-08-23,1505.97,7.84,0.52,1527.46,-1.41,True,1,11494,-1505.97,-2890024.95,17309619.18,14419594.23
18241,2000-08-24,1508.31,2.34,0.16,1527.46,-1.25,True,1,11495,-1508.31,-2891533.26,17338023.45,14446490.19
18242,2000-08-25,1506.45,-1.86,-0.12,1527.46,-1.38,True,1,11496,-1506.45,-2893039.71,17318149.2,14425109.49
18243,2000-08-28,1514.09,7.64,0.51,1527.46,-0.88,True,1,11497,-1514.09,-2894553.8,17407492.73,14512938.93
18244,2000-08-29,1509.84,-4.25,-0.28,1527.46,-1.15,True,1,11498,-1509.84,-2896063.64,17360140.32,14464076.68
18245,2000-08-30,1502.59,-7.25,-0.48,1527.46,-1.63,True,1,11499,-1502.59,-2897566.23,17278282.41,14380716.18
18246,2000-08-31,1517.68,15.09,1.0,1527.46,-0.64,True,1,11500,-1517.68,-2899083.91,17453320.0,14554236.09
18247,2000-09-01,1520.77,3.09,0.2,1527.46,-0.44,True,1,11501,-1520.77,-2900604.68,17490375.77,14589771.09
18248,2000-09-05,1507.08,-13.69,-0.9,1527.46,-1.33,True,1,11502,-1507.08,-2902111.76,17334434.16,14432322.4
18249,2000-09-06,1492.25,-14.83,-0.98,1527.46,-2.31,True,1,11503,-1492.25,-2903604.01,17165351.75,14261747.74
18250,2000-09-07,1502.51,10.26,0.69,1527.46,-1.63,True,1,11504,-1502.51,-2905106.52,17284875.04,14379768.52
18251,2000-09-08,1494.5,-8.01,-0.53,1527.46,-2.16,True,1,11505,-1494.5,-2906601.02,17194222.5,14287621.48
18252,2000-09-11,1489.26,-5.24,-0.35,1527.46,-2.5,True,1,11506,-1489.26,-2908090.28,17135425.56,14227335.28
18253,2000-09-12,1481.99,-7.27,-0.49,1527.46,-2.98,True,1,11507,-1481.99,-2909572.27,17053258.93,14143686.66
18254,2000-09-13,1484.91,2.92,0.2,1527.46,-2.79,True,1,11508,-1484.91,-2911057.18,17088344.28,14177287.1
18255,2000-09-14,1480.87,-4.04,-0.27,1527.46,-3.05,True,1,11509,-1480.87,-2912538.05,17043332.83,14130794.78
18256,2000-09-15,1465.81,-15.06,-1.02,1527.46,-4.04,True,1,11510,-1465.81,-2914003.86,16871473.1,13957469.24
18257,2000-09-18,1444.51,-21.3,-1.45,1527.46,-5.43,True,1,11511,-1444.51,-2915448.37,16627754.61,13712306.24
18258,2000-09-19,1459.9,15.39,1.06,1527.46,-4.42,True,1,11512,-1459.9,-2916908.27,16806368.8,13889460.53
18259,2000-09-20,1451.34,-8.56,-0.59,1527.46,-4.98,True,1,11513,-1451.34,-2918359.61,16709277.42,13790917.81
18260,2000-09-21,1449.05,-2.29,-0.16,1527.46,-5.13,True,1,11514,-1449.05,-2919808.66,16684361.7,13764553.04
18261,2000-09-22,1448.72,-0.33,-0.02,1527.46,-5.16,True,1,11515,-1448.72,-2921257.38,16682010.8,13760753.42
18262,2000-09-25,1439.03,-9.69,-0.67,1527.46,-5.79,True,1,11516,-1439.03,-2922696.41,16571869.48,13649173.07
18263,2000-09-26,1427.21,-11.82,-0.82,1527.46,-6.56,True,1,11517,-1427.21,-2924123.62,16437177.57,13513053.95
18264,2000-09-27,1426.57,-0.64,-0.04,1527.46,-6.6,True,1,11518,-1426.57,-2925550.19,16431233.26,13505683.07
18265,2000-09-28,1458.29,31.72,2.22,1527.46,-4.53,True,1,11519,-1458.29,-2927008.48,16798042.51,13871034.03
18266,2000-09-29,1436.51,-21.78,-1.49,1527.46,-5.95,True,1,11520,-1436.51,-2928444.99,16548595.2,13620150.21
18267,2000-10-02,1436.23,-0.28,-0.02,1527.46,-5.97,True,1,11521,-1436.23,-2929881.22,16546805.83,13616924.61
18268,2000-10-03,1426.46,-9.77,-0.68,1527.46,-6.61,True,1,11522,-1426.46,-2931307.68,16435672.12,13504364.44
18269,2000-10-04,1434.32,7.86,0.55,1527.46,-6.1,True,1,11523,-1434.32,-2932742.0,16527669.36,13594927.36
18270,2000-10-05,1436.28,1.96,0.14,1527.46,-5.97,True,1,11524,-1436.28,-2934178.28,16551690.72,13617512.44
18271,2000-10-06,1408.99,-27.29,-1.9,1527.46,-7.76,True,1,11525,-1408.99,-2935587.27,16238609.75,13303022.48
18272,2000-10-09,1402.03,-6.96,-0.49,1527.46,-8.21,True,1,11526,-1402.03,-2936989.3,16159797.78,13222808.48
18273,2000-10-10,1387.02,-15.01,-1.07,1527.46,-9.19,True,1,11527,-1387.02,-2938376.32,15988179.54,13049803.22
18274,2000-10-11,1364.59,-22.43,-1.62,1527.46,-10.66,True,1,11528,-1364.59,-2939740.91,15730993.52,12791252.61
18275,2000-10-12,1329.78,-34.81,-2.55,1527.46,-12.94,True,1,11529,-1329.78,-2941070.69,15331033.62,12389962.93
18276,2000-10-13,1374.17,44.39,3.34,1527.46,-10.04,True,1,11530,-1374.17,-2942444.86,15844180.1,12901735.24
18277,2000-10-16,1374.62,0.45,0.03,1527.46,-10.01,True,1,11531,-1374.62,-2943819.48,15850743.22,12906923.74
18278,2000-10-17,1349.97,-24.65,-1.79,1527.46,-11.62,True,1,11532,-1349.97,-2945169.45,15567854.04,12622684.59
18279,2000-10-18,1342.13,-7.84,-0.58,1527.46,-12.13,True,1,11533,-1342.13,-2946511.58,15478785.29,12532273.71
18280,2000-10-19,1388.76,46.63,3.47,1527.46,-9.08,True,1,11534,-1388.76,-2947900.34,16017957.84,13070057.5
18281,2000-10-20,1396.93,8.17,0.59,1527.46,-8.55,True,1,11535,-1396.93,-2949297.27,16113587.55,13164290.28
18282,2000-10-23,1395.78,-1.15,-0.08,1527.46,-8.62,True,1,11536,-1395.78,-2950693.05,16101718.08,13151025.03
18283,2000-10-24,1398.13,2.35,0.17,1527.46,-8.47,True,1,11537,-1398.13,-2952091.18,16130225.81,13178134.63
18284,2000-10-25,1364.9,-33.23,-2.38,1527.46,-10.64,True,1,11538,-1364.9,-2953456.08,15748216.2,12794760.12
18285,2000-10-26,1364.44,-0.46,-0.03,1527.46,-10.67,True,1,11539,-1364.44,-2954820.52,15744273.16,12789452.64
18286,2000-10-27,1379.58,15.14,1.11,1527.46,-9.68,True,1,11540,-1379.58,-2956200.1,15920353.2,12964153.1
18287,2000-10-30,1398.66,19.08,1.38,1527.46,-8.43,True,1,11541,-1398.66,-2957598.76,16141935.06,13184336.3
18288,2000-10-31,1429.4,30.74,2.2,1527.46,-6.42,True,1,11542,-1429.4,-2959028.16,16498134.8,13539106.64
18289,2000-11-01,1421.22,-8.18,-0.57,1527.46,-6.96,True,1,11543,-1421.22,-2960449.38,16405142.46,13444693.08
18290,2000-11-02,1428.32,7.1,0.5,1527.46,-6.49,True,1,11544,-1428.32,-2961877.7,16488526.08,13526648.38
18291,2000-11-03,1426.69,-1.63,-0.11,1527.46,-6.6,True,1,11545,-1426.69,-2963304.39,16471136.05,13507831.66
18292,2000-11-06,1432.19,5.5,0.39,1527.46,-6.24,True,1,11546,-1432.19,-2964736.58,16536065.74,13571329.16
18293,2000-11-07,1431.87,-0.32,-0.02,1527.46,-6.26,True,1,11547,-1431.87,-2966168.45,16533802.89,13567634.44
18294,2000-11-08,1409.28,-22.59,-1.58,1527.46,-7.74,True,1,11548,-1409.28,-2967577.73,16274365.44,13306787.71
18295,2000-11-09,1400.14,-9.14,-0.65,1527.46,-8.34,True,1,11549,-1400.14,-2968977.87,16170216.86,13201238.99
18296,2000-11-10,1365.98,-34.16,-2.44,1527.46,-10.57,True,1,11550,-1365.98,-2970343.85,15777069.0,12806725.15
18297,2000-11-13,1351.26,-14.72,-1.08,1527.46,-11.54,True,1,11551,-1351.26,-2971695.11,15608404.26,12636709.15
18298,2000-11-14,1382.95,31.69,2.35,1527.46,-9.46,True,1,11552,-1382.95,-2973078.06,15975838.4,13002760.34
18299,2000-11-15,1389.81,6.86,0.5,1527.46,-9.01,True,1,11553,-1389.81,-2974467.87,16056474.93,13082007.06
18300,2000-11-16,1372.32,-17.49,-1.26,1527.46,-10.16,True,1,11554,-1372.32,-2975840.19,15855785.28,12879945.09
18301,2000-11-17,1367.72,-4.6,-0.34,1527.46,-10.46,True,1,11555,-1367.72,-2977207.91,15804004.6,12826796.69
18302,2000-11-20,1342.62,-25.1,-1.84,1527.46,-12.1,True,1,11556,-1342.62,-2978550.53,15515316.72,12536766.19
18303,2000-11-21,1347.35,4.73,0.35,1527.46,-11.79,True,1,11557,-1347.35,-2979897.88,15571323.95,12591426.07
18304,2000-11-22,1322.36,-24.99,-1.86,1527.46,-13.43,True,1,11558,-1322.36,-2981220.24,15283836.88,12302616.64
18305,2000-11-24,1341.77,19.41,1.47,1527.46,-12.16,True,1,11559,-1341.77,-2982562.01,15509519.43,12526957.42
18306,2000-11-27,1348.97,7.2,0.54,1527.46,-11.68,True,1,11560,-1348.97,-2983910.98,15594093.2,12610182.22
18307,2000-11-28,1336.09,-12.88,-0.96,1527.46,-12.53,True,1,11561,-1336.09,-2985247.07,15446536.49,12461289.42
18308,2000-11-29,1341.93,5.84,0.44,1527.46,-12.15,True,1,11562,-1341.93,-2986589.0,15515394.66,12528805.66
18309,2000-11-30,1314.95,-26.98,-2.01,1527.46,-13.91,True,1,11563,-1314.95,-2987903.95,15204766.85,12216862.9
18310,2000-12-01,1315.23,0.28,0.02,1527.46,-13.89,True,1,11564,-1315.23,-2989219.18,15209319.72,12220100.54
18311,2000-12-04,1324.97,9.74,0.74,1527.46,-13.26,True,1,11565,-1324.97,-2990544.15,15323278.05,12332733.9
18312,2000-12-05,1376.54,51.57,3.89,1527.46,-9.88,True,1,11566,-1376.54,-2991920.69,15921061.64,12929140.95
18313,2000-12-06,1351.46,-25.08,-1.82,1527.46,-11.52,True,1,11567,-1351.46,-2993272.15,15632337.82,12639065.67
18314,2000-12-07,1343.55,-7.91,-0.58,1527.46,-12.04,True,1,11568,-1343.55,-2994615.7,15542186.4,12547570.7
18315,2000-12-08,1369.89,26.34,1.96,1527.46,-10.32,True,1,11569,-1369.89,-2995985.59,15848257.41,12852271.82
18316,2000-12-11,1380.2,10.31,0.75,1527.46,-9.64,True,1,11570,-1380.2,-2997365.79,15968914.0,12971548.21
18317,2000-12-12,1371.18,-9.02,-0.65,1527.46,-10.23,True,1,11571,-1371.18,-2998736.97,15865923.78,12867186.81
18318,2000-12-13,1359.99,-11.19,-0.82,1527.46,-10.96,True,1,11572,-1359.99,-3000096.96,15737804.28,12737707.32
18319,2000-12-14,1340.93,-19.06,-1.4,1527.46,-12.21,True,1,11573,-1340.93,-3001437.89,15518582.89,12517145.0
18320,2000-12-15,1312.15,-28.78,-2.15,1527.46,-14.1,True,1,11574,-1312.15,-3002750.04,15186824.1,12184074.06
18321,2000-12-18,1322.74,10.59,0.81,1527.46,-13.4,True,1,11575,-1322.74,-3004072.78,15310715.5,12306642.72
18322,2000-12-19,1305.6,-17.14,-1.3,1527.46,-14.52,True,1,11576,-1305.6,-3005378.38,15113625.6,12108247.22
18323,2000-12-20,1264.74,-40.86,-3.13,1527.46,-17.2,True,1,11577,-1264.74,-3006643.12,14641894.98,11635251.86
18324,2000-12-21,1274.86,10.12,0.8,1527.46,-16.54,True,1,11578,-1274.86,-3007917.98,14760329.08,11752411.1
18325,2000-12-22,1305.95,31.09,2.44,1527.46,-14.5,True,1,11579,-1305.95,-3009223.93,15121595.05,12112371.12
18326,2000-12-26,1315.19,9.24,0.71,1527.46,-13.9,True,1,11580,-1315.19,-3010539.12,15229900.2,12219361.08
18327,2000-12-27,1328.92,13.73,1.04,1527.46,-13.0,True,1,11581,-1328.92,-3011868.04,15390222.52,12378354.48
18328,2000-12-28,1334.22,5.3,0.4,1527.46,-12.65,True,1,11582,-1334.22,-3013202.26,15452936.04,12439733.78
18329,2000-12-29,1320.28,-13.94,-1.04,1527.46,-13.56,True,1,11583,-1320.28,-3014522.54,15292803.24,12278280.7
18330,2001-01-02,1283.27,-37.01,-2.8,1527.46,-15.99,True,1,11584,-1283.27,-3015805.81,14865399.68,11849593.87
18331,2001-01-03,1347.56,64.29,5.01,1527.46,-11.78,True,1,11585,-1347.56,-3017153.37,15611482.6,12594329.23
18332,2001-01-04,1333.34,-14.22,-1.06,1527.46,-12.71,True,1,11586,-1333.34,-3018486.71,15448077.24,12429590.53
18333,2001-01-05,1298.35,-34.99,-2.62,1527.46,-15.0,True,1,11587,-1298.35,-3019785.06,15043981.45,12024196.39
18334,2001-01-08,1295.86,-2.49,-0.19,1527.46,-15.16,True,1,11588,-1295.86,-3021080.92,15016425.68,11995344.76
18335,2001-01-09,1300.8,4.94,0.38,1527.46,-14.84,True,1,11589,-1300.8,-3022381.72,15074971.2,12052589.48
18336,2001-01-10,1313.27,12.47,0.96,1527.46,-14.02,True,1,11590,-1313.27,-3023694.99,15220799.3,12197104.31
18337,2001-01-11,1326.82,13.55,1.03,1527.46,-13.14,True,1,11591,-1326.82,-3025021.81,15379170.62,12354148.81
18338,2001-01-12,1318.55,-8.27,-0.62,1527.46,-13.68,True,1,11592,-1318.55,-3026340.36,15284631.6,12258291.24
18339,2001-01-16,1326.65,8.1,0.61,1527.46,-13.15,True,1,11593,-1326.65,-3027667.01,15379853.45,12352186.44
18340,2001-01-17,1329.47,2.82,0.21,1527.46,-12.96,True,1,11594,-1329.47,-3028996.48,15413875.18,12384878.7
18341,2001-01-18,1347.97,18.5,1.39,1527.46,-11.75,True,1,11595,-1347.97,-3030344.45,15629712.15,12599367.7
18342,2001-01-19,1342.54,-5.43,-0.4,1527.46,-12.11,True,1,11596,-1342.54,-3031686.99,15568093.84,12536406.85
18343,2001-01-22,1342.9,0.36,0.03,1527.46,-12.08,True,1,11597,-1342.9,-3033029.89,15573611.3,12540581.41
18344,2001-01-23,1360.4,17.5,1.3,1527.46,-10.94,True,1,11598,-1360.4,-3034390.29,15777919.2,12743528.91
18345,2001-01-24,1364.3,3.9,0.29,1527.46,-10.68,True,1,11599,-1364.3,-3035754.59,15824515.7,12788761.11
18346,2001-01-25,1357.51,-6.79,-0.5,1527.46,-11.13,True,1,11600,-1357.51,-3037112.1,15747116.0,12710003.9
18347,2001-01-26,1354.95,-2.56,-0.19,1527.46,-11.29,True,1,11601,-1354.95,-3038467.05,15718774.95,12680307.9
18348,2001-01-29,1364.17,9.22,0.68,1527.46,-10.69,True,1,11602,-1364.17,-3039831.22,15827100.34,12787269.12
18349,2001-01-30,1373.73,9.56,0.7,1527.46,-10.06,True,1,11603,-1373.73,-3041204.95,15939389.19,12898184.24
18350,2001-01-31,1366.01,-7.72,-0.56,1527.46,-10.57,True,1,11604,-1366.01,-3042570.96,15851180.04,12808609.08
18351,2001-02-01,1373.47,7.46,0.55,1527.46,-10.08,True,1,11605,-1373.47,-3043944.43,15939119.35,12895174.92
18352,2001-02-02,1349.47,-24.0,-1.75,1527.46,-11.65,True,1,11606,-1349.47,-3045293.9,15661948.82,12616654.92
18353,2001-02-05,1354.31,4.84,0.36,1527.46,-11.34,True,1,11607,-1354.31,-3046648.21,15719476.17,12672827.96
18354,2001-02-06,1352.26,-2.05,-0.15,1527.46,-11.47,True,1,11608,-1352.26,-3048000.47,15697034.08,12649033.61
18355,2001-02-07,1340.89,-11.37,-0.84,1527.46,-12.21,True,1,11609,-1340.89,-3049341.36,15566392.01,12517050.65
18356,2001-02-08,1332.53,-8.36,-0.62,1527.46,-12.76,True,1,11610,-1332.53,-3050673.89,15470673.3,12419999.41
18357,2001-02-09,1314.76,-17.77,-1.33,1527.46,-13.92,True,1,11611,-1314.76,-3051988.65,15265678.36,12213689.71
18358,2001-02-12,1330.31,15.55,1.18,1527.46,-12.91,True,1,11612,-1330.31,-3053318.96,15447559.72,12394240.76
18359,2001-02-13,1318.8,-11.51,-0.86,1527.46,-13.66,True,1,11613,-1318.8,-3054637.76,15315224.4,12260586.64
18360,2001-02-14,1315.92,-2.88,-0.22,1527.46,-13.85,True,1,11614,-1315.92,-3055953.68,15283094.88,12227141.2
18361,2001-02-15,1326.61,10.69,0.81,1527.46,-13.15,True,1,11615,-1326.61,-3057280.29,15408575.15,12351294.86
18362,2001-02-16,1301.53,-25.08,-1.89,1527.46,-14.79,True,1,11616,-1301.53,-3058581.82,15118572.48,12059990.66
18363,2001-02-20,1278.94,-22.59,-1.74,1527.46,-16.27,True,1,11617,-1278.94,-3059860.76,14857445.98,11797585.22
18364,2001-02-21,1255.27,-23.67,-1.85,1527.46,-17.82,True,1,11618,-1255.27,-3061116.03,14583726.86,11522610.83
18365,2001-02-22,1252.82,-2.45,-0.2,1527.46,-17.98,True,1,11619,-1252.82,-3062368.85,14556515.58,11494146.73
18366,2001-02-23,1245.86,-6.96,-0.56,1527.46,-18.44,True,1,11620,-1245.86,-3063614.71,14476893.2,11413278.49
18367,2001-02-26,1267.65,21.79,1.75,1527.46,-17.01,True,1,11621,-1267.65,-3064882.36,14731360.65,11666478.29
18368,2001-02-27,1257.94,-9.71,-0.77,1527.46,-17.64,True,1,11622,-1257.94,-3066140.3,14619778.68,11553638.38
18369,2001-02-28,1239.94,-18.0,-1.43,1527.46,-18.82,True,1,11623,-1239.94,-3067380.24,14411822.62,11344442.38
18370,2001-03-01,1241.23,1.29,0.1,1527.46,-18.74,True,1,11624,-1241.23,-3068621.47,14428057.52,11359436.05
18371,2001-03-02,1234.18,-7.05,-0.57,1527.46,-19.2,True,1,11625,-1234.18,-3069855.65,14347342.5,11277486.85
18372,2001-03-05,1241.41,7.23,0.59,1527.46,-18.73,True,1,11626,-1241.41,-3071097.06,14432632.66,11361535.6
18373,2001-03-06,1253.8,12.39,1.0,1527.46,-17.92,True,1,11627,-1253.8,-3072350.86,14577932.6,11505581.74
18374,2001-03-07,1261.89,8.09,0.64,1527.46,-17.39,True,1,11628,-1261.89,-3073612.75,14673256.92,11599644.17
18375,2001-03-08,1264.74,2.85,0.23,1527.46,-17.2,True,1,11629,-1264.74,-3074877.49,14707661.46,11632783.97
18376,2001-03-09,1233.42,-31.32,-2.48,1527.46,-19.25,True,1,11630,-1233.42,-3076110.91,14344674.6,11268563.69
18377,2001-03-12,1180.16,-53.26,-4.32,1527.46,-22.74,True,1,11631,-1180.16,-3077291.07,13726440.96,10649149.89
18378,2001-03-13,1197.66,17.5,1.48,1527.46,-21.59,True,1,11632,-1197.66,-3078488.73,13931181.12,10852692.39
18379,2001-03-14,1166.71,-30.95,-2.58,1527.46,-23.62,True,1,11633,-1166.71,-3079655.44,13572337.43,10492681.99
18380,2001-03-15,1173.56,6.85,0.59,1527.46,-23.17,True,1,11634,-1173.56,-3080829.0,13653197.04,10572368.04
18381,2001-03-16,1150.53,-23.03,-1.96,1527.46,-24.68,True,1,11635,-1150.53,-3081979.53,13386416.55,10304437.02
18382,2001-03-19,1170.81,20.28,1.76,1527.46,-23.35,True,1,11636,-1170.81,-3083150.34,13623545.16,10540394.82
18383,2001-03-20,1142.62,-28.19,-2.41,1527.46,-25.2,True,1,11637,-1142.62,-3084292.96,13296668.94,10212375.98
18384,2001-03-21,1122.14,-20.48,-1.79,1527.46,-26.54,True,1,11638,-1122.14,-3085415.1,13059465.32,9974050.22
18385,2001-03-22,1117.58,-4.56,-0.41,1527.46,-26.83,True,1,11639,-1117.58,-3086532.68,13007513.62,9920980.94
18386,2001-03-23,1139.83,22.25,1.99,1527.46,-25.38,True,1,11640,-1139.83,-3087672.51,13267621.2,10179948.69
18387,2001-03-26,1152.69,12.86,1.13,1527.46,-24.54,True,1,11641,-1152.69,-3088825.2,13418464.29,10329639.09
18388,2001-03-27,1182.17,29.48,2.56,1527.46,-22.6,True,1,11642,-1182.17,-3090007.37,13762823.14,10672815.77
18389,2001-03-28,1153.29,-28.88,-2.44,1527.46,-24.5,True,1,11643,-1153.29,-3091160.66,13427755.47,10336594.81
18390,2001-03-29,1147.95,-5.34,-0.46,1527.46,-24.85,True,1,11644,-1147.95,-3092308.61,13366729.8,10274421.19
18391,2001-03-30,1160.33,12.38,1.08,1527.46,-24.04,True,1,11645,-1160.33,-3093468.94,13512042.85,10418573.91
18392,2001-04-02,1145.87,-14.46,-1.25,1527.46,-24.98,True,1,11646,-1145.87,-3094614.81,13344802.02,10250187.21
18393,2001-04-03,1106.46,-39.41,-3.44,1527.46,-27.56,True,1,11647,-1106.46,-3095721.27,12886939.62,9791218.35
18394,2001-04-04,1103.25,-3.21,-0.29,1527.46,-27.77,True,1,11648,-1103.25,-3096824.52,12850656.0,9753831.48
18395,2001-04-05,1151.44,48.19,4.37,1527.46,-24.62,True,1,11649,-1151.44,-3097975.96,13413124.56,10315148.6
18396,2001-04-06,1128.43,-23.01,-2.0,1527.46,-26.12,True,1,11650,-1128.43,-3099104.39,13146209.5,10047105.11
18397,2001-04-09,1137.59,9.16,0.81,1527.46,-25.52,True,1,11651,-1137.59,-3100241.98,13254061.09,10153819.11
18398,2001-04-10,1168.38,30.79,2.71,1527.46,-23.51,True,1,11652,-1168.38,-3101410.36,13613963.76,10512553.4
18399,2001-04-11,1165.89,-2.49,-0.21,1527.46,-23.67,True,1,11653,-1165.89,-3102576.25,13586116.17,10483539.92
18400,2001-04-12,1183.5,17.61,1.51,1527.46,-22.52,True,1,11654,-1183.5,-3103759.75,13792509.0,10688749.25
18401,2001-04-16,1179.68,-3.82,-0.32,1527.46,-22.77,True,1,11655,-1179.68,-3104939.43,13749170.4,10644230.97
18402,2001-04-17,1191.81,12.13,1.03,1527.46,-21.97,True,1,11656,-1191.81,-3106131.24,13891737.36,10785606.12
18403,2001-04-18,1238.16,46.35,3.89,1527.46,-18.94,True,1,11657,-1238.16,-3107369.4,14433231.12,11325861.72
18404,2001-04-19,1253.69,15.53,1.25,1527.46,-17.92,True,1,11658,-1253.69,-3108623.09,14615518.02,11506894.93
18405,2001-04-20,1242.98,-10.71,-0.85,1527.46,-18.62,True,1,11659,-1242.98,-3109866.07,14491903.82,11382037.75
18406,2001-04-23,1224.36,-18.62,-1.5,1527.46,-19.84,True,1,11660,-1224.36,-3111090.43,14276037.6,11164947.17
18407,2001-04-24,1209.47,-14.89,-1.22,1527.46,-20.82,True,1,11661,-1209.47,-3112299.9,14103629.67,10991329.77
18408,2001-04-25,1228.75,19.28,1.59,1527.46,-19.56,True,1,11662,-1228.75,-3113528.65,14329682.5,11216153.85
18409,2001-04-26,1234.52,5.77,0.47,1527.46,-19.18,True,1,11663,-1234.52,-3114763.17,14398206.76,11283443.59
18410,2001-04-27,1253.05,18.53,1.5,1527.46,-17.96,True,1,11664,-1253.05,-3116016.22,14615575.2,11499558.98
18411,2001-04-30,1249.46,-3.59,-0.29,1527.46,-18.2,True,1,11665,-1249.46,-3117265.68,14574950.9,11457685.22
18412,2001-05-01,1266.44,16.98,1.36,1527.46,-17.09,True,1,11666,-1266.44,-3118532.12,14774289.04,11655756.92
18413,2001-05-02,1267.43,0.99,0.08,1527.46,-17.02,True,1,11667,-1267.43,-3119799.55,14787105.81,11667306.26
18414,2001-05-03,1248.58,-18.85,-1.49,1527.46,-18.26,True,1,11668,-1248.58,-3121048.13,14568431.44,11447383.31
18415,2001-05-04,1266.61,18.03,1.44,1527.46,-17.08,True,1,11669,-1266.61,-3122314.74,14780072.09,11657757.35
18416,2001-05-07,1263.51,-3.1,-0.24,1527.46,-17.28,True,1,11670,-1263.51,-3123578.25,14745161.7,11621583.45
18417,2001-05-08,1261.2,-2.31,-0.18,1527.46,-17.43,True,1,11671,-1261.2,-3124839.45,14719465.2,11594625.75
18418,2001-05-09,1255.54,-5.66,-0.45,1527.46,-17.8,True,1,11672,-1255.54,-3126094.99,14654662.88,11528567.89
18419,2001-05-10,1255.18,-0.36,-0.03,1527.46,-17.83,True,1,11673,-1255.18,-3127350.17,14651716.14,11524365.97
18420,2001-05-11,1245.67,-9.51,-0.76,1527.46,-18.45,True,1,11674,-1245.67,-3128595.84,14541951.58,11413355.74
18421,2001-05-14,1248.92,3.25,0.26,1527.46,-18.24,True,1,11675,-1248.92,-3129844.76,14581141.0,11451296.24
18422,2001-05-15,1249.44,0.52,0.04,1527.46,-18.2,True,1,11676,-1249.44,-3131094.2,14588461.44,11457367.24
18423,2001-05-16,1284.99,35.55,2.84,1527.46,-15.87,True,1,11677,-1284.99,-3132379.19,15004828.23,11872449.04
18424,2001-05-17,1288.49,3.5,0.27,1527.46,-15.64,True,1,11678,-1288.49,-3133667.68,15046986.22,11913318.54
18425,2001-05-18,1291.96,3.47,0.27,1527.46,-15.42,True,1,11679,-1291.96,-3134959.64,15088800.84,11953841.2
18426,2001-05-21,1312.83,20.87,1.62,1527.46,-14.05,True,1,11680,-1312.83,-3136272.47,15333854.4,12197581.93
18427,2001-05-22,1309.38,-3.45,-0.26,1527.46,-14.28,True,1,11681,-1309.38,-3137581.85,15294867.78,12157285.93
18428,2001-05-23,1289.05,-20.33,-1.55,1527.46,-15.61,True,1,11682,-1289.05,-3138870.9,15058682.1,11919811.2
18429,2001-05-24,1293.17,4.12,0.32,1527.46,-15.34,True,1,11683,-1293.17,-3140164.07,15108105.11,11967941.04
18430,2001-05-25,1277.89,-15.28,-1.18,1527.46,-16.34,True,1,11684,-1277.89,-3141441.96,14930866.76,11789424.8
18431,2001-05-29,1267.93,-9.96,-0.78,1527.46,-16.99,True,1,11685,-1267.93,-3142709.89,14815762.05,11673052.16
18432,2001-05-30,1248.08,-19.85,-1.57,1527.46,-18.29,True,1,11686,-1248.08,-3143957.97,14585062.88,11441104.91
18433,2001-05-31,1255.82,7.74,0.62,1527.46,-17.78,True,1,11687,-1255.82,-3145213.79,14676768.34,11531554.55
18434,2001-06-01,1260.67,4.85,0.39,1527.46,-17.47,True,1,11688,-1260.67,-3146474.46,14734710.96,11588236.5
18435,2001-06-04,1267.11,6.44,0.51,1527.46,-17.05,True,1,11689,-1267.11,-3147741.57,14811248.79,11663507.22
18436,2001-06-05,1283.57,16.46,1.3,1527.46,-15.97,True,1,11690,-1283.57,-3149025.14,15004933.3,11855908.16
18437,2001-06-06,1270.03,-13.54,-1.06,1527.46,-16.85,True,1,11691,-1270.03,-3150295.17,14847920.73,11697625.56
18438,2001-06-07,1276.96,6.93,0.55,1527.46,-16.4,True,1,11692,-1276.96,-3151572.13,14930216.32,11778644.19
18439,2001-06-08,1264.96,-12.0,-0.94,1527.46,-17.18,True,1,11693,-1264.96,-3152837.09,14791177.28,11638340.19
18440,2001-06-11,1254.39,-10.57,-0.84,1527.46,-17.88,True,1,11694,-1254.39,-3154091.48,14668836.66,11514745.18
18441,2001-06-12,1255.85,1.46,0.12,1527.46,-17.78,True,1,11695,-1255.85,-3155347.33,14687165.75,11531818.42
18442,2001-06-13,1241.6,-14.25,-1.14,1527.46,-18.72,True,1,11696,-1241.6,-3156588.93,14521753.6,11365164.67
18443,2001-06-14,1219.87,-21.73,-1.75,1527.46,-20.14,True,1,11697,-1219.87,-3157808.8,14268819.39,11111010.59
18444,2001-06-15,1214.36,-5.51,-0.45,1527.46,-20.5,True,1,11698,-1214.36,-3159023.16,14205583.28,11046560.12
18445,2001-06-18,1208.43,-5.93,-0.49,1527.46,-20.89,True,1,11699,-1208.43,-3160231.59,14137422.57,10977190.98
18446,2001-06-19,1212.58,4.15,0.34,1527.46,-20.62,True,1,11700,-1212.58,-3161444.17,14187186.0,11025741.83
18447,2001-06-20,1223.14,10.56,0.87,1527.46,-19.92,True,1,11701,-1223.14,-3162667.31,14311961.14,11149293.83
18448,2001-06-21,1237.04,13.9,1.14,1527.46,-19.01,True,1,11702,-1237.04,-3163904.35,14475842.08,11311937.73
18449,2001-06-22,1225.35,-11.69,-0.94,1527.46,-19.78,True,1,11703,-1225.35,-3165129.7,14340271.05,11175141.35
18450,2001-06-25,1218.6,-6.75,-0.55,1527.46,-20.22,True,1,11704,-1218.6,-3166348.3,14262494.4,11096146.1
18451,2001-06-26,1216.76,-1.84,-0.15,1527.46,-20.34,True,1,11705,-1216.76,-3167565.06,14242175.8,11074610.74
18452,2001-06-27,1211.07,-5.69,-0.47,1527.46,-20.71,True,1,11706,-1211.07,-3168776.13,14176785.42,11008009.29
18453,2001-06-28,1226.2,15.13,1.25,1527.46,-19.72,True,1,11707,-1226.2,-3170002.33,14355123.4,11185121.07
18454,2001-06-29,1224.38,-1.82,-0.15,1527.46,-19.84,True,1,11708,-1224.38,-3171226.71,14335041.04,11163814.33
18455,2001-07-02,1236.72,12.34,1.01,1527.46,-19.03,True,1,11709,-1236.72,-3172463.43,14480754.48,11308291.05
18456,2001-07-03,1234.45,-2.27,-0.18,1527.46,-19.18,True,1,11710,-1234.45,-3173697.88,14455409.5,11281711.62
18457,2001-07-05,1219.24,-15.21,-1.23,1527.46,-20.18,True,1,11711,-1219.24,-3174917.12,14278519.64,11103602.52
18458,2001-07-06,1190.59,-28.65,-2.35,1527.46,-22.05,True,1,11712,-1190.59,-3176107.71,13944190.08,10768082.37
18459,2001-07-09,1198.78,8.19,0.69,1527.46,-21.52,True,1,11713,-1198.78,-3177306.49,14041310.14,10864003.65
18460,2001-07-10,1181.52,-17.26,-1.44,1527.46,-22.65,True,1,11714,-1181.52,-3178488.01,13840325.28,10661837.27
18461,2001-07-11,1180.18,-1.34,-0.11,1527.46,-22.74,True,1,11715,-1180.18,-3179668.19,13825808.7,10646140.51
18462,2001-07-12,1208.14,27.96,2.37,1527.46,-20.9,True,1,11716,-1208.14,-3180876.33,14154568.24,10973691.91
18463,2001-07-13,1215.68,7.54,0.62,1527.46,-20.41,True,1,11717,-1215.68,-3182092.01,14244122.56,11062030.55
18464,2001-07-16,1202.45,-13.23,-1.09,1527.46,-21.28,True,1,11718,-1202.45,-3183294.46,14090309.1,10907014.64
18465,2001-07-17,1214.44,11.99,1.0,1527.46,-20.49,True,1,11719,-1214.44,-3184508.9,14232022.36,11047513.46
18466,2001-07-18,1207.71,-6.73,-0.55,1527.46,-20.93,True,1,11720,-1207.71,-3185716.61,14154361.2,10968644.59
18467,2001-07-19,1215.02,7.31,0.6,1527.46,-20.45,True,1,11721,-1215.02,-3186931.63,14241249.42,11054317.79
18468,2001-07-20,1210.85,-4.17,-0.34,1527.46,-20.73,True,1,11722,-1210.85,-3188142.48,14193583.7,11005441.22
18469,2001-07-23,1191.03,-19.82,-1.64,1527.46,-22.02,True,1,11723,-1191.03,-3189333.51,13962444.69,10773111.18
18470,2001-07-24,1171.65,-19.38,-1.63,1527.46,-23.29,True,1,11724,-1171.65,-3190505.16,13736424.6,10545919.44
18471,2001-07-25,1190.49,18.84,1.61,1527.46,-22.06,True,1,11725,-1190.49,-3191695.65,13958495.25,10766799.6
18472,2001-07-26,1202.93,12.44,1.04,1527.46,-21.25,True,1,11726,-1202.93,-3192898.58,14105557.18,10912658.6
18473,2001-07-27,1205.82,2.89,0.24,1527.46,-21.06,True,1,11727,-1205.82,-3194104.4,14140651.14,10946546.74
18474,2001-07-30,1204.52,-1.3,-0.11,1527.46,-21.14,True,1,11728,-1204.52,-3195308.92,14126610.56,10931301.64
18475,2001-07-31,1211.23,6.71,0.56,1527.46,-20.7,True,1,11729,-1211.23,-3196520.15,14206516.67,11009996.52
18476,2001-08-01,1215.93,4.7,0.39,1527.46,-20.4,True,1,11730,-1215.93,-3197736.08,14262858.9,11065122.82
18477,2001-08-02,1220.75,4.82,0.4,1527.46,-20.08,True,1,11731,-1220.75,-3198956.83,14320618.25,11121661.42
18478,2001-08-03,1214.35,-6.4,-0.52,1527.46,-20.5,True,1,11732,-1214.35,-3200171.18,14246754.2,11046583.02
18479,2001-08-06,1200.48,-13.87,-1.14,1527.46,-21.41,True,1,11733,-1200.48,-3201371.66,14085231.84,10883860.18
18480,2001-08-07,1204.4,3.92,0.33,1527.46,-21.15,True,1,11734,-1204.4,-3202576.06,14132429.6,10929853.54
18481,2001-08-08,1183.53,-20.87,-1.73,1527.46,-22.52,True,1,11735,-1183.53,-3203759.59,13888724.55,10684964.96
18482,2001-08-09,1183.43,-0.1,-0.01,1527.46,-22.52,True,1,11736,-1183.43,-3204943.02,13888734.48,10683791.46
18483,2001-08-10,1190.16,6.73,0.57,1527.46,-22.08,True,1,11737,-1190.16,-3206133.18,13968907.92,10762774.74
18484,2001-08-13,1191.29,1.13,0.1,1527.46,-22.01,True,1,11738,-1191.29,-3207324.47,13983362.02,10776037.55
18485,2001-08-14,1186.73,-4.56,-0.38,1527.46,-22.31,True,1,11739,-1186.73,-3208511.2,13931023.47,10722512.27
18486,2001-08-15,1178.02,-8.71,-0.73,1527.46,-22.88,True,1,11740,-1178.02,-3209689.22,13829954.8,10620265.58
18487,2001-08-16,1181.66,3.64,0.31,1527.46,-22.64,True,1,11741,-1181.66,-3210870.88,13873870.06,10662999.18
18488,2001-08-17,1161.97,-19.69,-1.67,1527.46,-23.93,True,1,11742,-1161.97,-3212032.85,13643851.74,10431818.89
18489,2001-08-20,1171.41,9.44,0.81,1527.46,-23.31,True,1,11743,-1171.41,-3213204.26,13755867.63,10542663.37
18490,2001-08-21,1157.26,-14.15,-1.21,1527.46,-24.24,True,1,11744,-1157.26,-3214361.52,13590861.44,10376499.92
18491,2001-08-22,1165.31,8.05,0.7,1527.46,-23.71,True,1,11745,-1165.31,-3215526.83,13686565.95,10471039.12
18492,2001-08-23,1162.09,-3.22,-0.28,1527.46,-23.92,True,1,11746,-1162.09,-3216688.92,13649909.14,10433220.22
18493,2001-08-24,1184.93,22.84,1.96,1527.46,-22.42,True,1,11747,-1184.93,-3217873.85,13919372.71,10701498.86
18494,2001-08-27,1179.21,-5.72,-0.48,1527.46,-22.8,True,1,11748,-1179.21,-3219053.06,13853359.08,10634306.02
18495,2001-08-28,1161.51,-17.7,-1.5,1527.46,-23.96,True,1,11749,-1161.51,-3220214.57,13646580.99,10426366.42
18496,2001-08-29,1148.56,-12.95,-1.12,1527.46,-24.81,True,1,11750,-1148.56,-3221363.13,13495580.0,10274216.87
18497,2001-08-30,1129.03,-19.53,-1.7,1527.46,-26.08,True,1,11751,-1129.03,-3222492.16,13267231.53,10044739.37
18498,2001-08-31,1133.58,4.55,0.4,1527.46,-25.79,True,1,11752,-1133.58,-3223625.74,13321832.16,10098206.42
18499,2001-09-04,1132.94,-0.64,-0.06,1527.46,-25.83,True,1,11753,-1132.94,-3224758.68,13315443.82,10090685.14
18500,2001-09-05,1131.74,-1.2,-0.11,1527.46,-25.91,True,1,11754,-1131.74,-3225890.42,13302471.96,10076581.54
18501,2001-09-06,1106.4,-25.34,-2.24,1527.46,-27.57,True,1,11755,-1106.4,-3226996.82,13005732.0,9778735.18
18502,2001-09-07,1085.78,-20.62,-1.86,1527.46,-28.92,True,1,11756,-1085.78,-3228082.6,12764429.68,9536347.08
18503,2001-09-10,1092.54,6.76,0.62,1527.46,-28.47,True,1,11757,-1092.54,-3229175.14,12844992.78,9615817.64
18504,2001-09-17,1038.77,-53.77,-4.92,1527.46,-31.99,True,1,11758,-1038.77,-3230213.91,12213857.66,8983643.75
18505,2001-09-18,1032.74,-6.03,-0.58,1527.46,-32.39,True,1,11759,-1032.74,-3231246.65,12143989.66,8912743.01
18506,2001-09-19,1016.1,-16.64,-1.61,1527.46,-33.48,True,1,11760,-1016.1,-3232262.75,11949336.0,8717073.25
18507,2001-09-20,984.54,-31.56,-3.11,1527.46,-35.54,True,1,11761,-984.54,-3233247.29,11579174.94,8345927.65
18508,2001-09-21,965.8,-18.74,-1.9,1527.46,-36.77,True,1,11762,-965.8,-3234213.09,11359739.6,8125526.51
18509,2001-09-24,1003.45,37.65,3.9,1527.46,-34.31,True,1,11763,-1003.45,-3235216.54,11803582.35,8568365.81
18510,2001-09-25,1012.27,8.82,0.88,1527.46,-33.73,True,1,11764,-1012.27,-3236228.81,11908344.28,8672115.47
18511,2001-09-26,1007.04,-5.23,-0.52,1527.46,-34.07,True,1,11765,-1007.04,-3237235.85,11847825.6,8610589.75
18512,2001-09-27,1018.61,11.57,1.15,1527.46,-33.31,True,1,11766,-1018.61,-3238254.46,11984965.26,8746710.8
18513,2001-09-28,1040.94,22.33,2.19,1527.46,-31.85,True,1,11767,-1040.94,-3239295.4,12248740.98,9009445.58
18514,2001-10-01,1038.55,-2.39,-0.23,1527.46,-32.01,True,1,11768,-1038.55,-3240333.95,12221656.4,8981322.45
18515,2001-10-02,1051.33,12.78,1.23,1527.46,-31.17,True,1,11769,-1051.33,-3241385.28,12373102.77,9131717.49
18516,2001-10-03,1072.28,20.95,1.99,1527.46,-29.8,True,1,11770,-1072.28,-3242457.56,12620735.6,9378278.04
18517,2001-10-04,1069.63,-2.65,-0.25,1527.46,-29.97,True,1,11771,-1069.63,-3243527.19,12590614.73,9347087.54
18518,2001-10-05,1071.38,1.75,0.16,1527.46,-29.86,True,1,11772,-1071.38,-3244598.57,12612285.36,9367686.79
18519,2001-10-08,1062.44,-8.94,-0.83,1527.46,-30.44,True,1,11773,-1062.44,-3245661.01,12508106.12,9262445.11
18520,2001-10-09,1056.75,-5.69,-0.54,1527.46,-30.82,True,1,11774,-1056.75,-3246717.76,12442174.5,9195456.74
18521,2001-10-10,1080.99,24.24,2.29,1527.46,-29.23,True,1,11775,-1080.99,-3247798.75,12728657.25,9480858.5
18522,2001-10-11,1097.43,16.44,1.52,1527.46,-28.15,True,1,11776,-1097.43,-3248896.18,12923335.68,9674439.5
18523,2001-10-12,1091.65,-5.78,-0.53,1527.46,-28.53,True,1,11777,-1091.65,-3249987.83,12856362.05,9606374.22
18524,2001-10-15,1089.98,-1.67,-0.15,1527.46,-28.64,True,1,11778,-1089.98,-3251077.81,12837784.44,9586706.63
18525,2001-10-16,1097.54,7.56,0.69,1527.46,-28.15,True,1,11779,-1097.54,-3252175.35,12927923.66,9675748.31
18526,2001-10-17,1077.09,-20.45,-1.86,1527.46,-29.48,True,1,11780,-1077.09,-3253252.44,12688120.2,9434867.76
18527,2001-10-18,1068.61,-8.48,-0.79,1527.46,-30.04,True,1,11781,-1068.61,-3254321.05,12589294.41,9334973.36
18528,2001-10-19,1073.48,4.87,0.46,1527.46,-29.72,True,1,11782,-1073.48,-3255394.53,12647741.36,9392346.83
18529,2001-10-22,1089.9,16.42,1.53,1527.46,-28.65,True,1,11783,-1089.9,-3256484.43,12842291.7,9585807.27
18530,2001-10-23,1084.78,-5.12,-0.47,1527.46,-28.98,True,1,11784,-1084.78,-3257569.21,12783047.52,9525478.31
18531,2001-10-24,1085.2,0.42,0.04,1527.46,-28.95,True,1,11785,-1085.2,-3258654.41,12789082.0,9530427.59
18532,2001-10-25,1100.09,14.89,1.37,1527.46,-27.98,True,1,11786,-1100.09,-3259754.5,12965660.74,9705906.24
18533,2001-10-26,1104.61,4.52,0.41,1527.46,-27.68,True,1,11787,-1104.61,-3260859.11,13020038.07,9759178.96
18534,2001-10-29,1078.3,-26.31,-2.38,1527.46,-29.41,True,1,11788,-1078.3,-3261937.41,12711000.4,9449062.99
18535,2001-10-30,1059.79,-18.51,-1.72,1527.46,-30.62,True,1,11789,-1059.79,-3262997.2,12493864.31,9230867.11
18536,2001-10-31,1059.78,-0.01,-0.0,1527.46,-30.62,True,1,11790,-1059.78,-3264056.98,12494806.2,9230749.22
18537,2001-11-01,1084.1,24.32,2.3,1527.46,-29.03,True,1,11791,-1084.1,-3265141.08,12782623.1,9517482.02
18538,2001-11-02,1087.2,3.1,0.29,1527.46,-28.82,True,1,11792,-1087.2,-3266228.28,12820262.4,9554034.12
18539,2001-11-05,1102.84,15.64,1.44,1527.46,-27.8,True,1,11793,-1102.84,-3267331.12,13005792.12,9738461.0
18540,2001-11-06,1118.86,16.02,1.45,1527.46,-26.75,True,1,11794,-1118.86,-3268449.98,13195834.84,9927384.86
18541,2001-11-07,1115.8,-3.06,-0.27,1527.46,-26.95,True,1,11795,-1115.8,-3269565.78,13160861.0,9891295.22
18542,2001-11-08,1118.54,2.74,0.25,1527.46,-26.77,True,1,11796,-1118.54,-3270684.32,13194297.84,9923613.52
18543,2001-11-09,1120.31,1.77,0.16,1527.46,-26.66,True,1,11797,-1120.31,-3271804.63,13216297.07,9944492.44
18544,2001-11-12,1118.33,-1.98,-0.18,1527.46,-26.78,True,1,11798,-1118.33,-3272922.96,13194057.34,9921134.38
18545,2001-11-13,1139.09,20.76,1.86,1527.46,-25.43,True,1,11799,-1139.09,-3274062.05,13440122.91,10166060.86
18546,2001-11-14,1141.21,2.12,0.19,1527.46,-25.29,True,1,11800,-1141.21,-3275203.26,13466278.0,10191074.74
18547,2001-11-15,1142.24,1.03,0.09,1527.46,-25.22,True,1,11801,-1142.24,-3276345.5,13479574.24,10203228.74
18548,2001-11-16,1138.65,-3.59,-0.31,1527.46,-25.46,True,1,11802,-1138.65,-3277484.15,13438347.3,10160863.15
18549,2001-11-19,1151.06,12.41,1.09,1527.46,-24.64,True,1,11803,-1151.06,-3278635.21,13585961.18,10307325.97
18550,2001-11-20,1142.66,-8.4,-0.73,1527.46,-25.19,True,1,11804,-1142.66,-3279777.87,13487958.64,10208180.77
18551,2001-11-21,1137.03,-5.63,-0.49,1527.46,-25.56,True,1,11805,-1137.03,-3280914.9,13422639.15,10141724.25
18552,2001-11-23,1150.34,13.31,1.17,1527.46,-24.69,True,1,11806,-1150.34,-3282065.24,13580914.04,10298848.8
18553,2001-11-26,1157.42,7.08,0.62,1527.46,-24.23,True,1,11807,-1157.42,-3283222.66,13665657.94,10382435.28
18554,2001-11-27,1149.5,-7.92,-0.68,1527.46,-24.74,True,1,11808,-1149.5,-3284372.16,13573296.0,10288923.84
18555,2001-11-28,1128.52,-20.98,-1.82,1527.46,-26.12,True,1,11809,-1128.52,-3285500.68,13326692.68,10041192.0
18556,2001-11-29,1140.2,11.68,1.03,1527.46,-25.35,True,1,11810,-1140.2,-3286640.88,13465762.0,10179121.12
18557,2001-11-30,1139.45,-0.75,-0.07,1527.46,-25.4,True,1,11811,-1139.45,-3287780.33,13458043.95,10170263.62
18558,2001-12-03,1129.9,-9.55,-0.84,1527.46,-26.03,True,1,11812,-1129.9,-3288910.23,13346378.8,10057468.57
18559,2001-12-04,1144.8,14.9,1.32,1527.46,-25.05,True,1,11813,-1144.8,-3290055.03,13523522.4,10233467.37
18560,2001-12-05,1170.35,25.55,2.23,1527.46,-23.38,True,1,11814,-1170.35,-3291225.38,13826514.9,10535289.52
18561,2001-12-06,1167.1,-3.25,-0.28,1527.46,-23.59,True,1,11815,-1167.1,-3292392.48,13789286.5,10496894.02
18562,2001-12-07,1158.31,-8.79,-0.75,1527.46,-24.17,True,1,11816,-1158.31,-3293550.79,13686590.96,10393040.17
18563,2001-12-10,1139.93,-18.38,-1.59,1527.46,-25.37,True,1,11817,-1139.93,-3294690.72,13470552.81,10175862.09
18564,2001-12-11,1136.76,-3.17,-0.28,1527.46,-25.58,True,1,11818,-1136.76,-3295827.48,13434229.68,10138402.2
18565,2001-12-12,1137.07,0.31,0.03,1527.46,-25.56,True,1,11819,-1137.07,-3296964.55,13439030.33,10142065.78
18566,2001-12-13,1119.38,-17.69,-1.56,1527.46,-26.72,True,1,11820,-1119.38,-3298083.93,13231071.6,9932987.67
18567,2001-12-14,1123.09,3.71,0.33,1527.46,-26.47,True,1,11821,-1123.09,-3299207.02,13276046.89,9976839.87
18568,2001-12-17,1134.36,11.27,1.0,1527.46,-25.74,True,1,11822,-1134.36,-3300341.38,13410403.92,10110062.54
18569,2001-12-18,1142.92,8.56,0.76,1527.46,-25.18,True,1,11823,-1142.92,-3301484.3,13512743.16,10211258.86
18570,2001-12-19,1149.56,6.64,0.58,1527.46,-24.74,True,1,11824,-1149.56,-3302633.86,13592397.44,10289763.58
18571,2001-12-20,1139.93,-9.63,-0.84,1527.46,-25.37,True,1,11825,-1139.93,-3303773.79,13479672.25,10175898.46
18572,2001-12-21,1144.89,4.96,0.44,1527.46,-25.05,True,1,11826,-1144.89,-3304918.68,13539469.14,10234550.46
18573,2001-12-24,1144.65,-0.24,-0.02,1527.46,-25.06,True,1,11827,-1144.65,-3306063.33,13537775.55,10231712.22
18574,2001-12-26,1149.37,4.72,0.41,1527.46,-24.75,True,1,11828,-1149.37,-3307212.7,13594748.36,10287535.66
18575,2001-12-27,1157.13,7.76,0.68,1527.46,-24.24,True,1,11829,-1157.13,-3308369.83,13687690.77,10379320.94
18576,2001-12-28,1161.02,3.89,0.34,1527.46,-23.99,True,1,11830,-1161.02,-3309530.85,13734866.6,10425335.75
18577,2001-12-31,1148.08,-12.94,-1.12,1527.46,-24.84,True,1,11831,-1148.08,-3310678.93,13582934.48,10272255.55
18578,2002-01-02,1154.67,6.59,0.57,1527.46,-24.41,True,1,11832,-1154.67,-3311833.6,13662055.44,10350221.84
18579,2002-01-03,1165.27,10.6,0.92,1527.46,-23.71,True,1,11833,-1165.27,-3312998.87,13788639.91,10475641.04
18580,2002-01-04,1172.51,7.24,0.62,1527.46,-23.24,True,1,11834,-1172.51,-3314171.38,13875483.34,10561311.96
18581,2002-01-07,1164.89,-7.62,-0.65,1527.46,-23.74,True,1,11835,-1164.89,-3315336.27,13786473.15,10471136.88
18582,2002-01-08,1160.71,-4.18,-0.36,1527.46,-24.01,True,1,11836,-1160.71,-3316496.98,13738163.56,10421666.58
18583,2002-01-09,1155.14,-5.57,-0.48,1527.46,-24.38,True,1,11837,-1155.14,-3317652.12,13673392.18,10355740.06
18584,2002-01-10,1156.55,1.41,0.12,1527.46,-24.28,True,1,11838,-1156.55,-3318808.67,13691238.9,10372430.23
18585,2002-01-11,1145.6,-10.95,-0.95,1527.46,-25.0,True,1,11839,-1145.6,-3319954.27,13562758.4,10242804.13
18586,2002-01-14,1138.41,-7.19,-0.63,1527.46,-25.47,True,1,11840,-1138.41,-3321092.68,13478774.4,10157681.72
18587,2002-01-15,1146.19,7.78,0.68,1527.46,-24.96,True,1,11841,-1146.19,-3322238.87,13572035.79,10249796.92
18588,2002-01-16,1127.57,-18.62,-1.62,1527.46,-26.18,True,1,11842,-1127.57,-3323366.44,13352683.94,10029317.5
18589,2002-01-17,1138.88,11.31,1.0,1527.46,-25.44,True,1,11843,-1138.88,-3324505.32,13487755.84,10163250.52
18590,2002-01-18,1127.58,-11.3,-0.99,1527.46,-26.18,True,1,11844,-1127.58,-3325632.9,13355057.52,10029424.62
18591,2002-01-22,1119.31,-8.27,-0.73,1527.46,-26.72,True,1,11845,-1119.31,-3326752.21,13258226.95,9931474.74
18592,2002-01-23,1128.18,8.87,0.79,1527.46,-26.14,True,1,11846,-1128.18,-3327880.39,13364420.28,10036539.89
18593,2002-01-24,1132.15,3.97,0.35,1527.46,-25.88,True,1,11847,-1132.15,-3329012.54,13412581.05,10083568.51
18594,2002-01-25,1133.28,1.13,0.1,1527.46,-25.81,True,1,11848,-1133.28,-3330145.82,13427101.44,10096955.62
18595,2002-01-28,1133.06,-0.22,-0.02,1527.46,-25.82,True,1,11849,-1133.06,-3331278.88,13425627.94,10094349.06
18596,2002-01-29,1100.64,-32.42,-2.86,1527.46,-27.94,True,1,11850,-1100.64,-3332379.52,13042584.0,9710204.48
18597,2002-01-30,1113.57,12.93,1.18,1527.46,-27.1,True,1,11851,-1113.57,-3333493.09,13196918.07,9863424.98
18598,2002-01-31,1130.2,16.63,1.49,1527.46,-26.01,True,1,11852,-1130.2,-3334623.29,13395130.4,10060507.11
18599,2002-02-01,1122.2,-8.0,-0.71,1527.46,-26.53,True,1,11853,-1122.2,-3335745.49,13301436.6,9965691.11
18600,2002-02-04,1094.44,-27.76,-2.47,1527.46,-28.35,True,1,11854,-1094.44,-3336839.93,12973491.76,9636651.83
18601,2002-02-05,1090.02,-4.42,-0.4,1527.46,-28.64,True,1,11855,-1090.02,-3337929.95,12922187.1,9584257.15
18602,2002-02-06,1083.51,-6.51,-0.6,1527.46,-29.06,True,1,11856,-1083.51,-3339013.46,12846094.56,9507081.1
18603,2002-02-07,1080.17,-3.34,-0.31,1527.46,-29.28,True,1,11857,-1080.17,-3340093.63,12807575.69,9467482.06
18604,2002-02-08,1096.22,16.05,1.49,1527.46,-28.23,True,1,11858,-1096.22,-3341189.85,12998976.76,9657786.91
18605,2002-02-11,1111.94,15.72,1.43,1527.46,-27.2,True,1,11859,-1111.94,-3342301.79,13186496.46,9844194.67
18606,2002-02-12,1107.5,-4.44,-0.4,1527.46,-27.49,True,1,11860,-1107.5,-3343409.29,13134950.0,9791540.71
18607,2002-02-13,1118.51,11.01,0.99,1527.46,-26.77,True,1,11861,-1118.51,-3344527.8,13266647.11,9922119.31
18608,2002-02-14,1116.48,-2.03,-0.18,1527.46,-26.91,True,1,11862,-1116.48,-3345644.28,13243685.76,9898041.48
18609,2002-02-15,1104.18,-12.3,-1.1,1527.46,-27.71,True,1,11863,-1104.18,-3346748.46,13098887.34,9752138.88
18610,2002-02-19,1083.34,-20.84,-1.89,1527.46,-29.08,True,1,11864,-1083.34,-3347831.8,12852745.76,9504913.96
18611,2002-02-20,1097.98,14.64,1.35,1527.46,-28.12,True,1,11865,-1097.98,-3348929.78,13027532.7,9678602.92
18612,2002-02-21,1080.95,-17.03,-1.55,1527.46,-29.23,True,1,11866,-1080.95,-3350010.73,12826552.7,9476541.97
18613,2002-02-22,1089.84,8.89,0.82,1527.46,-28.65,True,1,11867,-1089.84,-3351100.57,12933131.28,9582030.71
18614,2002-02-25,1109.43,19.59,1.8,1527.46,-27.37,True,1,11868,-1109.43,-3352210.0,13166715.24,9814505.24
18615,2002-02-26,1109.38,-0.05,-0.0,1527.46,-27.37,True,1,11869,-1109.38,-3353319.38,13167231.22,9813911.84
18616,2002-02-27,1109.89,0.51,0.05,1527.46,-27.34,True,1,11870,-1109.89,-3354429.27,13174394.3,9819965.03
18617,2002-02-28,1106.73,-3.16,-0.28,1527.46,-27.54,True,1,11871,-1106.73,-3355536.0,13137991.83,9782455.83
18618,2002-03-01,1131.78,25.05,2.26,1527.46,-25.9,True,1,11872,-1131.78,-3356667.78,13436492.16,10079824.38
18619,2002-03-04,1153.84,22.06,1.95,1527.46,-24.46,True,1,11873,-1153.84,-3357821.62,13699542.32,10341720.7
18620,2002-03-05,1146.14,-7.7,-0.67,1527.46,-24.96,True,1,11874,-1146.14,-3358967.76,13609266.36,10250298.6
18621,2002-03-06,1162.77,16.63,1.45,1527.46,-23.88,True,1,11875,-1162.77,-3360130.53,13807893.75,10447763.22
18622,2002-03-07,1157.54,-5.23,-0.45,1527.46,-24.22,True,1,11876,-1157.54,-3361288.07,13746945.04,10385656.97
18623,2002-03-08,1164.31,6.77,0.58,1527.46,-23.78,True,1,11877,-1164.31,-3362452.38,13828509.87,10466057.49
18624,2002-03-11,1168.26,3.95,0.34,1527.46,-23.52,True,1,11878,-1168.26,-3363620.64,13876592.28,10512971.64
18625,2002-03-12,1165.58,-2.68,-0.23,1527.46,-23.69,True,1,11879,-1165.58,-3364786.22,13845924.82,10481138.6
18626,2002-03-13,1154.09,-11.49,-0.99,1527.46,-24.44,True,1,11880,-1154.09,-3365940.31,13710589.2,10344648.89
18627,2002-03-14,1153.04,-1.05,-0.09,1527.46,-24.51,True,1,11881,-1153.04,-3367093.35,13699268.24,10332174.89
18628,2002-03-15,1166.16,13.12,1.14,1527.46,-23.65,True,1,11882,-1166.16,-3368259.51,13856313.12,10488053.61
18629,2002-03-18,1165.55,-0.61,-0.05,1527.46,-23.69,True,1,11883,-1165.55,-3369425.06,13850230.65,10480805.59
18630,2002-03-19,1170.29,4.74,0.41,1527.46,-23.38,True,1,11884,-1170.29,-3370595.35,13907726.36,10537131.01
18631,2002-03-20,1151.85,-18.44,-1.58,1527.46,-24.59,True,1,11885,-1151.85,-3371747.2,13689737.25,10317990.05
18632,2002-03-21,1153.59,1.74,0.15,1527.46,-24.48,True,1,11886,-1153.59,-3372900.79,13711570.74,10338669.95
18633,2002-03-22,1148.7,-4.89,-0.42,1527.46,-24.8,True,1,11887,-1148.7,-3374049.49,13654596.9,10280547.41
18634,2002-03-25,1131.87,-16.83,-1.46,1527.46,-25.9,True,1,11888,-1131.87,-3375181.36,13455670.56,10080489.2
18635,2002-03-26,1138.49,6.62,0.58,1527.46,-25.46,True,1,11889,-1138.49,-3376319.85,13535507.61,10159187.76
18636,2002-03-27,1144.58,6.09,0.54,1527.46,-25.07,True,1,11890,-1144.58,-3377464.43,13609056.2,10231591.77
18637,2002-03-28,1147.39,2.81,0.25,1527.46,-24.88,True,1,11891,-1147.39,-3378611.82,13643614.49,10265002.67
18638,2002-04-01,1146.54,-0.85,-0.07,1527.46,-24.94,True,1,11892,-1146.54,-3379758.36,13634653.68,10254895.32
18639,2002-04-02,1136.76,-9.78,-0.85,1527.46,-25.58,True,1,11893,-1136.76,-3380895.12,13519486.68,10138591.56
18640,2002-04-03,1125.4,-11.36,-1.0,1527.46,-26.32,True,1,11894,-1125.4,-3382020.52,13385507.6,10003487.08
18641,2002-04-04,1126.34,0.94,0.08,1527.46,-26.26,True,1,11895,-1126.34,-3383146.86,13397814.3,10014667.44
18642,2002-04-05,1122.73,-3.61,-0.32,1527.46,-26.5,True,1,11896,-1122.73,-3384269.59,13355996.08,9971726.49
18643,2002-04-08,1125.29,2.56,0.23,1527.46,-26.33,True,1,11897,-1125.29,-3385394.88,13387575.13,10002180.25
18644,2002-04-09,1117.8,-7.49,-0.67,1527.46,-26.82,True,1,11898,-1117.8,-3386512.68,13299584.4,9913071.72
18645,2002-04-10,1130.47,12.67,1.13,1527.46,-25.99,True,1,11899,-1130.47,-3387643.15,13451462.53,10063819.38
18646,2002-04-11,1103.69,-26.78,-2.37,1527.46,-27.74,True,1,11900,-1103.69,-3388746.84,13133911.0,9745164.16
18647,2002-04-12,1111.01,7.32,0.66,1527.46,-27.26,True,1,11901,-1111.01,-3389857.85,13222130.01,9832272.16
18648,2002-04-15,1102.55,-8.46,-0.76,1527.46,-27.82,True,1,11902,-1102.55,-3390960.4,13122550.1,9731589.7
18649,2002-04-16,1128.37,25.82,2.34,1527.46,-26.13,True,1,11903,-1128.37,-3392088.77,13430988.11,10038899.34
18650,2002-04-17,1126.07,-2.3,-0.2,1527.46,-26.28,True,1,11904,-1126.07,-3393214.84,13404737.28,10011522.44
18651,2002-04-18,1124.47,-1.6,-0.14,1527.46,-26.38,True,1,11905,-1124.47,-3394339.31,13386815.35,9992476.04
18652,2002-04-19,1125.17,0.7,0.06,1527.46,-26.34,True,1,11906,-1125.17,-3395464.48,13396274.02,10000809.54
18653,2002-04-22,1107.83,-17.34,-1.54,1527.46,-27.47,True,1,11907,-1107.83,-3396572.31,13190931.81,9794359.5
18654,2002-04-23,1100.96,-6.87,-0.62,1527.46,-27.92,True,1,11908,-1100.96,-3397673.27,13110231.68,9712558.41
18655,2002-04-24,1093.14,-7.82,-0.71,1527.46,-28.43,True,1,11909,-1093.14,-3398766.41,13018204.26,9619437.85
18656,2002-04-25,1091.48,-1.66,-0.15,1527.46,-28.54,True,1,11910,-1091.48,-3399857.89,12999526.8,9599668.91
18657,2002-04-26,1076.32,-15.16,-1.39,1527.46,-29.54,True,1,11911,-1076.32,-3400934.21,12820047.52,9419113.31
18658,2002-04-29,1065.45,-10.87,-1.01,1527.46,-30.25,True,1,11912,-1065.45,-3401999.66,12691640.4,9289640.74
18659,2002-04-30,1076.92,11.47,1.08,1527.46,-29.5,True,1,11913,-1076.92,-3403076.58,12829347.96,9426271.38
18660,2002-05-01,1086.46,9.54,0.89,1527.46,-28.87,True,1,11914,-1086.46,-3404163.04,12944084.44,9539921.4
18661,2002-05-02,1084.56,-1.9,-0.18,1527.46,-29.0,True,1,11915,-1084.56,-3405247.6,12922532.4,9517284.8
18662,2002-05-03,1073.43,-11.13,-1.03,1527.46,-29.72,True,1,11916,-1073.43,-3406321.03,12790991.88,9384670.85
18663,2002-05-06,1052.67,-20.76,-1.93,1527.46,-31.08,True,1,11917,-1052.67,-3407373.7,12544668.39,9137294.69
18664,2002-05-07,1049.49,-3.18,-0.3,1527.46,-31.29,True,1,11918,-1049.49,-3408423.19,12507821.82,9099398.63
18665,2002-05-08,1088.85,39.36,3.75,1527.46,-28.72,True,1,11919,-1088.85,-3409512.04,12978003.15,9568491.11
18666,2002-05-09,1073.01,-15.84,-1.46,1527.46,-29.75,True,1,11920,-1073.01,-3410585.05,12790279.2,9379694.15
18667,2002-05-10,1054.99,-18.02,-1.68,1527.46,-30.93,True,1,11921,-1054.99,-3411640.04,12576535.79,9164895.75
18668,2002-05-13,1074.56,19.57,1.86,1527.46,-29.65,True,1,11922,-1074.56,-3412714.6,12810904.32,9398189.72
18669,2002-05-14,1097.28,22.72,2.11,1527.46,-28.16,True,1,11923,-1097.28,-3413811.88,13082869.44,9669057.56
18670,2002-05-15,1091.07,-6.21,-0.57,1527.46,-28.57,True,1,11924,-1091.07,-3414902.95,13009918.68,9595015.73
18671,2002-05-16,1098.23,7.16,0.66,1527.46,-28.1,True,1,11925,-1098.23,-3416001.18,13096392.75,9680391.57
18672,2002-05-17,1106.59,8.36,0.76,1527.46,-27.55,True,1,11926,-1106.59,-3417107.77,13197192.34,9780084.57
18673,2002-05-20,1091.88,-14.71,-1.33,1527.46,-28.52,True,1,11927,-1091.88,-3418199.65,13022852.76,9604653.11
18674,2002-05-21,1079.88,-12.0,-1.1,1527.46,-29.3,True,1,11928,-1079.88,-3419279.53,12880808.64,9461529.11
18675,2002-05-22,1086.02,6.14,0.57,1527.46,-28.9,True,1,11929,-1086.02,-3420365.55,12955132.58,9534767.03
18676,2002-05-23,1097.08,11.06,1.02,1527.46,-28.18,True,1,11930,-1097.08,-3421462.63,13088164.4,9666701.77
18677,2002-05-24,1083.82,-13.26,-1.21,1527.46,-29.04,True,1,11931,-1083.82,-3422546.45,12931056.42,9508509.97
18678,2002-05-28,1074.55,-9.27,-0.86,1527.46,-29.65,True,1,11932,-1074.55,-3423621.0,12821530.6,9397909.6
18679,2002-05-29,1067.66,-6.89,-0.64,1527.46,-30.1,True,1,11933,-1067.66,-3424688.66,12740386.78,9315698.12
18680,2002-05-30,1064.66,-3.0,-0.28,1527.46,-30.3,True,1,11934,-1064.66,-3425753.32,12705652.44,9279899.12
18681,2002-05-31,1067.14,2.48,0.23,1527.46,-30.14,True,1,11935,-1067.14,-3426820.46,12736315.9,9309495.44
18682,2002-06-03,1040.68,-26.46,-2.48,1527.46,-31.87,True,1,11936,-1040.68,-3427861.14,12421556.48,8993695.34
18683,2002-06-04,1040.69,0.01,0.0,1527.46,-31.87,True,1,11937,-1040.69,-3428901.83,12422716.53,8993814.7
18684,2002-06-05,1049.9,9.21,0.88,1527.46,-31.26,True,1,11938,-1049.9,-3429951.73,12533706.2,9103754.47
18685,2002-06-06,1029.15,-20.75,-1.98,1527.46,-32.62,True,1,11939,-1029.15,-3430980.88,12287021.85,8856040.97
18686,2002-06-07,1027.53,-1.62,-0.16,1527.46,-32.73,True,1,11940,-1027.53,-3432008.41,12268708.2,8836699.79
18687,2002-06-10,1030.74,3.21,0.31,1527.46,-32.52,True,1,11941,-1030.74,-3433039.15,12308066.34,8875027.19
18688,2002-06-11,1013.6,-17.14,-1.66,1527.46,-33.64,True,1,11942,-1013.6,-3434052.75,12104411.2,8670358.45
18689,2002-06-12,1020.26,6.66,0.66,1527.46,-33.2,True,1,11943,-1020.26,-3435073.01,12184965.18,8749892.17
18690,2002-06-13,1009.56,-10.7,-1.05,1527.46,-33.91,True,1,11944,-1009.56,-3436082.57,12058184.64,8622102.07
18691,2002-06-14,1007.27,-2.29,-0.23,1527.46,-34.06,True,1,11945,-1007.27,-3437089.84,12031840.15,8594750.31
18692,2002-06-17,1036.17,28.9,2.87,1527.46,-32.16,True,1,11946,-1036.17,-3438126.01,12378086.82,8939960.81
18693,2002-06-18,1037.14,0.97,0.09,1527.46,-32.1,True,1,11947,-1037.14,-3439163.15,12390711.58,8951548.43
18694,2002-06-19,1019.99,-17.15,-1.65,1527.46,-33.22,True,1,11948,-1019.99,-3440183.14,12186840.52,8746657.38
18695,2002-06-20,1006.29,-13.7,-1.34,1527.46,-34.12,True,1,11949,-1006.29,-3441189.43,12024159.21,8582969.78
18696,2002-06-21,989.14,-17.15,-1.7,1527.46,-35.24,True,1,11950,-989.14,-3442178.57,11820223.0,8378044.43
18697,2002-06-24,992.72,3.58,0.36,1527.46,-35.01,True,1,11951,-992.72,-3443171.29,11863996.72,8420825.43
18698,2002-06-25,976.14,-16.58,-1.67,1527.46,-36.09,True,1,11952,-976.14,-3444147.43,11666825.28,8222677.85
18699,2002-06-26,973.53,-2.61,-0.27,1527.46,-36.26,True,1,11953,-973.53,-3445120.96,11636604.09,8191483.13
18700,2002-06-27,990.64,17.11,1.76,1527.46,-35.15,True,1,11954,-990.64,-3446111.6,11842110.56,8395998.96
18701,2002-06-28,989.82,-0.82,-0.08,1527.46,-35.2,True,1,11955,-989.82,-3447101.42,11833298.1,8386196.68
18702,2002-07-01,968.65,-21.17,-2.14,1527.46,-36.58,True,1,11956,-968.65,-3448070.07,11581179.4,8133109.33
18703,2002-07-02,948.09,-20.56,-2.12,1527.46,-37.93,True,1,11957,-948.09,-3449018.16,11336312.13,7887293.97
18704,2002-07-03,953.99,5.9,0.62,1527.46,-37.54,True,1,11958,-953.99,-3449972.15,11407812.42,7957840.27
18705,2002-07-05,989.03,35.04,3.67,1527.46,-35.25,True,1,11959,-989.03,-3450961.18,11827809.77,8376848.59
18706,2002-07-08,976.98,-12.05,-1.22,1527.46,-36.04,True,1,11960,-976.98,-3451938.16,11684680.8,8232742.64
18707,2002-07-09,952.83,-24.15,-2.47,1527.46,-37.62,True,1,11961,-952.83,-3452890.99,11396799.63,7943908.64
18708,2002-07-10,920.47,-32.36,-3.4,1527.46,-39.74,True,1,11962,-920.47,-3453811.46,11010662.14,7556850.68
18709,2002-07-11,927.37,6.9,0.75,1527.46,-39.29,True,1,11963,-927.37,-3454738.83,11094127.31,7639388.48
18710,2002-07-12,921.39,-5.98,-0.64,1527.46,-39.68,True,1,11964,-921.39,-3455660.22,11023509.96,7567849.74
18711,2002-07-15,917.93,-3.46,-0.38,1527.46,-39.9,True,1,11965,-917.93,-3456578.15,10983032.45,7526454.3
18712,2002-07-16,900.94,-16.99,-1.85,1527.46,-41.02,True,1,11966,-900.94,-3457479.09,10780648.04,7323168.95
18713,2002-07-17,906.04,5.1,0.57,1527.46,-40.68,True,1,11967,-906.04,-3458385.13,10842580.68,7384195.55
18714,2002-07-18,881.56,-24.48,-2.7,1527.46,-42.29,True,1,11968,-881.56,-3459266.69,10550510.08,7091243.39
18715,2002-07-19,847.75,-33.81,-3.84,1527.46,-44.5,True,1,11969,-847.75,-3460114.44,10146719.75,6686605.31
18716,2002-07-22,819.85,-27.9,-3.29,1527.46,-46.33,True,1,11970,-819.85,-3460934.29,9813604.5,6352670.21
18717,2002-07-23,797.7,-22.15,-2.7,1527.46,-47.78,True,1,11971,-797.7,-3461731.99,9549266.7,6087534.71
18718,2002-07-24,843.43,45.73,5.73,1527.46,-44.78,True,1,11972,-843.43,-3462575.42,10097543.96,6634968.54
18719,2002-07-25,838.68,-4.75,-0.56,1527.46,-45.09,True,1,11973,-838.68,-3463414.1,10041515.64,6578101.54
18720,2002-07-26,852.84,14.16,1.69,1527.46,-44.17,True,1,11974,-852.84,-3464266.94,10211906.16,6747639.22
18721,2002-07-29,898.96,46.12,5.41,1527.46,-41.15,True,1,11975,-898.96,-3465165.9,10765046.0,7299880.1
18722,2002-07-30,902.78,3.82,0.42,1527.46,-40.9,True,1,11976,-902.78,-3466068.68,10811693.28,7345624.6
18723,2002-07-31,911.62,8.84,0.98,1527.46,-40.32,True,1,11977,-911.62,-3466980.3,10918472.74,7451492.44
18724,2002-08-01,884.66,-26.96,-2.96,1527.46,-42.08,True,1,11978,-884.66,-3467864.96,10596457.48,7128592.52
18725,2002-08-02,864.24,-20.42,-2.31,1527.46,-43.42,True,1,11979,-864.24,-3468729.2,10352730.96,6884001.76
18726,2002-08-05,834.6,-29.64,-3.43,1527.46,-45.36,True,1,11980,-834.6,-3469563.8,9998508.0,6528944.2
18727,2002-08-06,859.57,24.97,2.99,1527.46,-43.73,True,1,11981,-859.57,-3470423.37,10298508.17,6828084.8
18728,2002-08-07,876.77,17.2,2.0,1527.46,-42.6,True,1,11982,-876.77,-3471300.14,10505458.14,7034158.0
18729,2002-08-08,905.46,28.69,3.27,1527.46,-40.72,True,1,11983,-905.46,-3472205.6,10850127.18,7377921.58
18730,2002-08-09,908.64,3.18,0.35,1527.46,-40.51,True,1,11984,-908.64,-3473114.24,10889141.76,7416027.52
18731,2002-08-12,903.8,-4.84,-0.53,1527.46,-40.83,True,1,11985,-903.8,-3474018.04,10832043.0,7358024.96
18732,2002-08-13,884.21,-19.59,-2.17,1527.46,-42.11,True,1,11986,-884.21,-3474902.25,10598141.06,7123238.81
18733,2002-08-14,919.62,35.41,4.0,1527.46,-39.79,True,1,11987,-919.62,-3475821.87,11023484.94,7547663.07
18734,2002-08-15,930.25,10.63,1.16,1527.46,-39.1,True,1,11988,-930.25,-3476752.12,11151837.0,7675084.88
18735,2002-08-16,928.77,-1.48,-0.16,1527.46,-39.2,True,1,11989,-928.77,-3477680.89,11135023.53,7657342.64
18736,2002-08-19,950.7,21.93,2.36,1527.46,-37.76,True,1,11990,-950.7,-3478631.59,11398893.0,7920261.41
18737,2002-08-20,937.43,-13.27,-1.4,1527.46,-38.63,True,1,11991,-937.43,-3479569.02,11240723.13,7761154.11
18738,2002-08-21,949.36,11.93,1.27,1527.46,-37.85,True,1,11992,-949.36,-3480518.38,11384725.12,7904206.74
18739,2002-08-22,962.7,13.34,1.4,1527.46,-36.97,True,1,11993,-962.7,-3481481.08,11545661.1,8064180.02
18740,2002-08-23,940.86,-21.84,-2.27,1527.46,-38.4,True,1,11994,-940.86,-3482421.94,11284674.84,7802252.9
18741,2002-08-26,947.95,7.09,0.75,1527.46,-37.94,True,1,11995,-947.95,-3483369.89,11370660.25,7887290.36
18742,2002-08-27,934.82,-13.13,-1.38,1527.46,-38.8,True,1,11996,-934.82,-3484304.71,11214100.72,7729796.01
18743,2002-08-28,917.87,-16.95,-1.81,1527.46,-39.91,True,1,11997,-917.87,-3485222.58,11011686.39,7526463.81
18744,2002-08-29,917.8,-0.07,-0.01,1527.46,-39.91,True,1,11998,-917.8,-3486140.38,11011764.4,7525624.02
18745,2002-08-30,916.07,-1.73,-0.19,1527.46,-40.03,True,1,11999,-916.07,-3487056.45,10991923.93,7504867.48
18746,2002-09-03,878.02,-38.05,-4.15,1527.46,-42.52,True,1,12000,-878.02,-3487934.47,10536240.0,7048305.53
18747,2002-09-04,893.4,15.38,1.75,1527.46,-41.51,True,1,12001,-893.4,-3488827.87,10721693.4,7232865.53
18748,2002-09-05,879.15,-14.25,-1.6,1527.46,-42.44,True,1,12002,-879.15,-3489707.02,10551558.3,7061851.28
18749,2002-09-06,893.92,14.77,1.68,1527.46,-41.48,True,1,12003,-893.92,-3490600.94,10729721.76,7239120.82
18750,2002-09-09,902.96,9.04,1.01,1527.46,-40.88,True,1,12004,-902.96,-3491503.9,10839131.84,7347627.94
18751,2002-09-10,909.58,6.62,0.73,1527.46,-40.45,True,1,12005,-909.58,-3492413.48,10919507.9,7427094.42
18752,2002-09-11,909.45,-0.13,-0.01,1527.46,-40.46,True,1,12006,-909.45,-3493322.93,10918856.7,7425533.77
18753,2002-09-12,886.91,-22.54,-2.48,1527.46,-41.94,True,1,12007,-886.91,-3494209.84,10649128.37,7154918.53
18754,2002-09-13,889.81,2.9,0.33,1527.46,-41.75,True,1,12008,-889.81,-3495099.65,10684838.48,7189738.83
18755,2002-09-16,891.1,1.29,0.14,1527.46,-41.66,True,1,12009,-891.1,-3495990.75,10701219.9,7205229.15
18756,2002-09-17,873.52,-17.58,-1.97,1527.46,-42.81,True,1,12010,-873.52,-3496864.27,10490975.2,6994110.93
18757,2002-09-18,869.46,-4.06,-0.46,1527.46,-43.08,True,1,12011,-869.46,-3497733.73,10443084.06,6945350.33
18758,2002-09-19,843.32,-26.14,-3.01,1527.46,-44.79,True,1,12012,-843.32,-3498577.05,10129959.84,6631382.79
18759,2002-09-20,845.39,2.07,0.24,1527.46,-44.65,True,1,12013,-845.39,-3499422.44,10155670.07,6656247.63
18760,2002-09-23,833.7,-11.69,-1.38,1527.46,-45.42,True,1,12014,-833.7,-3500256.14,10016071.8,6515815.66
18761,2002-09-24,819.29,-14.41,-1.73,1527.46,-46.36,True,1,12015,-819.29,-3501075.43,9843769.35,6342693.92
18762,2002-09-25,839.66,20.37,2.49,1527.46,-45.03,True,1,12016,-839.66,-3501915.09,10089354.56,6587439.47
18763,2002-09-26,854.95,15.29,1.82,1527.46,-44.03,True,1,12017,-854.95,-3502770.04,10273934.15,6771164.11
18764,2002-09-27,827.37,-27.58,-3.23,1527.46,-45.83,True,1,12018,-827.37,-3503597.41,9943332.66,6439735.25
18765,2002-09-30,815.28,-12.09,-1.46,1527.46,-46.62,True,1,12019,-815.28,-3504412.69,9798850.32,6294437.63
18766,2002-10-01,847.91,32.63,4.0,1527.46,-44.49,True,1,12020,-847.91,-3505260.6,10191878.2,6686617.6
18767,2002-10-02,827.91,-20.0,-2.36,1527.46,-45.8,True,1,12021,-827.91,-3506088.51,9952306.11,6446217.6
18768,2002-10-03,818.95,-8.96,-1.08,1527.46,-46.38,True,1,12022,-818.95,-3506907.46,9845416.9,6338509.44
18769,2002-10-04,800.58,-18.37,-2.24,1527.46,-47.59,True,1,12023,-800.58,-3507708.04,9625373.34,6117665.3
18770,2002-10-07,785.28,-15.3,-1.91,1527.46,-48.59,True,1,12024,-785.28,-3508493.32,9442206.72,5933713.4
18771,2002-10-08,798.55,13.27,1.69,1527.46,-47.72,True,1,12025,-798.55,-3509291.87,9602563.75,6093271.88
18772,2002-10-09,776.76,-21.79,-2.73,1527.46,-49.15,True,1,12026,-776.76,-3510068.63,9341315.76,5831247.13
18773,2002-10-10,803.92,27.16,3.5,1527.46,-47.37,True,1,12027,-803.92,-3510872.55,9668745.84,6157873.29
18774,2002-10-11,835.32,31.4,3.91,1527.46,-45.31,True,1,12028,-835.32,-3511707.87,10047228.96,6535521.09
18775,2002-10-14,841.44,6.12,0.73,1527.46,-44.91,True,1,12029,-841.44,-3512549.31,10121681.76,6609132.45
18776,2002-10-15,881.27,39.83,4.73,1527.46,-42.3,True,1,12030,-881.27,-3513430.58,10601678.1,7088247.52
18777,2002-10-16,860.02,-21.25,-2.41,1527.46,-43.7,True,1,12031,-860.02,-3514290.6,10346900.62,6832610.02
18778,2002-10-17,879.2,19.18,2.23,1527.46,-42.44,True,1,12032,-879.2,-3515169.8,10578534.4,7063364.6
18779,2002-10-18,884.39,5.19,0.59,1527.46,-42.1,True,1,12033,-884.39,-3516054.19,10641864.87,7125810.68
18780,2002-10-21,899.72,15.33,1.73,1527.46,-41.1,True,1,12034,-899.72,-3516953.91,10827230.48,7310276.57
18781,2002-10-22,890.16,-9.56,-1.06,1527.46,-41.72,True,1,12035,-890.16,-3517844.07,10713075.6,7195231.53
18782,2002-10-23,896.14,5.98,0.67,1527.46,-41.33,True,1,12036,-896.14,-3518740.21,10785941.04,7267200.83
18783,2002-10-24,882.5,-13.64,-1.52,1527.46,-42.22,True,1,12037,-882.5,-3519622.71,10622652.5,7103029.79
18784,2002-10-25,897.65,15.15,1.72,1527.46,-41.23,True,1,12038,-897.65,-3520520.36,10805910.7,7285390.34
18785,2002-10-28,890.23,-7.42,-0.83,1527.46,-41.72,True,1,12039,-890.23,-3521410.59,10717478.97,7196068.38
18786,2002-10-29,882.15,-8.08,-0.91,1527.46,-42.25,True,1,12040,-882.15,-3522292.74,10621086.0,7098793.26
18787,2002-10-30,890.71,8.56,0.97,1527.46,-41.69,True,1,12041,-890.71,-3523183.45,10725039.11,7201855.66
18788,2002-10-31,885.76,-4.95,-0.56,1527.46,-42.01,True,1,12042,-885.76,-3524069.21,10666321.92,7142252.71
18789,2002-11-01,900.96,15.2,1.72,1527.46,-41.02,True,1,12043,-900.96,-3524970.17,10850261.28,7325291.11
18790,2002-11-04,908.35,7.39,0.82,1527.46,-40.53,True,1,12044,-908.35,-3525878.52,10940167.4,7414288.88
18791,2002-11-05,915.39,7.04,0.78,1527.46,-40.07,True,1,12045,-915.39,-3526793.91,11025872.55,7499078.64
18792,2002-11-06,923.76,8.37,0.91,1527.46,-39.52,True,1,12046,-923.76,-3527717.67,11127612.96,7599895.29
18793,2002-11-07,902.65,-21.11,-2.28,1527.46,-40.9,True,1,12047,-902.65,-3528620.32,10874224.55,7345604.23
18794,2002-11-08,894.74,-7.91,-0.88,1527.46,-41.42,True,1,12048,-894.74,-3529515.06,10779827.52,7250312.46
18795,2002-11-11,876.19,-18.55,-2.07,1527.46,-42.64,True,1,12049,-876.19,-3530391.25,10557213.31,7026822.06
18796,2002-11-12,882.95,6.76,0.77,1527.46,-42.2,True,1,12050,-882.95,-3531274.2,10639547.5,7108273.3
18797,2002-11-13,882.53,-0.42,-0.05,1527.46,-42.22,True,1,12051,-882.53,-3532156.73,10635369.03,7103212.3
18798,2002-11-14,904.27,21.74,2.46,1527.46,-40.8,True,1,12052,-904.27,-3533061.0,10898262.04,7365201.04
18799,2002-11-15,909.83,5.56,0.62,1527.46,-40.44,True,1,12053,-909.83,-3533970.83,10966180.99,7432210.16
18800,2002-11-18,900.36,-9.47,-1.04,1527.46,-41.06,True,1,12054,-900.36,-3534871.19,10852939.44,7318068.25
18801,2002-11-19,896.74,-3.62,-0.4,1527.46,-41.29,True,1,12055,-896.74,-3535767.93,10810200.7,7274432.77
18802,2002-11-20,914.15,17.41,1.94,1527.46,-40.15,True,1,12056,-914.15,-3536682.08,11020992.4,7484310.32
18803,2002-11-21,933.76,19.61,2.14,1527.46,-38.87,True,1,12057,-933.76,-3537615.84,11258344.32,7720728.48
18804,2002-11-22,930.55,-3.21,-0.34,1527.46,-39.08,True,1,12058,-930.55,-3538546.39,11220571.9,7682025.51
18805,2002-11-25,932.87,2.32,0.25,1527.46,-38.93,True,1,12059,-932.87,-3539479.26,11249479.33,7710000.07
18806,2002-11-26,913.31,-19.56,-2.1,1527.46,-40.21,True,1,12060,-913.31,-3540392.57,11014518.6,7474126.03
18807,2002-11-27,938.87,25.56,2.8,1527.46,-38.53,True,1,12061,-938.87,-3541331.44,11323711.07,7782379.63
18808,2002-11-29,936.31,-2.56,-0.27,1527.46,-38.7,True,1,12062,-936.31,-3542267.75,11293771.22,7751503.47
18809,2002-12-02,934.53,-1.78,-0.19,1527.46,-38.82,True,1,12063,-934.53,-3543202.28,11273235.39,7730033.11
18810,2002-12-03,920.75,-13.78,-1.48,1527.46,-39.72,True,1,12064,-920.75,-3544123.03,11107928.0,7563804.97
18811,2002-12-04,917.58,-3.17,-0.34,1527.46,-39.93,True,1,12065,-917.58,-3545040.61,11070602.7,7525562.09
18812,2002-12-05,906.55,-11.03,-1.2,1527.46,-40.65,True,1,12066,-906.55,-3545947.16,10938432.3,7392485.14
18813,2002-12-06,912.23,5.68,0.63,1527.46,-40.28,True,1,12067,-912.23,-3546859.39,11007879.41,7461020.02
18814,2002-12-09,892.0,-20.23,-2.22,1527.46,-41.6,True,1,12068,-892.0,-3547751.39,10764656.0,7216904.61
18815,2002-12-10,904.45,12.45,1.4,1527.46,-40.79,True,1,12069,-904.45,-3548655.84,10915807.05,7367151.21
18816,2002-12-11,904.96,0.51,0.06,1527.46,-40.75,True,1,12070,-904.96,-3549560.8,10922867.2,7373306.4
18817,2002-12-12,901.58,-3.38,-0.37,1527.46,-40.98,True,1,12071,-901.58,-3550462.38,10882972.18,7332509.8
18818,2002-12-13,889.48,-12.1,-1.34,1527.46,-41.77,True,1,12072,-889.48,-3551351.86,10737802.56,7186450.7
18819,2002-12-16,910.4,20.92,2.35,1527.46,-40.4,True,1,12073,-910.4,-3552262.26,10991259.2,7438996.94
18820,2002-12-17,902.99,-7.41,-0.81,1527.46,-40.88,True,1,12074,-902.99,-3553165.25,10902701.26,7349536.01
18821,2002-12-18,891.12,-11.87,-1.32,1527.46,-41.66,True,1,12075,-891.12,-3554056.37,10760274.0,7206217.63
18822,2002-12-19,884.25,-6.87,-0.77,1527.46,-42.11,True,1,12076,-884.25,-3554940.62,10678203.0,7123262.38
18823,2002-12-20,895.76,11.51,1.3,1527.46,-41.36,True,1,12077,-895.76,-3555836.38,10818093.52,7262257.14
18824,2002-12-23,897.38,1.62,0.18,1527.46,-41.25,True,1,12078,-897.38,-3556733.76,10838555.64,7281821.88
18825,2002-12-24,892.47,-4.91,-0.55,1527.46,-41.57,True,1,12079,-892.47,-3557626.23,10780145.13,7222518.9
18826,2002-12-26,889.66,-2.81,-0.32,1527.46,-41.76,True,1,12080,-889.66,-3558515.89,10747092.8,7188576.91
18827,2002-12-27,875.4,-14.26,-1.6,1527.46,-42.69,True,1,12081,-875.4,-3559391.29,10575707.4,7016316.11
18828,2002-12-30,879.39,3.99,0.46,1527.46,-42.43,True,1,12082,-879.39,-3560270.68,10624789.98,7064519.3
18829,2002-12-31,879.82,0.43,0.05,1527.46,-42.4,True,1,12083,-879.82,-3561150.5,10630865.06,7069714.56
18830,2003-01-02,909.03,29.21,3.32,1527.46,-40.49,True,1,12084,-909.03,-3562059.53,10984718.52,7422658.99
18831,2003-01-03,908.59,-0.44,-0.05,1527.46,-40.52,True,1,12085,-908.59,-3562968.12,10980310.15,7417342.03
18832,2003-01-06,929.01,20.42,2.25,1527.46,-39.18,True,1,12086,-929.01,-3563897.13,11228014.86,7664117.73
18833,2003-01-07,922.93,-6.08,-0.65,1527.46,-39.58,True,1,12087,-922.93,-3564820.06,11155454.91,7590634.85
18834,2003-01-08,909.93,-13.0,-1.41,1527.46,-40.43,True,1,12088,-909.93,-3565729.99,10999233.84,7433503.85
18835,2003-01-09,927.57,17.64,1.94,1527.46,-39.27,True,1,12089,-927.57,-3566657.56,11213393.73,7646736.17
18836,2003-01-10,927.57,0.0,0.0,1527.46,-39.27,True,1,12090,-927.57,-3567585.13,11214321.3,7646736.17
18837,2003-01-13,926.26,-1.31,-0.14,1527.46,-39.36,True,1,12091,-926.26,-3568511.39,11199409.66,7630898.27
18838,2003-01-14,931.66,5.4,0.58,1527.46,-39.01,True,1,12092,-931.66,-3569443.05,11265632.72,7696189.67
18839,2003-01-15,918.22,-13.44,-1.44,1527.46,-39.89,True,1,12093,-918.22,-3570361.27,11104034.46,7533673.19
18840,2003-01-16,914.6,-3.62,-0.39,1527.46,-40.12,True,1,12094,-914.6,-3571275.87,11061172.4,7489896.53
18841,2003-01-17,901.78,-12.82,-1.4,1527.46,-40.96,True,1,12095,-901.78,-3572177.65,10907029.1,7334851.45
18842,2003-01-21,887.62,-14.16,-1.57,1527.46,-41.89,True,1,12096,-887.62,-3573065.27,10736651.52,7163586.25
18843,2003-01-22,878.36,-9.26,-1.04,1527.46,-42.5,True,1,12097,-878.36,-3573943.63,10625520.92,7051577.29
18844,2003-01-23,887.34,8.98,1.02,1527.46,-41.91,True,1,12098,-887.34,-3574830.97,10735039.32,7160208.35
18845,2003-01-24,861.4,-25.94,-2.92,1527.46,-43.61,True,1,12099,-861.4,-3575692.37,10422078.6,6846386.23
18846,2003-01-27,847.48,-13.92,-1.62,1527.46,-44.52,True,1,12100,-847.48,-3576539.85,10254508.0,6677968.15
18847,2003-01-28,858.54,11.06,1.3,1527.46,-43.79,True,1,12101,-858.54,-3577398.39,10389192.54,6811794.15
18848,2003-01-29,864.36,5.82,0.68,1527.46,-43.41,True,1,12102,-864.36,-3578262.75,10460484.72,6882221.97
18849,2003-01-30,844.61,-19.75,-2.28,1527.46,-44.7,True,1,12103,-844.61,-3579107.36,10222314.83,6643207.47
18850,2003-01-31,855.7,11.09,1.31,1527.46,-43.98,True,1,12104,-855.7,-3579963.06,10357392.8,6777429.74
18851,2003-02-03,860.32,4.62,0.54,1527.46,-43.68,True,1,12105,-860.32,-3580823.38,10414173.6,6833350.22
18852,2003-02-04,848.2,-12.12,-1.41,1527.46,-44.47,True,1,12106,-848.2,-3581671.58,10268309.2,6686637.62
18853,2003-02-05,843.59,-4.61,-0.54,1527.46,-44.77,True,1,12107,-843.59,-3582515.17,10213344.13,6630828.96
18854,2003-02-06,838.15,-5.44,-0.64,1527.46,-45.13,True,1,12108,-838.15,-3583353.32,10148320.2,6564966.88
18855,2003-02-07,829.69,-8.46,-1.01,1527.46,-45.68,True,1,12109,-829.69,-3584183.01,10046716.21,6462533.2
18856,2003-02-10,835.97,6.28,0.76,1527.46,-45.27,True,1,12110,-835.97,-3585018.98,10123596.7,6538577.72
18857,2003-02-11,829.2,-6.77,-0.81,1527.46,-45.71,True,1,12111,-829.2,-3585848.18,10042441.2,6456593.02
18858,2003-02-12,818.68,-10.52,-1.27,1527.46,-46.4,True,1,12112,-818.68,-3586666.86,9915852.16,6329185.3
18859,2003-02-13,817.37,-1.31,-0.16,1527.46,-46.49,True,1,12113,-817.37,-3587484.23,9900802.81,6313318.58
18860,2003-02-14,834.89,17.52,2.14,1527.46,-45.34,True,1,12114,-834.89,-3588319.12,10113857.46,6525538.34
18861,2003-02-18,851.17,16.28,1.95,1527.46,-44.28,True,1,12115,-851.17,-3589170.29,10311924.55,6722754.26
18862,2003-02-19,845.13,-6.04,-0.71,1527.46,-44.67,True,1,12116,-845.13,-3590015.42,10239595.08,6649579.66
18863,2003-02-20,837.1,-8.03,-0.95,1527.46,-45.2,True,1,12117,-837.1,-3590852.52,10143140.7,6552288.18
18864,2003-02-21,848.17,11.07,1.32,1527.46,-44.47,True,1,12118,-848.17,-3591700.69,10278124.06,6686423.37
18865,2003-02-24,832.58,-15.59,-1.84,1527.46,-45.49,True,1,12119,-832.58,-3592533.27,10090037.02,6497503.75
18866,2003-02-25,838.57,5.99,0.72,1527.46,-45.1,True,1,12120,-838.57,-3593371.84,10163468.4,6570096.56
18867,2003-02-26,827.55,-11.02,-1.31,1527.46,-45.82,True,1,12121,-827.55,-3594199.39,10030733.55,6436534.16
18868,2003-02-27,837.28,9.73,1.18,1527.46,-45.18,True,1,12122,-837.28,-3595036.67,10149508.16,6554471.49
18869,2003-02-28,841.15,3.87,0.46,1527.46,-44.93,True,1,12123,-841.15,-3595877.82,10197261.45,6601383.63
18870,2003-03-03,834.81,-6.34,-0.75,1527.46,-45.35,True,1,12124,-834.81,-3596712.63,10121236.44,6524523.81
18871,2003-03-04,821.99,-12.82,-1.54,1527.46,-46.19,True,1,12125,-821.99,-3597534.62,9966628.75,6369094.13
18872,2003-03-05,829.85,7.86,0.96,1527.46,-45.67,True,1,12126,-829.85,-3598364.47,10062761.1,6464396.63
18873,2003-03-06,822.1,-7.75,-0.93,1527.46,-46.18,True,1,12127,-822.1,-3599186.57,9969606.7,6370420.13
18874,2003-03-07,828.89,6.79,0.83,1527.46,-45.73,True,1,12128,-828.89,-3600015.46,10052777.92,6452762.46
18875,2003-03-10,807.48,-21.41,-2.58,1527.46,-47.14,True,1,12129,-807.48,-3600822.94,9793924.92,6193101.98
18876,2003-03-11,800.73,-6.75,-0.84,1527.46,-47.58,True,1,12130,-800.73,-3601623.67,9712854.9,6111231.23
18877,2003-03-12,804.19,3.46,0.43,1527.46,-47.35,True,1,12131,-804.19,-3602427.86,9755628.89,6153201.03
18878,2003-03-13,831.9,27.71,3.45,1527.46,-45.54,True,1,12132,-831.9,-3603259.76,10092610.8,6489351.04
18879,2003-03-14,833.27,1.37,0.16,1527.46,-45.45,True,1,12133,-833.27,-3604093.03,10110064.91,6505971.88
18880,2003-03-17,862.79,29.52,3.54,1527.46,-43.52,True,1,12134,-862.79,-3604955.82,10469093.86,6864138.04
18881,2003-03-18,866.45,3.66,0.42,1527.46,-43.28,True,1,12135,-866.45,-3605822.27,10514370.75,6908548.48
18882,2003-03-19,874.02,7.57,0.87,1527.46,-42.78,True,1,12136,-874.02,-3606696.29,10607106.72,7000410.43
18883,2003-03-20,875.67,1.65,0.19,1527.46,-42.67,True,1,12137,-875.67,-3607571.96,10628006.79,7020434.83
18884,2003-03-21,895.79,20.12,2.3,1527.46,-41.35,True,1,12138,-895.79,-3608467.75,10873099.02,7264631.27
18885,2003-03-24,864.23,-31.56,-3.52,1527.46,-43.42,True,1,12139,-864.23,-3609331.98,10490887.97,6881555.99
18886,2003-03-25,874.74,10.51,1.22,1527.46,-42.73,True,1,12140,-874.74,-3610206.72,10619343.6,7009136.88
18887,2003-03-26,869.95,-4.79,-0.55,1527.46,-43.05,True,1,12141,-869.95,-3611076.67,10562062.95,6950986.28
18888,2003-03-27,868.52,-1.43,-0.16,1527.46,-43.14,True,1,12142,-868.52,-3611945.19,10545569.84,6933624.65
18889,2003-03-28,863.5,-5.02,-0.58,1527.46,-43.47,True,1,12143,-863.5,-3612808.69,10485480.5,6872671.81
18890,2003-03-31,848.18,-15.32,-1.77,1527.46,-44.47,True,1,12144,-848.18,-3613656.87,10300297.92,6686641.05
18891,2003-04-01,858.48,10.3,1.21,1527.46,-43.8,True,1,12145,-858.48,-3614515.35,10426239.6,6811724.25
18892,2003-04-02,880.9,22.42,2.61,1527.46,-42.33,True,1,12146,-880.9,-3615396.25,10699411.4,7084015.15
18893,2003-04-03,876.45,-4.45,-0.5,1527.46,-42.62,True,1,12147,-876.45,-3616272.7,10646238.15,7029965.45
18894,2003-04-04,878.85,2.4,0.27,1527.46,-42.46,True,1,12148,-878.85,-3617151.55,10676269.8,7059118.25
18895,2003-04-07,879.93,1.08,0.12,1527.46,-42.39,True,1,12149,-879.93,-3618031.48,10690269.57,7072238.09
18896,2003-04-08,878.29,-1.64,-0.19,1527.46,-42.5,True,1,12150,-878.29,-3618909.77,10671223.5,7052313.73
18897,2003-04-09,865.99,-12.3,-1.4,1527.46,-43.3,True,1,12151,-865.99,-3619775.76,10522644.49,6902868.73
18898,2003-04-10,871.58,5.59,0.65,1527.46,-42.94,True,1,12152,-871.58,-3620647.34,10591440.16,6970792.82
18899,2003-04-11,868.3,-3.28,-0.38,1527.46,-43.15,True,1,12153,-868.3,-3621515.64,10552449.9,6930934.26
18900,2003-04-14,885.23,16.93,1.95,1527.46,-42.05,True,1,12154,-885.23,-3622400.87,10759085.42,7136684.55
18901,2003-04-15,890.81,5.58,0.63,1527.46,-41.68,True,1,12155,-890.81,-3623291.68,10827795.55,7204503.87
18902,2003-04-16,879.91,-10.9,-1.22,1527.46,-42.39,True,1,12156,-879.91,-3624171.59,10696185.96,7072014.37
18903,2003-04-17,893.58,13.67,1.55,1527.46,-41.5,True,1,12157,-893.58,-3625065.17,10863252.06,7238186.89
18904,2003-04-21,892.01,-1.57,-0.18,1527.46,-41.6,True,1,12158,-892.01,-3625957.18,10845057.58,7219100.4
18905,2003-04-22,911.37,19.36,2.17,1527.46,-40.33,True,1,12159,-911.37,-3626868.55,11081347.83,7454479.28
18906,2003-04-23,919.02,7.65,0.84,1527.46,-39.83,True,1,12160,-919.02,-3627787.57,11175283.2,7547495.63
18907,2003-04-24,911.43,-7.59,-0.83,1527.46,-40.33,True,1,12161,-911.43,-3628699.0,11083900.23,7455201.23
18908,2003-04-25,898.81,-12.62,-1.38,1527.46,-41.16,True,1,12162,-898.81,-3629597.81,10931327.22,7301729.41
18909,2003-04-28,914.84,16.03,1.78,1527.46,-40.11,True,1,12163,-914.84,-3630512.65,11127198.92,7496686.27
18910,2003-04-29,917.84,3.0,0.33,1527.46,-39.91,True,1,12164,-917.84,-3631430.49,11164605.76,7533175.27
18911,2003-04-30,916.92,-0.92,-0.1,1527.46,-39.97,True,1,12165,-916.92,-3632347.41,11154331.8,7521984.39
18912,2003-05-01,916.3,-0.62,-0.07,1527.46,-40.01,True,1,12166,-916.3,-3633263.71,11147705.8,7514442.09
18913,2003-05-02,930.08,13.78,1.5,1527.46,-39.11,True,1,12167,-930.08,-3634193.79,11316283.36,7682089.57
18914,2003-05-05,926.55,-3.53,-0.38,1527.46,-39.34,True,1,12168,-926.55,-3635120.34,11274260.4,7639140.06
18915,2003-05-06,934.39,7.84,0.85,1527.46,-38.83,True,1,12169,-934.39,-3636054.73,11370591.91,7734537.18
18916,2003-05-07,929.62,-4.77,-0.51,1527.46,-39.14,True,1,12170,-929.62,-3636984.35,11313475.4,7676491.05
18917,2003-05-08,920.27,-9.35,-1.01,1527.46,-39.75,True,1,12171,-920.27,-3637904.62,11200606.17,7562701.55
18918,2003-05-09,933.41,13.14,1.43,1527.46,-38.89,True,1,12172,-933.41,-3638838.03,11361466.52,7722628.49
18919,2003-05-12,945.11,11.7,1.25,1527.46,-38.12,True,1,12173,-945.11,-3639783.14,11504824.03,7865040.89
18920,2003-05-13,942.3,-2.81,-0.3,1527.46,-38.31,True,1,12174,-942.3,-3640725.44,11471560.2,7830834.76
18921,2003-05-14,939.28,-3.02,-0.32,1527.46,-38.51,True,1,12175,-939.28,-3641664.72,11435734.0,7794069.28
18922,2003-05-15,946.67,7.39,0.79,1527.46,-38.02,True,1,12176,-946.67,-3642611.39,11526653.92,7884042.53
18923,2003-05-16,944.3,-2.37,-0.25,1527.46,-38.18,True,1,12177,-944.3,-3643555.69,11498741.1,7855185.41
18924,2003-05-19,920.77,-23.53,-2.49,1527.46,-39.72,True,1,12178,-920.77,-3644476.46,11213137.06,7568660.6
18925,2003-05-20,919.73,-1.04,-0.11,1527.46,-39.79,True,1,12179,-919.73,-3645396.19,11201391.67,7555995.48
18926,2003-05-21,923.42,3.69,0.4,1527.46,-39.54,True,1,12180,-923.42,-3646319.61,11247255.6,7600935.99
18927,2003-05-22,931.87,8.45,0.92,1527.46,-38.99,True,1,12181,-931.87,-3647251.48,11351108.47,7703856.99
18928,2003-05-23,933.22,1.35,0.14,1527.46,-38.9,True,1,12182,-933.22,-3648184.7,11368486.04,7720301.34
18929,2003-05-27,951.48,18.26,1.96,1527.46,-37.71,True,1,12183,-951.48,-3649136.18,11591880.84,7942744.66
18930,2003-05-28,953.22,1.74,0.18,1527.46,-37.59,True,1,12184,-953.22,-3650089.4,11614032.48,7963943.08
18931,2003-05-29,949.64,-3.58,-0.38,1527.46,-37.83,True,1,12185,-949.64,-3651039.04,11571363.4,7920324.36
18932,2003-05-30,963.59,13.95,1.47,1527.46,-36.92,True,1,12186,-963.59,-3652002.63,11742307.74,8090305.11
18933,2003-06-02,967.0,3.41,0.35,1527.46,-36.69,True,1,12187,-967.0,-3652969.63,11784829.0,8131859.37
18934,2003-06-03,971.56,4.56,0.47,1527.46,-36.39,True,1,12188,-971.56,-3653941.19,11841373.28,8187432.09
18935,2003-06-04,986.24,14.68,1.51,1527.46,-35.43,True,1,12189,-986.24,-3654927.43,12021279.36,8366351.93
18936,2003-06-05,990.14,3.9,0.4,1527.46,-35.18,True,1,12190,-990.14,-3655917.57,12069806.6,8413889.03
18937,2003-06-06,987.76,-2.38,-0.24,1527.46,-35.33,True,1,12191,-987.76,-3656905.33,12041782.16,8384876.83
18938,2003-06-09,975.93,-11.83,-1.2,1527.46,-36.11,True,1,12192,-975.93,-3657881.26,11898538.56,8240657.3
18939,2003-06-10,984.84,8.91,0.91,1527.46,-35.52,True,1,12193,-984.84,-3658866.1,12008154.12,8349288.02
18940,2003-06-11,997.48,12.64,1.28,1527.46,-34.7,True,1,12194,-997.48,-3659863.58,12163271.12,8503407.54
18941,2003-06-12,998.51,1.03,0.1,1527.46,-34.63,True,1,12195,-998.51,-3660862.09,12176829.45,8515967.36
18942,2003-06-13,988.61,-9.9,-0.99,1527.46,-35.28,True,1,12196,-988.61,-3661850.7,12057087.56,8395236.86
18943,2003-06-16,1010.74,22.13,2.24,1527.46,-33.83,True,1,12197,-1010.74,-3662861.44,12327995.78,8665134.34
18944,2003-06-17,1011.66,0.92,0.09,1527.46,-33.77,True,1,12198,-1011.66,-3663873.1,12340228.68,8676355.58
18945,2003-06-18,1010.09,-1.57,-0.16,1527.46,-33.87,True,1,12199,-1010.09,-3664883.19,12322087.91,8657204.72
18946,2003-06-19,994.7,-15.39,-1.52,1527.46,-34.88,True,1,12200,-994.7,-3665877.89,12135340.0,8469462.11
18947,2003-06-20,995.69,0.99,0.1,1527.46,-34.81,True,1,12201,-995.69,-3666873.58,12148413.69,8481540.11
18948,2003-06-23,981.64,-14.05,-1.41,1527.46,-35.73,True,1,12202,-981.64,-3667855.22,11977971.28,8310116.06
18949,2003-06-24,983.45,1.81,0.18,1527.46,-35.62,True,1,12203,-983.45,-3668838.67,12001040.35,8332201.68
18950,2003-06-25,975.32,-8.13,-0.83,1527.46,-36.15,True,1,12204,-975.32,-3669813.99,11902805.28,8232991.29
18951,2003-06-26,985.82,10.5,1.08,1527.46,-35.46,True,1,12205,-985.82,-3670799.81,12031933.1,8361133.29
18952,2003-06-27,976.22,-9.6,-0.97,1527.46,-36.09,True,1,12206,-976.22,-3671776.03,11915741.32,8243965.29
18953,2003-06-30,974.5,-1.72,-0.18,1527.46,-36.2,True,1,12207,-974.5,-3672750.53,11895721.5,8222970.97
18954,2003-07-01,982.32,7.82,0.8,1527.46,-35.69,True,1,12208,-982.32,-3673732.85,11992162.56,8318429.71
18955,2003-07-02,993.75,11.43,1.16,1527.46,-34.94,True,1,12209,-993.75,-3674726.6,12132693.75,8457967.15
18956,2003-07-03,985.7,-8.05,-0.81,1527.46,-35.47,True,1,12210,-985.7,-3675712.3,12035397.0,8359684.7
18957,2003-07-07,1004.42,18.72,1.9,1527.46,-34.24,True,1,12211,-1004.42,-3676716.72,12264972.62,8588255.9
18958,2003-07-08,1007.84,3.42,0.34,1527.46,-34.02,True,1,12212,-1007.84,-3677724.56,12307742.08,8630017.52
18959,2003-07-09,1002.21,-5.63,-0.56,1527.46,-34.39,True,1,12213,-1002.21,-3678726.77,12239990.73,8561263.96
18960,2003-07-10,988.7,-13.51,-1.35,1527.46,-35.27,True,1,12214,-988.7,-3679715.47,12075981.8,8396266.33
18961,2003-07-11,998.14,9.44,0.96,1527.46,-34.65,True,1,12215,-998.14,-3680713.61,12192280.1,8511566.49
18962,2003-07-14,1003.86,5.72,0.57,1527.46,-34.28,True,1,12216,-1003.86,-3681717.47,12263153.76,8581436.29
18963,2003-07-15,1000.42,-3.44,-0.34,1527.46,-34.5,True,1,12217,-1000.42,-3682717.89,12222131.14,8539413.25
18964,2003-07-16,994.09,-6.33,-0.63,1527.46,-34.92,True,1,12218,-994.09,-3683711.98,12145791.62,8462079.64
18965,2003-07-17,981.73,-12.36,-1.24,1527.46,-35.73,True,1,12219,-981.73,-3684693.71,11995758.87,8311065.16
18966,2003-07-18,993.32,11.59,1.18,1527.46,-34.97,True,1,12220,-993.32,-3685687.03,12138370.4,8452683.37
18967,2003-07-21,978.8,-14.52,-1.46,1527.46,-35.92,True,1,12221,-978.8,-3686665.83,11961914.8,8275248.97
18968,2003-07-22,988.11,9.31,0.95,1527.46,-35.31,True,1,12222,-988.11,-3687653.94,12076680.42,8389026.48
18969,2003-07-23,988.61,0.5,0.05,1527.46,-35.28,True,1,12223,-988.61,-3688642.55,12083780.03,8395137.48
18970,2003-07-24,981.6,-7.01,-0.71,1527.46,-35.74,True,1,12224,-981.6,-3689624.15,11999078.4,8309454.25
18971,2003-07-25,998.68,17.08,1.74,1527.46,-34.62,True,1,12225,-998.68,-3690622.83,12208863.0,8518240.17
18972,2003-07-28,996.52,-2.16,-0.22,1527.46,-34.76,True,1,12226,-996.52,-3691619.35,12183453.52,8491834.17
18973,2003-07-29,989.28,-7.24,-0.73,1527.46,-35.23,True,1,12227,-989.28,-3692608.63,12095926.56,8403317.93
18974,2003-07-30,987.49,-1.79,-0.18,1527.46,-35.35,True,1,12228,-987.49,-3693596.12,12075027.72,8381431.6
18975,2003-07-31,990.31,2.82,0.29,1527.46,-35.17,True,1,12229,-990.31,-3694586.43,12110500.99,8415914.56
18976,2003-08-01,980.15,-10.16,-1.03,1527.46,-35.83,True,1,12230,-980.15,-3695566.58,11987234.5,8291667.92
18977,2003-08-04,982.82,2.67,0.27,1527.46,-35.66,True,1,12231,-982.82,-3696549.4,12020871.42,8324322.02
18978,2003-08-05,965.46,-17.36,-1.77,1527.46,-36.79,True,1,12232,-965.46,-3697514.86,11809506.72,8111991.86
18979,2003-08-06,967.08,1.62,0.17,1527.46,-36.69,True,1,12233,-967.08,-3698481.94,11830289.64,8131807.7
18980,2003-08-07,974.12,7.04,0.73,1527.46,-36.23,True,1,12234,-974.12,-3699456.06,11917384.08,8217928.02
18981,2003-08-08,977.59,3.47,0.36,1527.46,-36.0,True,1,12235,-977.59,-3700433.65,11960813.65,8260380.0
18982,2003-08-11,980.59,3.0,0.31,1527.46,-35.8,True,1,12236,-980.59,-3701414.24,11998499.24,8297085.0
18983,2003-08-12,990.35,9.76,1.0,1527.46,-35.16,True,1,12237,-990.35,-3702404.59,12118912.95,8416508.36
18984,2003-08-13,984.03,-6.32,-0.64,1527.46,-35.58,True,1,12238,-984.03,-3703388.62,12042559.14,8339170.52
18985,2003-08-14,990.51,6.48,0.66,1527.46,-35.15,True,1,12239,-990.51,-3704379.13,12122851.89,8418472.76
18986,2003-08-15,990.67,0.16,0.02,1527.46,-35.14,True,1,12240,-990.67,-3705369.8,12125800.8,8420431.0
18987,2003-08-18,999.74,9.07,0.92,1527.46,-34.55,True,1,12241,-999.74,-3706369.54,12237817.34,8531447.8
18988,2003-08-19,1002.35,2.61,0.26,1527.46,-34.38,True,1,12242,-1002.35,-3707371.89,12270768.7,8563396.81
18989,2003-08-20,1000.3,-2.05,-0.2,1527.46,-34.51,True,1,12243,-1000.3,-3708372.19,12246672.9,8538300.71
18990,2003-08-21,1003.27,2.97,0.3,1527.46,-34.32,True,1,12244,-1003.27,-3709375.46,12284037.88,8574662.42
18991,2003-08-22,993.06,-10.21,-1.02,1527.46,-34.99,True,1,12245,-993.06,-3710368.52,12160019.7,8449651.18
18992,2003-08-25,993.71,0.65,0.06,1527.46,-34.94,True,1,12246,-993.71,-3711362.23,12168972.66,8457610.43
18993,2003-08-26,996.73,3.02,0.3,1527.46,-34.75,True,1,12247,-996.73,-3712358.96,12206952.31,8494593.35
18994,2003-08-27,996.79,0.06,0.01,1527.46,-34.74,True,1,12248,-996.79,-3713355.75,12208683.92,8495328.17
18995,2003-08-28,1002.84,6.05,0.61,1527.46,-34.35,True,1,12249,-1002.84,-3714358.59,12283787.16,8569428.57
18996,2003-08-29,1008.01,5.17,0.52,1527.46,-34.01,True,1,12250,-1008.01,-3715366.6,12348122.5,8632755.9
18997,2003-09-02,1021.99,13.98,1.39,1527.46,-33.09,True,1,12251,-1021.99,-3716388.59,12520399.49,8804010.9
18998,2003-09-03,1026.27,4.28,0.42,1527.46,-32.81,True,1,12252,-1026.27,-3717414.86,12573860.04,8856445.18
18999,2003-09-04,1027.97,1.7,0.17,1527.46,-32.7,True,1,12253,-1027.97,-3718442.83,12595716.41,8877273.58
19000,2003-09-05,1021.39,-6.58,-0.64,1527.46,-33.13,True,1,12254,-1021.39,-3719464.22,12516113.06,8796648.84
19001,2003-09-08,1031.64,10.25,1.0,1527.46,-32.46,True,1,12255,-1031.64,-3720495.86,12642748.2,8922252.34
19002,2003-09-09,1023.17,-8.47,-0.82,1527.46,-33.02,True,1,12256,-1023.17,-3721519.03,12539971.52,8818452.49
19003,2003-09-10,1010.92,-12.25,-1.2,1527.46,-33.82,True,1,12257,-1010.92,-3722529.95,12390846.44,8668316.49
19004,2003-09-11,1016.42,5.5,0.54,1527.46,-33.46,True,1,12258,-1016.42,-3723546.37,12459276.36,8735729.99
19005,2003-09-12,1018.63,2.21,0.22,1527.46,-33.31,True,1,12259,-1018.63,-3724565.0,12487385.17,8762820.17
19006,2003-09-15,1014.81,-3.82,-0.38,1527.46,-33.56,True,1,12260,-1014.81,-3725579.81,12441570.6,8715990.79
19007,2003-09-16,1029.32,14.51,1.43,1527.46,-32.61,True,1,12261,-1029.32,-3726609.13,12620492.52,8893883.39
19008,2003-09-17,1025.97,-3.35,-0.32,1527.46,-32.83,True,1,12262,-1025.97,-3727635.1,12580444.14,8852809.04
19009,2003-09-18,1039.58,13.61,1.33,1527.46,-31.94,True,1,12263,-1039.58,-3728674.68,12748369.54,9019694.86
19010,2003-09-19,1036.3,-3.28,-0.32,1527.46,-32.16,True,1,12264,-1036.3,-3729710.98,12709183.2,8979472.22
19011,2003-09-22,1022.82,-13.48,-1.3,1527.46,-33.04,True,1,12265,-1022.82,-3730733.8,12544887.3,8814153.5
19012,2003-09-23,1029.03,6.21,0.61,1527.46,-32.63,True,1,12266,-1029.03,-3731762.83,12622081.98,8890319.15
19013,2003-09-24,1009.38,-19.65,-1.91,1527.46,-33.92,True,1,12267,-1009.38,-3732772.21,12382064.46,8649292.25
19014,2003-09-25,1003.27,-6.11,-0.6,1527.46,-34.32,True,1,12268,-1003.27,-3733775.48,12308116.36,8574340.88
19015,2003-09-26,996.85,-6.42,-0.64,1527.46,-34.74,True,1,12269,-996.85,-3734772.33,12230352.65,8495580.32
19016,2003-09-29,1006.58,9.73,0.98,1527.46,-34.1,True,1,12270,-1006.58,-3735778.91,12350736.6,8614957.69
19017,2003-09-30,995.97,-10.61,-1.05,1527.46,-34.8,True,1,12271,-995.97,-3736774.88,12221547.87,8484772.99
19018,2003-10-01,1018.22,22.25,2.23,1527.46,-33.34,True,1,12272,-1018.22,-3737793.1,12495595.84,8757802.74
19019,2003-10-02,1020.24,2.02,0.2,1527.46,-33.21,True,1,12273,-1020.24,-3738813.34,12521405.52,8782592.18
19020,2003-10-03,1029.85,9.61,0.94,1527.46,-32.58,True,1,12274,-1029.85,-3739843.19,12640378.9,8900535.71
19021,2003-10-06,1034.35,4.5,0.44,1527.46,-32.28,True,1,12275,-1034.35,-3740877.54,12696646.25,8955768.71
19022,2003-10-07,1039.25,4.9,0.47,1527.46,-31.96,True,1,12276,-1039.25,-3741916.79,12757833.0,9015916.21
19023,2003-10-08,1033.78,-5.47,-0.53,1527.46,-32.32,True,1,12277,-1033.78,-3742950.57,12691717.06,8948766.49
19024,2003-10-09,1038.73,4.95,0.48,1527.46,-32.0,True,1,12278,-1038.73,-3743989.3,12753526.94,9009537.64
19025,2003-10-10,1038.06,-0.67,-0.06,1527.46,-32.04,True,1,12279,-1038.06,-3745027.36,12746338.74,9001311.38
19026,2003-10-13,1045.35,7.29,0.7,1527.46,-31.56,True,1,12280,-1045.35,-3746072.71,12836898.0,9090825.29
19027,2003-10-14,1049.48,4.13,0.4,1527.46,-31.29,True,1,12281,-1049.48,-3747122.19,12888663.88,9141541.69
19028,2003-10-15,1046.76,-2.72,-0.26,1527.46,-31.47,True,1,12282,-1046.76,-3748168.95,12856306.32,9108137.37
19029,2003-10-16,1050.07,3.31,0.32,1527.46,-31.25,True,1,12283,-1050.07,-3749219.02,12898009.81,9148790.79
19030,2003-10-17,1039.32,-10.75,-1.02,1527.46,-31.96,True,1,12284,-1039.32,-3750258.34,12767006.88,9016748.54
19031,2003-10-20,1044.68,5.36,0.52,1527.46,-31.61,True,1,12285,-1044.68,-3751303.02,12833893.8,9082590.78
19032,2003-10-21,1046.03,1.35,0.13,1527.46,-31.52,True,1,12286,-1046.03,-3752349.05,12851524.58,9099175.53
19033,2003-10-22,1030.36,-15.67,-1.5,1527.46,-32.54,True,1,12287,-1030.36,-3753379.41,12660033.32,8906653.91
19034,2003-10-23,1033.77,3.41,0.33,1527.46,-32.32,True,1,12288,-1033.77,-3754413.18,12702965.76,8948552.58
19035,2003-10-24,1028.91,-4.86,-0.47,1527.46,-32.64,True,1,12289,-1028.91,-3755442.09,12644274.99,8888832.9
19036,2003-10-27,1031.13,2.22,0.22,1527.46,-32.49,True,1,12290,-1031.13,-3756473.22,12672587.7,8916114.48
19037,2003-10-28,1046.79,15.66,1.52,1527.46,-31.47,True,1,12291,-1046.79,-3757520.01,12866095.89,9108575.88
19038,2003-10-29,1048.11,1.32,0.13,1527.46,-31.38,True,1,12292,-1048.11,-3758568.12,12883368.12,9124800.0
19039,2003-10-30,1046.94,-1.17,-0.11,1527.46,-31.46,True,1,12293,-1046.94,-3759615.06,12870033.42,9110418.36
19040,2003-10-31,1050.71,3.77,0.36,1527.46,-31.21,True,1,12294,-1050.71,-3760665.77,12917428.74,9156762.97
19041,2003-11-03,1059.02,8.31,0.79,1527.46,-30.67,True,1,12295,-1059.02,-3761724.79,13020650.9,9258926.11
19042,2003-11-04,1053.25,-5.77,-0.55,1527.46,-31.05,True,1,12296,-1053.25,-3762778.04,12950762.0,9187983.96
19043,2003-11-05,1051.81,-1.44,-0.14,1527.46,-31.14,True,1,12297,-1051.81,-3763829.85,12934107.57,9170277.72
19044,2003-11-06,1058.05,6.24,0.59,1527.46,-30.73,True,1,12298,-1058.05,-3764887.9,13011898.9,9247011.0
19045,2003-11-07,1053.21,-4.84,-0.46,1527.46,-31.05,True,1,12299,-1053.21,-3765941.11,12953429.79,9187488.68
19046,2003-11-10,1047.11,-6.1,-0.58,1527.46,-31.45,True,1,12300,-1047.11,-3766988.22,12879453.0,9112464.78
19047,2003-11-11,1046.57,-0.54,-0.05,1527.46,-31.48,True,1,12301,-1046.57,-3768034.79,12873857.57,9105822.78
19048,2003-11-12,1058.53,11.96,1.14,1527.46,-30.7,True,1,12302,-1058.53,-3769093.32,13022036.06,9252942.74
19049,2003-11-13,1058.41,-0.12,-0.01,1527.46,-30.71,True,1,12303,-1058.41,-3770151.73,13021618.23,9251466.5
19050,2003-11-14,1050.35,-8.06,-0.76,1527.46,-31.24,True,1,12304,-1050.35,-3771202.08,12923506.4,9152304.32
19051,2003-11-17,1043.63,-6.72,-0.64,1527.46,-31.68,True,1,12305,-1043.63,-3772245.71,12841867.15,9069621.44
19052,2003-11-18,1034.15,-9.48,-0.91,1527.46,-32.3,True,1,12306,-1034.15,-3773279.86,12726249.9,8952970.04
19053,2003-11-19,1042.44,8.29,0.8,1527.46,-31.75,True,1,12307,-1042.44,-3774322.3,12829309.08,9054986.78
19054,2003-11-20,1033.65,-8.79,-0.84,1527.46,-32.33,True,1,12308,-1033.65,-3775355.95,12722164.2,8946808.25
19055,2003-11-21,1035.28,1.63,0.16,1527.46,-32.22,True,1,12309,-1035.28,-3776391.23,12743261.52,8966870.29
19056,2003-11-24,1052.08,16.8,1.62,1527.46,-31.12,True,1,12310,-1052.08,-3777443.31,12951104.8,9173661.49
19057,2003-11-25,1053.89,1.81,0.17,1527.46,-31.0,True,1,12311,-1053.89,-3778497.2,12974439.79,9195942.59
19058,2003-11-26,1058.45,4.56,0.43,1527.46,-30.7,True,1,12312,-1058.45,-3779555.65,13031636.4,9252080.75
19059,2003-11-28,1058.2,-0.25,-0.02,1527.46,-30.72,True,1,12313,-1058.2,-3780613.85,13029616.6,9249002.75
19060,2003-12-01,1070.12,11.92,1.13,1527.46,-29.94,True,1,12314,-1070.12,-3781683.97,13177457.68,9395773.71
19061,2003-12-02,1066.62,-3.5,-0.33,1527.46,-30.17,True,1,12315,-1066.62,-3782750.59,13135425.3,9352674.71
19062,2003-12-03,1064.73,-1.89,-0.18,1527.46,-30.29,True,1,12316,-1064.73,-3783815.32,13113214.68,9329399.36
19063,2003-12-04,1069.72,4.99,0.47,1527.46,-29.97,True,1,12317,-1069.72,-3784885.04,13175741.24,9390856.2
19064,2003-12-05,1061.5,-8.22,-0.77,1527.46,-30.51,True,1,12318,-1061.5,-3785946.54,13075557.0,9289610.46
19065,2003-12-08,1069.3,7.8,0.74,1527.46,-30.0,True,1,12319,-1069.3,-3787015.84,13172706.7,9385690.86
19066,2003-12-09,1060.18,-9.12,-0.85,1527.46,-30.59,True,1,12320,-1060.18,-3788076.02,13061417.6,9273341.58
19067,2003-12-10,1059.05,-1.13,-0.11,1527.46,-30.67,True,1,12321,-1059.05,-3789135.07,13048555.05,9259419.98
19068,2003-12-11,1071.21,12.16,1.15,1527.46,-29.87,True,1,12322,-1071.21,-3790206.28,13199449.62,9409243.34
19069,2003-12-12,1074.14,2.93,0.27,1527.46,-29.68,True,1,12323,-1074.14,-3791280.42,13236627.22,9445346.8
19070,2003-12-15,1068.04,-6.1,-0.57,1527.46,-30.08,True,1,12324,-1068.04,-3792348.46,13162524.96,9370176.5
19071,2003-12-16,1075.13,7.09,0.66,1527.46,-29.61,True,1,12325,-1075.13,-3793423.59,13250977.25,9457553.66
19072,2003-12-17,1076.48,1.35,0.13,1527.46,-29.52,True,1,12326,-1076.48,-3794500.07,13268692.48,9474192.41
19073,2003-12-18,1089.18,12.7,1.18,1527.46,-28.69,True,1,12327,-1089.18,-3795589.25,13426321.86,9630732.61
19074,2003-12-19,1088.66,-0.52,-0.05,1527.46,-28.73,True,1,12328,-1088.66,-3796677.91,13421000.48,9624322.57
19075,2003-12-22,1092.94,4.28,0.39,1527.46,-28.45,True,1,12329,-1092.94,-3797770.85,13474857.26,9677086.41
19076,2003-12-23,1096.02,3.08,0.28,1527.46,-28.25,True,1,12330,-1096.02,-3798866.87,13513926.6,9715059.73
19077,2003-12-24,1094.04,-1.98,-0.18,1527.46,-28.38,True,1,12331,-1094.04,-3799960.91,13490607.24,9690646.33
19078,2003-12-26,1095.89,1.85,0.17,1527.46,-28.25,True,1,12332,-1095.89,-3801056.8,13514515.48,9713458.68
19079,2003-12-29,1109.48,13.59,1.24,1527.46,-27.36,True,1,12333,-1109.48,-3802166.28,13683216.84,9881050.56
19080,2003-12-30,1109.64,0.16,0.01,1527.46,-27.35,True,1,12334,-1109.64,-3803275.92,13686299.76,9883023.84
19081,2003-12-31,1111.92,2.28,0.2,1527.46,-27.2,True,1,12335,-1111.92,-3804387.84,13715533.2,9911145.36
19082,2004-01-02,1108.48,-3.44,-0.31,1527.46,-27.43,True,1,12336,-1108.48,-3805496.32,13674209.28,9868712.96
19083,2004-01-05,1122.22,13.74,1.24,1527.46,-26.53,True,1,12337,-1122.22,-3806618.54,13844828.14,10038209.6
19084,2004-01-06,1123.67,1.45,0.13,1527.46,-26.44,True,1,12338,-1123.67,-3807742.21,13863840.46,10056098.25
19085,2004-01-07,1126.33,2.66,0.24,1527.46,-26.26,True,1,12339,-1126.33,-3808868.54,13897785.87,10088917.33
19086,2004-01-08,1131.92,5.59,0.5,1527.46,-25.9,True,1,12340,-1131.92,-3810000.46,13967892.8,10157892.34
19087,2004-01-09,1121.86,-10.06,-0.89,1527.46,-26.55,True,1,12341,-1121.86,-3811122.32,13844874.26,10033751.94
19088,2004-01-12,1127.23,5.37,0.48,1527.46,-26.2,True,1,12342,-1127.23,-3812249.55,13912272.66,10100023.11
19089,2004-01-13,1121.22,-6.01,-0.53,1527.46,-26.6,True,1,12343,-1121.22,-3813370.77,13839218.46,10025847.69
19090,2004-01-14,1130.52,9.3,0.83,1527.46,-25.99,True,1,12344,-1130.52,-3814501.29,13955138.88,10140637.59
19091,2004-01-15,1132.05,1.53,0.14,1527.46,-25.89,True,1,12345,-1132.05,-3815633.34,13975157.25,10159523.91
19092,2004-01-16,1139.83,7.78,0.69,1527.46,-25.38,True,1,12346,-1139.83,-3816773.17,14072341.18,10255568.01
19093,2004-01-20,1138.77,-1.06,-0.09,1527.46,-25.45,True,1,12347,-1138.77,-3817911.94,14060393.19,10242481.25
19094,2004-01-21,1147.62,8.85,0.78,1527.46,-24.87,True,1,12348,-1147.62,-3819059.56,14170811.76,10351752.2
19095,2004-01-22,1143.94,-3.68,-0.32,1527.46,-25.11,True,1,12349,-1143.94,-3820203.5,14126515.06,10306311.56
19096,2004-01-23,1141.55,-2.39,-0.21,1527.46,-25.26,True,1,12350,-1141.55,-3821345.05,14098142.5,10276797.45
19097,2004-01-26,1155.37,13.82,1.21,1527.46,-24.36,True,1,12351,-1155.37,-3822500.42,14269974.87,10447474.45
19098,2004-01-27,1144.05,-11.32,-0.98,1527.46,-25.1,True,1,12352,-1144.05,-3823644.47,14131305.6,10307661.13
19099,2004-01-28,1128.48,-15.57,-1.36,1527.46,-26.12,True,1,12353,-1128.48,-3824772.95,13940113.44,10115340.49
19100,2004-01-29,1134.11,5.63,0.5,1527.46,-25.75,True,1,12354,-1134.11,-3825907.06,14010794.94,10184887.88
19101,2004-01-30,1131.13,-2.98,-0.26,1527.46,-25.95,True,1,12355,-1131.13,-3827038.19,13975111.15,10148072.96
19102,2004-02-02,1135.26,4.13,0.36,1527.46,-25.68,True,1,12356,-1135.26,-3828173.45,14027272.56,10199099.11
19103,2004-02-03,1136.03,0.77,0.07,1527.46,-25.63,True,1,12357,-1136.03,-3829309.48,14037922.71,10208613.23
19104,2004-02-04,1126.52,-9.51,-0.84,1527.46,-26.25,True,1,12358,-1126.52,-3830436.0,13921534.16,10091098.16
19105,2004-02-05,1128.59,2.07,0.18,1527.46,-26.11,True,1,12359,-1128.59,-3831564.59,13948243.81,10116679.22
19106,2004-02-06,1142.76,14.17,1.26,1527.46,-25.19,True,1,12360,-1142.76,-3832707.35,14124513.6,10291806.25
19107,2004-02-09,1139.81,-2.95,-0.26,1527.46,-25.38,True,1,12361,-1139.81,-3833847.16,14089191.41,10255344.25
19108,2004-02-10,1145.54,5.73,0.5,1527.46,-25.0,True,1,12362,-1145.54,-3834992.7,14161165.48,10326172.78
19109,2004-02-11,1157.76,12.22,1.07,1527.46,-24.2,True,1,12363,-1157.76,-3836150.46,14313386.88,10477236.42
19110,2004-02-12,1152.11,-5.65,-0.49,1527.46,-24.57,True,1,12364,-1152.11,-3837302.57,14244688.04,10407385.47
19111,2004-02-13,1145.81,-6.3,-0.55,1527.46,-24.99,True,1,12365,-1145.81,-3838448.38,14167940.65,10329492.27
19112,2004-02-17,1156.99,11.18,0.98,1527.46,-24.25,True,1,12366,-1156.99,-3839605.37,14307338.34,10467732.97
19113,2004-02-18,1151.82,-5.17,-0.45,1527.46,-24.59,True,1,12367,-1151.82,-3840757.19,14244557.94,10403800.75
19114,2004-02-19,1147.06,-4.76,-0.41,1527.46,-24.9,True,1,12368,-1147.06,-3841904.25,14186838.08,10344933.83
19115,2004-02-20,1144.11,-2.95,-0.26,1527.46,-25.1,True,1,12369,-1144.11,-3843048.36,14151496.59,10308448.23
19116,2004-02-23,1140.99,-3.12,-0.27,1527.46,-25.3,True,1,12370,-1140.99,-3844189.35,14114046.3,10269856.95
19117,2004-02-24,1139.09,-1.9,-0.17,1527.46,-25.43,True,1,12371,-1139.09,-3845328.44,14091682.39,10246353.95
19118,2004-02-25,1143.67,4.58,0.4,1527.46,-25.13,True,1,12372,-1143.67,-3846472.11,14149485.24,10303013.13
19119,2004-02-26,1144.91,1.24,0.11,1527.46,-25.04,True,1,12373,-1144.91,-3847617.02,14165971.43,10318354.41
19120,2004-02-27,1144.94,0.03,0.0,1527.46,-25.04,True,1,12374,-1144.94,-3848761.96,14167487.56,10318725.6
19121,2004-03-01,1155.97,11.03,0.96,1527.46,-24.32,True,1,12375,-1155.97,-3849917.93,14305128.75,10455210.82
19122,2004-03-02,1149.1,-6.87,-0.59,1527.46,-24.77,True,1,12376,-1149.1,-3851067.03,14221261.6,10370194.57
19123,2004-03-03,1151.03,1.93,0.17,1527.46,-24.64,True,1,12377,-1151.03,-3852218.06,14246298.31,10394080.25
19124,2004-03-04,1154.87,3.84,0.33,1527.46,-24.39,True,1,12378,-1154.87,-3853372.93,14294980.86,10441607.93
19125,2004-03-05,1156.86,1.99,0.17,1527.46,-24.26,True,1,12379,-1156.86,-3854529.79,14320769.94,10466240.15
19126,2004-03-08,1147.2,-9.66,-0.84,1527.46,-24.9,True,1,12380,-1147.2,-3855676.99,14202336.0,10346659.01
19127,2004-03-09,1140.58,-6.62,-0.58,1527.46,-25.33,True,1,12381,-1140.58,-3856817.57,14121520.98,10264703.41
19128,2004-03-10,1123.89,-16.69,-1.46,1527.46,-26.42,True,1,12382,-1123.89,-3857941.46,13916005.98,10058064.52
19129,2004-03-11,1106.78,-17.11,-1.52,1527.46,-27.54,True,1,12383,-1106.78,-3859048.24,13705256.74,9846208.5
19130,2004-03-12,1120.57,13.79,1.25,1527.46,-26.64,True,1,12384,-1120.57,-3860168.81,13877138.88,10016970.07
19131,2004-03-15,1104.49,-16.08,-1.44,1527.46,-27.69,True,1,12385,-1104.49,-3861273.3,13679108.65,9817835.35
19132,2004-03-16,1110.7,6.21,0.56,1527.46,-27.28,True,1,12386,-1110.7,-3862384.0,13757130.2,9894746.2
19133,2004-03-17,1123.75,13.05,1.18,1527.46,-26.43,True,1,12387,-1123.75,-3863507.75,13919891.25,10056383.5
19134,2004-03-18,1122.32,-1.43,-0.13,1527.46,-26.52,True,1,12388,-1122.32,-3864630.07,13903300.16,10038670.09
19135,2004-03-19,1109.78,-12.54,-1.12,1527.46,-27.34,True,1,12389,-1109.78,-3865739.85,13749064.42,9883324.57
19136,2004-03-22,1095.4,-14.38,-1.3,1527.46,-28.29,True,1,12390,-1095.4,-3866835.25,13572006.0,9705170.75
19137,2004-03-23,1093.95,-1.45,-0.13,1527.46,-28.38,True,1,12391,-1093.95,-3867929.2,13555134.45,9687205.25
19138,2004-03-24,1091.33,-2.62,-0.24,1527.46,-28.55,True,1,12392,-1091.33,-3869020.53,13523761.36,9654740.83
19139,2004-03-25,1109.19,17.86,1.64,1527.46,-27.38,True,1,12393,-1109.19,-3870129.72,13746191.67,9876061.95
19140,2004-03-26,1108.06,-1.13,-0.1,1527.46,-27.46,True,1,12394,-1108.06,-3871237.78,13733295.64,9862057.86
19141,2004-03-29,1122.47,14.41,1.3,1527.46,-26.51,True,1,12395,-1122.47,-3872360.25,13913015.65,10040655.4
19142,2004-03-30,1127.0,4.53,0.4,1527.46,-26.22,True,1,12396,-1127.0,-3873487.25,13970292.0,10096804.75
19143,2004-03-31,1126.21,-0.79,-0.07,1527.46,-26.27,True,1,12397,-1126.21,-3874613.46,13961625.37,10087011.91
19144,2004-04-01,1132.17,5.96,0.53,1527.46,-25.88,True,1,12398,-1132.17,-3875745.63,14036643.66,10160898.03
19145,2004-04-02,1141.81,9.64,0.85,1527.46,-25.25,True,1,12399,-1141.81,-3876887.44,14157302.19,10280414.75
19146,2004-04-05,1150.57,8.76,0.77,1527.46,-24.67,True,1,12400,-1150.57,-3878038.01,14267068.0,10389029.99
19147,2004-04-06,1148.16,-2.41,-0.21,1527.46,-24.83,True,1,12401,-1148.16,-3879186.17,14238332.16,10359145.99
19148,2004-04-07,1140.53,-7.63,-0.66,1527.46,-25.33,True,1,12402,-1140.53,-3880326.7,14144853.06,10264526.36
19149,2004-04-08,1139.32,-1.21,-0.11,1527.46,-25.41,True,1,12403,-1139.32,-3881466.02,14130985.96,10249519.94
19150,2004-04-12,1145.2,5.88,0.52,1527.46,-25.03,True,1,12404,-1145.2,-3882611.22,14205060.8,10322449.58
19151,2004-04-13,1129.44,-15.76,-1.38,1527.46,-26.06,True,1,12405,-1129.44,-3883740.66,14010703.2,10126962.54
19152,2004-04-14,1128.17,-1.27,-0.11,1527.46,-26.14,True,1,12406,-1128.17,-3884868.83,13996077.02,10111208.19
19153,2004-04-15,1128.84,0.67,0.06,1527.46,-26.1,True,1,12407,-1128.84,-3885997.67,14005517.88,10119520.21
19154,2004-04-16,1134.61,5.77,0.51,1527.46,-25.72,True,1,12408,-1134.61,-3887132.28,14078240.88,10191108.6
19155,2004-04-19,1135.82,1.21,0.11,1527.46,-25.64,True,1,12409,-1135.82,-3888268.1,14094390.38,10206122.28
19156,2004-04-20,1118.15,-17.67,-1.56,1527.46,-26.8,True,1,12410,-1118.15,-3889386.25,13876241.5,9986855.25
19157,2004-04-21,1124.09,5.94,0.53,1527.46,-26.41,True,1,12411,-1124.09,-3890510.34,13951080.99,10060570.65
19158,2004-04-22,1139.93,15.84,1.41,1527.46,-25.37,True,1,12412,-1139.93,-3891650.27,14148811.16,10257160.89
19159,2004-04-23,1140.6,0.67,0.06,1527.46,-25.33,True,1,12413,-1140.6,-3892790.87,14158267.8,10265476.93
19160,2004-04-26,1135.53,-5.07,-0.44,1527.46,-25.66,True,1,12414,-1135.53,-3893926.4,14096469.42,10202543.02
19161,2004-04-27,1138.11,2.58,0.23,1527.46,-25.49,True,1,12415,-1138.11,-3895064.51,14129635.65,10234571.14
19162,2004-04-28,1122.41,-15.7,-1.38,1527.46,-26.52,True,1,12416,-1122.41,-3896186.92,13935842.56,10039655.64
19163,2004-04-29,1113.89,-8.52,-0.76,1527.46,-27.08,True,1,12417,-1113.89,-3897300.81,13831172.13,9933871.32
19164,2004-04-30,1107.3,-6.59,-0.59,1527.46,-27.51,True,1,12418,-1107.3,-3898408.11,13750451.4,9852043.29
19165,2004-05-03,1117.49,10.19,0.92,1527.46,-26.84,True,1,12419,-1117.49,-3899525.6,13878108.31,9978582.71
19166,2004-05-04,1119.55,2.06,0.18,1527.46,-26.7,True,1,12420,-1119.55,-3900645.15,13904811.0,10004165.85
19167,2004-05-05,1121.53,1.98,0.18,1527.46,-26.58,True,1,12421,-1121.53,-3901766.68,13930524.13,10028757.45
19168,2004-05-06,1113.99,-7.54,-0.67,1527.46,-27.07,True,1,12422,-1113.99,-3902880.67,13837983.78,9935103.11
19169,2004-05-07,1098.7,-15.29,-1.37,1527.46,-28.07,True,1,12423,-1098.7,-3903979.37,13649150.1,9745170.73
19170,2004-05-10,1087.12,-11.58,-1.05,1527.46,-28.83,True,1,12424,-1087.12,-3905066.49,13506378.88,9601312.39
19171,2004-05-11,1095.45,8.33,0.77,1527.46,-28.28,True,1,12425,-1095.45,-3906161.94,13610966.25,9704804.31
19172,2004-05-12,1097.28,1.83,0.17,1527.46,-28.16,True,1,12426,-1097.28,-3907259.22,13634801.28,9727542.06
19173,2004-05-13,1096.44,-0.84,-0.08,1527.46,-28.22,True,1,12427,-1096.44,-3908355.66,13625459.88,9717104.22
19174,2004-05-14,1095.7,-0.74,-0.07,1527.46,-28.27,True,1,12428,-1095.7,-3909451.36,13617359.6,9707908.24
19175,2004-05-17,1084.1,-11.6,-1.06,1527.46,-29.03,True,1,12429,-1084.1,-3910535.46,13474278.9,9563743.44
19176,2004-05-18,1091.49,7.39,0.68,1527.46,-28.54,True,1,12430,-1091.49,-3911626.95,13567220.7,9655593.75
19177,2004-05-19,1088.68,-2.81,-0.26,1527.46,-28.73,True,1,12431,-1088.68,-3912715.63,13533381.08,9620665.45
19178,2004-05-20,1089.19,0.51,0.05,1527.46,-28.69,True,1,12432,-1089.19,-3913804.82,13540810.08,9627005.26
19179,2004-05-21,1093.56,4.37,0.4,1527.46,-28.41,True,1,12433,-1093.56,-3914898.38,13596231.48,9681333.1
19180,2004-05-24,1095.41,1.85,0.17,1527.46,-28.29,True,1,12434,-1095.41,-3915993.79,13620327.94,9704334.15
19181,2004-05-25,1113.05,17.64,1.61,1527.46,-27.13,True,1,12435,-1113.05,-3917106.84,13840776.75,9923669.91
19182,2004-05-26,1114.94,1.89,0.17,1527.46,-27.01,True,1,12436,-1114.94,-3918221.78,13865393.84,9947172.06
19183,2004-05-27,1121.28,6.34,0.57,1527.46,-26.59,True,1,12437,-1121.28,-3919343.06,13945359.36,10026016.3
19184,2004-05-28,1120.68,-0.6,-0.05,1527.46,-26.63,True,1,12438,-1120.68,-3920463.74,13939017.84,10018554.1
19185,2004-06-01,1121.2,0.52,0.05,1527.46,-26.6,True,1,12439,-1121.2,-3921584.94,13946606.8,10025021.86
19186,2004-06-02,1124.99,3.79,0.34,1527.46,-26.35,True,1,12440,-1124.99,-3922709.93,13994875.6,10072165.67
19187,2004-06-03,1116.64,-8.35,-0.74,1527.46,-26.9,True,1,12441,-1116.64,-3923826.57,13892118.24,9968291.67
19188,2004-06-04,1122.5,5.86,0.52,1527.46,-26.51,True,1,12442,-1122.5,-3924949.07,13966145.0,10041195.93
19189,2004-06-07,1140.42,17.92,1.6,1527.46,-25.34,True,1,12443,-1140.42,-3926089.49,14190246.06,10264156.57
19190,2004-06-08,1142.18,1.76,0.15,1527.46,-25.22,True,1,12444,-1142.18,-3927231.67,14213287.92,10286056.25
19191,2004-06-09,1131.33,-10.85,-0.95,1527.46,-25.93,True,1,12445,-1131.33,-3928363.0,14079401.85,10151038.85
19192,2004-06-10,1136.47,5.14,0.45,1527.46,-25.6,True,1,12446,-1136.47,-3929499.47,14144505.62,10215006.15
19193,2004-06-14,1125.29,-11.18,-0.98,1527.46,-26.33,True,1,12447,-1125.29,-3930624.76,14006484.63,10075859.87
19194,2004-06-15,1132.01,6.72,0.6,1527.46,-25.89,True,1,12448,-1132.01,-3931756.77,14091260.48,10159503.71
19195,2004-06-16,1133.56,1.55,0.14,1527.46,-25.79,True,1,12449,-1133.56,-3932890.33,14111688.44,10178798.11
19196,2004-06-17,1132.05,-1.51,-0.13,1527.46,-25.89,True,1,12450,-1132.05,-3934022.38,14094022.5,10160000.12
19197,2004-06-18,1135.02,2.97,0.26,1527.46,-25.69,True,1,12451,-1135.02,-3935157.4,14132134.02,10196976.62
19198,2004-06-21,1130.3,-4.72,-0.42,1527.46,-26.0,True,1,12452,-1130.3,-3936287.7,14074495.6,10138207.9
19199,2004-06-22,1134.41,4.11,0.36,1527.46,-25.73,True,1,12453,-1134.41,-3937422.11,14126807.73,10189385.62
19200,2004-06-23,1144.06,9.65,0.85,1527.46,-25.1,True,1,12454,-1144.06,-3938566.17,14248123.24,10309557.07
19201,2004-06-24,1140.65,-3.41,-0.3,1527.46,-25.32,True,1,12455,-1140.65,-3939706.82,14206795.75,10267088.93
19202,2004-06-25,1134.43,-6.22,-0.55,1527.46,-25.73,True,1,12456,-1134.43,-3940841.25,14130460.08,10189618.83
19203,2004-06-28,1133.35,-1.08,-0.1,1527.46,-25.8,True,1,12457,-1133.35,-3941974.6,14118140.95,10176166.35
19204,2004-06-29,1136.2,2.85,0.25,1527.46,-25.62,True,1,12458,-1136.2,-3943110.8,14154779.6,10211668.8
19205,2004-06-30,1140.84,4.64,0.41,1527.46,-25.31,True,1,12459,-1140.84,-3944251.64,14213725.56,10269473.92
19206,2004-07-01,1128.94,-11.9,-1.04,1527.46,-26.09,True,1,12460,-1128.94,-3945380.58,14066592.4,10121211.82
19207,2004-07-02,1125.38,-3.56,-0.32,1527.46,-26.32,True,1,12461,-1125.38,-3946505.96,14023360.18,10076854.22
19208,2004-07-06,1116.21,-9.17,-0.82,1527.46,-26.92,True,1,12462,-1116.21,-3947622.17,13910209.02,9962586.85
19209,2004-07-07,1118.33,2.12,0.19,1527.46,-26.78,True,1,12463,-1118.33,-3948740.5,13937746.79,9989006.29
19210,2004-07-08,1109.11,-9.22,-0.82,1527.46,-27.39,True,1,12464,-1109.11,-3949849.61,13823947.04,9874097.43
19211,2004-07-09,1112.81,3.7,0.33,1527.46,-27.15,True,1,12465,-1112.81,-3950962.42,13871176.65,9920214.23
19212,2004-07-12,1114.35,1.54,0.14,1527.46,-27.05,True,1,12466,-1114.35,-3952076.77,13891487.1,9939410.33
19213,2004-07-13,1115.14,0.79,0.07,1527.46,-26.99,True,1,12467,-1115.14,-3953191.91,13902450.38,9949258.47
19214,2004-07-14,1111.47,-3.67,-0.33,1527.46,-27.23,True,1,12468,-1111.47,-3954303.38,13857807.96,9903504.58
19215,2004-07-15,1106.69,-4.78,-0.43,1527.46,-27.55,True,1,12469,-1106.69,-3955410.07,13799317.61,9843907.54
19216,2004-07-16,1101.39,-5.3,-0.48,1527.46,-27.89,True,1,12470,-1101.39,-3956511.46,13734333.3,9777821.84
19217,2004-07-19,1100.9,-0.49,-0.04,1527.46,-27.93,True,1,12471,-1100.9,-3957612.36,13729323.9,9771711.54
19218,2004-07-20,1108.67,7.77,0.71,1527.46,-27.42,True,1,12472,-1108.67,-3958721.03,13827332.24,9868611.21
19219,2004-07-21,1093.88,-14.79,-1.33,1527.46,-28.39,True,1,12473,-1093.88,-3959814.91,13643965.24,9684150.33
19220,2004-07-22,1096.84,2.96,0.27,1527.46,-28.19,True,1,12474,-1096.84,-3960911.75,13681982.16,9721070.41
19221,2004-07-23,1086.2,-10.64,-0.97,1527.46,-28.89,True,1,12475,-1086.2,-3961997.95,13550345.0,9588347.05
19222,2004-07-26,1084.07,-2.13,-0.2,1527.46,-29.03,True,1,12476,-1084.07,-3963082.02,13524857.32,9561775.3
19223,2004-07-27,1094.83,10.76,0.99,1527.46,-28.32,True,1,12477,-1094.83,-3964176.85,13660193.91,9696017.06
19224,2004-07-28,1095.42,0.59,0.05,1527.46,-28.28,True,1,12478,-1095.42,-3965272.27,13668650.76,9703378.49
19225,2004-07-29,1100.43,5.01,0.46,1527.46,-27.96,True,1,12479,-1100.43,-3966372.7,13732265.97,9765893.27
19226,2004-07-30,1101.72,1.29,0.12,1527.46,-27.87,True,1,12480,-1101.72,-3967474.42,13749465.6,9781991.18
19227,2004-08-02,1106.62,4.9,0.44,1527.46,-27.55,True,1,12481,-1106.62,-3968581.04,13811724.22,9843143.18
19228,2004-08-03,1099.69,-6.93,-0.63,1527.46,-28.0,True,1,12482,-1099.69,-3969680.73,13726330.58,9756649.85
19229,2004-08-04,1098.63,-1.06,-0.1,1527.46,-28.08,True,1,12483,-1098.63,-3970779.36,13714198.29,9743418.93
19230,2004-08-05,1080.7,-17.93,-1.63,1527.46,-29.25,True,1,12484,-1080.7,-3971860.06,13491458.8,9519598.74
19231,2004-08-06,1063.97,-16.73,-1.55,1527.46,-30.34,True,1,12485,-1063.97,-3972924.03,13283665.45,9310741.42
19232,2004-08-09,1065.22,1.25,0.12,1527.46,-30.26,True,1,12486,-1065.22,-3973989.25,13300336.92,9326347.67
19233,2004-08-10,1079.04,13.82,1.3,1527.46,-29.36,True,1,12487,-1079.04,-3975068.29,13473972.48,9498904.19
19234,2004-08-11,1075.79,-3.25,-0.3,1527.46,-29.57,True,1,12488,-1075.79,-3976144.08,13434465.52,9458321.44
19235,2004-08-12,1063.23,-12.56,-1.17,1527.46,-30.39,True,1,12489,-1063.23,-3977207.31,13278679.47,9301472.16
19236,2004-08-13,1064.8,1.57,0.15,1527.46,-30.29,True,1,12490,-1064.8,-3978272.11,13299352.0,9321079.89
19237,2004-08-16,1079.34,14.54,1.37,1527.46,-29.34,True,1,12491,-1079.34,-3979351.45,13482035.94,9502684.49
19238,2004-08-17,1081.71,2.37,0.22,1527.46,-29.18,True,1,12492,-1081.71,-3980433.16,13512721.32,9532288.16
19239,2004-08-18,1095.17,13.46,1.24,1527.46,-28.3,True,1,12493,-1095.17,-3981528.33,13681958.81,9700430.48
19240,2004-08-19,1091.23,-3.94,-0.36,1527.46,-28.56,True,1,12494,-1091.23,-3982619.56,13633827.62,9651208.06
19241,2004-08-20,1098.35,7.12,0.65,1527.46,-28.09,True,1,12495,-1098.35,-3983717.91,13723883.25,9740165.34
19242,2004-08-23,1095.68,-2.67,-0.24,1527.46,-28.27,True,1,12496,-1095.68,-3984813.59,13691617.28,9706803.69
19243,2004-08-24,1096.19,0.51,0.05,1527.46,-28.23,True,1,12497,-1096.19,-3985909.78,13699086.43,9713176.65
19244,2004-08-25,1104.96,8.77,0.8,1527.46,-27.66,True,1,12498,-1104.96,-3987014.74,13809790.08,9822775.34
19245,2004-08-26,1105.09,0.13,0.01,1527.46,-27.65,True,1,12499,-1105.09,-3988119.83,13812519.91,9824400.08
19246,2004-08-27,1107.77,2.68,0.24,1527.46,-27.48,True,1,12500,-1107.77,-3989227.6,13847125.0,9857897.4
19247,2004-08-30,1099.15,-8.62,-0.78,1527.46,-28.04,True,1,12501,-1099.15,-3990326.75,13740474.15,9750147.4
19248,2004-08-31,1104.24,5.09,0.46,1527.46,-27.71,True,1,12502,-1104.24,-3991430.99,13805208.48,9813777.49
19249,2004-09-01,1105.91,1.67,0.15,1527.46,-27.6,True,1,12503,-1105.91,-3992536.9,13827192.73,9834655.83
19250,2004-09-02,1118.31,12.4,1.12,1527.46,-26.79,True,1,12504,-1118.31,-3993655.21,13983348.24,9989693.03
19251,2004-09-03,1113.63,-4.68,-0.42,1527.46,-27.09,True,1,12505,-1113.63,-3994768.84,13925943.15,9931174.31
19252,2004-09-07,1121.3,7.67,0.69,1527.46,-26.59,True,1,12506,-1121.3,-3995890.14,14022977.8,10027087.66
19253,2004-09-08,1116.27,-5.03,-0.45,1527.46,-26.92,True,1,12507,-1116.27,-3997006.41,13961188.89,9964182.48
19254,2004-09-09,1118.38,2.11,0.19,1527.46,-26.78,True,1,12508,-1118.38,-3998124.79,13988697.04,9990572.25
19255,2004-09-10,1123.92,5.54,0.5,1527.46,-26.42,True,1,12509,-1123.92,-3999248.71,14059115.28,10059866.57
19256,2004-09-13,1125.82,1.9,0.17,1527.46,-26.3,True,1,12510,-1125.82,-4000374.53,14084008.2,10083633.67
19257,2004-09-14,1128.33,2.51,0.22,1527.46,-26.13,True,1,12511,-1128.33,-4001502.86,14116536.63,10115033.77
19258,2004-09-15,1120.37,-7.96,-0.7,1527.46,-26.65,True,1,12512,-1120.37,-4002623.23,14018069.44,10015446.21
19259,2004-09-16,1123.5,3.13,0.28,1527.46,-26.45,True,1,12513,-1123.5,-4003746.73,14058355.5,10054608.77
19260,2004-09-17,1128.55,5.05,0.45,1527.46,-26.12,True,1,12514,-1128.55,-4004875.28,14122674.7,10117799.42
19261,2004-09-20,1122.2,-6.35,-0.56,1527.46,-26.53,True,1,12515,-1122.2,-4005997.48,14044333.0,10038335.52
19262,2004-09-21,1129.3,7.1,0.63,1527.46,-26.07,True,1,12516,-1129.3,-4007126.78,14134318.8,10127192.02
19263,2004-09-22,1113.56,-15.74,-1.39,1527.46,-27.1,True,1,12517,-1113.56,-4008240.34,13938430.52,9930190.18
19264,2004-09-23,1108.36,-5.2,-0.47,1527.46,-27.44,True,1,12518,-1108.36,-4009348.7,13874450.48,9865101.78
19265,2004-09-24,1110.11,1.75,0.16,1527.46,-27.32,True,1,12519,-1110.11,-4010458.81,13897467.09,9887008.28
19266,2004-09-27,1103.52,-6.59,-0.59,1527.46,-27.76,True,1,12520,-1103.52,-4011562.33,13816070.4,9804508.07
19267,2004-09-28,1110.06,6.54,0.59,1527.46,-27.33,True,1,12521,-1110.06,-4012672.39,13899061.26,9886388.87
19268,2004-09-29,1114.8,4.74,0.43,1527.46,-27.02,True,1,12522,-1114.8,-4013787.19,13959525.6,9945738.41
19269,2004-09-30,1114.58,-0.22,-0.02,1527.46,-27.03,True,1,12523,-1114.58,-4014901.77,13957885.34,9942983.57
19270,2004-10-01,1131.5,16.92,1.52,1527.46,-25.92,True,1,12524,-1131.5,-4016033.27,14170906.0,10154872.73
19271,2004-10-04,1135.17,3.67,0.32,1527.46,-25.68,True,1,12525,-1135.17,-4017168.44,14218004.25,10200835.81
19272,2004-10-05,1134.48,-0.69,-0.06,1527.46,-25.73,True,1,12526,-1134.48,-4018302.92,14210496.48,10192193.56
19273,2004-10-06,1142.05,7.57,0.67,1527.46,-25.23,True,1,12527,-1142.05,-4019444.97,14306460.35,10287015.38
19274,2004-10-07,1130.65,-11.4,-1.0,1527.46,-25.98,True,1,12528,-1130.65,-4020575.62,14164783.2,10144207.58
19275,2004-10-08,1122.14,-8.51,-0.75,1527.46,-26.54,True,1,12529,-1122.14,-4021697.76,14059292.06,10037594.3
19276,2004-10-11,1124.39,2.25,0.2,1527.46,-26.39,True,1,12530,-1124.39,-4022822.15,14088606.7,10065784.55
19277,2004-10-12,1121.84,-2.55,-0.23,1527.46,-26.56,True,1,12531,-1121.84,-4023943.99,14057777.04,10033833.05
19278,2004-10-13,1113.65,-8.19,-0.73,1527.46,-27.09,True,1,12532,-1113.65,-4025057.64,13956261.8,9931204.16
19279,2004-10-14,1103.29,-10.36,-0.93,1527.46,-27.77,True,1,12533,-1103.29,-4026160.93,13827533.57,9801372.64
19280,2004-10-15,1108.2,4.91,0.44,1527.46,-27.45,True,1,12534,-1108.2,-4027269.13,13890178.8,9862909.67
19281,2004-10-18,1114.02,5.82,0.52,1527.46,-27.07,True,1,12535,-1114.02,-4028383.15,13964240.7,9935857.55
19282,2004-10-19,1103.23,-10.79,-0.97,1527.46,-27.77,True,1,12536,-1103.23,-4029486.38,13830091.28,9800604.9
19283,2004-10-20,1103.66,0.43,0.04,1527.46,-27.74,True,1,12537,-1103.66,-4030590.04,13836585.42,9805995.38
19284,2004-10-21,1106.49,2.83,0.26,1527.46,-27.56,True,1,12538,-1106.49,-4031696.53,13873171.62,9841475.09
19285,2004-10-22,1095.74,-10.75,-0.97,1527.46,-28.26,True,1,12539,-1095.74,-4032792.27,13739483.86,9706691.59
19286,2004-10-25,1094.8,-0.94,-0.09,1527.46,-28.32,True,1,12540,-1094.8,-4033887.07,13728792.0,9694904.93
19287,2004-10-26,1111.09,16.29,1.49,1527.46,-27.26,True,1,12541,-1111.09,-4034998.16,13934179.69,9899181.53
19288,2004-10-27,1125.4,14.31,1.29,1527.46,-26.32,True,1,12542,-1125.4,-4036123.56,14114766.8,10078643.24
19289,2004-10-28,1127.44,2.04,0.18,1527.46,-26.19,True,1,12543,-1127.44,-4037251.0,14141479.92,10104228.92
19290,2004-10-29,1130.2,2.76,0.24,1527.46,-26.01,True,1,12544,-1130.2,-4038381.2,14177228.8,10138847.6
19291,2004-11-01,1130.51,0.31,0.03,1527.46,-25.99,True,1,12545,-1130.51,-4039511.71,14182247.95,10142736.24
19292,2004-11-02,1130.56,0.05,0.0,1527.46,-25.98,True,1,12546,-1130.56,-4040642.27,14184005.76,10143363.49
19293,2004-11-03,1143.2,12.64,1.12,1527.46,-25.16,True,1,12547,-1143.2,-4041785.47,14343730.4,10301944.93
19294,2004-11-04,1161.67,18.47,1.62,1527.46,-23.95,True,1,12548,-1161.67,-4042947.14,14576635.16,10533688.02
19295,2004-11-05,1166.17,4.5,0.39,1527.46,-23.65,True,1,12549,-1166.17,-4044113.31,14634267.33,10590154.02
19296,2004-11-08,1164.89,-1.28,-0.11,1527.46,-23.74,True,1,12550,-1164.89,-4045278.2,14619369.5,10574091.3
19297,2004-11-09,1164.08,-0.81,-0.07,1527.46,-23.79,True,1,12551,-1164.08,-4046442.28,14610368.08,10563925.8
19298,2004-11-10,1162.91,-1.17,-0.1,1527.46,-23.87,True,1,12552,-1162.91,-4047605.19,14596846.32,10549241.13
19299,2004-11-11,1173.48,10.57,0.91,1527.46,-23.17,True,1,12553,-1173.48,-4048778.67,14730694.44,10681915.77
19300,2004-11-12,1184.17,10.69,0.91,1527.46,-22.48,True,1,12554,-1184.17,-4049962.84,14866070.18,10816107.34
19301,2004-11-15,1183.81,-0.36,-0.03,1527.46,-22.5,True,1,12555,-1183.81,-4051146.65,14862734.55,10811587.9
19302,2004-11-16,1175.43,-8.38,-0.71,1527.46,-23.05,True,1,12556,-1175.43,-4052322.08,14758699.08,10706377.0
19303,2004-11-17,1181.94,6.51,0.55,1527.46,-22.62,True,1,12557,-1181.94,-4053504.02,14841620.58,10788116.56
19304,2004-11-18,1183.55,1.61,0.14,1527.46,-22.52,True,1,12558,-1183.55,-4054687.57,14863020.9,10808333.33
19305,2004-11-19,1170.34,-13.21,-1.12,1527.46,-23.38,True,1,12559,-1170.34,-4055857.91,14698300.06,10642442.15
19306,2004-11-22,1177.24,6.9,0.59,1527.46,-22.93,True,1,12560,-1177.24,-4057035.15,14786134.4,10729099.25
19307,2004-11-23,1176.94,-0.3,-0.02,1527.46,-22.95,True,1,12561,-1176.94,-4058212.09,14783543.34,10725331.25
19308,2004-11-24,1181.76,4.82,0.41,1527.46,-22.63,True,1,12562,-1181.76,-4059393.85,14845269.12,10785875.27
19309,2004-11-26,1182.65,0.89,0.08,1527.46,-22.57,True,1,12563,-1182.65,-4060576.5,14857631.95,10797055.45
19310,2004-11-29,1178.57,-4.08,-0.34,1527.46,-22.84,True,1,12564,-1178.57,-4061755.07,14807553.48,10745798.41
19311,2004-11-30,1173.82,-4.75,-0.4,1527.46,-23.15,True,1,12565,-1173.82,-4062928.89,14749048.3,10686119.41
19312,2004-12-01,1191.37,17.55,1.5,1527.46,-22.0,True,1,12566,-1191.37,-4064120.26,14970755.42,10906635.16
19313,2004-12-02,1190.33,-1.04,-0.09,1527.46,-22.07,True,1,12567,-1190.33,-4065310.59,14958877.11,10893566.52
19314,2004-12-03,1191.17,0.84,0.07,1527.46,-22.02,True,1,12568,-1191.17,-4066501.76,14970624.56,10904122.8
19315,2004-12-06,1190.25,-0.92,-0.08,1527.46,-22.08,True,1,12569,-1190.25,-4067692.01,14960252.25,10892560.24
19316,2004-12-07,1177.07,-13.18,-1.11,1527.46,-22.94,True,1,12570,-1177.07,-4068869.08,14795769.9,10726900.82
19317,2004-12-08,1182.81,5.74,0.49,1527.46,-22.56,True,1,12571,-1182.81,-4070051.89,14869104.51,10799052.62
19318,2004-12-09,1189.24,6.43,0.54,1527.46,-22.14,True,1,12572,-1189.24,-4071241.13,14951125.28,10879884.15
19319,2004-12-10,1188.0,-1.24,-0.1,1527.46,-22.22,True,1,12573,-1188.0,-4072429.13,14936724.0,10864294.87
19320,2004-12-13,1198.68,10.68,0.9,1527.46,-21.52,True,1,12574,-1198.68,-4073627.81,15072202.32,10998574.51
19321,2004-12-14,1203.38,4.7,0.39,1527.46,-21.22,True,1,12575,-1203.38,-4074831.19,15132503.5,11057672.31
19322,2004-12-15,1205.72,2.34,0.19,1527.46,-21.06,True,1,12576,-1205.72,-4076036.91,15163134.72,11087097.81
19323,2004-12-16,1203.21,-2.51,-0.21,1527.46,-21.23,True,1,12577,-1203.21,-4077240.12,15132772.17,11055532.05
19324,2004-12-17,1194.2,-9.01,-0.75,1527.46,-21.82,True,1,12578,-1194.2,-4078434.32,15020647.6,10942213.28
19325,2004-12-20,1194.65,0.45,0.04,1527.46,-21.79,True,1,12579,-1194.65,-4079628.97,15027502.35,10947873.38
19326,2004-12-21,1205.45,10.8,0.9,1527.46,-21.08,True,1,12580,-1205.45,-4080834.42,15164561.0,11083726.58
19327,2004-12-22,1209.57,4.12,0.34,1527.46,-20.81,True,1,12581,-1209.57,-4082043.99,15217600.17,11135556.18
19328,2004-12-23,1210.13,0.56,0.05,1527.46,-20.78,True,1,12582,-1210.13,-4083254.12,15225855.66,11142601.54
19329,2004-12-27,1204.92,-5.21,-0.43,1527.46,-21.12,True,1,12583,-1204.92,-4084459.04,15161508.36,11077049.32
19330,2004-12-28,1213.54,8.62,0.72,1527.46,-20.55,True,1,12584,-1213.54,-4085672.58,15271187.36,11185514.78
19331,2004-12-29,1213.45,-0.09,-0.01,1527.46,-20.56,True,1,12585,-1213.45,-4086886.03,15271268.25,11184382.22
19332,2004-12-30,1213.55,0.1,0.01,1527.46,-20.55,True,1,12586,-1213.55,-4088099.58,15273740.3,11185640.72
19333,2004-12-31,1211.92,-1.63,-0.13,1527.46,-20.66,True,1,12587,-1211.92,-4089311.5,15254437.04,11165125.54
19334,2005-01-03,1202.08,-9.84,-0.81,1527.46,-21.3,True,1,12588,-1202.08,-4090513.58,15131783.04,11041269.46
19335,2005-01-04,1188.05,-14.03,-1.17,1527.46,-22.22,True,1,12589,-1188.05,-4091701.63,14956361.45,10864659.82
19336,2005-01-05,1183.74,-4.31,-0.36,1527.46,-22.5,True,1,12590,-1183.74,-4092885.37,14903286.6,10810401.23
19337,2005-01-06,1187.89,4.15,0.35,1527.46,-22.23,True,1,12591,-1187.89,-4094073.26,14956722.99,10862649.73
19338,2005-01-07,1186.19,-1.7,-0.14,1527.46,-22.34,True,1,12592,-1186.19,-4095259.45,14936504.48,10841245.03
19339,2005-01-10,1190.25,4.06,0.34,1527.46,-22.08,True,1,12593,-1190.25,-4096449.7,14988818.25,10892368.55
19340,2005-01-11,1182.99,-7.26,-0.61,1527.46,-22.55,True,1,12594,-1182.99,-4097632.69,14898576.06,10800943.37
19341,2005-01-12,1187.7,4.71,0.4,1527.46,-22.24,True,1,12595,-1187.7,-4098820.39,14959081.5,10860261.11
19342,2005-01-13,1177.45,-10.25,-0.86,1527.46,-22.92,True,1,12596,-1177.45,-4099997.84,14831160.2,10731162.36
19343,2005-01-14,1184.52,7.07,0.6,1527.46,-22.45,True,1,12597,-1184.52,-4101182.36,14921398.44,10820216.08
19344,2005-01-18,1195.98,11.46,0.97,1527.46,-21.7,True,1,12598,-1195.98,-4102378.34,15066956.04,10964577.7
19345,2005-01-19,1184.63,-11.35,-0.95,1527.46,-22.44,True,1,12599,-1184.63,-4103562.97,14925153.37,10821590.4
19346,2005-01-20,1175.41,-9.22,-0.78,1527.46,-23.05,True,1,12600,-1175.41,-4104738.38,14810166.0,10705427.62
19347,2005-01-21,1167.87,-7.54,-0.64,1527.46,-23.54,True,1,12601,-1167.87,-4105906.25,14716329.87,10610423.62
19348,2005-01-24,1163.75,-4.12,-0.35,1527.46,-23.81,True,1,12602,-1163.75,-4107070.0,14665577.5,10558507.5
19349,2005-01-25,1168.41,4.66,0.4,1527.46,-23.51,True,1,12603,-1168.41,-4108238.41,14725471.23,10617232.82
19350,2005-01-26,1174.07,5.66,0.48,1527.46,-23.14,True,1,12604,-1174.07,-4109412.48,14797978.28,10688565.8
19351,2005-01-27,1174.55,0.48,0.04,1527.46,-23.1,True,1,12605,-1174.55,-4110587.03,14805202.75,10694615.72
19352,2005-01-28,1171.36,-3.19,-0.27,1527.46,-23.31,True,1,12606,-1171.36,-4111758.39,14766164.16,10654405.77
19353,2005-01-31,1181.27,9.91,0.85,1527.46,-22.66,True,1,12607,-1181.27,-4112939.66,14892270.89,10779331.23
19354,2005-02-01,1189.41,8.14,0.69,1527.46,-22.13,True,1,12608,-1189.41,-4114129.07,14996081.28,10881952.21
19355,2005-02-02,1193.19,3.78,0.32,1527.46,-21.88,True,1,12609,-1193.19,-4115322.26,15044932.71,10929610.45
19356,2005-02-03,1189.89,-3.3,-0.28,1527.46,-22.1,True,1,12610,-1189.89,-4116512.15,15004512.9,10888000.75
19357,2005-02-04,1203.03,13.14,1.1,1527.46,-21.24,True,1,12611,-1203.03,-4117715.18,15171411.33,11053696.15
19358,2005-02-07,1201.72,-1.31,-0.11,1527.46,-21.33,True,1,12612,-1201.72,-4118916.9,15156092.64,11037175.74
19359,2005-02-08,1202.3,0.58,0.05,1527.46,-21.29,True,1,12613,-1202.3,-4120119.2,15164609.9,11044490.7
19360,2005-02-09,1191.99,-10.31,-0.86,1527.46,-21.96,True,1,12614,-1191.99,-4121311.19,15035761.86,10914450.67
19361,2005-02-10,1197.01,5.02,0.42,1527.46,-21.63,True,1,12615,-1197.01,-4122508.2,15100281.15,10977772.95
19362,2005-02-11,1205.3,8.29,0.69,1527.46,-21.09,True,1,12616,-1205.3,-4123713.5,15206064.8,11082351.3
19363,2005-02-14,1206.14,0.84,0.07,1527.46,-21.04,True,1,12617,-1206.14,-4124919.64,15217868.38,11092948.74
19364,2005-02-15,1210.12,3.98,0.33,1527.46,-20.78,True,1,12618,-1210.12,-4126129.76,15269294.16,11143164.4
19365,2005-02-16,1210.34,0.22,0.02,1527.46,-20.76,True,1,12619,-1210.34,-4127340.1,15273280.46,11145940.36
19366,2005-02-17,1200.75,-9.59,-0.79,1527.46,-21.39,True,1,12620,-1200.75,-4128540.85,15153465.0,11024924.15
19367,2005-02-18,1201.59,0.84,0.07,1527.46,-21.33,True,1,12621,-1201.59,-4129742.44,15165267.39,11035524.95
19368,2005-02-22,1184.16,-17.43,-1.45,1527.46,-22.48,True,1,12622,-1184.16,-4130926.6,14946467.52,10815540.92
19369,2005-02-23,1190.8,6.64,0.56,1527.46,-22.04,True,1,12623,-1190.8,-4132117.4,15031468.4,10899351.0
19370,2005-02-24,1200.2,9.4,0.79,1527.46,-21.42,True,1,12624,-1200.2,-4133317.6,15151324.8,11018007.2
19371,2005-02-25,1211.37,11.17,0.93,1527.46,-20.69,True,1,12625,-1211.37,-4134528.97,15293546.25,11159017.28
19372,2005-02-28,1203.6,-7.77,-0.64,1527.46,-21.2,True,1,12626,-1203.6,-4135732.57,15196653.6,11060921.03
19373,2005-03-01,1210.41,6.81,0.57,1527.46,-20.76,True,1,12627,-1210.41,-4136942.98,15283847.07,11146904.09
19374,2005-03-02,1210.08,-0.33,-0.03,1527.46,-20.78,True,1,12628,-1210.08,-4138153.06,15280890.24,11142737.18
19375,2005-03-03,1210.47,0.39,0.03,1527.46,-20.75,True,1,12629,-1210.47,-4139363.53,15287025.63,11147662.1
19376,2005-03-04,1222.12,11.65,0.96,1527.46,-19.99,True,1,12630,-1222.12,-4140585.65,15435375.6,11294789.95
19377,2005-03-07,1225.31,3.19,0.26,1527.46,-19.78,True,1,12631,-1225.31,-4141810.96,15476890.61,11335079.65
19378,2005-03-08,1219.43,-5.88,-0.48,1527.46,-20.17,True,1,12632,-1219.43,-4143030.39,15403839.76,11260809.37
19379,2005-03-09,1207.01,-12.42,-1.02,1527.46,-20.98,True,1,12633,-1207.01,-4144237.4,15248157.33,11103919.93
19380,2005-03-10,1209.25,2.24,0.19,1527.46,-20.83,True,1,12634,-1209.25,-4145446.65,15277664.5,11132217.85
19381,2005-03-11,1200.08,-9.17,-0.76,1527.46,-21.43,True,1,12635,-1200.08,-4146646.73,15163010.8,11016364.07
19382,2005-03-14,1206.83,6.75,0.56,1527.46,-20.99,True,1,12636,-1206.83,-4147853.56,15249503.88,11101650.32
19383,2005-03-15,1197.75,-9.08,-0.75,1527.46,-21.59,True,1,12637,-1197.75,-4149051.31,15135966.75,10986915.44
19384,2005-03-16,1188.07,-9.68,-0.81,1527.46,-22.22,True,1,12638,-1188.07,-4150239.38,15014828.66,10864589.28
19385,2005-03-17,1190.21,2.14,0.18,1527.46,-22.08,True,1,12639,-1190.21,-4151429.59,15043064.19,10891634.6
19386,2005-03-18,1189.65,-0.56,-0.05,1527.46,-22.12,True,1,12640,-1189.65,-4152619.24,15037176.0,10884556.76
19387,2005-03-21,1183.78,-5.87,-0.49,1527.46,-22.5,True,1,12641,-1183.78,-4153803.02,14964162.98,10810359.96
19388,2005-03-22,1171.71,-12.07,-1.02,1527.46,-23.29,True,1,12642,-1171.71,-4154974.73,14812757.82,10657783.09
19389,2005-03-23,1172.53,0.82,0.07,1527.46,-23.24,True,1,12643,-1172.53,-4156147.26,14824296.79,10668149.53
19390,2005-03-24,1171.42,-1.11,-0.1,1527.46,-23.31,True,1,12644,-1171.42,-4157318.68,14811434.48,10654115.8
19391,2005-03-28,1174.28,2.86,0.24,1527.46,-23.12,True,1,12645,-1174.28,-4158492.96,14848770.6,10690277.64
19392,2005-03-29,1165.36,-8.92,-0.76,1527.46,-23.71,True,1,12646,-1165.36,-4159658.32,14737142.56,10577484.24
19393,2005-03-30,1181.41,16.05,1.38,1527.46,-22.66,True,1,12647,-1181.41,-4160839.73,14941292.27,10780452.54
19394,2005-03-31,1180.59,-0.82,-0.07,1527.46,-22.71,True,1,12648,-1180.59,-4162020.32,14932102.32,10770082.0
19395,2005-04-01,1172.92,-7.67,-0.65,1527.46,-23.21,True,1,12649,-1172.92,-4163193.24,14836265.08,10673071.84
19396,2005-04-04,1176.12,3.2,0.27,1527.46,-23.0,True,1,12650,-1176.12,-4164369.36,14877918.0,10713548.64
19397,2005-04-05,1181.39,5.27,0.45,1527.46,-22.66,True,1,12651,-1181.39,-4165550.75,14945764.89,10780214.14
19398,2005-04-06,1184.07,2.68,0.23,1527.46,-22.48,True,1,12652,-1184.07,-4166734.82,14980853.64,10814118.82
19399,2005-04-07,1191.14,7.07,0.6,1527.46,-22.02,True,1,12653,-1191.14,-4167925.96,15071494.42,10903568.46
19400,2005-04-08,1181.2,-9.94,-0.84,1527.46,-22.67,True,1,12654,-1181.2,-4169107.16,14946904.8,10777797.64
19401,2005-04-11,1181.21,0.01,0.0,1527.46,-22.67,True,1,12655,-1181.21,-4170288.37,14948212.55,10777924.18
19402,2005-04-12,1187.76,6.55,0.56,1527.46,-22.24,True,1,12656,-1187.76,-4171476.13,15032290.56,10860814.43
19403,2005-04-13,1173.79,-13.97,-1.18,1527.46,-23.15,True,1,12657,-1173.79,-4172649.92,14856660.03,10684010.11
19404,2005-04-14,1162.05,-11.74,-1.0,1527.46,-23.92,True,1,12658,-1162.05,-4173811.97,14709228.9,10535416.93
19405,2005-04-15,1142.62,-19.43,-1.67,1527.46,-25.2,True,1,12659,-1142.62,-4174954.59,14464426.58,10289471.99
19406,2005-04-18,1145.98,3.36,0.29,1527.46,-24.98,True,1,12660,-1145.98,-4176100.57,14508106.8,10332006.23
19407,2005-04-19,1152.78,6.8,0.59,1527.46,-24.53,True,1,12661,-1152.78,-4177253.35,14595347.58,10418094.23
19408,2005-04-20,1137.5,-15.28,-1.32,1527.46,-25.53,True,1,12662,-1137.5,-4178390.85,14403025.0,10224634.15
19409,2005-04-21,1159.95,22.45,1.97,1527.46,-24.06,True,1,12663,-1159.95,-4179550.8,14688446.85,10508896.05
19410,2005-04-22,1152.12,-7.83,-0.68,1527.46,-24.57,True,1,12664,-1152.12,-4180702.92,14590447.68,10409744.76
19411,2005-04-25,1162.1,9.98,0.87,1527.46,-23.92,True,1,12665,-1162.1,-4181865.02,14717996.5,10536131.48
19412,2005-04-26,1151.83,-10.27,-0.88,1527.46,-24.59,True,1,12666,-1151.83,-4183016.85,14589078.78,10406061.93
19413,2005-04-27,1156.38,4.55,0.4,1527.46,-24.29,True,1,12667,-1156.38,-4184173.23,14647865.46,10463692.23
19414,2005-04-28,1143.22,-13.16,-1.14,1527.46,-25.16,True,1,12668,-1143.22,-4185316.45,14482310.96,10296994.51
19415,2005-04-29,1156.85,13.63,1.19,1527.46,-24.26,True,1,12669,-1156.85,-4186473.3,14656132.65,10469659.35
19416,2005-05-02,1162.16,5.31,0.46,1527.46,-23.92,True,1,12670,-1162.16,-4187635.46,14724567.2,10536931.74
19417,2005-05-03,1161.17,-0.99,-0.08,1527.46,-23.98,True,1,12671,-1161.17,-4188796.63,14713185.07,10524388.44
19418,2005-05-04,1175.65,14.48,1.25,1527.46,-23.03,True,1,12672,-1175.65,-4189972.28,14897836.8,10707864.52
19419,2005-05-05,1172.63,-3.02,-0.26,1527.46,-23.23,True,1,12673,-1172.63,-4191144.91,14860739.99,10669595.08
19420,2005-05-06,1171.35,-1.28,-0.11,1527.46,-23.31,True,1,12674,-1171.35,-4192316.26,14845689.9,10653373.64
19421,2005-05-09,1178.84,7.49,0.64,1527.46,-22.82,True,1,12675,-1178.84,-4193495.1,14941797.0,10748301.9
19422,2005-05-10,1166.22,-12.62,-1.07,1527.46,-23.65,True,1,12676,-1166.22,-4194661.32,14783004.72,10588343.4
19423,2005-05-11,1171.11,4.89,0.42,1527.46,-23.33,True,1,12677,-1171.11,-4195832.43,14846161.47,10650329.04
19424,2005-05-12,1159.36,-11.75,-1.0,1527.46,-24.1,True,1,12678,-1159.36,-4196991.79,14698366.08,10501374.29
19425,2005-05-13,1154.05,-5.31,-0.46,1527.46,-24.45,True,1,12679,-1154.05,-4198145.84,14632199.95,10434054.11
19426,2005-05-16,1165.69,11.64,1.01,1527.46,-23.68,True,1,12680,-1165.69,-4199311.53,14780949.2,10581637.67
19427,2005-05-17,1173.8,8.11,0.7,1527.46,-23.15,True,1,12681,-1173.8,-4200485.33,14884957.8,10684472.47
19428,2005-05-18,1185.56,11.76,1.0,1527.46,-22.38,True,1,12682,-1185.56,-4201670.89,15035271.92,10833601.03
19429,2005-05-19,1191.08,5.52,0.47,1527.46,-22.02,True,1,12683,-1191.08,-4202861.97,15106467.64,10903605.67
19430,2005-05-20,1189.28,-1.8,-0.15,1527.46,-22.14,True,1,12684,-1189.28,-4204051.25,15084827.52,10880776.27
19431,2005-05-23,1193.86,4.58,0.38,1527.46,-21.84,True,1,12685,-1193.86,-4205245.11,15144114.1,10938868.99
19432,2005-05-24,1194.07,0.21,0.02,1527.46,-21.83,True,1,12686,-1194.07,-4206439.18,15147972.02,10941532.84
19433,2005-05-25,1190.01,-4.06,-0.34,1527.46,-22.09,True,1,12687,-1190.01,-4207629.19,15097656.87,10890027.68
19434,2005-05-26,1197.62,7.61,0.64,1527.46,-21.59,True,1,12688,-1197.62,-4208826.81,15195402.56,10986575.75
19435,2005-05-27,1198.78,1.16,0.1,1527.46,-21.52,True,1,12689,-1198.78,-4210025.59,15211319.42,11001293.83
19436,2005-05-31,1191.5,-7.28,-0.61,1527.46,-22.0,True,1,12690,-1191.5,-4211217.09,15120135.0,10908917.91
19437,2005-06-01,1202.22,10.72,0.9,1527.46,-21.29,True,1,12691,-1202.22,-4212419.31,15257374.02,11044954.71
19438,2005-06-02,1204.29,2.07,0.17,1527.46,-21.16,True,1,12692,-1204.29,-4213623.6,15284848.68,11071225.08
19439,2005-06-03,1196.02,-8.27,-0.69,1527.46,-21.7,True,1,12693,-1196.02,-4214819.62,15181081.86,10966262.24
19440,2005-06-06,1197.51,1.49,0.12,1527.46,-21.6,True,1,12694,-1197.51,-4216017.13,15201191.94,10985174.81
19441,2005-06-07,1197.26,-0.25,-0.02,1527.46,-21.62,True,1,12695,-1197.26,-4217214.39,15199215.7,10982001.31
19442,2005-06-08,1194.67,-2.59,-0.22,1527.46,-21.79,True,1,12696,-1194.67,-4218409.06,15167530.32,10949121.26
19443,2005-06-09,1200.93,6.26,0.52,1527.46,-21.38,True,1,12697,-1200.93,-4219609.99,15248208.21,11028598.22
19444,2005-06-10,1198.11,-2.82,-0.24,1527.46,-21.56,True,1,12698,-1198.11,-4220808.1,15213600.78,10992792.68
19445,2005-06-13,1200.82,2.71,0.23,1527.46,-21.38,True,1,12699,-1200.82,-4222008.92,15249213.18,11027204.26
19446,2005-06-14,1203.91,3.09,0.26,1527.46,-21.18,True,1,12700,-1203.91,-4223212.83,15289657.0,11066444.17
19447,2005-06-15,1206.58,2.67,0.22,1527.46,-21.01,True,1,12701,-1206.58,-4224419.41,15324772.58,11100353.17
19448,2005-06-16,1210.96,4.38,0.36,1527.46,-20.72,True,1,12702,-1210.96,-4225630.37,15381613.92,11155983.55
19449,2005-06-17,1216.96,6.0,0.5,1527.46,-20.33,True,1,12703,-1216.96,-4226847.33,15459042.88,11232195.55
19450,2005-06-20,1216.1,-0.86,-0.07,1527.46,-20.38,True,1,12704,-1216.1,-4228063.43,15449334.4,11221270.97
19451,2005-06-21,1213.61,-2.49,-0.2,1527.46,-20.55,True,1,12705,-1213.61,-4229277.04,15418915.05,11189638.01
19452,2005-06-22,1213.88,0.27,0.02,1527.46,-20.53,True,1,12706,-1213.88,-4230490.92,15423559.28,11193068.36
19453,2005-06-23,1200.73,-13.15,-1.08,1527.46,-21.39,True,1,12707,-1200.73,-4231691.65,15257676.11,11025984.46
19454,2005-06-24,1191.57,-9.16,-0.76,1527.46,-21.99,True,1,12708,-1191.57,-4232883.22,15142471.56,10909588.34
19455,2005-06-27,1190.69,-0.88,-0.07,1527.46,-22.05,True,1,12709,-1190.69,-4234073.91,15132479.21,10898405.3
19456,2005-06-28,1201.57,10.88,0.91,1527.46,-21.34,True,1,12710,-1201.57,-4235275.48,15271954.7,11036679.22
19457,2005-06-29,1199.85,-1.72,-0.14,1527.46,-21.45,True,1,12711,-1199.85,-4236475.33,15251293.35,11014818.02
19458,2005-06-30,1191.33,-8.52,-0.71,1527.46,-22.01,True,1,12712,-1191.33,-4237666.66,15144186.96,10906520.3
19459,2005-07-01,1194.44,3.11,0.26,1527.46,-21.8,True,1,12713,-1194.44,-4238861.1,15184915.72,10946054.62
19460,2005-07-05,1204.99,10.55,0.88,1527.46,-21.11,True,1,12714,-1204.99,-4240066.09,15320242.86,11080176.77
19461,2005-07-06,1194.94,-10.05,-0.83,1527.46,-21.77,True,1,12715,-1194.94,-4241261.03,15193662.1,10952401.07
19462,2005-07-07,1197.87,2.93,0.24,1527.46,-21.58,True,1,12716,-1197.87,-4242458.9,15232114.92,10989656.02
19463,2005-07-08,1211.86,13.99,1.17,1527.46,-20.66,True,1,12717,-1211.86,-4243670.76,15411223.62,11167552.86
19464,2005-07-11,1219.44,7.58,0.62,1527.46,-20.17,True,1,12718,-1219.44,-4244890.2,15508837.92,11263947.72
19465,2005-07-12,1222.21,2.77,0.23,1527.46,-19.98,True,1,12719,-1222.21,-4246112.41,15545288.99,11299176.58
19466,2005-07-13,1223.29,1.08,0.09,1527.46,-19.91,True,1,12720,-1223.29,-4247335.7,15560248.8,11312913.1
19467,2005-07-14,1226.5,3.21,0.26,1527.46,-19.7,True,1,12721,-1226.5,-4248562.2,15602306.5,11353744.3
19468,2005-07-15,1227.92,1.42,0.12,1527.46,-19.61,True,1,12722,-1227.92,-4249790.12,15621598.24,11371808.12
19469,2005-07-18,1221.13,-6.79,-0.55,1527.46,-20.06,True,1,12723,-1221.13,-4251011.25,15536436.99,11285425.74
19470,2005-07-19,1229.35,8.22,0.67,1527.46,-19.52,True,1,12724,-1229.35,-4252240.6,15642249.4,11390008.8
19471,2005-07-20,1235.2,5.85,0.48,1527.46,-19.13,True,1,12725,-1235.2,-4253475.8,15717920.0,11464444.2
19472,2005-07-21,1227.04,-8.16,-0.66,1527.46,-19.67,True,1,12726,-1227.04,-4254702.84,15615311.04,11360608.2
19473,2005-07-22,1233.68,6.64,0.54,1527.46,-19.23,True,1,12727,-1233.68,-4255936.52,15701045.36,11445108.84
19474,2005-07-25,1229.03,-4.65,-0.38,1527.46,-19.54,True,1,12728,-1229.03,-4257165.55,15643093.84,11385928.29
19475,2005-07-26,1231.16,2.13,0.17,1527.46,-19.4,True,1,12729,-1231.16,-4258396.71,15671435.64,11413038.93
19476,2005-07-27,1236.79,5.63,0.46,1527.46,-19.03,True,1,12730,-1236.79,-4259633.5,15744336.7,11484703.2
19477,2005-07-28,1243.72,6.93,0.56,1527.46,-18.58,True,1,12731,-1243.72,-4260877.22,15833799.32,11572922.1
19478,2005-07-29,1234.18,-9.54,-0.77,1527.46,-19.2,True,1,12732,-1234.18,-4262111.4,15713579.76,11451468.36
19479,2005-08-01,1235.35,1.17,0.1,1527.46,-19.12,True,1,12733,-1235.35,-4263346.75,15729711.55,11466364.8
19480,2005-08-02,1244.12,8.77,0.71,1527.46,-18.55,True,1,12734,-1244.12,-4264590.87,15842624.08,11578033.21
19481,2005-08-03,1245.04,0.92,0.07,1527.46,-18.49,True,1,12735,-1245.04,-4265835.91,15855584.4,11589748.49
19482,2005-08-04,1235.86,-9.18,-0.74,1527.46,-19.09,True,1,12736,-1235.86,-4267071.77,15739912.96,11472841.19
19483,2005-08-05,1226.42,-9.44,-0.76,1527.46,-19.71,True,1,12737,-1226.42,-4268298.19,15620911.54,11352613.35
19484,2005-08-08,1223.13,-3.29,-0.27,1527.46,-19.92,True,1,12738,-1223.13,-4269521.32,15580229.94,11310708.62
19485,2005-08-09,1231.38,8.25,0.67,1527.46,-19.38,True,1,12739,-1231.38,-4270752.7,15686549.82,11415797.12
19486,2005-08-10,1229.13,-2.25,-0.18,1527.46,-19.53,True,1,12740,-1229.13,-4271981.83,15659116.2,11387134.37
19487,2005-08-11,1237.81,8.68,0.71,1527.46,-18.96,True,1,12741,-1237.81,-4273219.64,15770937.21,11497717.57
19488,2005-08-12,1230.39,-7.42,-0.6,1527.46,-19.45,True,1,12742,-1230.39,-4274450.03,15677629.38,11403179.35
19489,2005-08-15,1233.87,3.48,0.28,1527.46,-19.22,True,1,12743,-1233.87,-4275683.9,15723205.41,11447521.51
19490,2005-08-16,1219.34,-14.53,-1.18,1527.46,-20.17,True,1,12744,-1219.34,-4276903.24,15539268.96,11262365.72
19491,2005-08-17,1220.24,0.9,0.07,1527.46,-20.11,True,1,12745,-1220.24,-4278123.48,15551958.8,11273835.32
19492,2005-08-18,1219.02,-1.22,-0.1,1527.46,-20.19,True,1,12746,-1219.02,-4279342.5,15537628.92,11258286.42
19493,2005-08-19,1219.71,0.69,0.06,1527.46,-20.15,True,1,12747,-1219.71,-4280562.21,15547643.37,11267081.16
19494,2005-08-22,1221.73,2.02,0.17,1527.46,-20.02,True,1,12748,-1221.73,-4281783.94,15574614.04,11292830.1
19495,2005-08-23,1217.59,-4.14,-0.34,1527.46,-20.29,True,1,12749,-1217.59,-4283001.53,15523054.91,11240053.38
19496,2005-08-24,1209.59,-8.0,-0.66,1527.46,-20.81,True,1,12750,-1209.59,-4284211.12,15422272.5,11138061.38
19497,2005-08-25,1212.37,2.78,0.23,1527.46,-20.63,True,1,12751,-1212.37,-4285423.49,15458929.87,11173506.38
19498,2005-08-26,1205.1,-7.27,-0.6,1527.46,-21.1,True,1,12752,-1205.1,-4286628.59,15367435.2,11080806.61
19499,2005-08-29,1212.28,7.18,0.6,1527.46,-20.63,True,1,12753,-1212.28,-4287840.87,15460206.84,11172365.97
19500,2005-08-30,1208.41,-3.87,-0.32,1527.46,-20.89,True,1,12754,-1208.41,-4289049.28,15412061.14,11123011.86
19501,2005-08-31,1220.33,11.92,0.99,1527.46,-20.11,True,1,12755,-1220.33,-4290269.61,15565309.15,11275039.54
19502,2005-09-01,1221.59,1.26,0.1,1527.46,-20.02,True,1,12756,-1221.59,-4291491.2,15582602.04,11291110.84
19503,2005-09-02,1218.02,-3.57,-0.29,1527.46,-20.26,True,1,12757,-1218.02,-4292709.22,15538281.14,11245571.92
19504,2005-09-06,1233.39,15.37,1.26,1527.46,-19.25,True,1,12758,-1233.39,-4293942.61,15735589.62,11441647.01
19505,2005-09-07,1236.36,2.97,0.24,1527.46,-19.06,True,1,12759,-1236.36,-4295178.97,15774717.24,11479538.27
19506,2005-09-08,1231.67,-4.69,-0.38,1527.46,-19.36,True,1,12760,-1231.67,-4296410.64,15716109.2,11419698.56
19507,2005-09-09,1241.48,9.81,0.8,1527.46,-18.72,True,1,12761,-1241.48,-4297652.12,15842526.28,11544874.16
19508,2005-09-12,1240.56,-0.92,-0.07,1527.46,-18.78,True,1,12762,-1240.56,-4298892.68,15832026.72,11533134.04
19509,2005-09-13,1231.2,-9.36,-0.76,1527.46,-19.4,True,1,12763,-1231.2,-4300123.88,15713805.6,11413681.72
19510,2005-09-14,1227.16,-4.04,-0.33,1527.46,-19.66,True,1,12764,-1227.16,-4301351.04,15663470.24,11362119.2
19511,2005-09-15,1227.73,0.57,0.05,1527.46,-19.62,True,1,12765,-1227.73,-4302578.77,15671973.45,11369394.68
19512,2005-09-16,1237.91,10.18,0.83,1527.46,-18.96,True,1,12766,-1237.91,-4303816.68,15803159.06,11499342.38
19513,2005-09-19,1231.02,-6.89,-0.56,1527.46,-19.41,True,1,12767,-1231.02,-4305047.7,15716432.34,11411384.64
19514,2005-09-20,1221.34,-9.68,-0.79,1527.46,-20.04,True,1,12768,-1221.34,-4306269.04,15594069.12,11287800.08
19515,2005-09-21,1210.2,-11.14,-0.91,1527.46,-20.77,True,1,12769,-1210.2,-4307479.24,15453043.8,11145564.56
19516,2005-09-22,1214.62,4.42,0.36,1527.46,-20.48,True,1,12770,-1214.62,-4308693.86,15510697.4,11202003.54
19517,2005-09-23,1215.29,0.67,0.06,1527.46,-20.44,True,1,12771,-1215.29,-4309909.15,15520468.59,11210559.44
19518,2005-09-26,1215.63,0.34,0.03,1527.46,-20.42,True,1,12772,-1215.63,-4311124.78,15526026.36,11214901.58
19519,2005-09-27,1215.66,0.03,0.0,1527.46,-20.41,True,1,12773,-1215.66,-4312340.44,15527625.18,11215284.74
19520,2005-09-28,1216.89,1.23,0.1,1527.46,-20.33,True,1,12774,-1216.89,-4313557.33,15544552.86,11230995.53
19521,2005-09-29,1227.68,10.79,0.89,1527.46,-19.63,True,1,12775,-1227.68,-4314785.01,15683612.0,11368826.99
19522,2005-09-30,1228.81,1.13,0.09,1527.46,-19.55,True,1,12776,-1228.81,-4316013.82,15699276.56,11383262.74
19523,2005-10-03,1226.7,-2.11,-0.17,1527.46,-19.69,True,1,12777,-1226.7,-4317240.52,15673545.9,11356305.38
19524,2005-10-04,1214.47,-12.23,-1.0,1527.46,-20.49,True,1,12778,-1214.47,-4318454.99,15518497.66,11200042.67
19525,2005-10-05,1196.39,-18.08,-1.49,1527.46,-21.68,True,1,12779,-1196.39,-4319651.38,15288667.81,10969016.43
19526,2005-10-06,1191.49,-4.9,-0.41,1527.46,-22.0,True,1,12780,-1191.49,-4320842.87,15227242.2,10906399.33
19527,2005-10-07,1195.9,4.41,0.37,1527.46,-21.71,True,1,12781,-1195.9,-4322038.77,15284797.9,10962759.13
19528,2005-10-10,1187.33,-8.57,-0.72,1527.46,-22.27,True,1,12782,-1187.33,-4323226.1,15176452.06,10853225.96
19529,2005-10-11,1184.87,-2.46,-0.21,1527.46,-22.43,True,1,12783,-1184.87,-4324410.97,15146193.21,10821782.24
19530,2005-10-12,1177.68,-7.19,-0.61,1527.46,-22.9,True,1,12784,-1177.68,-4325588.65,15055461.12,10729872.47
19531,2005-10-13,1176.84,-0.84,-0.07,1527.46,-22.95,True,1,12785,-1176.84,-4326765.49,15045899.4,10719133.91
19532,2005-10-14,1186.57,9.73,0.83,1527.46,-22.32,True,1,12786,-1186.57,-4327952.06,15171484.02,10843531.96
19533,2005-10-17,1190.1,3.53,0.3,1527.46,-22.09,True,1,12787,-1190.1,-4329142.16,15217808.7,10888666.54
19534,2005-10-18,1178.14,-11.96,-1.0,1527.46,-22.87,True,1,12788,-1178.14,-4330320.3,15066054.32,10735734.02
19535,2005-10-19,1195.76,17.62,1.5,1527.46,-21.72,True,1,12789,-1195.76,-4331516.06,15292574.64,10961058.58
19536,2005-10-20,1177.8,-17.96,-1.5,1527.46,-22.89,True,1,12790,-1177.8,-4332693.86,15064062.0,10731368.14
19537,2005-10-21,1179.59,1.79,0.15,1527.46,-22.77,True,1,12791,-1179.59,-4333873.45,15088135.69,10754262.24
19538,2005-10-24,1199.38,19.79,1.68,1527.46,-21.48,True,1,12792,-1199.38,-4335072.83,15342468.96,11007396.13
19539,2005-10-25,1196.54,-2.84,-0.24,1527.46,-21.66,True,1,12793,-1196.54,-4336269.37,15307336.22,10971066.85
19540,2005-10-26,1191.38,-5.16,-0.43,1527.46,-22.0,True,1,12794,-1191.38,-4337460.75,15242515.72,10905054.97
19541,2005-10-27,1178.9,-12.48,-1.05,1527.46,-22.82,True,1,12795,-1178.9,-4338639.65,15084025.5,10745385.85
19542,2005-10-28,1198.41,19.51,1.66,1527.46,-21.54,True,1,12796,-1198.41,-4339838.06,15334854.36,10995016.3
19543,2005-10-31,1207.01,8.6,0.72,1527.46,-20.98,True,1,12797,-1207.01,-4341045.07,15446106.97,11105061.9
19544,2005-11-01,1202.76,-4.25,-0.35,1527.46,-21.26,True,1,12798,-1202.76,-4342247.83,15392922.48,11050674.65
19545,2005-11-02,1214.76,12.0,1.0,1527.46,-20.47,True,1,12799,-1214.76,-4343462.59,15547713.24,11204250.65
19546,2005-11-03,1219.94,5.18,0.43,1527.46,-20.13,True,1,12800,-1219.94,-4344682.53,15615232.0,11270549.47
19547,2005-11-04,1220.14,0.2,0.02,1527.46,-20.12,True,1,12801,-1220.14,-4345902.67,15619012.14,11273109.47
19548,2005-11-07,1222.81,2.67,0.22,1527.46,-19.94,True,1,12802,-1222.81,-4347125.48,15654413.62,11307288.14
19549,2005-11-08,1218.59,-4.22,-0.34,1527.46,-20.22,True,1,12803,-1218.59,-4348344.07,15601607.77,11253263.7
19550,2005-11-09,1220.65,2.06,0.17,1527.46,-20.09,True,1,12804,-1220.65,-4349564.72,15629202.6,11279637.88
19551,2005-11-10,1230.96,10.31,0.84,1527.46,-19.41,True,1,12805,-1230.96,-4350795.68,15762442.8,11411647.12
19552,2005-11-11,1234.72,3.76,0.3,1527.46,-19.16,True,1,12806,-1234.72,-4352030.4,15811824.32,11459793.92
19553,2005-11-14,1233.76,-0.96,-0.08,1527.46,-19.23,True,1,12807,-1233.76,-4353264.16,15800764.32,11447500.16
19554,2005-11-15,1229.01,-4.75,-0.38,1527.46,-19.54,True,1,12808,-1229.01,-4354493.17,15741160.08,11386666.91
19555,2005-11-16,1231.21,2.2,0.18,1527.46,-19.4,True,1,12809,-1231.21,-4355724.38,15770568.89,11414844.51
19556,2005-11-17,1242.8,11.59,0.94,1527.46,-18.64,True,1,12810,-1242.8,-4356967.18,15920268.0,11563300.82
19557,2005-11-18,1248.27,5.47,0.44,1527.46,-18.28,True,1,12811,-1248.27,-4358215.45,15991586.97,11633371.52
19558,2005-11-21,1254.85,6.58,0.53,1527.46,-17.85,True,1,12812,-1254.85,-4359470.3,16077138.2,11717667.9
19559,2005-11-22,1261.23,6.38,0.51,1527.46,-17.43,True,1,12813,-1261.23,-4360731.53,16160139.99,11799408.46
19560,2005-11-23,1265.61,4.38,0.35,1527.46,-17.14,True,1,12814,-1265.61,-4361997.14,16217526.54,11855529.4
19561,2005-11-25,1268.25,2.64,0.21,1527.46,-16.97,True,1,12815,-1268.25,-4363265.39,16252623.75,11889358.36
19562,2005-11-28,1257.46,-10.79,-0.85,1527.46,-17.68,True,1,12816,-1257.46,-4364522.85,16115607.36,11751084.51
19563,2005-11-29,1257.48,0.02,0.0,1527.46,-17.68,True,1,12817,-1257.48,-4365780.33,16117121.16,11751340.83
19564,2005-11-30,1249.48,-8.0,-0.64,1527.46,-18.2,True,1,12818,-1249.48,-4367029.81,16015834.64,11648804.83
19565,2005-12-01,1264.67,15.19,1.22,1527.46,-17.2,True,1,12819,-1264.67,-4368294.48,16211804.73,11843510.25
19566,2005-12-02,1265.08,0.41,0.03,1527.46,-17.18,True,1,12820,-1265.08,-4369559.56,16218325.6,11848766.04
19567,2005-12-05,1262.09,-2.99,-0.24,1527.46,-17.37,True,1,12821,-1262.09,-4370821.65,16181255.89,11810434.24
19568,2005-12-06,1263.7,1.61,0.13,1527.46,-17.27,True,1,12822,-1263.7,-4372085.35,16203161.4,11831076.05
19569,2005-12-07,1257.37,-6.33,-0.5,1527.46,-17.68,True,1,12823,-1257.37,-4373342.72,16123255.51,11749912.79
19570,2005-12-08,1255.84,-1.53,-0.12,1527.46,-17.78,True,1,12824,-1255.84,-4374598.56,16104892.16,11730293.6
19571,2005-12-09,1259.37,3.53,0.28,1527.46,-17.55,True,1,12825,-1259.37,-4375857.93,16151420.25,11775562.32
19572,2005-12-12,1260.43,1.06,0.08,1527.46,-17.48,True,1,12826,-1260.43,-4377118.36,16166275.18,11789156.82
19573,2005-12-13,1267.43,7.0,0.56,1527.46,-17.02,True,1,12827,-1267.43,-4378385.79,16257324.61,11878938.82
19574,2005-12-14,1272.74,5.31,0.42,1527.46,-16.68,True,1,12828,-1272.74,-4379658.53,16326708.72,11947050.19
19575,2005-12-15,1270.94,-1.8,-0.14,1527.46,-16.79,True,1,12829,-1270.94,-4380929.47,16304889.26,11923959.79
19576,2005-12-16,1267.32,-3.62,-0.28,1527.46,-17.03,True,1,12830,-1267.32,-4382196.79,16259715.6,11877518.81
19577,2005-12-19,1259.92,-7.4,-0.58,1527.46,-17.52,True,1,12831,-1259.92,-4383456.71,16166033.52,11782576.81
19578,2005-12-20,1259.62,-0.3,-0.02,1527.46,-17.54,True,1,12832,-1259.62,-4384716.33,16163443.84,11778727.51
19579,2005-12-21,1262.79,3.17,0.25,1527.46,-17.33,True,1,12833,-1262.79,-4385979.12,16205384.07,11819404.95
19580,2005-12-22,1268.12,5.33,0.42,1527.46,-16.98,True,1,12834,-1268.12,-4387247.24,16275052.08,11887804.84
19581,2005-12-23,1268.66,0.54,0.04,1527.46,-16.94,True,1,12835,-1268.66,-4388515.9,16283251.1,11894735.2
19582,2005-12-27,1256.54,-12.12,-0.96,1527.46,-17.74,True,1,12836,-1256.54,-4389772.44,16128947.44,11739175.0
19583,2005-12-28,1258.17,1.63,0.13,1527.46,-17.63,True,1,12837,-1258.17,-4391030.61,16151128.29,11760097.68
19584,2005-12-29,1254.42,-3.75,-0.3,1527.46,-17.88,True,1,12838,-1254.42,-4392285.03,16104243.96,11711958.93
19585,2005-12-30,1248.29,-6.13,-0.49,1527.46,-18.28,True,1,12839,-1248.29,-4393533.32,16026795.31,11633261.99
19586,2006-01-03,1268.8,20.51,1.64,1527.46,-16.93,True,1,12840,-1268.8,-4394802.12,16291392.0,11896589.88
19587,2006-01-04,1273.46,4.66,0.37,1527.46,-16.63,True,1,12841,-1273.46,-4396075.58,16352499.86,11956424.28
19588,2006-01-05,1273.48,0.02,0.0,1527.46,-16.63,True,1,12842,-1273.48,-4397349.06,16354030.16,11956681.1
19589,2006-01-06,1285.45,11.97,0.94,1527.46,-15.84,True,1,12843,-1285.45,-4398634.51,16509034.35,12110399.84
19590,2006-01-09,1290.15,4.7,0.37,1527.46,-15.54,True,1,12844,-1290.15,-4399924.66,16570686.6,12170761.94
19591,2006-01-10,1289.69,-0.46,-0.04,1527.46,-15.57,True,1,12845,-1289.69,-4401214.35,16566068.05,12164853.7
19592,2006-01-11,1294.18,4.49,0.35,1527.46,-15.27,True,1,12846,-1294.18,-4402508.53,16625036.28,12222527.75
19593,2006-01-12,1286.06,-8.12,-0.63,1527.46,-15.8,True,1,12847,-1286.06,-4403794.59,16522012.82,12118218.23
19594,2006-01-13,1287.61,1.55,0.12,1527.46,-15.7,True,1,12848,-1287.61,-4405082.2,16543213.28,12138131.08
19595,2006-01-17,1282.93,-4.68,-0.36,1527.46,-16.01,True,1,12849,-1282.93,-4406365.13,16484367.57,12078002.44
19596,2006-01-18,1277.93,-5.0,-0.39,1527.46,-16.34,True,1,12850,-1277.93,-4407643.06,16421400.5,12013757.44
19597,2006-01-19,1285.04,7.11,0.56,1527.46,-15.87,True,1,12851,-1285.04,-4408928.1,16514049.04,12105120.94
19598,2006-01-20,1261.49,-23.55,-1.83,1527.46,-17.41,True,1,12852,-1261.49,-4410189.59,16212669.48,11802479.89
19599,2006-01-23,1263.82,2.33,0.18,1527.46,-17.26,True,1,12853,-1263.82,-4411453.41,16243878.46,11832425.05
19600,2006-01-24,1266.86,3.04,0.24,1527.46,-17.06,True,1,12854,-1266.86,-4412720.27,16284218.44,11871498.17
19601,2006-01-25,1264.68,-2.18,-0.17,1527.46,-17.2,True,1,12855,-1264.68,-4413984.95,16257461.4,11843476.45
19602,2006-01-26,1273.83,9.15,0.72,1527.46,-16.6,True,1,12856,-1273.83,-4415258.78,16376358.48,11961099.7
19603,2006-01-27,1283.72,9.89,0.78,1527.46,-15.96,True,1,12857,-1283.72,-4416542.5,16504788.04,12088245.54
19604,2006-01-30,1285.19,1.47,0.12,1527.46,-15.86,True,1,12858,-1285.19,-4417827.69,16524973.02,12107145.33
19605,2006-01-31,1280.08,-5.11,-0.4,1527.46,-16.2,True,1,12859,-1280.08,-4419107.77,16460548.72,12041440.95
19606,2006-02-01,1282.46,2.38,0.19,1527.46,-16.04,True,1,12860,-1282.46,-4420390.23,16492435.6,12072045.37
19607,2006-02-02,1270.84,-11.62,-0.91,1527.46,-16.8,True,1,12861,-1270.84,-4421661.07,16344273.24,11922612.17
19608,2006-02-03,1264.03,-6.81,-0.54,1527.46,-17.25,True,1,12862,-1264.03,-4422925.1,16257953.86,11835028.76
19609,2006-02-06,1265.02,0.99,0.08,1527.46,-17.18,True,1,12863,-1265.02,-4424190.12,16271952.26,11847762.14
19610,2006-02-07,1254.78,-10.24,-0.81,1527.46,-17.85,True,1,12864,-1254.78,-4425444.9,16141489.92,11716045.02
19611,2006-02-08,1265.65,10.87,0.87,1527.46,-17.14,True,1,12865,-1265.65,-4426710.55,16282587.25,11855876.7
19612,2006-02-09,1263.78,-1.87,-0.15,1527.46,-17.26,True,1,12866,-1263.78,-4427974.33,16259793.48,11831819.15
19613,2006-02-10,1266.99,3.21,0.25,1527.46,-17.05,True,1,12867,-1266.99,-4429241.32,16302360.33,11873119.01
19614,2006-02-13,1262.86,-4.13,-0.33,1527.46,-17.32,True,1,12868,-1262.86,-4430504.18,16250482.48,11819978.3
19615,2006-02-14,1275.53,12.67,1.0,1527.46,-16.49,True,1,12869,-1275.53,-4431779.71,16414795.57,11983015.86
19616,2006-02-15,1280.0,4.47,0.35,1527.46,-16.2,True,1,12870,-1280.0,-4433059.71,16473600.0,12040540.29
19617,2006-02-16,1289.38,9.38,0.73,1527.46,-15.59,True,1,12871,-1289.38,-4434349.09,16595609.98,12161260.89
19618,2006-02-17,1287.24,-2.14,-0.17,1527.46,-15.73,True,1,12872,-1287.24,-4435636.33,16569353.28,12133716.95
19619,2006-02-21,1283.03,-4.21,-0.33,1527.46,-16.0,True,1,12873,-1283.03,-4436919.36,16516445.19,12079525.83
19620,2006-02-22,1292.67,9.64,0.75,1527.46,-15.37,True,1,12874,-1292.67,-4438212.03,16641833.58,12203621.55
19621,2006-02-23,1287.79,-4.88,-0.38,1527.46,-15.69,True,1,12875,-1287.79,-4439499.82,16580296.25,12140796.43
19622,2006-02-24,1289.43,1.64,0.13,1527.46,-15.58,True,1,12876,-1289.43,-4440789.25,16602700.68,12161911.43
19623,2006-02-27,1294.12,4.69,0.36,1527.46,-15.28,True,1,12877,-1294.12,-4442083.37,16664383.24,12222299.87
19624,2006-02-28,1280.66,-13.46,-1.04,1527.46,-16.16,True,1,12878,-1280.66,-4443364.03,16492339.48,12048975.45
19625,2006-03-01,1291.24,10.58,0.83,1527.46,-15.46,True,1,12879,-1291.24,-4444655.27,16629879.96,12185224.69
19626,2006-03-02,1289.14,-2.1,-0.16,1527.46,-15.6,True,1,12880,-1289.14,-4445944.41,16604123.2,12158178.79
19627,2006-03-03,1287.23,-1.91,-0.15,1527.46,-15.73,True,1,12881,-1287.23,-4447231.64,16580809.63,12133577.99
19628,2006-03-06,1278.26,-8.97,-0.7,1527.46,-16.32,True,1,12882,-1278.26,-4448509.9,16466545.32,12018035.42
19629,2006-03-07,1275.88,-2.38,-0.19,1527.46,-16.47,True,1,12883,-1275.88,-4449785.78,16437162.04,11987376.26
19630,2006-03-08,1278.47,2.59,0.2,1527.46,-16.3,True,1,12884,-1278.47,-4451064.25,16471807.48,12020743.23
19631,2006-03-09,1272.23,-6.24,-0.49,1527.46,-16.71,True,1,12885,-1272.23,-4452336.48,16392683.55,11940347.07
19632,2006-03-10,1281.42,9.19,0.72,1527.46,-16.11,True,1,12886,-1281.42,-4453617.9,16512378.12,12058760.22
19633,2006-03-13,1284.13,2.71,0.21,1527.46,-15.93,True,1,12887,-1284.13,-4454902.03,16548583.31,12093681.28
19634,2006-03-14,1297.48,13.35,1.04,1527.46,-15.06,True,1,12888,-1297.48,-4456199.51,16721922.24,12265722.73
19635,2006-03-15,1303.02,5.54,0.43,1527.46,-14.69,True,1,12889,-1303.02,-4457502.53,16794624.78,12337122.25
19636,2006-03-16,1305.33,2.31,0.18,1527.46,-14.54,True,1,12890,-1305.33,-4458807.86,16825703.7,12366895.84
19637,2006-03-17,1307.25,1.92,0.15,1527.46,-14.42,True,1,12891,-1307.25,-4460115.11,16851759.75,12391644.64
19638,2006-03-20,1305.08,-2.17,-0.17,1527.46,-14.56,True,1,12892,-1305.08,-4461420.19,16825091.36,12363671.17
19639,2006-03-21,1297.23,-7.85,-0.6,1527.46,-15.07,True,1,12893,-1297.23,-4462717.42,16725186.39,12262468.97
19640,2006-03-22,1305.04,7.81,0.6,1527.46,-14.56,True,1,12894,-1305.04,-4464022.46,16827185.76,12363163.3
19641,2006-03-23,1301.67,-3.37,-0.26,1527.46,-14.78,True,1,12895,-1301.67,-4465324.13,16785034.65,12319710.52
19642,2006-03-24,1302.95,1.28,0.1,1527.46,-14.7,True,1,12896,-1302.95,-4466627.08,16802843.2,12336216.12
19643,2006-03-27,1301.61,-1.34,-0.1,1527.46,-14.79,True,1,12897,-1301.61,-4467928.69,16786864.17,12318935.48
19644,2006-03-28,1293.23,-8.38,-0.64,1527.46,-15.34,True,1,12898,-1293.23,-4469221.92,16680080.54,12210858.62
19645,2006-03-29,1302.89,9.66,0.75,1527.46,-14.7,True,1,12899,-1302.89,-4470524.81,16805978.11,12335453.3
19646,2006-03-30,1300.25,-2.64,-0.2,1527.46,-14.88,True,1,12900,-1300.25,-4471825.06,16773225.0,12301399.94
19647,2006-03-31,1294.87,-5.38,-0.41,1527.46,-15.23,True,1,12901,-1294.87,-4473119.93,16705117.87,12231997.94
19648,2006-04-03,1297.81,2.94,0.23,1527.46,-15.04,True,1,12902,-1297.81,-4474417.74,16744344.62,12269926.88
19649,2006-04-04,1305.93,8.12,0.63,1527.46,-14.5,True,1,12903,-1305.93,-4475723.67,16850414.79,12374691.12
19650,2006-04-05,1311.56,5.63,0.43,1527.46,-14.14,True,1,12904,-1311.56,-4477035.23,16924370.24,12447335.01
19651,2006-04-06,1309.04,-2.52,-0.19,1527.46,-14.3,True,1,12905,-1309.04,-4478344.27,16893161.2,12414816.93
19652,2006-04-07,1295.5,-13.54,-1.03,1527.46,-15.19,True,1,12906,-1295.5,-4479639.77,16719723.0,12240083.23
19653,2006-04-10,1296.62,1.12,0.09,1527.46,-15.11,True,1,12907,-1296.62,-4480936.39,16735474.34,12254537.95
19654,2006-04-11,1286.57,-10.05,-0.78,1527.46,-15.77,True,1,12908,-1286.57,-4482222.96,16607045.56,12124822.6
19655,2006-04-12,1288.12,1.55,0.12,1527.46,-15.67,True,1,12909,-1288.12,-4483511.08,16628341.08,12144830.0
19656,2006-04-13,1289.12,1.0,0.08,1527.46,-15.6,True,1,12910,-1289.12,-4484800.2,16642539.2,12157739.0
19657,2006-04-17,1285.33,-3.79,-0.29,1527.46,-15.85,True,1,12911,-1285.33,-4486085.53,16594895.63,12108810.1
19658,2006-04-18,1307.28,21.95,1.71,1527.46,-14.42,True,1,12912,-1307.28,-4487392.81,16879599.36,12392206.55
19659,2006-04-19,1309.93,2.65,0.2,1527.46,-14.24,True,1,12913,-1309.93,-4488702.74,16915126.09,12426423.35
19660,2006-04-20,1311.46,1.53,0.12,1527.46,-14.14,True,1,12914,-1311.46,-4490014.2,16936194.44,12446180.24
19661,2006-04-21,1311.28,-0.18,-0.01,1527.46,-14.15,True,1,12915,-1311.28,-4491325.48,16935181.2,12443855.72
19662,2006-04-24,1308.11,-3.17,-0.24,1527.46,-14.36,True,1,12916,-1308.11,-4492633.59,16895548.76,12402915.17
19663,2006-04-25,1301.74,-6.37,-0.49,1527.46,-14.78,True,1,12917,-1301.74,-4493935.33,16814575.58,12320640.25
19664,2006-04-26,1305.41,3.67,0.28,1527.46,-14.54,True,1,12918,-1305.41,-4495240.74,16863286.38,12368045.64
19665,2006-04-27,1309.72,4.31,0.33,1527.46,-14.26,True,1,12919,-1309.72,-4496550.46,16920272.68,12423722.22
19666,2006-04-28,1310.61,0.89,0.07,1527.46,-14.2,True,1,12920,-1310.61,-4497861.07,16933081.2,12435220.13
19667,2006-05-01,1305.19,-5.42,-0.41,1527.46,-14.55,True,1,12921,-1305.19,-4499166.26,16864359.99,12365193.73
19668,2006-05-02,1313.21,8.02,0.61,1527.46,-14.03,True,1,12922,-1313.21,-4500479.47,16969299.62,12468820.15
19669,2006-05-03,1308.12,-5.09,-0.39,1527.46,-14.36,True,1,12923,-1308.12,-4501787.59,16904834.76,12403047.17
19670,2006-05-04,1312.25,4.13,0.32,1527.46,-14.09,True,1,12924,-1312.25,-4503099.84,16959519.0,12456419.16
19671,2006-05-05,1325.76,13.51,1.03,1527.46,-13.2,True,1,12925,-1325.76,-4504425.6,17135448.0,12631022.4
19672,2006-05-08,1324.66,-1.1,-0.08,1527.46,-13.28,True,1,12926,-1324.66,-4505750.26,17122555.16,12616804.9
19673,2006-05-09,1325.14,0.48,0.04,1527.46,-13.25,True,1,12927,-1325.14,-4507075.4,17130084.78,12623009.38
19674,2006-05-10,1322.85,-2.29,-0.17,1527.46,-13.4,True,1,12928,-1322.85,-4508398.25,17101804.8,12593406.55
19675,2006-05-11,1305.92,-16.93,-1.28,1527.46,-14.5,True,1,12929,-1305.92,-4509704.17,16884239.68,12374535.51
19676,2006-05-12,1291.24,-14.68,-1.12,1527.46,-15.46,True,1,12930,-1291.24,-4510995.41,16695733.2,12184737.79
19677,2006-05-15,1294.5,3.26,0.25,1527.46,-15.25,True,1,12931,-1294.5,-4512289.91,16739179.5,12226889.59
19678,2006-05-16,1292.08,-2.42,-0.19,1527.46,-15.41,True,1,12932,-1292.08,-4513581.99,16709178.56,12195596.57
19679,2006-05-17,1270.32,-21.76,-1.68,1527.46,-16.83,True,1,12933,-1270.32,-4514852.31,16429048.56,11914196.25
19680,2006-05-18,1261.81,-8.51,-0.67,1527.46,-17.39,True,1,12934,-1261.81,-4516114.12,16320250.54,11804136.42
19681,2006-05-19,1267.03,5.22,0.41,1527.46,-17.05,True,1,12935,-1267.03,-4517381.15,16389033.05,11871651.9
19682,2006-05-22,1262.07,-4.96,-0.39,1527.46,-17.38,True,1,12936,-1262.07,-4518643.22,16326137.52,11807494.3
19683,2006-05-23,1256.58,-5.49,-0.44,1527.46,-17.73,True,1,12937,-1256.58,-4519899.8,16256375.46,11736475.66
19684,2006-05-24,1258.57,1.99,0.16,1527.46,-17.6,True,1,12938,-1258.57,-4521158.37,16283378.66,11762220.29
19685,2006-05-25,1272.88,14.31,1.14,1527.46,-16.67,True,1,12939,-1272.88,-4522431.25,16469794.32,11947363.07
19686,2006-05-26,1280.16,7.28,0.57,1527.46,-16.19,True,1,12940,-1280.16,-4523711.41,16565270.4,12041558.99
19687,2006-05-30,1259.87,-20.29,-1.58,1527.46,-17.52,True,1,12941,-1259.87,-4524971.28,16303977.67,11779006.39
19688,2006-05-31,1270.09,10.22,0.81,1527.46,-16.85,True,1,12942,-1270.09,-4526241.37,16437504.78,11911263.41
19689,2006-06-01,1285.71,15.62,1.23,1527.46,-15.83,True,1,12943,-1285.71,-4527527.08,16640944.53,12113417.45
19690,2006-06-02,1288.22,2.51,0.2,1527.46,-15.66,True,1,12944,-1288.22,-4528815.3,16674719.68,12145904.38
19691,2006-06-05,1265.29,-22.93,-1.78,1527.46,-17.16,True,1,12945,-1265.29,-4530080.59,16379179.05,11849098.46
19692,2006-06-06,1263.85,-1.44,-0.11,1527.46,-17.26,True,1,12946,-1263.85,-4531344.44,16361802.1,11830457.66
19693,2006-06-07,1256.15,-7.7,-0.61,1527.46,-17.76,True,1,12947,-1256.15,-4532600.59,16263374.05,11730773.46
19694,2006-06-08,1257.93,1.78,0.14,1527.46,-17.65,True,1,12948,-1257.93,-4533858.52,16287677.64,11753819.12
19695,2006-06-09,1252.3,-5.63,-0.45,1527.46,-18.01,True,1,12949,-1252.3,-4535110.82,16216032.7,11680921.88
19696,2006-06-12,1237.44,-14.86,-1.19,1527.46,-18.99,True,1,12950,-1237.44,-4536348.26,16024848.0,11488499.74
19697,2006-06-13,1223.69,-13.75,-1.11,1527.46,-19.89,True,1,12951,-1223.69,-4537571.95,15848009.19,11310437.24
19698,2006-06-14,1230.04,6.35,0.52,1527.46,-19.47,True,1,12952,-1230.04,-4538801.99,15931478.08,11392676.09
19699,2006-06-15,1256.16,26.12,2.12,1527.46,-17.76,True,1,12953,-1256.16,-4540058.15,16271040.48,11730982.33
19700,2006-06-16,1251.54,-4.62,-0.37,1527.46,-18.06,True,1,12954,-1251.54,-4541309.69,16212449.16,11671139.47
19701,2006-06-19,1240.13,-11.41,-0.91,1527.46,-18.81,True,1,12955,-1240.13,-4542549.82,16065884.15,11523334.33
19702,2006-06-20,1240.12,-0.01,-0.0,1527.46,-18.81,True,1,12956,-1240.12,-4543789.94,16066994.72,11523204.78
19703,2006-06-21,1252.2,12.08,0.97,1527.46,-18.02,True,1,12957,-1252.2,-4545042.14,16224755.4,11679713.26
19704,2006-06-22,1245.6,-6.6,-0.53,1527.46,-18.45,True,1,12958,-1245.6,-4546287.74,16140484.8,11594197.06
19705,2006-06-23,1244.5,-1.1,-0.09,1527.46,-18.52,True,1,12959,-1244.5,-4547532.24,16127475.5,11579943.26
19706,2006-06-26,1250.56,6.06,0.49,1527.46,-18.13,True,1,12960,-1250.56,-4548782.8,16207257.6,11658474.8
19707,2006-06-27,1239.2,-11.36,-0.91,1527.46,-18.87,True,1,12961,-1239.2,-4550022.0,16061271.2,11511249.2
19708,2006-06-28,1246.0,6.8,0.55,1527.46,-18.43,True,1,12962,-1246.0,-4551268.0,16150652.0,11599384.0
19709,2006-06-29,1272.87,26.87,2.16,1527.46,-16.67,True,1,12963,-1272.87,-4552540.87,16500213.81,11947672.94
19710,2006-06-30,1270.2,-2.67,-0.21,1527.46,-16.84,True,1,12964,-1270.2,-4553811.07,16466872.8,11913061.73
19711,2006-07-03,1280.19,9.99,0.79,1527.46,-16.19,True,1,12965,-1280.19,-4555091.26,16597663.35,12042572.09
19712,2006-07-05,1270.91,-9.28,-0.72,1527.46,-16.8,True,1,12966,-1270.91,-4556362.17,16478619.06,11922256.89
19713,2006-07-06,1274.08,3.17,0.25,1527.46,-16.59,True,1,12967,-1274.08,-4557636.25,16520995.36,11963359.11
19714,2006-07-07,1265.48,-8.6,-0.68,1527.46,-17.15,True,1,12968,-1265.48,-4558901.73,16410744.64,11851842.91
19715,2006-07-10,1267.34,1.86,0.15,1527.46,-17.03,True,1,12969,-1267.34,-4560169.07,16436132.46,11875963.39
19716,2006-07-11,1272.43,5.09,0.4,1527.46,-16.7,True,1,12970,-1272.43,-4561441.5,16503417.1,11941975.6
19717,2006-07-12,1258.6,-13.83,-1.09,1527.46,-17.6,True,1,12971,-1258.6,-4562700.1,16325300.6,11762600.5
19718,2006-07-13,1242.28,-16.32,-1.3,1527.46,-18.67,True,1,12972,-1242.28,-4563942.38,16114856.16,11550913.78
19719,2006-07-14,1236.2,-6.08,-0.49,1527.46,-19.07,True,1,12973,-1236.2,-4565178.58,16037222.6,11472044.02
19720,2006-07-17,1234.49,-1.71,-0.14,1527.46,-19.18,True,1,12974,-1234.49,-4566413.07,16016273.26,11449860.19
19721,2006-07-18,1236.86,2.37,0.19,1527.46,-19.02,True,1,12975,-1236.86,-4567649.93,16048258.5,11480608.57
19722,2006-07-19,1259.81,22.95,1.86,1527.46,-17.52,True,1,12976,-1259.81,-4568909.74,16347294.56,11778384.82
19723,2006-07-20,1249.13,-10.68,-0.85,1527.46,-18.22,True,1,12977,-1249.13,-4570158.87,16209960.01,11639801.14
19724,2006-07-21,1240.29,-8.84,-0.71,1527.46,-18.8,True,1,12978,-1240.29,-4571399.16,16096483.62,11525084.46
19725,2006-07-24,1260.91,20.62,1.66,1527.46,-17.45,True,1,12979,-1260.91,-4572660.07,16365350.89,11792690.82
19726,2006-07-25,1268.88,7.97,0.63,1527.46,-16.93,True,1,12980,-1268.88,-4573928.95,16470062.4,11896133.45
19727,2006-07-26,1268.4,-0.48,-0.04,1527.46,-16.96,True,1,12981,-1268.4,-4575197.35,16465100.4,11889903.05
19728,2006-07-27,1263.2,-5.2,-0.41,1527.46,-17.3,True,1,12982,-1263.2,-4576460.55,16398862.4,11822401.85
19729,2006-07-28,1278.55,15.35,1.22,1527.46,-16.3,True,1,12983,-1278.55,-4577739.1,16599414.65,12021675.55
19730,2006-07-31,1276.66,-1.89,-0.15,1527.46,-16.42,True,1,12984,-1276.66,-4579015.76,16576153.44,11997137.68
19731,2006-08-01,1270.92,-5.74,-0.45,1527.46,-16.8,True,1,12985,-1270.92,-4580286.68,16502896.2,11922609.52
19732,2006-08-02,1277.41,6.49,0.51,1527.46,-16.37,True,1,12986,-1277.41,-4581564.09,16588446.26,12006882.17
19733,2006-08-03,1280.27,2.86,0.22,1527.46,-16.18,True,1,12987,-1280.27,-4582844.36,16626866.49,12044022.13
19734,2006-08-04,1279.36,-0.91,-0.07,1527.46,-16.24,True,1,12988,-1279.36,-4584123.72,16616327.68,12032203.96
19735,2006-08-07,1275.77,-3.59,-0.28,1527.46,-16.48,True,1,12989,-1275.77,-4585399.49,16570976.53,11985577.04
19736,2006-08-08,1271.48,-4.29,-0.34,1527.46,-16.76,True,1,12990,-1271.48,-4586670.97,16516525.2,11929854.23
19737,2006-08-09,1265.95,-5.53,-0.44,1527.46,-17.12,True,1,12991,-1265.95,-4587936.92,16445956.45,11858019.53
19738,2006-08-10,1271.81,5.86,0.46,1527.46,-16.74,True,1,12992,-1271.81,-4589208.73,16523355.52,11934146.79
19739,2006-08-11,1266.74,-5.07,-0.4,1527.46,-17.07,True,1,12993,-1266.74,-4590475.47,16458752.82,11868277.35
19740,2006-08-14,1268.21,1.47,0.12,1527.46,-16.97,True,1,12994,-1268.21,-4591743.68,16479120.74,11887377.06
19741,2006-08-15,1285.58,17.37,1.37,1527.46,-15.84,True,1,12995,-1285.58,-4593029.26,16706112.1,12113082.84
19742,2006-08-16,1295.43,9.85,0.77,1527.46,-15.19,True,1,12996,-1295.43,-4594324.69,16835408.28,12241083.59
19743,2006-08-17,1297.48,2.05,0.16,1527.46,-15.06,True,1,12997,-1297.48,-4595622.17,16863347.56,12267725.39
19744,2006-08-18,1302.3,4.82,0.37,1527.46,-14.74,True,1,12998,-1302.3,-4596924.47,16927295.4,12330370.93
19745,2006-08-21,1297.52,-4.78,-0.37,1527.46,-15.05,True,1,12999,-1297.52,-4598221.99,16866462.48,12268240.49
19746,2006-08-22,1298.82,1.3,0.1,1527.46,-14.97,True,1,13000,-1298.82,-4599520.81,16884660.0,12285139.19
19747,2006-08-23,1292.99,-5.83,-0.45,1527.46,-15.35,True,1,13001,-1292.99,-4600813.8,16810162.99,12209349.19
19748,2006-08-24,1296.06,3.07,0.24,1527.46,-15.15,True,1,13002,-1296.06,-4602109.86,16851372.12,12249262.26
19749,2006-08-25,1295.09,-0.97,-0.08,1527.46,-15.21,True,1,13003,-1295.09,-4603404.95,16840055.27,12236650.32
19750,2006-08-28,1301.78,6.69,0.52,1527.46,-14.78,True,1,13004,-1301.78,-4604706.73,16928347.12,12323640.39
19751,2006-08-29,1304.28,2.5,0.19,1527.46,-14.61,True,1,13005,-1304.28,-4606011.01,16962161.4,12356150.39
19752,2006-08-30,1305.37,1.09,0.08,1527.46,-14.54,True,1,13006,-1305.37,-4607316.38,16977642.22,12370325.84
19753,2006-08-31,1303.82,-1.55,-0.12,1527.46,-14.64,True,1,13007,-1303.82,-4608620.2,16958786.74,12350166.54
19754,2006-09-01,1311.01,7.19,0.55,1527.46,-14.17,True,1,13008,-1311.01,-4609931.21,17053618.08,12443686.87
19755,2006-09-05,1313.25,2.24,0.17,1527.46,-14.02,True,1,13009,-1313.25,-4611244.46,17084069.25,12472824.79
19756,2006-09-06,1300.26,-12.99,-0.99,1527.46,-14.87,True,1,13010,-1300.26,-4612544.72,16916382.6,12303837.88
19757,2006-09-07,1294.02,-6.24,-0.48,1527.46,-15.28,True,1,13011,-1294.02,-4613838.74,16836494.22,12222655.48
19758,2006-09-08,1298.92,4.9,0.38,1527.46,-14.96,True,1,13012,-1298.92,-4615137.66,16901547.04,12286409.38
19759,2006-09-11,1299.54,0.62,0.05,1527.46,-14.92,True,1,13013,-1299.54,-4616437.2,16910914.02,12294476.82
19760,2006-09-12,1313.0,13.46,1.04,1527.46,-14.04,True,1,13014,-1313.0,-4617750.2,17087382.0,12469631.8
19761,2006-09-13,1318.07,5.07,0.39,1527.46,-13.71,True,1,13015,-1318.07,-4619068.27,17154681.05,12535612.78
19762,2006-09-14,1316.28,-1.79,-0.14,1527.46,-13.83,True,1,13016,-1316.28,-4620384.55,17132700.48,12512315.93
19763,2006-09-15,1319.66,3.38,0.26,1527.46,-13.6,True,1,13017,-1319.66,-4621704.21,17178014.22,12556310.01
19764,2006-09-18,1321.18,1.52,0.12,1527.46,-13.5,True,1,13018,-1321.18,-4623025.39,17199121.24,12576095.85
19765,2006-09-19,1317.64,-3.54,-0.27,1527.46,-13.74,True,1,13019,-1317.64,-4624343.03,17154355.16,12530012.13
19766,2006-09-20,1325.18,7.54,0.57,1527.46,-13.24,True,1,13020,-1325.18,-4625668.21,17253843.6,12628175.39
19767,2006-09-21,1318.03,-7.15,-0.54,1527.46,-13.71,True,1,13021,-1318.03,-4626986.24,17162068.63,12535082.39
19768,2006-09-22,1314.78,-3.25,-0.25,1527.46,-13.92,True,1,13022,-1314.78,-4628301.02,17121065.16,12492764.14
19769,2006-09-25,1326.37,11.59,0.88,1527.46,-13.16,True,1,13023,-1326.37,-4629627.39,17273316.51,12643689.12
19770,2006-09-26,1336.35,9.98,0.75,1527.46,-12.51,True,1,13024,-1336.35,-4630963.74,17404622.4,12773658.66
19771,2006-09-27,1336.59,0.24,0.02,1527.46,-12.5,True,1,13025,-1336.59,-4632300.33,17409084.75,12776784.42
19772,2006-09-28,1338.88,2.29,0.17,1527.46,-12.35,True,1,13026,-1338.88,-4633639.21,17440250.88,12806611.67
19773,2006-09-29,1335.85,-3.03,-0.23,1527.46,-12.54,True,1,13027,-1335.85,-4634975.06,17402117.95,12767142.89
19774,2006-10-02,1331.32,-4.53,-0.34,1527.46,-12.84,True,1,13028,-1331.32,-4636306.38,17344436.96,12708130.58
19775,2006-10-03,1334.11,2.79,0.21,1527.46,-12.66,True,1,13029,-1334.11,-4637640.49,17382119.19,12744478.7
19776,2006-10-04,1350.2,16.09,1.21,1527.46,-11.6,True,1,13030,-1350.2,-4638990.69,17593106.0,12954115.31
19777,2006-10-05,1353.22,3.02,0.22,1527.46,-11.41,True,1,13031,-1353.22,-4640343.91,17633809.82,12993465.91
19778,2006-10-06,1349.59,-3.63,-0.27,1527.46,-11.64,True,1,13032,-1349.59,-4641693.5,17587856.88,12946163.38
19779,2006-10-09,1350.66,1.07,0.08,1527.46,-11.58,True,1,13033,-1350.66,-4643044.16,17603151.78,12960107.62
19780,2006-10-10,1353.42,2.76,0.2,1527.46,-11.39,True,1,13034,-1353.42,-4644397.58,17640476.28,12996078.7
19781,2006-10-11,1349.95,-3.47,-0.26,1527.46,-11.62,True,1,13035,-1349.95,-4645747.53,17596598.25,12950850.72
19782,2006-10-12,1362.83,12.88,0.95,1527.46,-10.78,True,1,13036,-1362.83,-4647110.36,17765851.88,13118741.52
19783,2006-10-13,1365.62,2.79,0.2,1527.46,-10.6,True,1,13037,-1365.62,-4648475.98,17803587.94,13155111.96
19784,2006-10-16,1369.06,3.44,0.25,1527.46,-10.37,True,1,13038,-1369.06,-4649845.04,17849804.28,13199959.24
19785,2006-10-17,1364.05,-5.01,-0.37,1527.46,-10.7,True,1,13039,-1364.05,-4651209.09,17785847.95,13134638.86
19786,2006-10-18,1365.8,1.75,0.13,1527.46,-10.58,True,1,13040,-1365.8,-4652574.89,17810032.0,13157457.11
19787,2006-10-19,1366.96,1.16,0.08,1527.46,-10.51,True,1,13041,-1366.96,-4653941.85,17826525.36,13172583.51
19788,2006-10-20,1368.6,1.64,0.12,1527.46,-10.4,True,1,13042,-1368.6,-4655310.45,17849281.2,13193970.75
19789,2006-10-23,1377.02,8.42,0.62,1527.46,-9.85,True,1,13043,-1377.02,-4656687.47,17960471.86,13303784.39
19790,2006-10-24,1377.38,0.36,0.03,1527.46,-9.82,True,1,13044,-1377.38,-4658064.85,17966544.72,13308479.87
19791,2006-10-25,1382.22,4.84,0.35,1527.46,-9.51,True,1,13045,-1382.22,-4659447.07,18031059.9,13371612.83
19792,2006-10-26,1389.08,6.86,0.5,1527.46,-9.06,True,1,13046,-1389.08,-4660836.15,18121937.68,13461101.53
19793,2006-10-27,1377.34,-11.74,-0.84,1527.46,-9.83,True,1,13047,-1377.34,-4662213.49,17970154.98,13307941.49
19794,2006-10-30,1377.93,0.59,0.04,1527.46,-9.79,True,1,13048,-1377.93,-4663591.42,17979230.64,13315639.22
19795,2006-10-31,1377.94,0.01,0.0,1527.46,-9.79,True,1,13049,-1377.94,-4664969.36,17980739.06,13315769.7
19796,2006-11-01,1367.81,-10.13,-0.74,1527.46,-10.45,True,1,13050,-1367.81,-4666337.17,17849920.5,13183583.33
19797,2006-11-02,1367.34,-0.47,-0.03,1527.46,-10.48,True,1,13051,-1367.34,-4667704.51,17845154.34,13177449.83
19798,2006-11-03,1364.3,-3.04,-0.22,1527.46,-10.68,True,1,13052,-1364.3,-4669068.81,17806843.6,13137774.79
19799,2006-11-06,1379.78,15.48,1.14,1527.46,-9.67,True,1,13053,-1379.78,-4670448.59,18010268.34,13339819.75
19800,2006-11-07,1382.84,3.06,0.22,1527.46,-9.47,True,1,13054,-1382.84,-4671831.43,18051593.36,13379761.93
19801,2006-11-08,1385.72,2.88,0.21,1527.46,-9.28,True,1,13055,-1385.72,-4673217.15,18090574.6,13417357.45
19802,2006-11-09,1378.33,-7.39,-0.53,1527.46,-9.76,True,1,13056,-1378.33,-4674595.48,17995476.48,13320881.0
19803,2006-11-10,1380.9,2.57,0.19,1527.46,-9.6,True,1,13057,-1380.9,-4675976.38,18030411.3,13354434.92
19804,2006-11-13,1384.42,3.52,0.26,1527.46,-9.36,True,1,13058,-1384.42,-4677360.8,18077756.36,13400395.56
19805,2006-11-14,1393.22,8.8,0.64,1527.46,-8.79,True,1,13059,-1393.22,-4678754.02,18194059.98,13515305.96
19806,2006-11-15,1396.57,3.35,0.24,1527.46,-8.57,True,1,13060,-1396.57,-4680150.59,18239204.2,13559053.61
19807,2006-11-16,1399.76,3.19,0.23,1527.46,-8.36,True,1,13061,-1399.76,-4681550.35,18282265.36,13600715.01
19808,2006-11-17,1401.2,1.44,0.1,1527.46,-8.27,True,1,13062,-1401.2,-4682951.55,18302474.4,13619522.85
19809,2006-11-20,1400.5,-0.7,-0.05,1527.46,-8.31,True,1,13063,-1400.5,-4684352.05,18294731.5,13610379.45
19810,2006-11-21,1402.81,2.31,0.16,1527.46,-8.16,True,1,13064,-1402.81,-4685754.86,18326309.84,13640554.98
19811,2006-11-22,1406.09,3.28,0.23,1527.46,-7.95,True,1,13065,-1406.09,-4687160.95,18370565.85,13683404.9
19812,2006-11-24,1400.95,-5.14,-0.37,1527.46,-8.28,True,1,13066,-1400.95,-4688561.9,18304812.7,13616250.8
19813,2006-11-27,1381.96,-18.99,-1.36,1527.46,-9.53,True,1,13067,-1381.96,-4689943.86,18058071.32,13368127.46
19814,2006-11-28,1386.72,4.76,0.34,1527.46,-9.21,True,1,13068,-1386.72,-4691330.58,18121656.96,13430326.38
19815,2006-11-29,1399.48,12.76,0.92,1527.46,-8.38,True,1,13069,-1399.48,-4692730.06,18289804.12,13597074.06
19816,2006-11-30,1400.63,1.15,0.08,1527.46,-8.3,True,1,13070,-1400.63,-4694130.69,18306234.1,13612103.41
19817,2006-12-01,1396.71,-3.92,-0.28,1527.46,-8.56,True,1,13071,-1396.71,-4695527.4,18256396.41,13560869.01
19818,2006-12-04,1409.12,12.41,0.89,1527.46,-7.75,True,1,13072,-1409.12,-4696936.52,18420016.64,13723080.12
19819,2006-12-05,1414.76,5.64,0.4,1527.46,-7.38,True,1,13073,-1414.76,-4698351.28,18495157.48,13796806.2
19820,2006-12-06,1412.9,-1.86,-0.13,1527.46,-7.5,True,1,13074,-1412.9,-4699764.18,18472254.6,13772490.42
19821,2006-12-07,1407.29,-5.61,-0.4,1527.46,-7.87,True,1,13075,-1407.29,-4701171.47,18400316.75,13699145.28
19822,2006-12-08,1409.84,2.55,0.18,1527.46,-7.7,True,1,13076,-1409.84,-4702581.31,18435067.84,13732486.53
19823,2006-12-11,1413.04,3.2,0.23,1527.46,-7.49,True,1,13077,-1413.04,-4703994.35,18478324.08,13774329.73
19824,2006-12-12,1411.56,-1.48,-0.1,1527.46,-7.59,True,1,13078,-1411.56,-4705405.91,18460381.68,13754975.77
19825,2006-12-13,1413.21,1.65,0.12,1527.46,-7.48,True,1,13079,-1413.21,-4706819.12,18483373.59,13776554.47
19826,2006-12-14,1425.49,12.28,0.87,1527.46,-6.68,True,1,13080,-1425.49,-4708244.61,18645409.2,13937164.59
19827,2006-12-15,1427.09,1.6,0.11,1527.46,-6.57,True,1,13081,-1427.09,-4709671.7,18667764.29,13958092.59
19828,2006-12-18,1422.48,-4.61,-0.32,1527.46,-6.87,True,1,13082,-1422.48,-4711094.18,18608883.36,13897789.18
19829,2006-12-19,1425.55,3.07,0.22,1527.46,-6.67,True,1,13083,-1425.55,-4712519.73,18650470.65,13937950.92
19830,2006-12-20,1423.53,-2.02,-0.14,1527.46,-6.8,True,1,13084,-1423.53,-4713943.26,18625466.52,13911523.26
19831,2006-12-21,1418.3,-5.23,-0.37,1527.46,-7.15,True,1,13085,-1418.3,-4715361.56,18558455.5,13843093.94
19832,2006-12-22,1410.76,-7.54,-0.53,1527.46,-7.64,True,1,13086,-1410.76,-4716772.32,18461205.36,13744433.04
19833,2006-12-26,1416.9,6.14,0.44,1527.46,-7.24,True,1,13087,-1416.9,-4718189.22,18542970.3,13824781.08
19834,2006-12-27,1426.84,9.94,0.7,1527.46,-6.59,True,1,13088,-1426.84,-4719616.06,18674481.92,13954865.86
19835,2006-12-28,1424.73,-2.11,-0.15,1527.46,-6.73,True,1,13089,-1424.73,-4721040.79,18648290.97,13927250.18
19836,2006-12-29,1418.3,-6.43,-0.45,1527.46,-7.15,True,1,13090,-1418.3,-4722459.09,18565547.0,13843087.91
19837,2007-01-03,1416.6,-1.7,-0.12,1527.46,-7.26,True,1,13091,-1416.6,-4723875.69,18544710.6,13820834.91
19838,2007-01-04,1418.34,1.74,0.12,1527.46,-7.14,True,1,13092,-1418.34,-4725294.03,18568907.28,13843613.25
19839,2007-01-05,1409.71,-8.63,-0.61,1527.46,-7.71,True,1,13093,-1409.71,-4726703.74,18457333.03,13730629.29
19840,2007-01-08,1412.84,3.13,0.22,1527.46,-7.5,True,1,13094,-1412.84,-4728116.58,18499726.96,13771610.38
19841,2007-01-09,1412.11,-0.73,-0.05,1527.46,-7.55,True,1,13095,-1412.11,-4729528.69,18491580.45,13762051.76
19842,2007-01-10,1414.85,2.74,0.19,1527.46,-7.37,True,1,13096,-1414.85,-4730943.54,18528875.6,13797932.06
19843,2007-01-11,1423.82,8.97,0.63,1527.46,-6.78,True,1,13097,-1423.82,-4732367.36,18647770.54,13915403.18
19844,2007-01-12,1430.73,6.91,0.48,1527.46,-6.33,True,1,13098,-1430.73,-4733798.09,18739701.54,14005903.45
19845,2007-01-16,1431.9,1.17,0.08,1527.46,-6.26,True,1,13099,-1431.9,-4735229.99,18756458.1,14021228.11
19846,2007-01-17,1430.62,-1.28,-0.09,1527.46,-6.34,True,1,13100,-1430.62,-4736660.61,18741122.0,14004461.39
19847,2007-01-18,1426.37,-4.25,-0.3,1527.46,-6.62,True,1,13101,-1426.37,-4738086.98,18686873.37,13948786.39
19848,2007-01-19,1430.5,4.13,0.29,1527.46,-6.35,True,1,13102,-1430.5,-4739517.48,18742411.0,14002893.52
19849,2007-01-22,1422.95,-7.55,-0.53,1527.46,-6.84,True,1,13103,-1422.95,-4740940.43,18644913.85,13903973.42
19850,2007-01-23,1427.99,5.04,0.35,1527.46,-6.51,True,1,13104,-1427.99,-4742368.42,18712380.96,13970012.54
19851,2007-01-24,1440.13,12.14,0.85,1527.46,-5.72,True,1,13105,-1440.13,-4743808.55,18872903.65,14129095.1
19852,2007-01-25,1423.9,-16.23,-1.13,1527.46,-6.78,True,1,13106,-1423.9,-4745232.45,18661633.4,13916400.95
19853,2007-01-26,1422.18,-1.72,-0.12,1527.46,-6.89,True,1,13107,-1422.18,-4746654.63,18640513.26,13893858.63
19854,2007-01-29,1420.62,-1.56,-0.11,1527.46,-7.0,True,1,13108,-1420.62,-4748075.25,18621486.96,13873411.71
19855,2007-01-30,1428.82,8.2,0.58,1527.46,-6.46,True,1,13109,-1428.82,-4749504.07,18730401.38,13980897.31
19856,2007-01-31,1438.24,9.42,0.66,1527.46,-5.84,True,1,13110,-1438.24,-4750942.31,18855326.4,14104384.09
19857,2007-02-01,1445.94,7.7,0.54,1527.46,-5.34,True,1,13111,-1445.94,-4752388.25,18957719.34,14205331.09
19858,2007-02-02,1448.39,2.45,0.17,1527.46,-5.18,True,1,13112,-1448.39,-4753836.64,18991289.68,14237453.04
19859,2007-02-05,1446.99,-1.4,-0.1,1527.46,-5.27,True,1,13113,-1446.99,-4755283.63,18974379.87,14219096.24
19860,2007-02-06,1448.0,1.01,0.07,1527.46,-5.2,True,1,13114,-1448.0,-4756731.63,18989072.0,14232340.37
19861,2007-02-07,1450.02,2.02,0.14,1527.46,-5.07,True,1,13115,-1450.02,-4758181.65,19017012.3,14258830.65
19862,2007-02-08,1448.31,-1.71,-0.12,1527.46,-5.18,True,1,13116,-1448.31,-4759629.96,18996033.96,14236404.0
19863,2007-02-09,1438.06,-10.25,-0.71,1527.46,-5.85,True,1,13117,-1438.06,-4761068.02,18863033.02,14101965.0
19864,2007-02-12,1433.37,-4.69,-0.33,1527.46,-6.16,True,1,13118,-1433.37,-4762501.39,18802947.66,14040446.27
19865,2007-02-13,1444.26,10.89,0.76,1527.46,-5.45,True,1,13119,-1444.26,-4763945.65,18947246.94,14183301.29
19866,2007-02-14,1455.3,11.04,0.76,1527.46,-4.72,True,1,13120,-1455.3,-4765400.95,19093536.0,14328135.05
19867,2007-02-15,1456.81,1.51,0.1,1527.46,-4.62,True,1,13121,-1456.81,-4766857.76,19114804.01,14347946.25
19868,2007-02-16,1455.54,-1.27,-0.09,1527.46,-4.71,True,1,13122,-1455.54,-4768313.3,19099595.88,14331282.58
19869,2007-02-20,1459.68,4.14,0.28,1527.46,-4.44,True,1,13123,-1459.68,-4769772.98,19155380.64,14385607.66
19870,2007-02-21,1457.63,-2.05,-0.14,1527.46,-4.57,True,1,13124,-1457.63,-4771230.61,19129936.12,14358705.51
19871,2007-02-22,1456.38,-1.25,-0.09,1527.46,-4.65,True,1,13125,-1456.38,-4772686.99,19114987.5,14342300.51
19872,2007-02-23,1451.19,-5.19,-0.36,1527.46,-4.99,True,1,13126,-1451.19,-4774138.18,19048319.94,14274181.76
19873,2007-02-26,1449.37,-1.82,-0.12,1527.46,-5.11,True,1,13127,-1449.37,-4775587.55,19025879.99,14250292.44
19874,2007-02-27,1399.04,-50.33,-3.47,1527.46,-8.41,True,1,13128,-1399.04,-4776986.59,18366597.12,13589610.53
19875,2007-02-28,1406.82,7.78,0.56,1527.46,-7.9,True,1,13129,-1406.82,-4778393.41,18470139.78,13691746.37
19876,2007-03-01,1403.17,-3.65,-0.26,1527.46,-8.14,True,1,13130,-1403.17,-4779796.58,18423622.1,13643825.52
19877,2007-03-02,1387.17,-16.0,-1.14,1527.46,-9.18,True,1,13131,-1387.17,-4781183.75,18214929.27,13433745.52
19878,2007-03-05,1374.12,-13.05,-0.94,1527.46,-10.04,True,1,13132,-1374.12,-4782557.87,18044943.84,13262385.97
19879,2007-03-06,1395.41,21.29,1.55,1527.46,-8.64,True,1,13133,-1395.41,-4783953.28,18325919.53,13541966.25
19880,2007-03-07,1391.97,-3.44,-0.25,1527.46,-8.87,True,1,13134,-1391.97,-4785345.25,18282133.98,13496788.73
19881,2007-03-08,1401.89,9.92,0.71,1527.46,-8.22,True,1,13135,-1401.89,-4786747.14,18413825.15,13627078.01
19882,2007-03-09,1402.84,0.95,0.07,1527.46,-8.16,True,1,13136,-1402.84,-4788149.98,18427706.24,13639556.26
19883,2007-03-12,1406.6,3.76,0.27,1527.46,-7.91,True,1,13137,-1406.6,-4789556.58,18478504.2,13688947.62
19884,2007-03-13,1377.95,-28.65,-2.04,1527.46,-9.79,True,1,13138,-1377.95,-4790934.53,18103507.1,13312572.57
19885,2007-03-14,1387.17,9.22,0.67,1527.46,-9.18,True,1,13139,-1387.17,-4792321.7,18226026.63,13433704.93
19886,2007-03-15,1392.28,5.11,0.37,1527.46,-8.85,True,1,13140,-1392.28,-4793713.98,18294559.2,13500845.22
19887,2007-03-16,1386.95,-5.33,-0.38,1527.46,-9.2,True,1,13141,-1386.95,-4795100.93,18225909.95,13430809.02
19888,2007-03-19,1402.06,15.11,1.09,1527.46,-8.21,True,1,13142,-1402.06,-4796502.99,18425872.52,13629369.53
19889,2007-03-20,1410.94,8.88,0.63,1527.46,-7.63,True,1,13143,-1410.94,-4797913.93,18543984.42,13746070.49
19890,2007-03-21,1435.04,24.1,1.71,1527.46,-6.05,True,1,13144,-1435.04,-4799348.97,18862165.76,14062816.79
19891,2007-03-22,1434.54,-0.5,-0.04,1527.46,-6.08,True,1,13145,-1434.54,-4800783.51,18857028.3,14056244.79
19892,2007-03-23,1436.11,1.57,0.11,1527.46,-5.98,True,1,13146,-1436.11,-4802219.62,18879102.06,14076882.44
19893,2007-03-26,1437.5,1.39,0.1,1527.46,-5.89,True,1,13147,-1437.5,-4803657.12,18898812.5,14095155.38
19894,2007-03-27,1428.61,-8.89,-0.62,1527.46,-6.47,True,1,13148,-1428.61,-4805085.73,18783364.28,13978278.55
19895,2007-03-28,1417.23,-11.38,-0.8,1527.46,-7.22,True,1,13149,-1417.23,-4806502.96,18635157.27,13828654.31
19896,2007-03-29,1422.53,5.3,0.37,1527.46,-6.87,True,1,13150,-1422.53,-4807925.49,18706269.5,13898344.01
19897,2007-03-30,1420.86,-1.67,-0.12,1527.46,-6.98,True,1,13151,-1420.86,-4809346.35,18685729.86,13876383.51
19898,2007-04-02,1424.55,3.69,0.26,1527.46,-6.74,True,1,13152,-1424.55,-4810770.9,18735681.6,13924910.7
19899,2007-04-03,1437.77,13.22,0.93,1527.46,-5.87,True,1,13153,-1437.77,-4812208.67,18910988.81,14098780.14
19900,2007-04-04,1439.37,1.6,0.11,1527.46,-5.77,True,1,13154,-1439.37,-4813648.04,18933472.98,14119824.94
19901,2007-04-05,1443.76,4.39,0.3,1527.46,-5.48,True,1,13155,-1443.76,-4815091.8,18992662.8,14177571.0
19902,2007-04-09,1444.61,0.85,0.06,1527.46,-5.42,True,1,13156,-1444.61,-4816536.41,19005289.16,14188752.75
19903,2007-04-10,1448.39,3.78,0.26,1527.46,-5.18,True,1,13157,-1448.39,-4817984.8,19056467.23,14238482.43
19904,2007-04-11,1438.87,-9.52,-0.66,1527.46,-5.8,True,1,13158,-1438.87,-4819423.67,18932651.46,14113227.79
19905,2007-04-12,1447.8,8.93,0.62,1527.46,-5.22,True,1,13159,-1447.8,-4820871.47,19051600.2,14230728.73
19906,2007-04-13,1452.85,5.05,0.35,1527.46,-4.88,True,1,13160,-1452.85,-4822324.32,19119506.0,14297181.68
19907,2007-04-16,1468.33,15.48,1.06,1527.46,-3.87,True,1,13161,-1468.33,-4823792.65,19324691.13,14500898.48
19908,2007-04-17,1471.48,3.15,0.22,1527.46,-3.66,True,1,13162,-1471.48,-4825264.13,19367619.76,14542355.63
19909,2007-04-18,1472.5,1.02,0.07,1527.46,-3.6,True,1,13163,-1472.5,-4826736.63,19382517.5,14555780.87
19910,2007-04-19,1470.73,-1.77,-0.12,1527.46,-3.71,True,1,13164,-1470.73,-4828207.36,19360689.72,14532482.36
19911,2007-04-20,1484.35,13.62,0.93,1527.46,-2.82,True,1,13165,-1484.35,-4829691.71,19541467.75,14711776.04
19912,2007-04-23,1480.93,-3.42,-0.23,1527.46,-3.05,True,1,13166,-1480.93,-4831172.64,19497924.38,14666751.74
19913,2007-04-24,1480.41,-0.52,-0.04,1527.46,-3.08,True,1,13167,-1480.41,-4832653.05,19492558.47,14659905.42
19914,2007-04-25,1495.42,15.01,1.01,1527.46,-2.1,True,1,13168,-1495.42,-4834148.47,19691690.56,14857542.09
19915,2007-04-26,1494.25,-1.17,-0.08,1527.46,-2.17,True,1,13169,-1494.25,-4835642.72,19677778.25,14842135.53
19916,2007-04-27,1494.07,-0.18,-0.01,1527.46,-2.19,True,1,13170,-1494.07,-4837136.79,19676901.9,14839765.11
19917,2007-04-30,1482.37,-11.7,-0.78,1527.46,-2.95,True,1,13171,-1482.37,-4838619.16,19524295.27,14685676.11
19918,2007-05-01,1486.3,3.93,0.26,1527.46,-2.7,True,1,13172,-1486.3,-4840105.46,19577543.6,14737438.14
19919,2007-05-02,1495.92,9.62,0.65,1527.46,-2.06,True,1,13173,-1495.92,-4841601.38,19705754.16,14864152.78
19920,2007-05-03,1502.39,6.47,0.43,1527.46,-1.64,True,1,13174,-1502.39,-4843103.77,19792485.86,14949382.09
19921,2007-05-04,1505.62,3.23,0.22,1527.46,-1.43,True,1,13175,-1505.62,-4844609.39,19836543.5,14991934.11
19922,2007-05-07,1509.48,3.86,0.26,1527.46,-1.18,True,1,13176,-1509.48,-4846118.87,19888908.48,15042789.61
19923,2007-05-08,1507.72,-1.76,-0.12,1527.46,-1.29,True,1,13177,-1507.72,-4847626.59,19867226.44,15019599.85
19924,2007-05-09,1512.58,4.86,0.32,1527.46,-0.97,True,1,13178,-1512.58,-4849139.17,19932779.24,15083640.07
19925,2007-05-10,1491.47,-21.11,-1.4,1527.46,-2.36,True,1,13179,-1491.47,-4850630.64,19656083.13,14805452.49
19926,2007-05-11,1505.85,14.38,0.96,1527.46,-1.42,True,1,13180,-1505.85,-4852136.49,19847103.0,14994966.51
19927,2007-05-14,1503.15,-2.7,-0.18,1527.46,-1.59,True,1,13181,-1503.15,-4853639.64,19813020.15,14959380.51
19928,2007-05-15,1501.19,-1.96,-0.13,1527.46,-1.72,True,1,13182,-1501.19,-4855140.83,19788686.58,14933545.75
19929,2007-05-16,1514.14,12.95,0.86,1527.46,-0.87,True,1,13183,-1514.14,-4856654.97,19960907.62,15104252.65
19930,2007-05-17,1512.75,-1.39,-0.09,1527.46,-0.96,True,1,13184,-1512.75,-4858167.72,19944096.0,15085928.28
19931,2007-05-18,1522.75,10.0,0.66,1527.46,-0.31,True,1,13185,-1522.75,-4859690.47,20077458.75,15217768.28
19932,2007-05-21,1525.1,2.35,0.15,1527.46,-0.16,True,1,13186,-1525.1,-4861215.57,20109968.6,15248753.03
19933,2007-05-22,1524.12,-0.98,-0.06,1527.46,-0.22,True,1,13187,-1524.12,-4862739.69,20098570.44,15235830.75
19934,2007-05-23,1522.28,-1.84,-0.12,1527.46,-0.34,True,1,13188,-1522.28,-4864261.97,20075828.64,15211566.67
19935,2007-05-24,1507.51,-14.77,-0.97,1527.46,-1.31,True,1,13189,-1507.51,-4865769.48,19882549.39,15016779.91
19936,2007-05-25,1515.73,8.22,0.55,1527.46,-0.77,True,1,13190,-1515.73,-4867285.21,19992478.7,15125193.49
19937,2007-05-29,1518.11,2.38,0.16,1527.46,-0.61,True,1,13191,-1518.11,-4868803.32,20025389.01,15156585.69
19938,2007-05-30,1530.23,12.12,0.8,1530.23,0.0,True,1,13192,-1530.23,-4870333.55,20186794.16,15316460.61
19939,2007-05-31,1530.62,0.39,0.02,1530.62,0.0,True,1,13193,-1530.62,-4871864.17,20193469.66,15321605.49
19940,2007-06-01,1536.34,5.72,0.37,1536.34,0.0,True,1,13194,-1536.34,-4873400.51,20270469.96,15397069.45
19941,2007-06-04,1539.18,2.84,0.18,1539.18,0.0,True,1,13195,-1539.18,-4874939.69,20309480.1,15434540.41
19942,2007-06-05,1530.95,-8.23,-0.54,1539.18,-0.54,True,1,13196,-1530.95,-4876470.64,20202416.2,15325945.56
19943,2007-06-06,1517.38,-13.57,-0.89,1539.18,-1.42,True,1,13197,-1517.38,-4877988.02,20024863.86,15146875.84
19944,2007-06-07,1490.72,-26.66,-1.76,1539.18,-3.15,True,1,13198,-1490.72,-4879478.74,19674522.56,14795043.82
19945,2007-06-08,1507.67,16.95,1.14,1539.18,-2.05,True,1,13199,-1507.67,-4880986.41,19899736.33,15018749.92
19946,2007-06-11,1509.12,1.45,0.1,1539.18,-1.95,True,1,13200,-1509.12,-4882495.53,19920384.0,15037888.47
19947,2007-06-12,1493.0,-16.12,-1.07,1539.18,-3.0,True,1,13201,-1493.0,-4883988.53,19709093.0,14825104.47
19948,2007-06-13,1515.67,22.67,1.52,1539.18,-1.53,True,1,13202,-1515.67,-4885504.2,20009875.34,15124371.14
19949,2007-06-14,1522.97,7.3,0.48,1539.18,-1.05,True,1,13203,-1522.97,-4887027.17,20107772.91,15220745.74
19950,2007-06-15,1532.91,9.94,0.65,1539.18,-0.41,True,1,13204,-1532.91,-4888560.08,20240543.64,15351983.56
19951,2007-06-18,1531.05,-1.86,-0.12,1539.18,-0.53,True,1,13205,-1531.05,-4890091.13,20217515.25,15327424.12
19952,2007-06-19,1533.7,2.65,0.17,1539.18,-0.36,True,1,13206,-1533.7,-4891624.83,20254042.2,15362417.37
19953,2007-06-20,1512.84,-20.86,-1.36,1539.18,-1.71,True,1,13207,-1512.84,-4893137.67,19980077.88,15086940.21
19954,2007-06-21,1522.19,9.35,0.62,1539.18,-1.1,True,1,13208,-1522.19,-4894659.86,20105085.52,15210425.66
19955,2007-06-22,1502.56,-19.63,-1.29,1539.18,-2.38,True,1,13209,-1502.56,-4896162.42,19847315.04,14951152.62
19956,2007-06-25,1497.74,-4.82,-0.32,1539.18,-2.69,True,1,13210,-1497.74,-4897660.16,19785145.4,14887485.24
19957,2007-06-26,1492.89,-4.85,-0.32,1539.18,-3.01,True,1,13211,-1492.89,-4899153.05,19722569.79,14823416.74
19958,2007-06-27,1506.34,13.45,0.9,1539.18,-2.13,True,1,13212,-1506.34,-4900659.39,19901764.08,15001104.69
19959,2007-06-28,1505.71,-0.63,-0.04,1539.18,-2.17,True,1,13213,-1505.71,-4902165.1,19894946.23,14992781.13
19960,2007-06-29,1503.35,-2.36,-0.16,1539.18,-2.33,True,1,13214,-1503.35,-4903668.45,19865266.9,14961598.45
19961,2007-07-02,1519.43,16.08,1.07,1539.18,-1.28,True,1,13215,-1519.43,-4905187.88,20079267.45,15174079.57
19962,2007-07-03,1524.87,5.44,0.36,1539.18,-0.93,True,1,13216,-1524.87,-4906712.75,20152681.92,15245969.17
19963,2007-07-05,1525.4,0.53,0.04,1539.18,-0.9,True,1,13217,-1525.4,-4908238.15,20161211.8,15252973.65
19964,2007-07-06,1530.44,5.04,0.33,1539.18,-0.57,True,1,13218,-1530.44,-4909768.59,20229355.92,15319587.33
19965,2007-07-09,1531.85,1.41,0.09,1539.18,-0.48,True,1,13219,-1531.85,-4911300.44,20249525.15,15338224.71
19966,2007-07-10,1510.12,-21.73,-1.42,1539.18,-1.89,True,1,13220,-1510.12,-4912810.56,19963786.4,15050975.84
19967,2007-07-11,1518.76,8.64,0.57,1539.18,-1.33,True,1,13221,-1518.76,-4914329.32,20079525.96,15165196.64
19968,2007-07-12,1547.7,28.94,1.9,1547.7,0.0,True,1,13222,-1547.7,-4915877.02,20463689.4,15547812.38
19969,2007-07-13,1552.5,4.8,0.31,1552.5,0.0,True,1,13223,-1552.5,-4917429.52,20528707.5,15611277.98
19970,2007-07-16,1549.52,-2.98,-0.19,1552.5,-0.19,True,1,13224,-1549.52,-4918979.04,20490852.48,15571873.44
19971,2007-07-17,1549.37,-0.15,-0.01,1552.5,-0.2,True,1,13225,-1549.37,-4920528.41,20490418.25,15569889.84
19972,2007-07-18,1546.17,-3.2,-0.21,1552.5,-0.41,True,1,13226,-1546.17,-4922074.58,20449644.42,15527569.84
19973,2007-07-19,1553.08,6.91,0.45,1553.08,0.0,True,1,13227,-1553.08,-4923627.66,20542589.16,15618961.5
19974,2007-07-20,1534.1,-18.98,-1.22,1553.08,-1.22,True,1,13228,-1534.1,-4925161.76,20293074.8,15367913.04
19975,2007-07-23,1541.57,7.47,0.49,1553.08,-0.74,True,1,13229,-1541.57,-4926703.33,20393429.53,15466726.2
19976,2007-07-24,1511.04,-30.53,-1.98,1553.08,-2.71,True,1,13230,-1511.04,-4928214.37,19991059.2,15062844.83
19977,2007-07-25,1518.09,7.05,0.47,1553.08,-2.25,True,1,13231,-1518.09,-4929732.46,20085848.79,15156116.33
19978,2007-07-26,1482.66,-35.43,-2.33,1553.08,-4.53,True,1,13232,-1482.66,-4931215.12,19618557.12,14687342.0
19979,2007-07-27,1458.95,-23.71,-1.6,1553.08,-6.06,True,1,13233,-1458.95,-4932674.07,19306285.35,14373611.28
19980,2007-07-30,1473.91,14.96,1.02,1553.08,-5.1,True,1,13234,-1473.91,-4934147.98,19505724.94,14571576.96
19981,2007-07-31,1455.27,-18.64,-1.26,1553.08,-6.3,True,1,13235,-1455.27,-4935603.25,19260498.45,14324895.2
19982,2007-08-01,1465.81,10.54,0.72,1553.08,-5.62,True,1,13236,-1465.81,-4937069.06,19401461.16,14464392.1
19983,2007-08-02,1472.2,6.39,0.44,1553.08,-5.21,True,1,13237,-1472.2,-4938541.26,19487511.4,14548970.14
19984,2007-08-03,1433.06,-39.14,-2.66,1553.08,-7.73,True,1,13238,-1433.06,-4939974.32,18970848.28,14030873.96
19985,2007-08-06,1467.67,34.61,2.42,1553.08,-5.5,True,1,13239,-1467.67,-4941441.99,19430483.13,14489041.14
19986,2007-08-07,1476.71,9.04,0.62,1553.08,-4.92,True,1,13240,-1476.71,-4942918.7,19551640.4,14608721.7
19987,2007-08-08,1497.49,20.78,1.41,1553.08,-3.58,True,1,13241,-1497.49,-4944416.19,19828265.09,14883848.9
19988,2007-08-09,1453.09,-44.4,-2.96,1553.08,-6.44,True,1,13242,-1453.09,-4945869.28,19241817.78,14295948.5
19989,2007-08-10,1453.64,0.55,0.04,1553.08,-6.4,True,1,13243,-1453.64,-4947322.92,19250554.52,14303231.6
19990,2007-08-13,1452.92,-0.72,-0.05,1553.08,-6.45,True,1,13244,-1452.92,-4948775.84,19242472.48,14293696.64
19991,2007-08-14,1426.54,-26.38,-1.82,1553.08,-8.15,True,1,13245,-1426.54,-4950202.38,18894522.3,13944319.92
19992,2007-08-15,1406.7,-19.84,-1.39,1553.08,-9.43,True,1,13246,-1406.7,-4951609.08,18633148.2,13681539.12
19993,2007-08-16,1411.27,4.57,0.32,1553.08,-9.13,True,1,13247,-1411.27,-4953020.35,18695093.69,13742073.34
19994,2007-08-17,1445.94,34.67,2.46,1553.08,-6.9,True,1,13248,-1445.94,-4954466.29,19155813.12,14201346.83
19995,2007-08-20,1445.55,-0.39,-0.03,1553.08,-6.92,True,1,13249,-1445.55,-4955911.84,19152091.95,14196180.11
19996,2007-08-21,1447.12,1.57,0.11,1553.08,-6.82,True,1,13250,-1447.12,-4957358.96,19174340.0,14216981.04
19997,2007-08-22,1464.07,16.95,1.17,1553.08,-5.73,True,1,13251,-1464.07,-4958823.03,19400391.57,14441568.54
19998,2007-08-23,1462.5,-1.57,-0.11,1553.08,-5.83,True,1,13252,-1462.5,-4960285.53,19381050.0,14420764.47
19999,2007-08-24,1479.37,16.87,1.15,1553.08,-4.75,True,1,13253,-1479.37,-4961764.9,19606090.61,14644325.71
20000,2007-08-27,1466.79,-12.58,-0.85,1553.08,-5.56,True,1,13254,-1466.79,-4963231.69,19440834.66,14477602.97
20001,2007-08-28,1432.36,-34.43,-2.35,1553.08,-7.77,True,1,13255,-1432.36,-4964664.05,18985931.8,14021267.75
20002,2007-08-29,1463.76,31.4,2.19,1553.08,-5.75,True,1,13256,-1463.76,-4966127.81,19403602.56,14437474.75
20003,2007-08-30,1457.64,-6.12,-0.42,1553.08,-6.14,True,1,13257,-1457.64,-4967585.45,19323933.48,14356348.03
20004,2007-08-31,1473.99,16.35,1.12,1553.08,-5.09,True,1,13258,-1473.99,-4969059.44,19542159.42,14573099.98
20005,2007-09-04,1489.42,15.43,1.05,1553.08,-4.1,True,1,13259,-1489.42,-4970548.86,19748219.78,14777670.92
20006,2007-09-05,1472.29,-17.13,-1.15,1553.08,-5.2,True,1,13260,-1472.29,-4972021.15,19522565.4,14550544.25
20007,2007-09-06,1478.55,6.26,0.42,1553.08,-4.8,True,1,13261,-1478.55,-4973499.7,19607051.55,14633551.85
20008,2007-09-07,1453.55,-25.0,-1.69,1553.08,-6.41,True,1,13262,-1453.55,-4974953.25,19276980.1,14302026.85
20009,2007-09-10,1451.7,-1.85,-0.13,1553.08,-6.53,True,1,13263,-1451.7,-4976404.95,19253897.1,14277492.15
20010,2007-09-11,1471.49,19.79,1.36,1553.08,-5.25,True,1,13264,-1471.49,-4977876.44,19517843.36,14539966.92
20011,2007-09-12,1471.56,0.07,0.0,1553.08,-5.25,True,1,13265,-1471.56,-4979348.0,19520243.4,14540895.4
20012,2007-09-13,1483.95,12.39,0.84,1553.08,-4.45,True,1,13266,-1483.95,-4980831.95,19686080.7,14705248.75
20013,2007-09-14,1484.25,0.3,0.02,1553.08,-4.43,True,1,13267,-1484.25,-4982316.2,19691544.75,14709228.55
20014,2007-09-17,1476.65,-7.6,-0.51,1553.08,-4.92,True,1,13268,-1476.65,-4983792.85,19592192.2,14608399.35
20015,2007-09-18,1519.78,43.13,2.92,1553.08,-2.14,True,1,13269,-1519.78,-4985312.63,20165960.82,15180648.19
20016,2007-09-19,1529.03,9.25,0.61,1553.08,-1.55,True,1,13270,-1529.03,-4986841.66,20290228.1,15303386.44
20017,2007-09-20,1518.75,-10.28,-0.67,1553.08,-2.21,True,1,13271,-1518.75,-4988360.41,20155331.25,15166970.84
20018,2007-09-21,1525.75,7.0,0.46,1553.08,-1.76,True,1,13272,-1525.75,-4989886.16,20249754.0,15259867.84
20019,2007-09-24,1517.73,-8.02,-0.53,1553.08,-2.28,True,1,13273,-1517.73,-4991403.89,20144830.29,15153426.4
20020,2007-09-25,1517.21,-0.52,-0.03,1553.08,-2.31,True,1,13274,-1517.21,-4992921.1,20139445.54,15146524.44
20021,2007-09-26,1525.42,8.21,0.54,1553.08,-1.78,True,1,13275,-1525.42,-4994446.52,20249950.5,15255503.98
20022,2007-09-27,1531.38,5.96,0.39,1553.08,-1.4,True,1,13276,-1531.38,-4995977.9,20330600.88,15334622.98
20023,2007-09-28,1526.75,-4.63,-0.3,1553.08,-1.7,True,1,13277,-1526.75,-4997504.65,20270659.75,15273155.1
20024,2007-10-01,1547.04,20.29,1.33,1553.08,-0.39,True,1,13278,-1547.04,-4999051.69,20541597.12,15542545.43
20025,2007-10-02,1546.63,-0.41,-0.03,1553.08,-0.42,True,1,13279,-1546.63,-5000598.32,20537699.77,15537101.45
20026,2007-10-03,1539.59,-7.04,-0.46,1553.08,-0.87,True,1,13280,-1539.59,-5002137.91,20445755.2,15443617.29
20027,2007-10-04,1542.84,3.25,0.21,1553.08,-0.66,True,1,13281,-1542.84,-5003680.75,20490458.04,15486777.29
20028,2007-10-05,1557.59,14.75,0.96,1557.59,0.0,True,1,13282,-1557.59,-5005238.34,20687910.38,15682672.04
20029,2007-10-08,1552.58,-5.01,-0.32,1557.59,-0.32,True,1,13283,-1552.58,-5006790.92,20622920.14,15616129.22
20030,2007-10-09,1565.15,12.57,0.81,1565.15,0.0,True,1,13284,-1565.15,-5008356.07,20791452.6,15783096.53
20031,2007-10-10,1562.47,-2.68,-0.17,1565.15,-0.17,True,1,13285,-1562.47,-5009918.54,20757413.95,15747495.41
20032,2007-10-11,1554.41,-8.06,-0.52,1565.15,-0.69,True,1,13286,-1554.41,-5011472.95,20651891.26,15640418.31
20033,2007-10-12,1561.8,7.39,0.48,1565.15,-0.21,True,1,13287,-1561.8,-5013034.75,20751636.6,15738601.85
20034,2007-10-15,1548.71,-13.09,-0.84,1565.15,-1.05,True,1,13288,-1548.71,-5014583.46,20579258.48,15564675.02
20035,2007-10-16,1538.53,-10.18,-0.66,1565.15,-1.7,True,1,13289,-1538.53,-5016121.99,20445525.17,15429403.18
20036,2007-10-17,1541.24,2.71,0.18,1565.15,-1.53,True,1,13290,-1541.24,-5017663.23,20483079.6,15465416.37
20037,2007-10-18,1540.08,-1.16,-0.08,1565.15,-1.6,True,1,13291,-1540.08,-5019203.31,20469203.28,15449999.97
20038,2007-10-19,1500.63,-39.45,-2.56,1565.15,-4.12,True,1,13292,-1500.63,-5020703.94,19946373.96,14925670.02
20039,2007-10-22,1506.33,5.7,0.38,1565.15,-3.76,True,1,13293,-1506.33,-5022210.27,20023644.69,15001434.42
20040,2007-10-23,1519.59,13.26,0.88,1565.15,-2.91,True,1,13294,-1519.59,-5023729.86,20201429.46,15177699.6
20041,2007-10-24,1515.88,-3.71,-0.24,1565.15,-3.15,True,1,13295,-1515.88,-5025245.74,20153624.6,15128378.86
20042,2007-10-25,1514.4,-1.48,-0.1,1565.15,-3.24,True,1,13296,-1514.4,-5026760.14,20135462.4,15108702.26
20043,2007-10-26,1535.28,20.88,1.38,1565.15,-1.91,True,1,13297,-1535.28,-5028295.42,20414618.16,15386322.74
20044,2007-10-29,1540.98,5.7,0.37,1565.15,-1.54,True,1,13298,-1540.98,-5029836.4,20491952.04,15462115.64
20045,2007-10-30,1531.02,-9.96,-0.65,1565.15,-2.18,True,1,13299,-1531.02,-5031367.42,20361034.98,15329667.56
20046,2007-10-31,1549.38,18.36,1.2,1565.15,-1.01,True,1,13300,-1549.38,-5032916.8,20606754.0,15573837.2
20047,2007-11-01,1508.44,-40.94,-2.64,1565.15,-3.62,True,1,13301,-1508.44,-5034425.24,20063760.44,15029335.2
20048,2007-11-02,1509.65,1.21,0.08,1565.15,-3.55,True,1,13302,-1509.65,-5035934.89,20081364.3,15045429.41
20049,2007-11-05,1502.17,-7.48,-0.5,1565.15,-4.02,True,1,13303,-1502.17,-5037437.06,19983367.51,14945930.45
20050,2007-11-06,1520.27,18.1,1.2,1565.15,-2.87,True,1,13304,-1520.27,-5038957.33,20225672.08,15186714.75
20051,2007-11-07,1475.62,-44.65,-2.94,1565.15,-5.72,True,1,13305,-1475.62,-5040432.95,19633124.1,14592691.15
20052,2007-11-08,1474.77,-0.85,-0.06,1565.15,-5.78,True,1,13306,-1474.77,-5041907.72,19623289.62,14581381.9
20053,2007-11-09,1453.7,-21.07,-1.43,1565.15,-7.12,True,1,13307,-1453.7,-5043361.42,19344385.9,14301024.48
20054,2007-11-12,1439.18,-14.52,-1.0,1565.15,-8.05,True,1,13308,-1439.18,-5044800.6,19152607.44,14107806.84
20055,2007-11-13,1481.05,41.87,2.91,1565.15,-5.37,True,1,13309,-1481.05,-5046281.65,19711294.45,14665012.8
20056,2007-11-14,1470.58,-10.47,-0.71,1565.15,-6.04,True,1,13310,-1470.58,-5047752.23,19573419.8,14525667.57
20057,2007-11-15,1451.15,-19.43,-1.32,1565.15,-7.28,True,1,13311,-1451.15,-5049203.38,19316257.65,14267054.27
20058,2007-11-16,1458.74,7.59,0.52,1565.15,-6.8,True,1,13312,-1458.74,-5050662.12,19418746.88,14368084.76
20059,2007-11-19,1433.27,-25.47,-1.75,1565.15,-8.43,True,1,13313,-1433.27,-5052095.39,19081123.51,14029028.12
20060,2007-11-20,1439.7,6.43,0.45,1565.15,-8.02,True,1,13314,-1439.7,-5053535.09,19168165.8,14114630.71
20061,2007-11-21,1416.77,-22.93,-1.59,1565.15,-9.48,True,1,13315,-1416.77,-5054951.86,18864292.55,13809340.69
20062,2007-11-23,1440.7,23.93,1.69,1565.15,-7.95,True,1,13316,-1440.7,-5056392.56,19184361.2,14127968.64
20063,2007-11-26,1407.22,-33.48,-2.32,1565.15,-10.09,True,1,13317,-1407.22,-5057799.78,18739948.74,13682148.96
20064,2007-11-27,1428.23,21.01,1.49,1565.15,-8.75,True,1,13318,-1428.23,-5059228.01,19021167.14,13961939.13
20065,2007-11-28,1469.02,40.79,2.86,1565.15,-6.14,True,1,13319,-1469.02,-5060697.03,19565877.38,14505180.35
20066,2007-11-29,1469.72,0.7,0.05,1565.15,-6.1,True,1,13320,-1469.72,-5062166.75,19576670.4,14514503.65
20067,2007-11-30,1481.14,11.42,0.78,1565.15,-5.37,True,1,13321,-1481.14,-5063647.89,19730265.94,14666618.05
20068,2007-12-03,1472.42,-8.72,-0.59,1565.15,-5.92,True,1,13322,-1472.42,-5065120.31,19615579.24,14550458.93
20069,2007-12-04,1462.79,-9.63,-0.65,1565.15,-6.54,True,1,13323,-1462.79,-5066583.1,19488751.17,14422168.07
20070,2007-12-05,1485.01,22.22,1.52,1565.15,-5.12,True,1,13324,-1485.01,-5068068.11,19786273.24,14718205.13
20071,2007-12-06,1507.34,22.33,1.5,1565.15,-3.69,True,1,13325,-1507.34,-5069575.45,20085305.5,15015730.05
20072,2007-12-07,1504.66,-2.68,-0.18,1565.15,-3.86,True,1,13326,-1504.66,-5071080.11,20051099.16,14980019.05
20073,2007-12-10,1515.96,11.3,0.75,1565.15,-3.14,True,1,13327,-1515.96,-5072596.07,20203198.92,15130602.85
20074,2007-12-11,1477.65,-38.31,-2.53,1565.15,-5.59,True,1,13328,-1477.65,-5074073.72,19694119.2,14620045.48
20075,2007-12-12,1486.59,8.94,0.6,1565.15,-5.02,True,1,13329,-1486.59,-5075560.31,19814758.11,14739197.8
20076,2007-12-13,1488.41,1.82,0.12,1565.15,-4.9,True,1,13330,-1488.41,-5077048.72,19840505.3,14763456.58
20077,2007-12-14,1467.95,-20.46,-1.38,1565.15,-6.21,True,1,13331,-1467.95,-5078516.67,19569241.45,14490724.78
20078,2007-12-17,1445.9,-22.05,-1.5,1565.15,-7.62,True,1,13332,-1445.9,-5079962.57,19276738.8,14196776.23
20079,2007-12-18,1454.98,9.08,0.63,1565.15,-7.04,True,1,13333,-1454.98,-5081417.55,19399248.34,14317830.79
20080,2007-12-19,1453.0,-1.98,-0.14,1565.15,-7.16,True,1,13334,-1453.0,-5082870.55,19374302.0,14291431.45
20081,2007-12-20,1460.12,7.12,0.49,1565.15,-6.71,True,1,13335,-1460.12,-5084330.67,19470700.2,14386369.53
20082,2007-12-21,1484.46,24.34,1.67,1565.15,-5.16,True,1,13336,-1484.46,-5085815.13,19796758.56,14710943.43
20083,2007-12-24,1496.45,11.99,0.81,1565.15,-4.39,True,1,13337,-1496.45,-5087311.58,19958153.65,14870842.07
20084,2007-12-26,1497.66,1.21,0.08,1565.15,-4.31,True,1,13338,-1497.66,-5088809.24,19975789.08,14886979.84
20085,2007-12-27,1476.27,-21.39,-1.43,1565.15,-5.68,True,1,13339,-1476.27,-5090285.51,19691965.53,14601680.02
20086,2007-12-28,1478.49,2.22,0.15,1565.15,-5.54,True,1,13340,-1478.49,-5091764.0,19723056.6,14631292.6
20087,2007-12-31,1468.36,-10.13,-0.68,1565.15,-6.18,True,1,13341,-1468.36,-5093232.36,19589390.76,14496158.4
20088,2008-01-02,1447.16,-21.2,-1.44,1565.15,-7.54,True,1,13342,-1447.16,-5094679.52,19308008.72,14213329.2
20089,2008-01-03,1447.16,0.0,0.0,1565.15,-7.54,True,1,13343,-1447.16,-5096126.68,19309455.88,14213329.2
20090,2008-01-04,1411.63,-35.53,-2.46,1565.15,-9.81,True,1,13344,-1411.63,-5097538.31,18836790.72,13739252.41
20091,2008-01-07,1416.18,4.55,0.32,1565.15,-9.52,True,1,13345,-1416.18,-5098954.49,18898922.1,13799967.61
20092,2008-01-08,1390.19,-25.99,-1.84,1565.15,-11.18,True,1,13346,-1390.19,-5100344.68,18553475.74,13453131.06
20093,2008-01-09,1409.13,18.94,1.36,1565.15,-9.97,True,1,13347,-1409.13,-5101753.81,18807658.11,13705904.3
20094,2008-01-10,1420.33,11.2,0.8,1565.15,-9.25,True,1,13348,-1420.33,-5103174.14,18958564.84,13855390.7
20095,2008-01-11,1401.02,-19.31,-1.36,1565.15,-10.49,True,1,13349,-1401.02,-5104575.16,18702215.98,13597640.82
20096,2008-01-14,1416.25,15.23,1.09,1565.15,-9.51,True,1,13350,-1416.25,-5105991.41,18906937.5,13800946.09
20097,2008-01-15,1380.95,-35.3,-2.49,1565.15,-11.77,True,1,13351,-1380.95,-5107372.36,18437063.45,13329691.09
20098,2008-01-16,1373.2,-7.75,-0.56,1565.15,-12.26,True,1,13352,-1373.2,-5108745.56,18334966.4,13226220.84
20099,2008-01-17,1333.25,-39.95,-2.91,1565.15,-14.82,True,1,13353,-1333.25,-5110078.81,17802887.25,12692808.44
20100,2008-01-18,1325.19,-8.06,-0.6,1565.15,-15.33,True,1,13354,-1325.19,-5111404.0,17696587.26,12585183.26
20101,2008-01-22,1310.5,-14.69,-1.11,1565.15,-16.27,True,1,13355,-1310.5,-5112714.5,17501727.5,12389013.0
20102,2008-01-23,1338.6,28.1,2.14,1565.15,-14.48,True,1,13356,-1338.6,-5114053.1,17878341.6,12764288.5
20103,2008-01-24,1352.07,13.47,1.01,1565.15,-13.61,True,1,13357,-1352.07,-5115405.17,18059598.99,12944193.82
20104,2008-01-25,1330.61,-21.46,-1.59,1565.15,-14.98,True,1,13358,-1330.61,-5116735.78,17774288.38,12657552.6
20105,2008-01-28,1353.96,23.35,1.76,1565.15,-13.49,True,1,13359,-1353.96,-5118089.74,18087551.64,12969461.9
20106,2008-01-29,1362.3,8.34,0.62,1565.15,-12.96,True,1,13360,-1362.3,-5119452.04,18200328.0,13080875.96
20107,2008-01-30,1355.81,-6.49,-0.48,1565.15,-13.38,True,1,13361,-1355.81,-5120807.85,18114977.41,12994169.56
20108,2008-01-31,1378.55,22.74,1.68,1565.15,-11.92,True,1,13362,-1378.55,-5122186.4,18420185.1,13297998.7
20109,2008-02-01,1395.42,16.87,1.22,1565.15,-10.84,True,1,13363,-1395.42,-5123581.82,18646997.46,13523415.64
20110,2008-02-04,1380.82,-14.6,-1.05,1565.15,-11.78,True,1,13364,-1380.82,-5124962.64,18453278.48,13328315.84
20111,2008-02-05,1336.64,-44.18,-3.2,1565.15,-14.6,True,1,13365,-1336.64,-5126299.28,17864193.6,12737894.32
20112,2008-02-06,1326.45,-10.19,-0.76,1565.15,-15.25,True,1,13366,-1326.45,-5127625.73,17729330.7,12601704.97
20113,2008-02-07,1336.91,10.46,0.79,1565.15,-14.58,True,1,13367,-1336.91,-5128962.64,17870475.97,12741513.33
20114,2008-02-08,1331.29,-5.62,-0.42,1565.15,-14.94,True,1,13368,-1331.29,-5130293.93,17796684.72,12666390.79
20115,2008-02-11,1339.13,7.84,0.59,1565.15,-14.44,True,1,13369,-1339.13,-5131633.06,17902828.97,12771195.91
20116,2008-02-12,1348.86,9.73,0.73,1565.15,-13.82,True,1,13370,-1348.86,-5132981.92,18034258.2,12901276.28
20117,2008-02-13,1367.21,18.35,1.36,1565.15,-12.65,True,1,13371,-1367.21,-5134349.13,18280964.91,13146615.78
20118,2008-02-14,1348.86,-18.35,-1.34,1565.15,-13.82,True,1,13372,-1348.86,-5135697.99,18036955.92,12901257.93
20119,2008-02-15,1349.99,1.13,0.08,1565.15,-13.75,True,1,13373,-1349.99,-5137047.98,18053416.27,12916368.29
20120,2008-02-19,1348.78,-1.21,-0.09,1565.15,-13.82,True,1,13374,-1348.78,-5138396.76,18038583.72,12900186.96
20121,2008-02-20,1360.03,11.25,0.83,1565.15,-13.1,True,1,13375,-1360.03,-5139756.79,18190401.25,13050644.46
20122,2008-02-21,1342.53,-17.5,-1.29,1565.15,-14.22,True,1,13376,-1342.53,-5141099.32,17957681.28,12816581.96
20123,2008-02-22,1353.11,10.58,0.79,1565.15,-13.55,True,1,13377,-1353.11,-5142452.43,18100552.47,12958100.04
20124,2008-02-25,1371.8,18.69,1.38,1565.15,-12.35,True,1,13378,-1371.8,-5143824.23,18351940.4,13208116.17
20125,2008-02-26,1381.29,9.49,0.69,1565.15,-11.75,True,1,13379,-1381.29,-5145205.52,18480278.91,13335073.39
20126,2008-02-27,1380.02,-1.27,-0.09,1565.15,-11.83,True,1,13380,-1380.02,-5146585.54,18464667.6,13318082.06
20127,2008-02-28,1367.68,-12.34,-0.89,1565.15,-12.62,True,1,13381,-1367.68,-5147953.22,18300926.08,13152972.86
20128,2008-02-29,1330.63,-37.05,-2.71,1565.15,-14.98,True,1,13382,-1330.63,-5149283.85,17806490.66,12657206.81
20129,2008-03-03,1331.34,0.71,0.05,1565.15,-14.94,True,1,13383,-1331.34,-5150615.19,17817323.22,12666708.03
20130,2008-03-04,1326.75,-4.59,-0.34,1565.15,-15.23,True,1,13384,-1326.75,-5151941.94,17757222.0,12605280.06
20131,2008-03-05,1333.7,6.95,0.52,1565.15,-14.79,True,1,13385,-1333.7,-5153275.64,17851574.5,12698298.86
20132,2008-03-06,1304.34,-29.36,-2.2,1565.15,-16.66,True,1,13386,-1304.34,-5154579.98,17459895.24,12305315.26
20133,2008-03-07,1293.37,-10.97,-0.84,1565.15,-17.36,True,1,13387,-1293.37,-5155873.35,17314344.19,12158470.84
20134,2008-03-10,1273.37,-20.0,-1.55,1565.15,-18.64,True,1,13388,-1273.37,-5157146.72,17047877.56,11890730.84
20135,2008-03-11,1320.65,47.28,3.71,1565.15,-15.62,True,1,13389,-1320.65,-5158467.37,17682182.85,12523715.48
20136,2008-03-12,1308.77,-11.88,-0.9,1565.15,-16.38,True,1,13390,-1308.77,-5159776.14,17524430.3,12364654.16
20137,2008-03-13,1315.48,6.71,0.51,1565.15,-15.95,True,1,13391,-1315.48,-5161091.62,17615592.68,12454501.06
20138,2008-03-14,1288.14,-27.34,-2.08,1565.15,-17.7,True,1,13392,-1288.14,-5162379.76,17250770.88,12088391.12
20139,2008-03-17,1276.6,-11.54,-0.9,1565.15,-18.44,True,1,13393,-1276.6,-5163656.36,17097503.8,11933847.44
20140,2008-03-18,1330.74,54.14,4.24,1565.15,-14.98,True,1,13394,-1330.74,-5164987.1,17823931.56,12658944.46
20141,2008-03-19,1298.42,-32.32,-2.43,1565.15,-17.04,True,1,13395,-1298.42,-5166285.52,17392335.9,12226050.38
20142,2008-03-20,1329.51,31.09,2.39,1565.15,-15.06,True,1,13396,-1329.51,-5167615.03,17810115.96,12642500.93
20143,2008-03-24,1349.88,20.37,1.53,1565.15,-13.75,True,1,13397,-1349.88,-5168964.91,18084342.36,12915377.45
20144,2008-03-25,1352.99,3.11,0.23,1565.15,-13.56,True,1,13398,-1352.99,-5170317.9,18127360.02,12957042.12
20145,2008-03-26,1341.13,-11.86,-0.88,1565.15,-14.31,True,1,13399,-1341.13,-5171659.03,17969800.87,12798141.84
20146,2008-03-27,1325.76,-15.37,-1.15,1565.15,-15.3,True,1,13400,-1325.76,-5172984.79,17765184.0,12592199.21
20147,2008-03-28,1315.22,-10.54,-0.8,1565.15,-15.97,True,1,13401,-1315.22,-5174300.01,17625263.22,12450963.21
20148,2008-03-31,1322.7,7.48,0.57,1565.15,-15.49,True,1,13402,-1322.7,-5175622.71,17726825.4,12551202.69
20149,2008-04-01,1370.18,47.48,3.59,1565.15,-12.46,True,1,13403,-1370.18,-5176992.89,18364522.54,13187529.65
20150,2008-04-02,1367.53,-2.65,-0.19,1565.15,-12.63,True,1,13404,-1367.53,-5178360.42,18330372.12,13152011.7
20151,2008-04-03,1369.31,1.78,0.13,1565.15,-12.51,True,1,13405,-1369.31,-5179729.73,18355600.55,13175870.82
20152,2008-04-04,1370.4,1.09,0.08,1565.15,-12.44,True,1,13406,-1370.4,-5181100.13,18371582.4,13190482.27
20153,2008-04-07,1372.54,2.14,0.16,1565.15,-12.31,True,1,13407,-1372.54,-5182472.67,18401643.78,13219171.11
20154,2008-04-08,1365.54,-7.0,-0.51,1565.15,-12.75,True,1,13408,-1365.54,-5183838.21,18309160.32,13125322.11
20155,2008-04-09,1354.49,-11.05,-0.81,1565.15,-13.46,True,1,13409,-1354.49,-5185192.7,18162356.41,12977163.71
20156,2008-04-10,1360.55,6.06,0.45,1565.15,-13.07,True,1,13410,-1360.55,-5186553.25,18244975.5,13058422.25
20157,2008-04-11,1332.83,-27.72,-2.04,1565.15,-14.84,True,1,13411,-1332.83,-5187886.08,17874583.13,12686697.05
20158,2008-04-14,1328.32,-4.51,-0.34,1565.15,-15.13,True,1,13412,-1328.32,-5189214.4,17815427.84,12626213.44
20159,2008-04-15,1334.43,6.11,0.46,1565.15,-14.74,True,1,13413,-1334.43,-5190548.83,17898709.59,12708160.76
20160,2008-04-16,1364.71,30.28,2.27,1565.15,-12.81,True,1,13414,-1364.71,-5191913.54,18306219.94,13114306.4
20161,2008-04-17,1365.56,0.85,0.06,1565.15,-12.75,True,1,13415,-1365.56,-5193279.1,18318987.4,13125708.3
20162,2008-04-18,1390.33,24.77,1.81,1565.15,-11.17,True,1,13416,-1390.33,-5194669.43,18652667.28,13457997.85
20163,2008-04-21,1388.17,-2.16,-0.16,1565.15,-11.31,True,1,13417,-1388.17,-5196057.6,18625076.89,13429019.29
20164,2008-04-22,1375.94,-12.23,-0.88,1565.15,-12.09,True,1,13418,-1375.94,-5197433.54,18462362.92,13264929.38
20165,2008-04-23,1379.93,3.99,0.29,1565.15,-11.83,True,1,13419,-1379.93,-5198813.47,18517280.67,13318467.2
20166,2008-04-24,1388.82,8.89,0.64,1565.15,-11.27,True,1,13420,-1388.82,-5200202.29,18637964.4,13437762.11
20167,2008-04-25,1397.84,9.02,0.65,1565.15,-10.69,True,1,13421,-1397.84,-5201600.13,18760410.64,13558810.51
20168,2008-04-28,1396.37,-1.47,-0.1,1565.15,-10.78,True,1,13422,-1396.37,-5202996.5,18742078.14,13539081.64
20169,2008-04-29,1390.94,-5.43,-0.39,1565.15,-11.13,True,1,13423,-1390.94,-5204387.44,18670587.62,13466200.18
20170,2008-04-30,1385.59,-5.35,-0.38,1565.15,-11.47,True,1,13424,-1385.59,-5205773.03,18600160.16,13394387.13
20171,2008-05-01,1409.34,23.75,1.71,1565.15,-9.96,True,1,13425,-1409.34,-5207182.37,18920389.5,13713207.13
20172,2008-05-02,1413.9,4.56,0.32,1565.15,-9.66,True,1,13426,-1413.9,-5208596.27,18983021.4,13774425.13
20173,2008-05-05,1407.49,-6.41,-0.45,1565.15,-10.07,True,1,13427,-1407.49,-5210003.76,18898368.23,13688364.47
20174,2008-05-06,1418.26,10.77,0.76,1565.15,-9.38,True,1,13428,-1418.26,-5211422.02,19044395.28,13832973.26
20175,2008-05-07,1392.57,-25.69,-1.81,1565.15,-11.03,True,1,13429,-1392.57,-5212814.59,18700822.53,13488007.94
20176,2008-05-08,1397.68,5.11,0.37,1565.15,-10.7,True,1,13430,-1397.68,-5214212.27,18770842.4,13556630.13
20177,2008-05-09,1388.28,-9.4,-0.67,1565.15,-11.3,True,1,13431,-1388.28,-5215600.55,18645988.68,13430388.13
20178,2008-05-12,1403.58,15.3,1.1,1565.15,-10.32,True,1,13432,-1403.58,-5217004.13,18852886.56,13635882.43
20179,2008-05-13,1403.04,-0.54,-0.04,1565.15,-10.36,True,1,13433,-1403.04,-5218407.17,18847036.32,13628629.15
20180,2008-05-14,1408.66,5.62,0.4,1565.15,-10.0,True,1,13434,-1408.66,-5219815.83,18923938.44,13704122.61
20181,2008-05-15,1423.57,14.91,1.06,1565.15,-9.05,True,1,13435,-1423.57,-5221239.4,19125662.95,13904423.55
20182,2008-05-16,1425.35,1.78,0.12,1565.15,-8.93,True,1,13436,-1425.35,-5222664.75,19151002.6,13928337.85
20183,2008-05-19,1426.63,1.28,0.09,1565.15,-8.85,True,1,13437,-1426.63,-5224091.38,19169627.31,13945535.93
20184,2008-05-20,1413.4,-13.23,-0.93,1565.15,-9.7,True,1,13438,-1413.4,-5225504.78,18993269.2,13767764.42
20185,2008-05-21,1390.71,-22.69,-1.6,1565.15,-11.14,True,1,13439,-1390.71,-5226895.49,18689751.69,13462856.2
20186,2008-05-22,1394.35,3.64,0.26,1565.15,-10.91,True,1,13440,-1394.35,-5228289.84,18740064.0,13511774.16
20187,2008-05-23,1375.93,-18.42,-1.32,1565.15,-12.09,True,1,13441,-1375.93,-5229665.77,18493875.13,13264209.36
20188,2008-05-27,1385.35,9.42,0.68,1565.15,-11.49,True,1,13442,-1385.35,-5231051.12,18621874.7,13390823.58
20189,2008-05-28,1390.84,5.49,0.4,1565.15,-11.14,True,1,13443,-1390.84,-5232441.96,18697062.12,13464620.16
20190,2008-05-29,1398.26,7.42,0.53,1565.15,-10.66,True,1,13444,-1398.26,-5233840.22,18798207.44,13564367.22
20191,2008-05-30,1400.38,2.12,0.15,1565.15,-10.53,True,1,13445,-1400.38,-5235240.6,18828109.1,13592868.5
20192,2008-06-02,1385.67,-14.71,-1.05,1565.15,-11.47,True,1,13446,-1385.67,-5236626.27,18631718.82,13395092.55
20193,2008-06-03,1377.65,-8.02,-0.58,1565.15,-11.98,True,1,13447,-1377.65,-5238003.92,18525259.55,13287255.63
20194,2008-06-04,1377.2,-0.45,-0.03,1565.15,-12.01,True,1,13448,-1377.2,-5239381.12,18520585.6,13281204.48
20195,2008-06-05,1404.05,26.85,1.95,1565.15,-10.29,True,1,13449,-1404.05,-5240785.17,18883068.45,13642283.28
20196,2008-06-06,1360.68,-43.37,-3.09,1565.15,-13.06,True,1,13450,-1360.68,-5242145.85,18301146.0,13059000.15
20197,2008-06-09,1361.76,1.08,0.08,1565.15,-13.0,True,1,13451,-1361.76,-5243507.61,18317033.76,13073526.15
20198,2008-06-10,1358.44,-3.32,-0.24,1565.15,-13.21,True,1,13452,-1358.44,-5244866.05,18273734.88,13028868.83
20199,2008-06-11,1335.49,-22.95,-1.69,1565.15,-14.67,True,1,13453,-1335.49,-5246201.54,17966346.97,12720145.43
20200,2008-06-12,1339.87,4.38,0.33,1565.15,-14.39,True,1,13454,-1339.87,-5247541.41,18026610.98,12779069.57
20201,2008-06-13,1360.03,20.16,1.5,1565.15,-13.1,True,1,13455,-1360.03,-5248901.44,18299203.65,13050302.21
20202,2008-06-16,1360.14,0.11,0.01,1565.15,-13.1,True,1,13456,-1360.14,-5250261.58,18302043.84,13051782.26
20203,2008-06-17,1350.93,-9.21,-0.68,1565.15,-13.69,True,1,13457,-1350.93,-5251612.51,18179465.01,12927852.5
20204,2008-06-18,1337.81,-13.12,-0.97,1565.15,-14.52,True,1,13458,-1337.81,-5252950.32,18004246.98,12751296.66
20205,2008-06-19,1342.83,5.02,0.38,1565.15,-14.2,True,1,13459,-1342.83,-5254293.15,18073148.97,12818855.82
20206,2008-06-20,1317.93,-24.9,-1.85,1565.15,-15.8,True,1,13460,-1317.93,-5255611.08,17739337.8,12483726.72
20207,2008-06-23,1318.0,0.07,0.0,1565.15,-15.79,True,1,13461,-1318.0,-5256929.08,17741598.0,12484668.92
20208,2008-06-24,1314.29,-3.71,-0.28,1565.15,-16.03,True,1,13462,-1314.29,-5258243.37,17692971.98,12434728.61
20209,2008-06-25,1321.97,7.68,0.58,1565.15,-15.54,True,1,13463,-1321.97,-5259565.34,17797682.11,12538116.77
20210,2008-06-26,1283.15,-38.82,-2.94,1565.15,-18.02,True,1,13464,-1283.15,-5260848.49,17276331.6,12015483.11
20211,2008-06-27,1278.38,-4.77,-0.37,1565.15,-18.32,True,1,13465,-1278.38,-5262126.87,17213386.7,11951259.83
20212,2008-06-30,1280.0,1.62,0.13,1565.15,-18.22,True,1,13466,-1280.0,-5263406.87,17236480.0,11973073.13
20213,2008-07-01,1284.91,4.91,0.38,1565.15,-17.9,True,1,13467,-1284.91,-5264691.78,17303882.97,12039191.19
20214,2008-07-02,1261.52,-23.39,-1.82,1565.15,-19.4,True,1,13468,-1261.52,-5265953.3,16990151.36,11724198.06
20215,2008-07-03,1262.9,1.38,0.11,1565.15,-19.31,True,1,13469,-1262.9,-5267216.2,17010000.1,11742783.9
20216,2008-07-07,1252.31,-10.59,-0.84,1565.15,-19.99,True,1,13470,-1252.31,-5268468.51,16868615.7,11600147.19
20217,2008-07-08,1273.7,21.39,1.71,1565.15,-18.62,True,1,13471,-1273.7,-5269742.21,17158012.7,11888270.49
20218,2008-07-09,1244.69,-29.01,-2.28,1565.15,-20.48,True,1,13472,-1244.69,-5270986.9,16768463.68,11497476.78
20219,2008-07-10,1253.39,8.7,0.7,1565.15,-19.92,True,1,13473,-1253.39,-5272240.29,16886923.47,11614683.18
20220,2008-07-11,1239.49,-13.9,-1.11,1565.15,-20.81,True,1,13474,-1239.49,-5273479.78,16700888.26,11427408.48
20221,2008-07-14,1228.3,-11.19,-0.9,1565.15,-21.52,True,1,13475,-1228.3,-5274708.08,16551342.5,11276634.42
20222,2008-07-15,1214.91,-13.39,-1.09,1565.15,-22.38,True,1,13476,-1214.91,-5275922.99,16372127.16,11096204.17
20223,2008-07-16,1245.36,30.45,2.51,1565.15,-20.43,True,1,13477,-1245.36,-5277168.35,16783716.72,11506548.37
20224,2008-07-17,1260.32,14.96,1.2,1565.15,-19.48,True,1,13478,-1260.32,-5278428.67,16986592.96,11708164.29
20225,2008-07-18,1260.68,0.36,0.03,1565.15,-19.45,True,1,13479,-1260.68,-5279689.35,16992705.72,11713016.37
20226,2008-07-21,1260.0,-0.68,-0.05,1565.15,-19.5,True,1,13480,-1260.0,-5280949.35,16984800.0,11703850.65
20227,2008-07-22,1277.0,17.0,1.35,1565.15,-18.41,True,1,13481,-1277.0,-5282226.35,17215237.0,11933010.65
20228,2008-07-23,1282.19,5.19,0.41,1565.15,-18.08,True,1,13482,-1282.19,-5283508.54,17286485.58,12002977.04
20229,2008-07-24,1252.54,-29.65,-2.31,1565.15,-19.97,True,1,13483,-1252.54,-5284761.08,16887996.82,11603235.74
20230,2008-07-25,1257.76,5.22,0.42,1565.15,-19.64,True,1,13484,-1257.76,-5286018.84,16959635.84,11673617.0
20231,2008-07-28,1234.37,-23.39,-1.86,1565.15,-21.13,True,1,13485,-1234.37,-5287253.21,16645479.45,11358226.24
20232,2008-07-29,1263.2,28.83,2.34,1565.15,-19.29,True,1,13486,-1263.2,-5288516.41,17035515.2,11746998.79
20233,2008-07-30,1284.26,21.06,1.67,1565.15,-17.95,True,1,13487,-1284.26,-5289800.67,17320814.62,12031013.95
20234,2008-07-31,1267.38,-16.88,-1.31,1565.15,-19.02,True,1,13488,-1267.38,-5291068.05,17094421.44,11803353.39
20235,2008-08-01,1260.31,-7.07,-0.56,1565.15,-19.48,True,1,13489,-1260.31,-5292328.36,17000321.59,11707993.23
20236,2008-08-04,1249.01,-11.3,-0.9,1565.15,-20.2,True,1,13490,-1249.01,-5293577.37,16849144.9,11555567.53
20237,2008-08-05,1284.88,35.87,2.87,1565.15,-17.91,True,1,13491,-1284.88,-5294862.25,17334316.08,12039453.83
20238,2008-08-06,1289.19,4.31,0.34,1565.15,-17.63,True,1,13492,-1289.19,-5296151.44,17393751.48,12097600.04
20239,2008-08-07,1266.07,-23.12,-1.79,1565.15,-19.11,True,1,13493,-1266.07,-5297417.51,17083082.51,11785665.0
20240,2008-08-08,1296.32,30.25,2.39,1565.15,-17.18,True,1,13494,-1296.32,-5298713.83,17492542.08,12193828.25
20241,2008-08-11,1305.32,9.0,0.69,1565.15,-16.6,True,1,13495,-1305.32,-5300019.15,17615293.4,12315274.25
20242,2008-08-12,1289.59,-15.73,-1.2,1565.15,-17.61,True,1,13496,-1289.59,-5301308.74,17404306.64,12102997.9
20243,2008-08-13,1285.83,-3.76,-0.29,1565.15,-17.85,True,1,13497,-1285.83,-5302594.57,17354847.51,12052252.94
20244,2008-08-14,1292.93,7.1,0.55,1565.15,-17.39,True,1,13498,-1292.93,-5303887.5,17451969.14,12148081.64
20245,2008-08-15,1298.2,5.27,0.41,1565.15,-17.06,True,1,13499,-1298.2,-5305185.7,17524401.8,12219216.1
20246,2008-08-18,1278.6,-19.6,-1.51,1565.15,-18.31,True,1,13500,-1278.6,-5306464.3,17261100.0,11954635.7
20247,2008-08-19,1266.69,-11.91,-0.93,1565.15,-19.07,True,1,13501,-1266.69,-5307730.99,17101581.69,11793850.7
20248,2008-08-20,1274.54,7.85,0.62,1565.15,-18.57,True,1,13502,-1274.54,-5309005.53,17208839.08,11899833.55
20249,2008-08-21,1277.72,3.18,0.25,1565.15,-18.36,True,1,13503,-1277.72,-5310283.25,17253053.16,11942769.91
20250,2008-08-22,1292.2,14.48,1.13,1565.15,-17.44,True,1,13504,-1292.2,-5311575.45,17449868.8,12138293.35
20251,2008-08-25,1266.84,-25.36,-1.96,1565.15,-19.06,True,1,13505,-1266.84,-5312842.29,17108674.2,11795831.91
20252,2008-08-26,1271.51,4.67,0.37,1565.15,-18.76,True,1,13506,-1271.51,-5314113.8,17173014.06,11858900.26
20253,2008-08-27,1281.66,10.15,0.8,1565.15,-18.11,True,1,13507,-1281.66,-5315395.46,17311381.62,11995986.16
20254,2008-08-28,1300.68,19.02,1.48,1565.15,-16.9,True,1,13508,-1300.68,-5316696.14,17569585.44,12252889.3
20255,2008-08-29,1282.83,-17.85,-1.37,1565.15,-18.04,True,1,13509,-1282.83,-5317978.97,17329750.47,12011771.5
20256,2008-09-02,1277.58,-5.25,-0.41,1565.15,-18.37,True,1,13510,-1277.58,-5319256.55,17260105.8,11940849.25
20257,2008-09-03,1274.98,-2.6,-0.2,1565.15,-18.54,True,1,13511,-1274.98,-5320531.53,17226254.78,11905723.25
20258,2008-09-04,1236.83,-38.15,-2.99,1565.15,-20.98,True,1,13512,-1236.83,-5321768.36,16712046.96,11390278.6
20259,2008-09-05,1242.31,5.48,0.44,1565.15,-20.63,True,1,13513,-1242.31,-5323010.67,16787335.03,11464324.36
20260,2008-09-08,1267.79,25.48,2.05,1565.15,-19.0,True,1,13514,-1267.79,-5324278.46,17132914.06,11808635.6
20261,2008-09-09,1224.51,-43.28,-3.41,1565.15,-21.76,True,1,13515,-1224.51,-5325502.97,16549252.65,11223749.68
20262,2008-09-10,1232.04,7.53,0.62,1565.15,-21.28,True,1,13516,-1232.04,-5326735.01,16652252.64,11325517.63
20263,2008-09-11,1249.05,17.01,1.38,1565.15,-20.2,True,1,13517,-1249.05,-5327984.06,16883408.85,11555424.79
20264,2008-09-12,1251.7,2.65,0.21,1565.15,-20.03,True,1,13518,-1251.7,-5329235.76,16920480.6,11591244.84
20265,2008-09-15,1192.7,-59.0,-4.71,1565.15,-23.8,True,1,13519,-1192.7,-5330428.46,16124111.3,10793682.84
20266,2008-09-16,1213.6,20.9,1.75,1565.15,-22.46,True,1,13520,-1213.6,-5331642.06,16407872.0,11076229.94
20267,2008-09-17,1156.39,-57.21,-4.71,1565.15,-26.12,True,1,13521,-1156.39,-5332798.45,15635549.19,10302750.74
20268,2008-09-18,1206.51,50.12,4.33,1565.15,-22.91,True,1,13522,-1206.51,-5334004.96,16314428.22,10980423.26
20269,2008-09-19,1255.08,48.57,4.03,1565.15,-19.81,True,1,13523,-1255.08,-5335260.04,16972446.84,11637186.8
20270,2008-09-22,1207.09,-47.99,-3.82,1565.15,-22.88,True,1,13524,-1207.09,-5336467.13,16324685.16,10988218.03
20271,2008-09-23,1188.22,-18.87,-1.56,1565.15,-24.08,True,1,13525,-1188.22,-5337655.35,16070675.5,10733020.15
20272,2008-09-24,1185.87,-2.35,-0.2,1565.15,-24.23,True,1,13526,-1185.87,-5338841.22,16040077.62,10701236.4
20273,2008-09-25,1209.18,23.31,1.97,1565.15,-22.74,True,1,13527,-1209.18,-5340050.4,16356577.86,11016527.46
20274,2008-09-26,1213.27,4.09,0.34,1565.15,-22.48,True,1,13528,-1213.27,-5341263.67,16413116.56,11071852.89
20275,2008-09-29,1106.42,-106.85,-8.81,1565.15,-29.31,True,1,13529,-1106.42,-5342370.09,14968756.18,9626386.09
20276,2008-09-30,1166.36,59.94,5.42,1565.15,-25.48,True,1,13530,-1166.36,-5343536.45,15780850.8,10437314.35
20277,2008-10-01,1161.06,-5.3,-0.45,1565.15,-25.82,True,1,13531,-1161.06,-5344697.51,15710302.86,10365605.35
20278,2008-10-02,1114.28,-46.78,-4.03,1565.15,-28.81,True,1,13532,-1114.28,-5345811.79,15078436.96,9732625.17
20279,2008-10-03,1099.23,-15.05,-1.35,1565.15,-29.77,True,1,13533,-1099.23,-5346911.02,14875879.59,9528968.57
20280,2008-10-06,1056.89,-42.34,-3.85,1565.15,-32.47,True,1,13534,-1056.89,-5347967.91,14303949.26,8955981.35
20281,2008-10-07,996.23,-60.66,-5.74,1565.15,-36.35,True,1,13535,-996.23,-5348964.14,13483973.05,8135008.91
20282,2008-10-08,984.94,-11.29,-1.13,1565.15,-37.07,True,1,13536,-984.94,-5349949.08,13332147.84,7982198.76
20283,2008-10-09,909.92,-75.02,-7.62,1565.15,-41.86,True,1,13537,-909.92,-5350859.0,12317587.04,6966728.04
20284,2008-10-10,899.22,-10.7,-1.18,1565.15,-42.55,True,1,13538,-899.22,-5351758.22,12173640.36,6821882.14
20285,2008-10-13,1003.35,104.13,11.58,1565.15,-35.89,True,1,13539,-1003.35,-5352761.57,13584355.65,8231594.08
20286,2008-10-14,998.01,-5.34,-0.53,1565.15,-36.24,True,1,13540,-998.01,-5353759.58,13513055.4,8159295.82
20287,2008-10-15,907.84,-90.17,-9.04,1565.15,-42.0,True,1,13541,-907.84,-5354667.42,12293061.44,6938394.02
20288,2008-10-16,946.43,38.59,4.25,1565.15,-39.53,True,1,13542,-946.43,-5355613.85,12816555.06,7460941.21
20289,2008-10-17,940.55,-5.88,-0.62,1565.15,-39.91,True,1,13543,-940.55,-5356554.4,12737868.65,7381314.25
20290,2008-10-20,985.4,44.85,4.77,1565.15,-37.04,True,1,13544,-985.4,-5357539.8,13346257.6,7988717.8
20291,2008-10-21,955.05,-30.35,-3.08,1565.15,-38.98,True,1,13545,-955.05,-5358494.85,12936152.25,7577657.4
20292,2008-10-22,896.78,-58.27,-6.1,1565.15,-42.7,True,1,13546,-896.78,-5359391.63,12147781.88,6788390.25
20293,2008-10-23,908.11,11.33,1.26,1565.15,-41.98,True,1,13547,-908.11,-5360299.74,12302166.17,6941866.43
20294,2008-10-24,876.77,-31.34,-3.45,1565.15,-43.98,True,1,13548,-876.77,-5361176.51,11878479.96,6517303.45
20295,2008-10-27,848.92,-27.85,-3.18,1565.15,-45.76,True,1,13549,-848.92,-5362025.43,11502017.08,6139991.65
20296,2008-10-28,940.51,91.59,10.79,1565.15,-39.91,True,1,13550,-940.51,-5362965.94,12743910.5,7380944.56
20297,2008-10-29,930.09,-10.42,-1.11,1565.15,-40.58,True,1,13551,-930.09,-5363896.03,12603649.59,7239753.56
20298,2008-10-30,954.09,24.0,2.58,1565.15,-39.04,True,1,13552,-954.09,-5364850.12,12929827.68,7564977.56
20299,2008-10-31,968.75,14.66,1.54,1565.15,-38.1,True,1,13553,-968.75,-5365818.87,13129468.75,7763649.88
20300,2008-11-03,966.3,-2.45,-0.25,1565.15,-38.26,True,1,13554,-966.3,-5366785.17,13097230.2,7730445.03
20301,2008-11-04,1005.75,39.45,4.08,1565.15,-35.74,True,1,13555,-1005.75,-5367790.92,13632941.25,8265150.33
20302,2008-11-05,952.77,-52.98,-5.27,1565.15,-39.13,True,1,13556,-952.77,-5368743.69,12915750.12,7547006.43
20303,2008-11-06,904.88,-47.89,-5.03,1565.15,-42.19,True,1,13557,-904.88,-5369648.57,12267458.16,6897809.59
20304,2008-11-07,930.99,26.11,2.88,1565.15,-40.52,True,1,13558,-930.99,-5370579.56,12622362.42,7251782.86
20305,2008-11-10,919.21,-11.78,-1.26,1565.15,-41.27,True,1,13559,-919.21,-5371498.77,12463568.39,7092069.62
20306,2008-11-11,898.95,-20.26,-2.2,1565.15,-42.56,True,1,13560,-898.95,-5372397.72,12189762.0,6817364.28
20307,2008-11-12,852.3,-46.65,-5.19,1565.15,-45.54,True,1,13561,-852.3,-5373250.02,11558040.3,6184790.28
20308,2008-11-13,911.29,58.99,6.92,1565.15,-41.78,True,1,13562,-911.29,-5374161.31,12358914.98,6984753.67
20309,2008-11-14,873.29,-38.0,-4.17,1565.15,-44.2,True,1,13563,-873.29,-5375034.6,11844432.27,6469397.67
20310,2008-11-17,850.75,-22.54,-2.58,1565.15,-45.64,True,1,13564,-850.75,-5375885.35,11539573.0,6163687.65
20311,2008-11-18,859.12,8.37,0.98,1565.15,-45.11,True,1,13565,-859.12,-5376744.47,11653962.8,6277218.33
20312,2008-11-19,806.58,-52.54,-6.12,1565.15,-48.47,True,1,13566,-806.58,-5377551.05,10942064.28,5564513.23
20313,2008-11-20,752.44,-54.14,-6.71,1565.15,-51.92,True,1,13567,-752.44,-5378303.49,10208353.48,4830049.99
20314,2008-11-21,800.03,47.59,6.32,1565.15,-48.88,True,1,13568,-800.03,-5379103.52,10854807.04,5475703.52
20315,2008-11-24,851.81,51.78,6.47,1565.15,-45.58,True,1,13569,-851.81,-5379955.33,11558209.89,6178254.56
20316,2008-11-25,857.39,5.58,0.66,1565.15,-45.22,True,1,13570,-857.39,-5380812.72,11634782.3,6253969.58
20317,2008-11-26,887.68,30.29,3.53,1565.15,-43.28,True,1,13571,-887.68,-5381700.4,12046705.28,6665004.88
20318,2008-11-28,896.24,8.56,0.96,1565.15,-42.74,True,1,13572,-896.24,-5382596.64,12163769.28,6781172.64
20319,2008-12-01,816.21,-80.03,-8.93,1565.15,-47.85,True,1,13573,-816.21,-5383412.85,11078418.33,5695005.48
20320,2008-12-02,848.81,32.6,3.99,1565.15,-45.77,True,1,13574,-848.81,-5384261.66,11521746.94,6137485.28
20321,2008-12-03,870.74,21.93,2.58,1565.15,-44.37,True,1,13575,-870.74,-5385132.4,11820295.5,6435163.1
20322,2008-12-04,845.22,-25.52,-2.93,1565.15,-46.0,True,1,13576,-845.22,-5385977.62,11474706.72,6088729.1
20323,2008-12-05,876.07,30.85,3.65,1565.15,-44.03,True,1,13577,-876.07,-5386853.69,11894402.39,6507548.7
20324,2008-12-08,909.7,33.63,3.84,1565.15,-41.88,True,1,13578,-909.7,-5387763.39,12351906.6,6964143.21
20325,2008-12-09,888.67,-21.03,-2.31,1565.15,-43.22,True,1,13579,-888.67,-5388652.06,12067249.93,6678597.87
20326,2008-12-10,899.24,10.57,1.19,1565.15,-42.55,True,1,13580,-899.24,-5389551.3,12211679.2,6822127.9
20327,2008-12-11,873.59,-25.65,-2.85,1565.15,-44.18,True,1,13581,-873.59,-5390424.89,11864225.79,6473800.9
20328,2008-12-12,879.73,6.14,0.7,1565.15,-43.79,True,1,13582,-879.73,-5391304.62,11948492.86,6557188.24
20329,2008-12-15,868.57,-11.16,-1.27,1565.15,-44.51,True,1,13583,-868.57,-5392173.19,11797786.31,6405613.12
20330,2008-12-16,913.18,44.61,5.14,1565.15,-41.66,True,1,13584,-913.18,-5393086.37,12404637.12,7011550.75
20331,2008-12-17,904.42,-8.76,-0.96,1565.15,-42.22,True,1,13585,-904.42,-5393990.79,12286545.7,6892554.91
20332,2008-12-18,885.28,-19.14,-2.12,1565.15,-43.44,True,1,13586,-885.28,-5394876.07,12027414.08,6632538.01
20333,2008-12-19,887.88,2.6,0.29,1565.15,-43.27,True,1,13587,-887.88,-5395763.95,12063625.56,6667861.61
20334,2008-12-22,871.63,-16.25,-1.83,1565.15,-44.31,True,1,13588,-871.63,-5396635.58,11843708.44,6447072.86
20335,2008-12-23,863.16,-8.47,-0.97,1565.15,-44.85,True,1,13589,-863.16,-5397498.74,11729481.24,6331982.5
20336,2008-12-24,868.15,4.99,0.58,1565.15,-44.53,True,1,13590,-868.15,-5398366.89,11798158.5,6399791.61
20337,2008-12-26,872.8,4.65,0.54,1565.15,-44.24,True,1,13591,-872.8,-5399239.69,11862224.8,6462985.11
20338,2008-12-29,869.42,-3.38,-0.39,1565.15,-44.45,True,1,13592,-869.42,-5400109.11,11817156.64,6417047.53
20339,2008-12-30,890.64,21.22,2.44,1565.15,-43.1,True,1,13593,-890.64,-5400999.75,12106469.52,6705469.77
20340,2008-12-31,903.25,12.61,1.42,1565.15,-42.29,True,1,13594,-903.25,-5401903.0,12278780.5,6876877.5
20341,2009-01-02,931.8,28.55,3.16,1565.15,-40.47,True,1,13595,-931.8,-5402834.8,12667821.0,7264986.2
20342,2009-01-05,927.45,-4.35,-0.47,1565.15,-40.74,True,1,13596,-927.45,-5403762.25,12609610.2,7205847.95
20343,2009-01-06,934.7,7.25,0.78,1565.15,-40.28,True,1,13597,-934.7,-5404696.95,12709115.9,7304418.95
20344,2009-01-07,906.65,-28.05,-3.0,1565.15,-42.07,True,1,13598,-906.65,-5405603.6,12328626.7,6923023.1
20345,2009-01-08,909.73,3.08,0.34,1565.15,-41.88,True,1,13599,-909.73,-5406513.33,12371418.27,6964904.94
20346,2009-01-09,890.35,-19.38,-2.13,1565.15,-43.11,True,1,13600,-890.35,-5407403.68,12108760.0,6701356.32
20347,2009-01-12,870.26,-20.09,-2.26,1565.15,-44.4,True,1,13601,-870.26,-5408273.94,11836406.26,6428132.32
20348,2009-01-13,871.79,1.53,0.18,1565.15,-44.3,True,1,13602,-871.79,-5409145.73,11858087.58,6448941.85
20349,2009-01-14,842.62,-29.17,-3.35,1565.15,-46.16,True,1,13603,-842.62,-5409988.35,11462159.86,6052171.51
20350,2009-01-15,843.74,1.12,0.13,1565.15,-46.09,True,1,13604,-843.74,-5410832.09,11478238.96,6067406.87
20351,2009-01-16,850.12,6.38,0.76,1565.15,-45.68,True,1,13605,-850.12,-5411682.21,11565882.6,6154200.39
20352,2009-01-20,805.22,-44.9,-5.28,1565.15,-48.55,True,1,13606,-805.22,-5412487.43,10955823.32,5543335.89
20353,2009-01-21,840.24,35.02,4.35,1565.15,-46.32,True,1,13607,-840.24,-5413327.67,11433145.68,6019818.01
20354,2009-01-22,827.5,-12.74,-1.52,1565.15,-47.13,True,1,13608,-827.5,-5414155.17,11260620.0,5846464.83
20355,2009-01-23,831.95,4.45,0.54,1565.15,-46.84,True,1,13609,-831.95,-5414987.12,11322007.55,5907020.43
20356,2009-01-26,836.57,4.62,0.56,1565.15,-46.55,True,1,13610,-836.57,-5415823.69,11385717.7,5969894.01
20357,2009-01-27,845.71,9.14,1.09,1565.15,-45.97,True,1,13611,-845.71,-5416669.4,11510958.81,6094289.41
20358,2009-01-28,874.09,28.38,3.36,1565.15,-44.15,True,1,13612,-874.09,-5417543.49,11898113.08,6480569.59
20359,2009-01-29,845.14,-28.95,-3.31,1565.15,-46.0,True,1,13613,-845.14,-5418388.63,11504890.82,6086502.19
20360,2009-01-30,825.88,-19.26,-2.28,1565.15,-47.23,True,1,13614,-825.88,-5419214.51,11243530.32,5824315.81
20361,2009-02-02,825.44,-0.44,-0.05,1565.15,-47.26,True,1,13615,-825.44,-5420039.95,11238365.6,5818325.65
20362,2009-02-03,838.51,13.07,1.58,1565.15,-46.43,True,1,13616,-838.51,-5420878.46,11417152.16,5996273.7
20363,2009-02-04,832.23,-6.28,-0.75,1565.15,-46.83,True,1,13617,-832.23,-5421710.69,11332475.91,5910765.22
20364,2009-02-05,845.85,13.62,1.64,1565.15,-45.96,True,1,13618,-845.85,-5422556.54,11518785.3,6096228.76
20365,2009-02-06,868.6,22.75,2.69,1565.15,-44.5,True,1,13619,-868.6,-5423425.14,11829463.4,6406038.26
20366,2009-02-09,869.89,1.29,0.15,1565.15,-44.42,True,1,13620,-869.89,-5424295.03,11847901.8,6423606.77
20367,2009-02-10,827.16,-42.73,-4.91,1565.15,-47.15,True,1,13621,-827.16,-5425122.19,11266746.36,5841624.17
20368,2009-02-11,833.74,6.58,0.8,1565.15,-46.73,True,1,13622,-833.74,-5425955.93,11357206.28,5931250.35
20369,2009-02-12,835.19,1.45,0.17,1565.15,-46.64,True,1,13623,-835.19,-5426791.12,11377793.37,5951002.25
20370,2009-02-13,826.84,-8.35,-1.0,1565.15,-47.17,True,1,13624,-826.84,-5427617.96,11264868.16,5837250.2
20371,2009-02-17,789.17,-37.67,-4.56,1565.15,-49.58,True,1,13625,-789.17,-5428407.13,10752441.25,5324034.12
20372,2009-02-18,788.42,-0.75,-0.1,1565.15,-49.63,True,1,13626,-788.42,-5429195.55,10743010.92,5313815.37
20373,2009-02-19,778.94,-9.48,-1.2,1565.15,-50.23,True,1,13627,-778.94,-5429974.49,10614615.38,5184640.89
20374,2009-02-20,770.05,-8.89,-1.14,1565.15,-50.8,True,1,13628,-770.05,-5430744.54,10494241.4,5063496.86
20375,2009-02-23,743.33,-26.72,-3.47,1565.15,-52.51,True,1,13629,-743.33,-5431487.87,10130844.57,4699356.7
20376,2009-02-24,773.14,29.81,4.01,1565.15,-50.6,True,1,13630,-773.14,-5432261.01,10537898.2,5105637.19
20377,2009-02-25,764.9,-8.24,-1.07,1565.15,-51.13,True,1,13631,-764.9,-5433025.91,10426351.9,4993325.99
20378,2009-02-26,752.83,-12.07,-1.58,1565.15,-51.9,True,1,13632,-752.83,-5433778.74,10262578.56,4828799.82
20379,2009-02-27,735.09,-17.74,-2.36,1565.15,-53.03,True,1,13633,-735.09,-5434513.83,10021481.97,4586968.14
20380,2009-03-02,700.82,-34.27,-4.66,1565.15,-55.22,True,1,13634,-700.82,-5435214.65,9554979.88,4119765.23
20381,2009-03-03,696.33,-4.49,-0.64,1565.15,-55.51,True,1,13635,-696.33,-5435910.98,9494459.55,4058548.57
20382,2009-03-04,712.87,16.54,2.38,1565.15,-54.45,True,1,13636,-712.87,-5436623.85,9720695.32,4284071.47
20383,2009-03-05,682.55,-30.32,-4.25,1565.15,-56.39,True,1,13637,-682.55,-5437306.4,9307934.35,3870627.95
20384,2009-03-06,683.38,0.83,0.12,1565.15,-56.34,True,1,13638,-683.38,-5437989.78,9319936.44,3881946.66
20385,2009-03-09,676.53,-6.85,-1.0,1565.15,-56.78,True,1,13639,-676.53,-5438666.31,9227192.67,3788526.36
20386,2009-03-10,719.6,43.07,6.37,1565.15,-54.02,True,1,13640,-719.6,-5439385.91,9815344.0,4375958.09
20387,2009-03-11,721.36,1.76,0.24,1565.15,-53.91,True,1,13641,-721.36,-5440107.27,9840071.76,4399964.49
20388,2009-03-12,750.74,29.38,4.07,1565.15,-52.03,True,1,13642,-750.74,-5440858.01,10241595.08,4800737.07
20389,2009-03-13,756.55,5.81,0.77,1565.15,-51.66,True,1,13643,-756.55,-5441614.56,10321611.65,4879997.09
20390,2009-03-16,753.89,-2.66,-0.35,1565.15,-51.83,True,1,13644,-753.89,-5442368.45,10286075.16,4843706.71
20391,2009-03-17,778.12,24.23,3.21,1565.15,-50.28,True,1,13645,-778.12,-5443146.57,10617447.4,5174300.83
20392,2009-03-18,794.35,16.23,2.09,1565.15,-49.25,True,1,13646,-794.35,-5443940.92,10839700.1,5395759.18
20393,2009-03-19,784.04,-10.31,-1.3,1565.15,-49.91,True,1,13647,-784.04,-5444724.96,10699793.88,5255068.92
20394,2009-03-20,768.54,-15.5,-1.98,1565.15,-50.9,True,1,13648,-768.54,-5445493.5,10489033.92,5043540.42
20395,2009-03-23,822.92,54.38,7.08,1565.15,-47.42,True,1,13649,-822.92,-5446316.42,11232035.08,5785718.66
20396,2009-03-24,806.12,-16.8,-2.04,1565.15,-48.5,True,1,13650,-806.12,-5447122.54,11003538.0,5556415.46
20397,2009-03-25,813.88,7.76,0.96,1565.15,-48.0,True,1,13651,-813.88,-5447936.42,11110275.88,5662339.46
20398,2009-03-26,832.86,18.98,2.33,1565.15,-46.79,True,1,13652,-832.86,-5448769.28,11370204.72,5921435.44
20399,2009-03-27,815.94,-16.92,-2.03,1565.15,-47.87,True,1,13653,-815.94,-5449585.22,11140028.82,5690443.6
20400,2009-03-30,787.53,-28.41,-3.48,1565.15,-49.68,True,1,13654,-787.53,-5450372.75,10752934.62,5302561.87
20401,2009-03-31,797.87,10.34,1.31,1565.15,-49.02,True,1,13655,-797.87,-5451170.62,10894914.85,5443744.23
20402,2009-04-01,811.08,13.21,1.66,1565.15,-48.18,True,1,13656,-811.08,-5451981.7,11076108.48,5624126.78
20403,2009-04-02,834.38,23.3,2.87,1565.15,-46.69,True,1,13657,-834.38,-5452816.08,11395127.66,5942311.58
20404,2009-04-03,842.5,8.12,0.97,1565.15,-46.17,True,1,13658,-842.5,-5453658.58,11506865.0,6053206.42
20405,2009-04-06,835.48,-7.02,-0.83,1565.15,-46.62,True,1,13659,-835.48,-5454494.06,11411821.32,5957327.26
20406,2009-04-07,815.55,-19.93,-2.38,1565.15,-47.89,True,1,13660,-815.55,-5455309.61,11140413.0,5685103.39
20407,2009-04-08,825.16,9.61,1.18,1565.15,-47.28,True,1,13661,-825.16,-5456134.77,11272510.76,5816375.99
20408,2009-04-09,856.56,31.4,3.8,1565.15,-45.27,True,1,13662,-856.56,-5456991.33,11702322.72,6245331.39
20409,2009-04-13,858.73,2.17,0.25,1565.15,-45.13,True,1,13663,-858.73,-5457850.06,11732827.99,6274977.93
20410,2009-04-14,841.5,-17.23,-2.01,1565.15,-46.24,True,1,13664,-841.5,-5458691.56,11498256.0,6039564.44
20411,2009-04-15,852.06,10.56,1.25,1565.15,-45.56,True,1,13665,-852.06,-5459543.62,11643399.9,6183856.28
20412,2009-04-16,865.3,13.24,1.55,1565.15,-44.72,True,1,13666,-865.3,-5460408.92,11825189.8,6364780.88
20413,2009-04-17,869.6,4.3,0.5,1565.15,-44.44,True,1,13667,-869.6,-5461278.52,11884823.2,6423544.68
20414,2009-04-20,832.39,-37.21,-4.28,1565.15,-46.82,True,1,13668,-832.39,-5462110.91,11377106.52,5914995.61
20415,2009-04-21,850.08,17.69,2.12,1565.15,-45.69,True,1,13669,-850.08,-5462960.99,11619743.52,6156782.53
20416,2009-04-22,843.55,-6.53,-0.77,1565.15,-46.1,True,1,13670,-843.55,-5463804.54,11531328.5,6067523.96
20417,2009-04-23,851.92,8.37,0.99,1565.15,-45.57,True,1,13671,-851.92,-5464656.46,11646598.32,6181941.86
20418,2009-04-24,866.23,14.31,1.68,1565.15,-44.66,True,1,13672,-866.23,-5465522.69,11843096.56,6377573.87
20419,2009-04-27,857.51,-8.72,-1.01,1565.15,-45.21,True,1,13673,-857.51,-5466380.2,11724734.23,6258354.03
20420,2009-04-28,855.16,-2.35,-0.27,1565.15,-45.36,True,1,13674,-855.16,-5467235.36,11693457.84,6226222.48
20421,2009-04-29,873.64,18.48,2.16,1565.15,-44.18,True,1,13675,-873.64,-5468109.0,11947027.0,6478918.0
20422,2009-04-30,872.81,-0.83,-0.1,1565.15,-44.24,True,1,13676,-872.81,-5468981.81,11936549.56,6467567.75
20423,2009-05-01,877.52,4.71,0.54,1565.15,-43.93,True,1,13677,-877.52,-5469859.33,12001841.04,6531981.71
20424,2009-05-04,907.24,29.72,3.39,1565.15,-42.04,True,1,13678,-907.24,-5470766.57,12409228.72,6938462.15
20425,2009-05-05,903.8,-3.44,-0.38,1565.15,-42.26,True,1,13679,-903.8,-5471670.37,12363080.2,6891409.83
20426,2009-05-06,919.53,15.73,1.74,1565.15,-41.25,True,1,13680,-919.53,-5472589.9,12579170.4,7106580.5
20427,2009-05-07,907.39,-12.14,-1.32,1565.15,-42.02,True,1,13681,-907.39,-5473497.29,12414002.59,6940505.3
20428,2009-05-08,929.23,21.84,2.41,1565.15,-40.63,True,1,13682,-929.23,-5474426.52,12713724.86,7239298.34
20429,2009-05-11,909.24,-19.99,-2.15,1565.15,-41.91,True,1,13683,-909.24,-5475335.76,12441130.92,6965795.16
20430,2009-05-12,908.35,-0.89,-0.1,1565.15,-41.96,True,1,13684,-908.35,-5476244.11,12429861.4,6953617.29
20431,2009-05-13,883.92,-24.43,-2.69,1565.15,-43.52,True,1,13685,-883.92,-5477128.03,12096445.2,6619317.17
20432,2009-05-14,893.07,9.15,1.03,1565.15,-42.94,True,1,13686,-893.07,-5478021.1,12222556.02,6744534.92
20433,2009-05-15,882.88,-10.19,-1.14,1565.15,-43.59,True,1,13687,-882.88,-5478903.98,12083978.56,6605074.58
20434,2009-05-18,909.71,26.83,3.04,1565.15,-41.88,True,1,13688,-909.71,-5479813.69,12452110.48,6972296.79
20435,2009-05-19,908.13,-1.58,-0.17,1565.15,-41.98,True,1,13689,-908.13,-5480721.82,12431391.57,6950669.75
20436,2009-05-20,903.47,-4.66,-0.51,1565.15,-42.28,True,1,13690,-903.47,-5481625.29,12368504.3,6886879.01
20437,2009-05-21,888.33,-15.14,-1.68,1565.15,-43.24,True,1,13691,-888.33,-5482513.62,12162126.03,6679612.41
20438,2009-05-22,887.0,-1.33,-0.15,1565.15,-43.33,True,1,13692,-887.0,-5483400.62,12144804.0,6661403.38
20439,2009-05-26,910.33,23.33,2.63,1565.15,-41.84,True,1,13693,-910.33,-5484310.95,12465148.69,6980837.74
20440,2009-05-27,893.06,-17.27,-1.9,1565.15,-42.94,True,1,13694,-893.06,-5485204.01,12229563.64,6744359.63
20441,2009-05-28,906.83,13.77,1.54,1565.15,-42.06,True,1,13695,-906.83,-5486110.84,12419036.85,6932926.01
20442,2009-05-29,919.14,12.31,1.36,1565.15,-41.28,True,1,13696,-919.14,-5487029.98,12588541.44,7101511.46
20443,2009-06-01,942.87,23.73,2.58,1565.15,-39.76,True,1,13697,-942.87,-5487972.85,12914490.39,7426517.54
20444,2009-06-02,944.74,1.87,0.2,1565.15,-39.64,True,1,13698,-944.74,-5488917.59,12941048.52,7452130.93
20445,2009-06-03,931.76,-12.98,-1.37,1565.15,-40.47,True,1,13699,-931.76,-5489849.35,12764180.24,7274330.89
20446,2009-06-04,942.46,10.7,1.15,1565.15,-39.78,True,1,13700,-942.46,-5490791.81,12911702.0,7420910.19
20447,2009-06-05,940.09,-2.37,-0.25,1565.15,-39.94,True,1,13701,-940.09,-5491731.9,12880173.09,7388441.19
20448,2009-06-08,939.14,-0.95,-0.1,1565.15,-40.0,True,1,13702,-939.14,-5492671.04,12868096.28,7375425.24
20449,2009-06-09,942.43,3.29,0.35,1565.15,-39.79,True,1,13703,-942.43,-5493613.47,12914118.29,7420504.82
20450,2009-06-10,939.15,-3.28,-0.35,1565.15,-40.0,True,1,13704,-939.15,-5494552.62,12870111.6,7375558.98
20451,2009-06-11,944.89,5.74,0.61,1565.15,-39.63,True,1,13705,-944.89,-5495497.51,12949717.45,7454219.94
20452,2009-06-12,946.21,1.32,0.14,1565.15,-39.54,True,1,13706,-946.21,-5496443.72,12968754.26,7472310.54
20453,2009-06-15,923.72,-22.49,-2.38,1565.15,-40.98,True,1,13707,-923.72,-5497367.44,12661430.04,7164062.6
20454,2009-06-16,911.97,-11.75,-1.27,1565.15,-41.73,True,1,13708,-911.97,-5498279.41,12501284.76,7003005.35
20455,2009-06-17,910.71,-1.26,-0.14,1565.15,-41.81,True,1,13709,-910.71,-5499190.12,12484923.39,6985733.27
20456,2009-06-18,918.37,7.66,0.84,1565.15,-41.32,True,1,13710,-918.37,-5500108.49,12590852.7,7090744.21
20457,2009-06-19,921.23,2.86,0.31,1565.15,-41.14,True,1,13711,-921.23,-5501029.72,12630984.53,7129954.81
20458,2009-06-22,893.04,-28.19,-3.06,1565.15,-42.94,True,1,13712,-893.04,-5501922.76,12245364.48,6743441.72
20459,2009-06-23,895.1,2.06,0.23,1565.15,-42.81,True,1,13713,-895.1,-5502817.86,12274506.3,6771688.44
20460,2009-06-24,900.94,5.84,0.65,1565.15,-42.44,True,1,13714,-900.94,-5503718.8,12355491.16,6851772.36
20461,2009-06-25,920.26,19.32,2.14,1565.15,-41.2,True,1,13715,-920.26,-5504639.06,12621365.9,7116726.84
20462,2009-06-26,918.9,-1.36,-0.15,1565.15,-41.29,True,1,13716,-918.9,-5505557.96,12603632.4,7098074.44
20463,2009-06-29,927.23,8.33,0.91,1565.15,-40.76,True,1,13717,-927.23,-5506485.19,12718813.91,7212328.72
20464,2009-06-30,919.32,-7.91,-0.85,1565.15,-41.26,True,1,13718,-919.32,-5507404.51,12611231.76,7103827.25
20465,2009-07-01,923.33,4.01,0.44,1565.15,-41.01,True,1,13719,-923.33,-5508327.84,12667164.27,7158836.43
20466,2009-07-02,896.42,-26.91,-2.91,1565.15,-42.73,True,1,13720,-896.42,-5509224.26,12298882.4,6789658.14
20467,2009-07-06,898.72,2.3,0.26,1565.15,-42.58,True,1,13721,-898.72,-5510122.98,12331337.12,6821214.14
20468,2009-07-07,881.03,-17.69,-1.97,1565.15,-43.71,True,1,13722,-881.03,-5511004.01,12089493.66,6578489.65
20469,2009-07-08,879.56,-1.47,-0.17,1565.15,-43.8,True,1,13723,-879.56,-5511883.57,12070201.88,6558318.31
20470,2009-07-09,882.68,3.12,0.36,1565.15,-43.6,True,1,13724,-882.68,-5512766.25,12113900.32,6601134.07
20471,2009-07-10,879.13,-3.55,-0.4,1565.15,-43.83,True,1,13725,-879.13,-5513645.38,12066059.25,6552413.87
20472,2009-07-13,901.05,21.92,2.49,1565.15,-42.43,True,1,13726,-901.05,-5514546.43,12367812.3,6853265.87
20473,2009-07-14,905.84,4.79,0.53,1565.15,-42.12,True,1,13727,-905.84,-5515452.27,12434465.68,6919013.41
20474,2009-07-15,932.68,26.84,2.96,1565.15,-40.41,True,1,13728,-932.68,-5516384.95,12803831.04,7287446.09
20475,2009-07-16,940.74,8.06,0.86,1565.15,-39.9,True,1,13729,-940.74,-5517325.69,12915419.46,7398093.77
20476,2009-07-17,940.38,-0.36,-0.04,1565.15,-39.92,True,1,13730,-940.38,-5518266.07,12911417.4,7393151.33
20477,2009-07-20,951.13,10.75,1.14,1565.15,-39.23,True,1,13731,-951.13,-5519217.2,13059966.03,7540748.83
20478,2009-07-21,954.58,3.45,0.36,1565.15,-39.01,True,1,13732,-954.58,-5520171.78,13108292.56,7588120.78
20479,2009-07-22,954.07,-0.51,-0.05,1565.15,-39.04,True,1,13733,-954.07,-5521125.85,13102243.31,7581117.46
20480,2009-07-23,976.29,22.22,2.33,1565.15,-37.62,True,1,13734,-976.29,-5522102.14,13408366.86,7886264.72
20481,2009-07-24,979.26,2.97,0.3,1565.15,-37.43,True,1,13735,-979.26,-5523081.4,13450136.1,7927054.7
20482,2009-07-27,982.18,2.92,0.3,1565.15,-37.25,True,1,13736,-982.18,-5524063.58,13491224.48,7967160.9
20483,2009-07-28,979.62,-2.56,-0.26,1565.15,-37.41,True,1,13737,-979.62,-5525043.2,13457039.94,7931996.74
20484,2009-07-29,975.15,-4.47,-0.46,1565.15,-37.7,True,1,13738,-975.15,-5526018.35,13396610.7,7870592.35
20485,2009-07-30,986.75,11.6,1.19,1565.15,-36.96,True,1,13739,-986.75,-5527005.1,13556958.25,8029953.15
20486,2009-07-31,987.48,0.73,0.07,1565.15,-36.91,True,1,13740,-987.48,-5527992.58,13567975.2,8039982.62
20487,2009-08-03,1002.63,15.15,1.53,1565.15,-35.94,True,1,13741,-1002.63,-5528995.21,13777138.83,8248143.62
20488,2009-08-04,1005.65,3.02,0.3,1565.15,-35.75,True,1,13742,-1005.65,-5530000.86,13819642.3,8289641.44
20489,2009-08-05,1002.72,-2.93,-0.29,1565.15,-35.94,True,1,13743,-1002.72,-5531003.58,13780380.96,8249377.38
20490,2009-08-06,997.08,-5.64,-0.56,1565.15,-36.3,True,1,13744,-997.08,-5532000.66,13703867.52,8171866.86
20491,2009-08-07,1010.48,13.4,1.34,1565.15,-35.44,True,1,13745,-1010.48,-5533011.14,13889047.6,8356036.46
20492,2009-08-10,1007.1,-3.38,-0.33,1565.15,-35.66,True,1,13746,-1007.1,-5534018.24,13843596.6,8309578.36
20493,2009-08-11,994.35,-12.75,-1.27,1565.15,-36.47,True,1,13747,-994.35,-5535012.59,13669329.45,8134316.86
20494,2009-08-12,1005.81,11.46,1.15,1565.15,-35.74,True,1,13748,-1005.81,-5536018.4,13827875.88,8291857.48
20495,2009-08-13,1012.73,6.92,0.69,1565.15,-35.3,True,1,13749,-1012.73,-5537031.13,13924024.77,8386993.64
20496,2009-08-14,1004.09,-8.64,-0.85,1565.15,-35.85,True,1,13750,-1004.09,-5538035.22,13806237.5,8268202.28
20497,2009-08-17,979.73,-24.36,-2.43,1565.15,-37.4,True,1,13751,-979.73,-5539014.95,13472267.23,7933252.28
20498,2009-08-18,989.67,9.94,1.01,1565.15,-36.77,True,1,13752,-989.67,-5540004.62,13609941.84,8069937.22
20499,2009-08-19,996.46,6.79,0.69,1565.15,-36.34,True,1,13753,-996.46,-5541001.08,13704314.38,8163313.3
20500,2009-08-20,1007.37,10.91,1.1,1565.15,-35.64,True,1,13754,-1007.37,-5542008.45,13855366.98,8313358.53
20501,2009-08-21,1026.13,18.76,1.86,1565.15,-34.44,True,1,13755,-1026.13,-5543034.58,14114418.15,8571383.57
20502,2009-08-24,1025.57,-0.56,-0.06,1565.15,-34.48,True,1,13756,-1025.57,-5544060.15,14107740.92,8563680.77
20503,2009-08-25,1028.0,2.43,0.24,1565.15,-34.32,True,1,13757,-1028.0,-5545088.15,14142196.0,8597107.85
20504,2009-08-26,1028.12,0.12,0.01,1565.15,-34.31,True,1,13758,-1028.12,-5546116.27,14144874.96,8598758.69
20505,2009-08-27,1030.98,2.86,0.28,1565.15,-34.13,True,1,13759,-1030.98,-5547147.25,14185253.82,8638106.57
20506,2009-08-28,1028.93,-2.05,-0.2,1565.15,-34.26,True,1,13760,-1028.93,-5548176.18,14158076.8,8609900.62
20507,2009-08-31,1020.62,-8.31,-0.81,1565.15,-34.79,True,1,13761,-1020.62,-5549196.8,14044751.82,8495555.02
20508,2009-09-01,998.04,-22.58,-2.21,1565.15,-36.23,True,1,13762,-998.04,-5550194.84,13735026.48,8184831.64
20509,2009-09-02,994.75,-3.29,-0.33,1565.15,-36.44,True,1,13763,-994.75,-5551189.59,13690744.25,8139554.66
20510,2009-09-03,1003.24,8.49,0.85,1565.15,-35.9,True,1,13764,-1003.24,-5552192.83,13808595.36,8256402.53
20511,2009-09-04,1016.4,13.16,1.31,1565.15,-35.06,True,1,13765,-1016.4,-5553209.23,13990746.0,8437536.77
20512,2009-09-08,1025.39,8.99,0.88,1565.15,-34.49,True,1,13766,-1025.39,-5554234.62,14115518.74,8561284.12
20513,2009-09-09,1033.37,7.98,0.78,1565.15,-33.98,True,1,13767,-1033.37,-5555267.99,14226404.79,8671136.8
20514,2009-09-10,1044.14,10.77,1.04,1565.15,-33.29,True,1,13768,-1044.14,-5556312.13,14375719.52,8819407.39
20515,2009-09-11,1042.73,-1.41,-0.14,1565.15,-33.38,True,1,13769,-1042.73,-5557354.86,14357349.37,8799994.51
20516,2009-09-14,1049.34,6.61,0.63,1565.15,-32.96,True,1,13770,-1049.34,-5558404.2,14449411.8,8891007.6
20517,2009-09-15,1052.63,3.29,0.31,1565.15,-32.75,True,1,13771,-1052.63,-5559456.83,14495767.73,8936310.9
20518,2009-09-16,1068.76,16.13,1.53,1565.15,-31.72,True,1,13772,-1068.76,-5560525.59,14718962.72,9158437.13
20519,2009-09-17,1065.49,-3.27,-0.31,1565.15,-31.92,True,1,13773,-1065.49,-5561591.08,14674993.77,9113402.69
20520,2009-09-18,1068.3,2.81,0.26,1565.15,-31.74,True,1,13774,-1068.3,-5562659.38,14714764.2,9152104.82
20521,2009-09-21,1064.66,-3.64,-0.34,1565.15,-31.98,True,1,13775,-1064.66,-5563724.04,14665691.5,9101967.46
20522,2009-09-22,1071.66,7.0,0.66,1565.15,-31.53,True,1,13776,-1071.66,-5564795.7,14763188.16,9198392.46
20523,2009-09-23,1060.87,-10.79,-1.01,1565.15,-32.22,True,1,13777,-1060.87,-5565856.57,14615605.99,9049749.42
20524,2009-09-24,1050.78,-10.09,-0.95,1565.15,-32.86,True,1,13778,-1050.78,-5566907.35,14477646.84,8910739.49
20525,2009-09-25,1044.38,-6.4,-0.61,1565.15,-33.27,True,1,13779,-1044.38,-5567951.73,14390512.02,8822560.29
20526,2009-09-28,1062.98,18.6,1.78,1565.15,-32.08,True,1,13780,-1062.98,-5569014.71,14647864.4,9078849.69
20527,2009-09-29,1060.61,-2.37,-0.22,1565.15,-32.24,True,1,13781,-1060.61,-5570075.32,14616266.41,9046191.09
20528,2009-09-30,1057.08,-3.53,-0.33,1565.15,-32.46,True,1,13782,-1057.08,-5571132.4,14568676.56,8997544.16
20529,2009-10-01,1029.85,-27.23,-2.58,1565.15,-34.2,True,1,13783,-1029.85,-5572162.25,14194422.55,8622260.3
20530,2009-10-02,1025.21,-4.64,-0.45,1565.15,-34.5,True,1,13784,-1025.21,-5573187.46,14131494.64,8558307.18
20531,2009-10-05,1040.46,15.25,1.49,1565.15,-33.52,True,1,13785,-1040.46,-5574227.92,14342741.1,8768513.18
20532,2009-10-06,1054.72,14.26,1.37,1565.15,-32.61,True,1,13786,-1054.72,-5575282.64,14540369.92,8965087.28
20533,2009-10-07,1057.58,2.86,0.27,1565.15,-32.43,True,1,13787,-1057.58,-5576340.22,14580855.46,9004515.24
20534,2009-10-08,1065.48,7.9,0.75,1565.15,-31.92,True,1,13788,-1065.48,-5577405.7,14690838.24,9113432.54
20535,2009-10-09,1071.49,6.01,0.56,1565.15,-31.54,True,1,13789,-1071.49,-5578477.19,14774775.61,9196298.42
20536,2009-10-12,1076.19,4.7,0.44,1565.15,-31.24,True,1,13790,-1076.19,-5579553.38,14840660.1,9261106.72
20537,2009-10-13,1073.19,-3.0,-0.28,1565.15,-31.43,True,1,13791,-1073.19,-5580626.57,14800363.29,9219736.72
20538,2009-10-14,1092.02,18.83,1.76,1565.15,-30.23,True,1,13792,-1092.02,-5581718.59,15061139.84,9479421.25
20539,2009-10-15,1096.56,4.54,0.42,1565.15,-29.94,True,1,13793,-1096.56,-5582815.15,15124852.08,9542036.93
20540,2009-10-16,1087.68,-8.88,-0.81,1565.15,-30.51,True,1,13794,-1087.68,-5583902.83,15003457.92,9419555.09
20541,2009-10-19,1097.91,10.23,0.94,1565.15,-29.85,True,1,13795,-1097.91,-5585000.74,15145668.45,9560667.71
20542,2009-10-20,1091.06,-6.85,-0.62,1565.15,-30.29,True,1,13796,-1091.06,-5586091.8,15052263.76,9466171.96
20543,2009-10-21,1081.4,-9.66,-0.88,1565.15,-30.91,True,1,13797,-1081.4,-5587173.2,14920075.8,9332902.6
20544,2009-10-22,1092.91,11.51,1.06,1565.15,-30.17,True,1,13798,-1092.91,-5588266.11,15079972.18,9491706.07
20545,2009-10-23,1079.6,-13.31,-1.22,1565.15,-31.02,True,1,13799,-1079.6,-5589345.71,14897400.4,9308054.69
20546,2009-10-26,1066.95,-12.65,-1.17,1565.15,-31.83,True,1,13800,-1066.95,-5590412.66,14723910.0,9133497.34
20547,2009-10-27,1063.41,-3.54,-0.33,1565.15,-32.06,True,1,13801,-1063.41,-5591476.07,14676121.41,9084645.34
20548,2009-10-28,1042.63,-20.78,-1.95,1565.15,-33.38,True,1,13802,-1042.63,-5592518.7,14390379.26,8797860.56
20549,2009-10-29,1066.11,23.48,2.25,1565.15,-31.88,True,1,13803,-1066.11,-5593584.81,14715516.33,9121931.52
20550,2009-10-30,1036.19,-29.92,-2.81,1565.15,-33.8,True,1,13804,-1036.19,-5594621.0,14303566.76,8708945.76
20551,2009-11-02,1042.88,6.69,0.65,1565.15,-33.37,True,1,13805,-1042.88,-5595663.88,14396958.4,8801294.52
20552,2009-11-03,1045.41,2.53,0.24,1565.15,-33.21,True,1,13806,-1045.41,-5596709.29,14432930.46,8836221.17
20553,2009-11-04,1046.5,1.09,0.1,1565.15,-33.14,True,1,13807,-1046.5,-5597755.79,14449025.5,8851269.71
20554,2009-11-05,1066.63,20.13,1.92,1565.15,-31.85,True,1,13808,-1066.63,-5598822.42,14728027.04,9129204.62
20555,2009-11-06,1069.3,2.67,0.25,1565.15,-31.68,True,1,13809,-1069.3,-5599891.72,14765963.7,9166071.98
20556,2009-11-09,1093.08,23.78,2.22,1565.15,-30.16,True,1,13810,-1093.08,-5600984.8,15095434.8,9494450.0
20557,2009-11-10,1093.01,-0.07,-0.01,1565.15,-30.17,True,1,13811,-1093.01,-5602077.81,15095561.11,9493483.3
20558,2009-11-11,1098.51,5.5,0.5,1565.15,-29.81,True,1,13812,-1098.51,-5603176.32,15172620.12,9569443.8
20559,2009-11-12,1087.24,-11.27,-1.03,1565.15,-30.53,True,1,13813,-1087.24,-5604263.56,15018046.12,9413782.56
20560,2009-11-13,1093.48,6.24,0.57,1565.15,-30.14,True,1,13814,-1093.48,-5605357.04,15105332.72,9499975.68
20561,2009-11-16,1109.3,15.82,1.45,1565.15,-29.12,True,1,13815,-1109.3,-5606466.34,15324979.5,9718513.16
20562,2009-11-17,1110.32,1.02,0.09,1565.15,-29.06,True,1,13816,-1110.32,-5607576.66,15340181.12,9732604.46
20563,2009-11-18,1109.8,-0.52,-0.05,1565.15,-29.09,True,1,13817,-1109.8,-5608686.46,15334106.6,9725420.14
20564,2009-11-19,1094.9,-14.9,-1.34,1565.15,-30.04,True,1,13818,-1094.9,-5609781.36,15129328.2,9519546.84
20565,2009-11-20,1091.38,-3.52,-0.32,1565.15,-30.27,True,1,13819,-1091.38,-5610872.74,15081780.22,9470907.48
20566,2009-11-23,1106.24,14.86,1.36,1565.15,-29.32,True,1,13820,-1106.24,-5611978.98,15288236.8,9676257.82
20567,2009-11-24,1105.65,-0.59,-0.05,1565.15,-29.36,True,1,13821,-1105.65,-5613084.63,15281188.65,9668104.02
20568,2009-11-25,1110.63,4.98,0.45,1565.15,-29.04,True,1,13822,-1110.63,-5614195.26,15351127.86,9736932.6
20569,2009-11-27,1091.49,-19.14,-1.72,1565.15,-30.26,True,1,13823,-1091.49,-5615286.75,15087666.27,9472379.52
20570,2009-11-30,1095.63,4.14,0.38,1565.15,-30.0,True,1,13824,-1095.63,-5616382.38,15145989.12,9529606.74
20571,2009-12-01,1108.86,13.23,1.21,1565.15,-29.15,True,1,13825,-1108.86,-5617491.24,15329989.5,9712498.26
20572,2009-12-02,1109.24,0.38,0.03,1565.15,-29.13,True,1,13826,-1109.24,-5618600.48,15336352.24,9717751.76
20573,2009-12-03,1099.92,-9.32,-0.84,1565.15,-29.72,True,1,13827,-1099.92,-5619700.4,15208593.84,9588893.44
20574,2009-12-04,1105.98,6.06,0.55,1565.15,-29.34,True,1,13828,-1105.98,-5620806.38,15293491.44,9672685.06
20575,2009-12-07,1103.25,-2.73,-0.25,1565.15,-29.51,True,1,13829,-1103.25,-5621909.63,15256844.25,9634934.62
20576,2009-12-08,1091.94,-11.31,-1.02,1565.15,-30.23,True,1,13830,-1091.94,-5623001.57,15101530.2,9478528.63
20577,2009-12-09,1095.95,4.01,0.37,1565.15,-29.98,True,1,13831,-1095.95,-5624097.52,15158084.45,9533986.93
20578,2009-12-10,1102.35,6.4,0.58,1565.15,-29.57,True,1,13832,-1102.35,-5625199.87,15247705.2,9622505.33
20579,2009-12-11,1106.41,4.06,0.37,1565.15,-29.31,True,1,13833,-1106.41,-5626306.28,15304969.53,9678663.25
20580,2009-12-14,1114.11,7.7,0.7,1565.15,-28.82,True,1,13834,-1114.11,-5627420.39,15412597.74,9785177.35
20581,2009-12-15,1107.93,-6.18,-0.56,1565.15,-29.21,True,1,13835,-1107.93,-5628528.32,15328211.55,9699683.23
20582,2009-12-16,1109.18,1.25,0.11,1565.15,-29.13,True,1,13836,-1109.18,-5629637.5,15346614.48,9716976.98
20583,2009-12-17,1096.08,-13.1,-1.18,1565.15,-29.97,True,1,13837,-1096.08,-5630733.58,15166458.96,9535725.38
20584,2009-12-18,1102.47,6.39,0.58,1565.15,-29.56,True,1,13838,-1102.47,-5631836.05,15255979.86,9624143.81
20585,2009-12-21,1114.05,11.58,1.05,1565.15,-28.82,True,1,13839,-1114.05,-5632950.1,15417337.95,9784387.85
20586,2009-12-22,1118.02,3.97,0.36,1565.15,-28.57,True,1,13840,-1118.02,-5634068.12,15473396.8,9839328.68
20587,2009-12-23,1120.59,2.57,0.23,1565.15,-28.4,True,1,13841,-1120.59,-5635188.71,15510086.19,9874897.48
20588,2009-12-24,1126.48,5.89,0.53,1565.15,-28.03,True,1,13842,-1126.48,-5636315.19,15592736.16,9956420.97
20589,2009-12-28,1127.78,1.3,0.12,1565.15,-27.94,True,1,13843,-1127.78,-5637442.97,15611858.54,9974415.57
20590,2009-12-29,1126.2,-1.58,-0.14,1565.15,-28.04,True,1,13844,-1126.2,-5638569.17,15591112.8,9952543.63
20591,2009-12-30,1126.42,0.22,0.02,1565.15,-28.03,True,1,13845,-1126.42,-5639695.59,15595284.9,9955589.31
20592,2009-12-31,1115.1,-11.32,-1.0,1565.15,-28.75,True,1,13846,-1115.1,-5640810.69,15439674.6,9798863.91
20593,2010-01-04,1132.99,17.89,1.6,1565.15,-27.61,True,1,13847,-1132.99,-5641943.68,15688512.53,10046568.85
20594,2010-01-05,1136.52,3.53,0.31,1565.15,-27.39,True,1,13848,-1136.52,-5643080.2,15738528.96,10095448.76
20595,2010-01-06,1137.14,0.62,0.06,1565.15,-27.35,True,1,13849,-1137.14,-5644217.34,15748251.86,10104034.52
20596,2010-01-07,1141.69,4.55,0.4,1565.15,-27.06,True,1,13850,-1141.69,-5645359.03,15812406.5,10167047.47
20597,2010-01-08,1144.98,3.29,0.29,1565.15,-26.84,True,1,13851,-1144.98,-5646504.01,15859117.98,10212613.97
20598,2010-01-11,1146.98,2.0,0.18,1565.15,-26.72,True,1,13852,-1146.98,-5647650.99,15887966.96,10240315.97
20599,2010-01-12,1136.22,-10.76,-0.94,1565.15,-27.4,True,1,13853,-1136.22,-5648787.21,15740055.66,10091268.45
20600,2010-01-13,1145.68,9.46,0.83,1565.15,-26.8,True,1,13854,-1145.68,-5649932.89,15872250.72,10222317.83
20601,2010-01-14,1148.46,2.78,0.24,1565.15,-26.62,True,1,13855,-1148.46,-5651081.35,15911913.3,10260831.95
20602,2010-01-15,1136.03,-12.43,-1.08,1565.15,-27.42,True,1,13856,-1136.03,-5652217.38,15740831.68,10088614.3
20603,2010-01-19,1150.23,14.2,1.25,1565.15,-26.51,True,1,13857,-1150.23,-5653367.61,15938737.11,10285369.5
20604,2010-01-20,1138.04,-12.19,-1.06,1565.15,-27.29,True,1,13858,-1138.04,-5654505.65,15770958.32,10116452.67
20605,2010-01-21,1116.48,-21.56,-1.89,1565.15,-28.67,True,1,13859,-1116.48,-5655622.13,15473296.32,9817674.19
20606,2010-01-22,1091.76,-24.72,-2.21,1565.15,-30.25,True,1,13860,-1091.76,-5656713.89,15131793.6,9475079.71
20607,2010-01-25,1096.78,5.02,0.46,1565.15,-29.92,True,1,13861,-1096.78,-5657810.67,15202467.58,9544656.91
20608,2010-01-26,1092.17,-4.61,-0.42,1565.15,-30.22,True,1,13862,-1092.17,-5658902.84,15139660.54,9480757.7
20609,2010-01-27,1097.5,5.33,0.49,1565.15,-29.88,True,1,13863,-1097.5,-5660000.34,15214642.5,9554642.16
20610,2010-01-28,1084.53,-12.97,-1.18,1565.15,-30.71,True,1,13864,-1084.53,-5661084.87,15035923.92,9374839.05
20611,2010-01-29,1073.87,-10.66,-0.98,1565.15,-31.39,True,1,13865,-1073.87,-5662158.74,14889207.55,9227048.81
20612,2010-02-01,1089.19,15.32,1.43,1565.15,-30.41,True,1,13866,-1089.19,-5663247.93,15102708.54,9439460.61
20613,2010-02-02,1103.32,14.13,1.3,1565.15,-29.51,True,1,13867,-1103.32,-5664351.25,15299738.44,9635387.19
20614,2010-02-03,1097.28,-6.04,-0.55,1565.15,-29.89,True,1,13868,-1097.28,-5665448.53,15217079.04,9551630.51
20615,2010-02-04,1063.11,-34.17,-3.11,1565.15,-32.08,True,1,13869,-1063.11,-5666511.64,14744272.59,9077760.95
20616,2010-02-05,1066.19,3.08,0.29,1565.15,-31.88,True,1,13870,-1066.19,-5667577.83,14788055.3,9120477.47
20617,2010-02-08,1056.74,-9.45,-0.89,1565.15,-32.48,True,1,13871,-1056.74,-5668634.57,14658040.54,8989405.97
20618,2010-02-09,1070.52,13.78,1.3,1565.15,-31.6,True,1,13872,-1070.52,-5669705.09,14850253.44,9180548.35
20619,2010-02-10,1068.13,-2.39,-0.22,1565.15,-31.76,True,1,13873,-1068.13,-5670773.22,14818167.49,9147394.27
20620,2010-02-11,1078.47,10.34,0.97,1565.15,-31.1,True,1,13874,-1078.47,-5671851.69,14962692.78,9290841.09
20621,2010-02-12,1075.51,-2.96,-0.27,1565.15,-31.28,True,1,13875,-1075.51,-5672927.2,14922701.25,9249774.05
20622,2010-02-16,1094.87,19.36,1.8,1565.15,-30.05,True,1,13876,-1094.87,-5674022.07,15192416.12,9518394.05
20623,2010-02-17,1099.51,4.64,0.42,1565.15,-29.75,True,1,13877,-1099.51,-5675121.58,15257900.27,9582778.69
20624,2010-02-18,1106.75,7.24,0.66,1565.15,-29.29,True,1,13878,-1106.75,-5676228.33,15359476.5,9683248.17
20625,2010-02-19,1109.17,2.42,0.22,1565.15,-29.13,True,1,13879,-1109.17,-5677337.5,15394170.43,9716832.93
20626,2010-02-22,1108.01,-1.16,-0.1,1565.15,-29.21,True,1,13880,-1108.01,-5678445.51,15379178.8,9700733.29
20627,2010-02-23,1094.6,-13.41,-1.21,1565.15,-30.06,True,1,13881,-1094.6,-5679540.11,15194142.6,9514602.49
20628,2010-02-24,1105.24,10.64,0.97,1565.15,-29.38,True,1,13882,-1105.24,-5680645.35,15342941.68,9662296.33
20629,2010-02-25,1102.94,-2.3,-0.21,1565.15,-29.53,True,1,13883,-1102.94,-5681748.29,15312116.02,9630367.73
20630,2010-02-26,1104.49,1.55,0.14,1565.15,-29.43,True,1,13884,-1104.49,-5682852.78,15334739.16,9651886.38
20631,2010-03-01,1115.71,11.22,1.02,1565.15,-28.72,True,1,13885,-1115.71,-5683968.49,15491633.35,9807664.86
20632,2010-03-02,1118.31,2.6,0.23,1565.15,-28.55,True,1,13886,-1118.31,-5685086.8,15528852.66,9843765.86
20633,2010-03-03,1118.79,0.48,0.04,1565.15,-28.52,True,1,13887,-1118.79,-5686205.59,15536636.73,9850431.14
20634,2010-03-04,1122.97,4.18,0.37,1565.15,-28.25,True,1,13888,-1122.97,-5687328.56,15595807.36,9908478.8
20635,2010-03-05,1138.7,15.73,1.4,1565.15,-27.25,True,1,13889,-1138.7,-5688467.26,15815404.3,10126937.04
20636,2010-03-08,1138.5,-0.2,-0.02,1565.15,-27.26,True,1,13890,-1138.5,-5689605.76,15813765.0,10124159.24
20637,2010-03-09,1140.45,1.95,0.17,1565.15,-27.14,True,1,13891,-1140.45,-5690746.21,15841990.95,10151244.74
20638,2010-03-10,1145.61,5.16,0.45,1565.15,-26.8,True,1,13892,-1145.61,-5691891.82,15914814.12,10222922.3
20639,2010-03-11,1150.24,4.63,0.4,1565.15,-26.51,True,1,13893,-1150.24,-5693042.06,15980284.32,10287242.26
20640,2010-03-12,1149.99,-0.25,-0.02,1565.15,-26.52,True,1,13894,-1149.99,-5694192.05,15977961.06,10283769.01
20641,2010-03-15,1150.51,0.52,0.04,1565.15,-26.49,True,1,13895,-1150.51,-5695342.56,15986336.45,10290993.89
20642,2010-03-16,1159.46,8.95,0.78,1565.15,-25.92,True,1,13896,-1159.46,-5696502.02,16111856.16,10415354.14
20643,2010-03-17,1166.21,6.75,0.58,1565.15,-25.49,True,1,13897,-1166.21,-5697668.23,16206820.37,10509152.14
20644,2010-03-18,1165.83,-0.38,-0.03,1565.15,-25.51,True,1,13898,-1165.83,-5698834.06,16202705.34,10503871.28
20645,2010-03-19,1159.9,-5.93,-0.51,1565.15,-25.89,True,1,13899,-1159.9,-5699993.96,16121450.1,10421456.14
20646,2010-03-22,1165.81,5.91,0.51,1565.15,-25.51,True,1,13900,-1165.81,-5701159.77,16204759.0,10503599.23
20647,2010-03-23,1174.17,8.36,0.72,1565.15,-24.98,True,1,13901,-1174.17,-5702333.94,16322137.17,10619803.23
20648,2010-03-24,1167.72,-6.45,-0.55,1565.15,-25.39,True,1,13902,-1167.72,-5703501.66,16233643.44,10530141.78
20649,2010-03-25,1165.73,-1.99,-0.17,1565.15,-25.52,True,1,13903,-1165.73,-5704667.39,16207144.19,10502476.8
20650,2010-03-26,1166.59,0.86,0.07,1565.15,-25.46,True,1,13904,-1166.59,-5705833.98,16220267.36,10514433.38
20651,2010-03-29,1173.22,6.63,0.57,1565.15,-25.04,True,1,13905,-1173.22,-5707007.2,16313624.1,10606616.9
20652,2010-03-30,1173.27,0.05,0.0,1565.15,-25.04,True,1,13906,-1173.27,-5708180.47,16315492.62,10607312.15
20653,2010-03-31,1169.43,-3.84,-0.33,1565.15,-25.28,True,1,13907,-1169.43,-5709349.9,16263263.01,10553913.11
20654,2010-04-01,1178.1,8.67,0.74,1565.15,-24.73,True,1,13908,-1178.1,-5710528.0,16385014.8,10674486.8
20655,2010-04-05,1187.44,9.34,0.79,1565.15,-24.13,True,1,13909,-1187.44,-5711715.44,16516102.96,10804387.52
20656,2010-04-06,1189.44,2.0,0.17,1565.15,-24.0,True,1,13910,-1189.44,-5712904.88,16545110.4,10832205.52
20657,2010-04-07,1182.45,-6.99,-0.59,1565.15,-24.45,True,1,13911,-1182.45,-5714087.33,16449061.95,10734974.62
20658,2010-04-08,1186.44,3.99,0.34,1565.15,-24.2,True,1,13912,-1186.44,-5715273.77,16505753.28,10790479.51
20659,2010-04-09,1194.37,7.93,0.67,1565.15,-23.69,True,1,13913,-1194.37,-5716468.14,16617269.81,10900801.67
20660,2010-04-12,1196.48,2.11,0.18,1565.15,-23.56,True,1,13914,-1196.48,-5717664.62,16647822.72,10930158.1
20661,2010-04-13,1197.3,0.82,0.07,1565.15,-23.5,True,1,13915,-1197.3,-5718861.92,16660429.5,10941567.58
20662,2010-04-14,1210.65,13.35,1.12,1565.15,-22.65,True,1,13916,-1210.65,-5720072.57,16847405.4,11127332.83
20663,2010-04-15,1211.67,1.02,0.08,1565.15,-22.58,True,1,13917,-1211.67,-5721284.24,16862811.39,11141527.15
20664,2010-04-16,1192.13,-19.54,-1.61,1565.15,-23.83,True,1,13918,-1192.13,-5722476.37,16592065.34,10869588.97
20665,2010-04-19,1197.52,5.39,0.45,1565.15,-23.49,True,1,13919,-1197.52,-5723673.89,16668280.88,10944606.99
20666,2010-04-20,1207.17,9.65,0.81,1565.15,-22.87,True,1,13920,-1207.17,-5724881.06,16803806.4,11078925.34
20667,2010-04-21,1205.94,-1.23,-0.1,1565.15,-22.95,True,1,13921,-1205.94,-5726087.0,16787890.74,11061803.74
20668,2010-04-22,1208.67,2.73,0.23,1565.15,-22.78,True,1,13922,-1208.67,-5727295.67,16827103.74,11099808.07
20669,2010-04-23,1217.28,8.61,0.71,1565.15,-22.23,True,1,13923,-1217.28,-5728512.95,16948189.44,11219676.49
20670,2010-04-26,1212.05,-5.23,-0.43,1565.15,-22.56,True,1,13924,-1212.05,-5729725.0,16876584.2,11146859.2
20671,2010-04-27,1183.71,-28.34,-2.34,1565.15,-24.37,True,1,13925,-1183.71,-5730908.71,16483161.75,10752253.04
20672,2010-04-28,1191.36,7.65,0.65,1565.15,-23.88,True,1,13926,-1191.36,-5732100.07,16590879.36,10858779.29
20673,2010-04-29,1206.78,15.42,1.29,1565.15,-22.9,True,1,13927,-1206.78,-5733306.85,16806825.06,11073518.21
20674,2010-04-30,1186.69,-20.09,-1.66,1565.15,-24.18,True,1,13928,-1186.69,-5734493.54,16528218.32,10793724.78
20675,2010-05-03,1202.26,15.57,1.31,1565.15,-23.19,True,1,13929,-1202.26,-5735695.8,16746279.54,11010583.74
20676,2010-05-04,1173.6,-28.66,-2.38,1565.15,-25.02,True,1,13930,-1173.6,-5736869.4,16348248.0,10611378.6
20677,2010-05-05,1165.87,-7.73,-0.66,1565.15,-25.51,True,1,13931,-1165.87,-5738035.27,16241734.97,10503699.7
20678,2010-05-06,1128.15,-37.72,-3.24,1565.15,-27.92,True,1,13932,-1128.15,-5739163.42,15717385.8,9978222.38
20679,2010-05-07,1110.88,-17.27,-1.53,1565.15,-29.02,True,1,13933,-1110.88,-5740274.3,15477891.04,9737616.74
20680,2010-05-10,1159.73,48.85,4.4,1565.15,-25.9,True,1,13934,-1159.73,-5741434.03,16159677.82,10418243.79
20681,2010-05-11,1155.79,-3.94,-0.34,1565.15,-26.16,True,1,13935,-1155.79,-5742589.82,16105933.65,10363343.83
20682,2010-05-12,1171.67,15.88,1.37,1565.15,-25.14,True,1,13936,-1171.67,-5743761.49,16328393.12,10584631.63
20683,2010-05-13,1157.44,-14.23,-1.22,1565.15,-26.05,True,1,13937,-1157.44,-5744918.93,16131241.28,10386322.35
20684,2010-05-14,1135.68,-21.76,-1.88,1565.15,-27.44,True,1,13938,-1135.68,-5746054.61,15829107.84,10083053.23
20685,2010-05-17,1136.94,1.26,0.11,1565.15,-27.36,True,1,13939,-1136.94,-5747191.55,15847806.66,10100615.11
20686,2010-05-18,1120.8,-16.14,-1.42,1565.15,-28.39,True,1,13940,-1120.8,-5748312.35,15623952.0,9875639.65
20687,2010-05-19,1115.05,-5.75,-0.51,1565.15,-28.76,True,1,13941,-1115.05,-5749427.4,15544912.05,9795484.65
20688,2010-05-20,1071.59,-43.46,-3.9,1565.15,-31.53,True,1,13942,-1071.59,-5750498.99,14940107.78,9189608.79
20689,2010-05-21,1087.69,16.1,1.5,1565.15,-30.51,True,1,13943,-1087.69,-5751586.68,15165661.67,9414074.99
20690,2010-05-24,1073.65,-14.04,-1.29,1565.15,-31.4,True,1,13944,-1073.65,-5752660.33,14970975.6,9218315.27
20691,2010-05-25,1074.03,0.38,0.04,1565.15,-31.38,True,1,13945,-1074.03,-5753734.36,14977348.35,9223613.99
20692,2010-05-26,1067.95,-6.08,-0.57,1565.15,-31.77,True,1,13946,-1067.95,-5754802.31,14893630.7,9138828.39
20693,2010-05-27,1103.06,35.11,3.29,1565.15,-29.52,True,1,13947,-1103.06,-5755905.37,15384377.82,9628472.45
20694,2010-05-28,1089.41,-13.65,-1.24,1565.15,-30.4,True,1,13948,-1089.41,-5756994.78,15195090.68,9438095.9
20695,2010-06-01,1070.71,-18.7,-1.72,1565.15,-31.59,True,1,13949,-1070.71,-5758065.49,14935333.79,9177268.3
20696,2010-06-02,1098.38,27.67,2.58,1565.15,-29.82,True,1,13950,-1098.38,-5759163.87,15322401.0,9563237.13
20697,2010-06-03,1102.83,4.45,0.4,1565.15,-29.54,True,1,13951,-1102.83,-5760266.7,15385581.33,9625314.63
20698,2010-06-04,1064.88,-37.95,-3.44,1565.15,-31.96,True,1,13952,-1064.88,-5761331.58,14857205.76,9095874.18
20699,2010-06-07,1050.47,-14.41,-1.35,1565.15,-32.88,True,1,13953,-1050.47,-5762382.05,14657207.91,8894825.86
20700,2010-06-08,1062.0,11.53,1.1,1565.15,-32.15,True,1,13954,-1062.0,-5763444.05,14819148.0,9055703.95
20701,2010-06-09,1055.69,-6.31,-0.59,1565.15,-32.55,True,1,13955,-1055.69,-5764499.74,14732153.95,8967654.21
20702,2010-06-10,1086.84,31.15,2.95,1565.15,-30.56,True,1,13956,-1086.84,-5765586.58,15167939.04,9402352.46
20703,2010-06-11,1091.6,4.76,0.44,1565.15,-30.26,True,1,13957,-1091.6,-5766678.18,15235461.2,9468783.02
20704,2010-06-14,1089.63,-1.97,-0.18,1565.15,-30.38,True,1,13958,-1089.63,-5767767.81,15209055.54,9441287.73
20705,2010-06-15,1115.23,25.6,2.35,1565.15,-28.75,True,1,13959,-1115.23,-5768883.04,15567495.57,9798612.53
20706,2010-06-16,1114.61,-0.62,-0.06,1565.15,-28.79,True,1,13960,-1114.61,-5769997.65,15559955.6,9789957.95
20707,2010-06-17,1116.04,1.43,0.13,1565.15,-28.69,True,1,13961,-1116.04,-5771113.69,15581034.44,9809920.75
20708,2010-06-18,1117.51,1.47,0.13,1565.15,-28.6,True,1,13962,-1117.51,-5772231.2,15602674.62,9830443.42
20709,2010-06-21,1113.2,-4.31,-0.39,1565.15,-28.88,True,1,13963,-1113.2,-5773344.4,15543611.6,9770267.2
20710,2010-06-22,1095.31,-17.89,-1.61,1565.15,-30.02,True,1,13964,-1095.31,-5774439.71,15294908.84,9520469.13
20711,2010-06-23,1092.04,-3.27,-0.3,1565.15,-30.23,True,1,13965,-1092.04,-5775531.75,15250338.6,9474806.85
20712,2010-06-24,1073.69,-18.35,-1.68,1565.15,-31.4,True,1,13966,-1073.69,-5776605.44,14995154.54,9218549.1
20713,2010-06-25,1076.76,3.07,0.29,1565.15,-31.2,True,1,13967,-1076.76,-5777682.2,15039106.92,9261424.72
20714,2010-06-28,1074.57,-2.19,-0.2,1565.15,-31.34,True,1,13968,-1074.57,-5778756.77,15009593.76,9230836.99
20715,2010-06-29,1041.24,-33.33,-3.1,1565.15,-33.47,True,1,13969,-1041.24,-5779798.01,14545081.56,8765283.55
20716,2010-06-30,1030.71,-10.53,-1.01,1565.15,-34.15,True,1,13970,-1030.71,-5780828.72,14399018.7,8618189.98
20717,2010-07-01,1027.37,-3.34,-0.32,1565.15,-34.36,True,1,13971,-1027.37,-5781856.09,14353386.27,8571530.18
20718,2010-07-02,1022.58,-4.79,-0.47,1565.15,-34.67,True,1,13972,-1022.58,-5782878.67,14287487.76,8504609.09
20719,2010-07-06,1028.06,5.48,0.54,1565.15,-34.32,True,1,13973,-1028.06,-5783906.73,14365082.38,8581175.65
20720,2010-07-07,1060.27,32.21,3.13,1565.15,-32.26,True,1,13974,-1060.27,-5784967.0,14816212.98,9031245.98
20721,2010-07-08,1070.25,9.98,0.94,1565.15,-31.62,True,1,13975,-1070.25,-5786037.25,14956743.75,9170706.5
20722,2010-07-09,1077.96,7.71,0.72,1565.15,-31.13,True,1,13976,-1077.96,-5787115.21,15065568.96,9278453.75
20723,2010-07-12,1078.75,0.79,0.07,1565.15,-31.08,True,1,13977,-1078.75,-5788193.96,15077688.75,9289494.79
20724,2010-07-13,1095.34,16.59,1.54,1565.15,-30.02,True,1,13978,-1095.34,-5789289.3,15310662.52,9521373.22
20725,2010-07-14,1095.17,-0.17,-0.02,1565.15,-30.03,True,1,13979,-1095.17,-5790384.47,15309381.43,9518996.96
20726,2010-07-15,1096.48,1.31,0.12,1565.15,-29.94,True,1,13980,-1096.48,-5791480.95,15328790.4,9537309.45
20727,2010-07-16,1064.88,-31.6,-2.88,1565.15,-31.96,True,1,13981,-1064.88,-5792545.83,14888087.28,9095541.45
20728,2010-07-19,1071.25,6.37,0.6,1565.15,-31.56,True,1,13982,-1071.25,-5793617.08,14978217.5,9184600.42
20729,2010-07-20,1083.48,12.23,1.14,1565.15,-30.78,True,1,13983,-1083.48,-5794700.56,15150300.84,9355600.28
20730,2010-07-21,1069.59,-13.89,-1.28,1565.15,-31.66,True,1,13984,-1069.59,-5795770.15,14957146.56,9161376.41
20731,2010-07-22,1093.67,24.08,2.25,1565.15,-30.12,True,1,13985,-1093.67,-5796863.82,15294974.95,9498111.13
20732,2010-07-23,1102.66,8.99,0.82,1565.15,-29.55,True,1,13986,-1102.66,-5797966.48,15421802.76,9623836.28
20733,2010-07-26,1115.01,12.35,1.12,1565.15,-28.76,True,1,13987,-1115.01,-5799081.49,15595644.87,9796563.38
20734,2010-07-27,1113.84,-1.17,-0.1,1565.15,-28.84,True,1,13988,-1113.84,-5800195.33,15580393.92,9780198.59
20735,2010-07-28,1106.13,-7.71,-0.69,1565.15,-29.33,True,1,13989,-1106.13,-5801301.46,15473652.57,9672351.11
20736,2010-07-29,1101.53,-4.6,-0.42,1565.15,-29.62,True,1,13990,-1101.53,-5802402.99,15410404.7,9608001.71
20737,2010-07-30,1101.6,0.07,0.01,1565.15,-29.62,True,1,13991,-1101.6,-5803504.59,15412485.6,9608981.01
20738,2010-08-02,1125.86,24.26,2.2,1565.15,-28.07,True,1,13992,-1125.86,-5804630.45,15753033.12,9948402.67
20739,2010-08-03,1120.46,-5.4,-0.48,1565.15,-28.41,True,1,13993,-1120.46,-5805750.91,15678596.78,9872845.87
20740,2010-08-04,1127.24,6.78,0.6,1565.15,-27.98,True,1,13994,-1127.24,-5806878.15,15774596.56,9967718.41
20741,2010-08-05,1125.81,-1.43,-0.13,1565.15,-28.07,True,1,13995,-1125.81,-5808003.96,15755710.95,9947706.99
20742,2010-08-06,1121.64,-4.17,-0.37,1565.15,-28.34,True,1,13996,-1121.64,-5809125.6,15698473.44,9889347.84
20743,2010-08-09,1127.79,6.15,0.55,1565.15,-27.94,True,1,13997,-1127.79,-5810253.39,15785676.63,9975423.24
20744,2010-08-10,1121.06,-6.73,-0.6,1565.15,-28.37,True,1,13998,-1121.06,-5811374.45,15692597.88,9881223.43
20745,2010-08-11,1089.47,-31.59,-2.82,1565.15,-30.39,True,1,13999,-1089.47,-5812463.92,15251490.53,9439026.61
20746,2010-08-12,1083.61,-5.86,-0.54,1565.15,-30.77,True,1,14000,-1083.61,-5813547.53,15170540.0,9356992.47
20747,2010-08-13,1079.25,-4.36,-0.4,1565.15,-31.04,True,1,14001,-1079.25,-5814626.78,15110579.25,9295952.47
20748,2010-08-16,1079.38,0.13,0.01,1565.15,-31.04,True,1,14002,-1079.38,-5815706.16,15113478.76,9297772.6
20749,2010-08-17,1092.54,13.16,1.22,1565.15,-30.2,True,1,14003,-1092.54,-5816798.7,15298837.62,9482038.92
20750,2010-08-18,1094.16,1.62,0.15,1565.15,-30.09,True,1,14004,-1094.16,-5817892.86,15322616.64,9504723.78
20751,2010-08-19,1075.63,-18.53,-1.69,1565.15,-31.28,True,1,14005,-1075.63,-5818968.49,15064198.15,9245229.66
20752,2010-08-20,1071.69,-3.94,-0.37,1565.15,-31.53,True,1,14006,-1071.69,-5820040.18,15010090.14,9190049.96
20753,2010-08-23,1067.36,-4.33,-0.4,1565.15,-31.8,True,1,14007,-1067.36,-5821107.54,14950511.52,9129403.98
20754,2010-08-24,1051.87,-15.49,-1.45,1565.15,-32.79,True,1,14008,-1051.87,-5822159.41,14734594.96,8912435.55
20755,2010-08-25,1055.33,3.46,0.33,1565.15,-32.57,True,1,14009,-1055.33,-5823214.74,14784117.97,8960903.23
20756,2010-08-26,1047.22,-8.11,-0.77,1565.15,-33.09,True,1,14010,-1047.22,-5824261.96,14671552.2,8847290.24
20757,2010-08-27,1064.59,17.37,1.66,1565.15,-31.98,True,1,14011,-1064.59,-5825326.55,14915970.49,9090643.94
20758,2010-08-30,1048.92,-15.67,-1.47,1565.15,-32.98,True,1,14012,-1048.92,-5826375.47,14697467.04,8871091.57
20759,2010-08-31,1049.33,0.41,0.04,1565.15,-32.96,True,1,14013,-1049.33,-5827424.8,14704261.29,8876836.49
20760,2010-09-01,1080.29,30.96,2.95,1565.15,-30.98,True,1,14014,-1080.29,-5828505.09,15139184.06,9310678.97
20761,2010-09-02,1090.1,9.81,0.91,1565.15,-30.35,True,1,14015,-1090.1,-5829595.19,15277751.5,9448156.31
20762,2010-09-03,1104.51,14.41,1.32,1565.15,-29.43,True,1,14016,-1104.51,-5830699.7,15480812.16,9650112.46
20763,2010-09-07,1091.84,-12.67,-1.15,1565.15,-30.24,True,1,14017,-1091.84,-5831791.54,15304321.28,9472529.74
20764,2010-09-08,1098.87,7.03,0.64,1565.15,-29.79,True,1,14018,-1098.87,-5832890.41,15403959.66,9571069.25
20765,2010-09-09,1104.18,5.31,0.48,1565.15,-29.45,True,1,14019,-1104.18,-5833994.59,15479499.42,9645504.83
20766,2010-09-10,1109.55,5.37,0.49,1565.15,-29.11,True,1,14020,-1109.55,-5835104.14,15555891.0,9720786.86
20767,2010-09-13,1121.9,12.35,1.11,1565.15,-28.32,True,1,14021,-1121.9,-5836226.04,15730159.9,9893933.86
20768,2010-09-14,1121.1,-0.8,-0.07,1565.15,-28.37,True,1,14022,-1121.1,-5837347.14,15720064.2,9882717.06
20769,2010-09-15,1125.07,3.97,0.35,1565.15,-28.12,True,1,14023,-1125.07,-5838472.21,15776856.61,9938384.4
20770,2010-09-16,1124.66,-0.41,-0.04,1565.15,-28.14,True,1,14024,-1124.66,-5839596.87,15772231.84,9932634.97
20771,2010-09-17,1125.59,0.93,0.08,1565.15,-28.08,True,1,14025,-1125.59,-5840722.46,15786399.75,9945677.29
20772,2010-09-20,1142.71,17.12,1.52,1565.15,-26.99,True,1,14026,-1142.71,-5841865.17,16027650.46,10185785.29
20773,2010-09-21,1139.78,-2.93,-0.26,1565.15,-27.18,True,1,14027,-1139.78,-5843004.95,15987694.06,10144689.11
20774,2010-09-22,1134.28,-5.5,-0.48,1565.15,-27.53,True,1,14028,-1134.28,-5844139.23,15911679.84,10067540.61
20775,2010-09-23,1124.83,-9.45,-0.83,1565.15,-28.13,True,1,14029,-1124.83,-5845264.06,15780240.07,9934976.01
20776,2010-09-24,1148.67,23.84,2.12,1565.15,-26.61,True,1,14030,-1148.67,-5846412.73,16115840.1,10269427.37
20777,2010-09-27,1142.16,-6.51,-0.57,1565.15,-27.03,True,1,14031,-1142.16,-5847554.89,16025646.96,10178092.07
20778,2010-09-28,1147.7,5.54,0.48,1565.15,-26.67,True,1,14032,-1147.7,-5848702.59,16104526.4,10255823.81
20779,2010-09-29,1144.73,-2.97,-0.26,1565.15,-26.86,True,1,14033,-1144.73,-5849847.32,16063996.09,10214148.77
20780,2010-09-30,1141.2,-3.53,-0.31,1565.15,-27.09,True,1,14034,-1141.2,-5850988.52,16015600.8,10164612.28
20781,2010-10-01,1146.24,5.04,0.44,1565.15,-26.76,True,1,14035,-1146.24,-5852134.76,16087478.4,10235343.64
20782,2010-10-04,1137.03,-9.21,-0.8,1565.15,-27.35,True,1,14036,-1137.03,-5853271.79,15959353.08,10106081.29
20783,2010-10-05,1160.75,23.72,2.09,1565.15,-25.84,True,1,14037,-1160.75,-5854432.54,16293447.75,10439015.21
20784,2010-10-06,1159.97,-0.78,-0.07,1565.15,-25.89,True,1,14038,-1159.97,-5855592.51,16283658.86,10428066.35
20785,2010-10-07,1158.06,-1.91,-0.16,1565.15,-26.01,True,1,14039,-1158.06,-5856750.57,16258004.34,10401253.77
20786,2010-10-08,1165.15,7.09,0.61,1565.15,-25.56,True,1,14040,-1165.15,-5857915.72,16358706.0,10500790.28
20787,2010-10-11,1165.32,0.17,0.02,1565.15,-25.55,True,1,14041,-1165.32,-5859081.04,16362258.12,10503177.08
20788,2010-10-12,1169.77,4.45,0.38,1565.15,-25.26,True,1,14042,-1169.77,-5860250.81,16425910.34,10565659.53
20789,2010-10-13,1178.1,8.33,0.71,1565.15,-24.73,True,1,14043,-1178.1,-5861428.91,16544058.3,10682629.39
20790,2010-10-14,1173.81,-4.29,-0.36,1565.15,-25.0,True,1,14044,-1173.81,-5862602.72,16484987.64,10622384.92
20791,2010-10-15,1176.19,2.38,0.2,1565.15,-24.85,True,1,14045,-1176.19,-5863778.91,16519588.55,10655809.64
20792,2010-10-18,1184.71,8.52,0.72,1565.15,-24.31,True,1,14046,-1184.71,-5864963.62,16640436.66,10775473.04
20793,2010-10-19,1165.9,-18.81,-1.59,1565.15,-25.51,True,1,14047,-1165.9,-5866129.52,16377397.3,10511267.78
20794,2010-10-20,1178.17,12.27,1.05,1565.15,-24.72,True,1,14048,-1178.17,-5867307.69,16550932.16,10683624.47
20795,2010-10-21,1180.26,2.09,0.18,1565.15,-24.59,True,1,14049,-1180.26,-5868487.95,16581472.74,10712984.79
20796,2010-10-22,1183.08,2.82,0.24,1565.15,-24.41,True,1,14050,-1183.08,-5869671.03,16622274.0,10752602.97
20797,2010-10-25,1185.62,2.54,0.22,1565.15,-24.25,True,1,14051,-1185.62,-5870856.65,16659146.62,10788289.97
20798,2010-10-26,1185.64,0.02,0.0,1565.15,-24.25,True,1,14052,-1185.64,-5872042.29,16660613.28,10788570.99
20799,2010-10-27,1182.45,-3.19,-0.27,1565.15,-24.45,True,1,14053,-1182.45,-5873224.74,16616969.85,10743745.11
20800,2010-10-28,1183.78,1.33,0.11,1565.15,-24.37,True,1,14054,-1183.78,-5874408.52,16636844.12,10762435.6
20801,2010-10-29,1183.26,-0.52,-0.04,1565.15,-24.4,True,1,14055,-1183.26,-5875591.78,16630719.3,10755127.52
20802,2010-11-01,1184.38,1.12,0.1,1565.15,-24.33,True,1,14056,-1184.38,-5876776.16,16647645.28,10770869.12
20803,2010-11-02,1193.57,9.19,0.78,1565.15,-23.74,True,1,14057,-1193.57,-5877969.73,16778013.49,10900043.76
20804,2010-11-03,1197.96,4.39,0.37,1565.15,-23.46,True,1,14058,-1197.96,-5879167.69,16840921.68,10961753.99
20805,2010-11-04,1221.06,23.1,1.93,1565.15,-21.98,True,1,14059,-1221.06,-5880388.75,17166882.54,11286493.79
20806,2010-11-05,1225.85,4.79,0.39,1565.15,-21.68,True,1,14060,-1225.85,-5881614.6,17235451.0,11353836.4
20807,2010-11-08,1223.25,-2.6,-0.21,1565.15,-21.84,True,1,14061,-1223.25,-5882837.85,17200118.25,11317280.4
20808,2010-11-09,1213.4,-9.85,-0.8,1565.15,-22.47,True,1,14062,-1213.4,-5884051.25,17062830.8,11178779.55
20809,2010-11-10,1218.71,5.31,0.44,1565.15,-22.14,True,1,14063,-1218.71,-5885269.96,17138718.73,11253448.77
20810,2010-11-11,1213.54,-5.17,-0.42,1565.15,-22.46,True,1,14064,-1213.54,-5886483.5,17067226.56,11180743.06
20811,2010-11-12,1199.21,-14.33,-1.18,1565.15,-23.38,True,1,14065,-1199.21,-5887682.71,16866888.65,10979205.94
20812,2010-11-15,1197.75,-1.46,-0.12,1565.15,-23.47,True,1,14066,-1197.75,-5888880.46,16847551.5,10958671.04
20813,2010-11-16,1178.34,-19.41,-1.62,1565.15,-24.71,True,1,14067,-1178.34,-5890058.8,16575708.78,10685649.98
20814,2010-11-17,1178.59,0.25,0.02,1565.15,-24.7,True,1,14068,-1178.59,-5891237.39,16580404.12,10689166.73
20815,2010-11-18,1196.69,18.1,1.54,1565.15,-23.54,True,1,14069,-1196.69,-5892434.08,16836231.61,10943797.53
20816,2010-11-19,1199.73,3.04,0.25,1565.15,-23.35,True,1,14070,-1199.73,-5893633.81,16880201.1,10986567.29
20817,2010-11-22,1197.84,-1.89,-0.16,1565.15,-23.47,True,1,14071,-1197.84,-5894831.65,16854806.64,10959974.99
20818,2010-11-23,1180.73,-17.11,-1.43,1565.15,-24.56,True,1,14072,-1180.73,-5896012.38,16615232.56,10719220.18
20819,2010-11-24,1198.35,17.62,1.49,1565.15,-23.44,True,1,14073,-1198.35,-5897210.73,16864379.55,10967168.82
20820,2010-11-26,1189.4,-8.95,-0.75,1565.15,-24.01,True,1,14074,-1189.4,-5898400.13,16739615.6,10841215.47
20821,2010-11-29,1187.76,-1.64,-0.14,1565.15,-24.11,True,1,14075,-1187.76,-5899587.89,16717722.0,10818134.11
20822,2010-11-30,1180.55,-7.21,-0.61,1565.15,-24.57,True,1,14076,-1180.55,-5900768.44,16617421.8,10716653.36
20823,2010-12-01,1206.07,25.52,2.16,1565.15,-22.94,True,1,14077,-1206.07,-5901974.51,16977847.39,11075872.88
20824,2010-12-02,1221.53,15.46,1.28,1565.15,-21.95,True,1,14078,-1221.53,-5903196.04,17196699.34,11293503.3
20825,2010-12-03,1224.71,3.18,0.26,1565.15,-21.75,True,1,14079,-1224.71,-5904420.75,17242692.09,11338271.34
20826,2010-12-06,1223.12,-1.59,-0.13,1565.15,-21.85,True,1,14080,-1223.12,-5905643.87,17221529.6,11315885.73
20827,2010-12-07,1223.75,0.63,0.05,1565.15,-21.81,True,1,14081,-1223.75,-5906867.62,17231623.75,11324756.13
20828,2010-12-08,1228.28,4.53,0.37,1565.15,-21.52,True,1,14082,-1228.28,-5908095.9,17296638.96,11388543.06
20829,2010-12-09,1233.0,4.72,0.38,1565.15,-21.22,True,1,14083,-1233.0,-5909328.9,17364339.0,11455010.1
20830,2010-12-10,1240.4,7.4,0.6,1565.15,-20.75,True,1,14084,-1240.4,-5910569.3,17469793.6,11559224.3
20831,2010-12-13,1240.46,0.06,0.0,1565.15,-20.74,True,1,14085,-1240.46,-5911809.76,17471879.1,11560069.34
20832,2010-12-14,1241.59,1.13,0.09,1565.15,-20.67,True,1,14086,-1241.59,-5913051.35,17489036.74,11575985.39
20833,2010-12-15,1235.23,-6.36,-0.51,1565.15,-21.08,True,1,14087,-1235.23,-5914286.58,17400685.01,11486398.43
20834,2010-12-16,1242.87,7.64,0.62,1565.15,-20.59,True,1,14088,-1242.87,-5915529.45,17509552.56,11594023.11
20835,2010-12-17,1243.91,1.04,0.08,1565.15,-20.52,True,1,14089,-1243.91,-5916773.36,17525447.99,11608674.63
20836,2010-12-20,1247.08,3.17,0.26,1565.15,-20.32,True,1,14090,-1247.08,-5918020.44,17571357.2,11653336.76
20837,2010-12-21,1254.6,7.52,0.6,1565.15,-19.84,True,1,14091,-1254.6,-5919275.04,17678568.6,11759293.56
20838,2010-12-22,1258.84,4.24,0.34,1565.15,-19.57,True,1,14092,-1258.84,-5920533.88,17739573.28,11819039.4
20839,2010-12-23,1256.77,-2.07,-0.16,1565.15,-19.7,True,1,14093,-1256.77,-5921790.65,17711659.61,11789868.96
20840,2010-12-27,1257.54,0.77,0.06,1565.15,-19.65,True,1,14094,-1257.54,-5923048.19,17723768.76,11800720.57
20841,2010-12-28,1258.51,0.97,0.08,1565.15,-19.59,True,1,14095,-1258.51,-5924306.7,17738698.45,11814391.75
20842,2010-12-29,1259.78,1.27,0.1,1565.15,-19.51,True,1,14096,-1259.78,-5925566.48,17757858.88,11832292.4
20843,2010-12-30,1257.88,-1.9,-0.15,1565.15,-19.63,True,1,14097,-1257.88,-5926824.36,17732334.36,11805510.0
20844,2010-12-31,1257.64,-0.24,-0.02,1565.15,-19.65,True,1,14098,-1257.64,-5928082.0,17730208.72,11802126.72
20845,2011-01-03,1271.87,14.23,1.13,1565.15,-18.74,True,1,14099,-1271.87,-5929353.87,17932095.13,12002741.26
20846,2011-01-04,1270.2,-1.67,-0.13,1565.15,-18.84,True,1,14100,-1270.2,-5930624.07,17909820.0,11979195.93
20847,2011-01-05,1276.56,6.36,0.5,1565.15,-18.44,True,1,14101,-1276.56,-5931900.63,18000772.56,12068871.93
20848,2011-01-06,1273.85,-2.71,-0.21,1565.15,-18.61,True,1,14102,-1273.85,-5933174.48,17963832.7,12030658.22
20849,2011-01-07,1271.5,-2.35,-0.18,1565.15,-18.76,True,1,14103,-1271.5,-5934445.98,17931964.5,11997518.52
20850,2011-01-10,1269.75,-1.75,-0.14,1565.15,-18.87,True,1,14104,-1269.75,-5935715.73,17908554.0,11972838.27
20851,2011-01-11,1274.48,4.73,0.37,1565.15,-18.57,True,1,14105,-1274.48,-5936990.21,17976540.4,12039550.19
20852,2011-01-12,1285.96,11.48,0.9,1565.15,-17.84,True,1,14106,-1285.96,-5938276.17,18139751.76,12201475.59
20853,2011-01-13,1283.76,-2.2,-0.17,1565.15,-17.98,True,1,14107,-1283.76,-5939559.93,18110002.32,12170442.39
20854,2011-01-14,1293.24,9.48,0.74,1565.15,-17.37,True,1,14108,-1293.24,-5940853.17,18245029.92,12304176.75
20855,2011-01-18,1295.02,1.78,0.14,1565.15,-17.26,True,1,14109,-1295.02,-5942148.19,18271437.18,12329288.99
20856,2011-01-19,1281.92,-13.1,-1.01,1565.15,-18.1,True,1,14110,-1281.92,-5943430.11,18087891.2,12144461.09
20857,2011-01-20,1280.26,-1.66,-0.13,1565.15,-18.2,True,1,14111,-1280.26,-5944710.37,18065748.86,12121038.49
20858,2011-01-21,1283.35,3.09,0.24,1565.15,-18.0,True,1,14112,-1283.35,-5945993.72,18110635.2,12164641.48
20859,2011-01-24,1290.84,7.49,0.58,1565.15,-17.53,True,1,14113,-1290.84,-5947284.56,18217624.92,12270340.36
20860,2011-01-25,1291.18,0.34,0.03,1565.15,-17.5,True,1,14114,-1291.18,-5948575.74,18223714.52,12275138.78
20861,2011-01-26,1296.63,5.45,0.42,1565.15,-17.16,True,1,14115,-1296.63,-5949872.37,18301932.45,12352060.08
20862,2011-01-27,1299.54,2.91,0.22,1565.15,-16.97,True,1,14116,-1299.54,-5951171.91,18344306.64,12393134.73
20863,2011-01-28,1276.34,-23.2,-1.78,1565.15,-18.45,True,1,14117,-1276.34,-5952448.25,18018091.78,12065643.53
20864,2011-01-31,1286.12,9.78,0.77,1565.15,-17.83,True,1,14118,-1286.12,-5953734.37,18157442.16,12203707.79
20865,2011-02-01,1307.59,21.47,1.67,1565.15,-16.46,True,1,14119,-1307.59,-5955041.96,18461863.21,12506821.25
20866,2011-02-02,1304.03,-3.56,-0.27,1565.15,-16.68,True,1,14120,-1304.03,-5956345.99,18412903.6,12456557.61
20867,2011-02-03,1307.1,3.07,0.24,1565.15,-16.49,True,1,14121,-1307.1,-5957653.09,18457559.1,12499906.01
20868,2011-02-04,1310.87,3.77,0.29,1565.15,-16.25,True,1,14122,-1310.87,-5958963.96,18512106.14,12553142.18
20869,2011-02-07,1319.05,8.18,0.62,1565.15,-15.72,True,1,14123,-1319.05,-5960283.01,18628943.15,12668660.14
20870,2011-02-08,1324.57,5.52,0.42,1565.15,-15.37,True,1,14124,-1324.57,-5961607.58,18708226.68,12746619.1
20871,2011-02-09,1320.88,-3.69,-0.28,1565.15,-15.61,True,1,14125,-1320.88,-5962928.46,18657430.0,12694501.54
20872,2011-02-10,1321.87,0.99,0.08,1565.15,-15.54,True,1,14126,-1321.87,-5964250.33,18672735.62,12708485.29
20873,2011-02-11,1329.15,7.28,0.55,1565.15,-15.08,True,1,14127,-1329.15,-5965579.48,18776902.05,12811322.57
20874,2011-02-14,1332.32,3.17,0.24,1565.15,-14.88,True,1,14128,-1332.32,-5966911.8,18823016.96,12856105.16
20875,2011-02-15,1328.01,-4.31,-0.32,1565.15,-15.15,True,1,14129,-1328.01,-5968239.81,18763453.29,12795213.48
20876,2011-02-16,1336.32,8.31,0.63,1565.15,-14.62,True,1,14130,-1336.32,-5969576.13,18882201.6,12912625.47
20877,2011-02-17,1340.43,4.11,0.31,1565.15,-14.36,True,1,14131,-1340.43,-5970916.56,18941616.33,12970699.77
20878,2011-02-18,1343.01,2.58,0.19,1565.15,-14.19,True,1,14132,-1343.01,-5972259.57,18979417.32,13007157.75
20879,2011-02-22,1315.44,-27.57,-2.05,1565.15,-15.95,True,1,14133,-1315.44,-5973575.01,18591113.52,12617538.51
20880,2011-02-23,1307.4,-8.04,-0.61,1565.15,-16.47,True,1,14134,-1307.4,-5974882.41,18478791.6,12503909.19
20881,2011-02-24,1306.1,-1.3,-0.1,1565.15,-16.55,True,1,14135,-1306.1,-5976188.51,18461723.5,12485534.99
20882,2011-02-25,1319.88,13.78,1.06,1565.15,-15.67,True,1,14136,-1319.88,-5977508.39,18657823.68,12680315.29
20883,2011-02-28,1327.22,7.34,0.56,1565.15,-15.2,True,1,14137,-1327.22,-5978835.61,18762909.14,12784073.53
20884,2011-03-01,1306.33,-20.89,-1.57,1565.15,-16.54,True,1,14138,-1306.33,-5980141.94,18468893.54,12488751.6
20885,2011-03-02,1308.44,2.11,0.16,1565.15,-16.4,True,1,14139,-1308.44,-5981450.38,18500033.16,12518582.78
20886,2011-03-03,1330.97,22.53,1.72,1565.15,-14.96,True,1,14140,-1330.97,-5982781.35,18819915.8,12837134.45
20887,2011-03-04,1321.15,-9.82,-0.74,1565.15,-15.59,True,1,14141,-1321.15,-5984102.5,18682382.15,12698279.65
20888,2011-03-07,1310.13,-11.02,-0.83,1565.15,-16.29,True,1,14142,-1310.13,-5985412.63,18527858.46,12542445.83
20889,2011-03-08,1321.82,11.69,0.89,1565.15,-15.55,True,1,14143,-1321.82,-5986734.45,18694500.26,12707765.81
20890,2011-03-09,1320.02,-1.8,-0.14,1565.15,-15.66,True,1,14144,-1320.02,-5988054.47,18670362.88,12682308.41
20891,2011-03-10,1295.11,-24.91,-1.89,1565.15,-17.25,True,1,14145,-1295.11,-5989349.58,18319330.95,12329981.37
20892,2011-03-11,1304.28,9.17,0.71,1565.15,-16.67,True,1,14146,-1304.28,-5990653.86,18450344.88,12459691.02
20893,2011-03-14,1296.39,-7.89,-0.6,1565.15,-17.17,True,1,14147,-1296.39,-5991950.25,18340029.33,12348079.08
20894,2011-03-15,1281.87,-14.52,-1.12,1565.15,-18.1,True,1,14148,-1281.87,-5993232.12,18135896.76,12142664.64
20895,2011-03-16,1256.88,-24.99,-1.95,1565.15,-19.7,True,1,14149,-1256.88,-5994489.0,17783595.12,11789106.12
20896,2011-03-17,1273.72,16.84,1.34,1565.15,-18.62,True,1,14150,-1273.72,-5995762.72,18023138.0,12027375.28
20897,2011-03-18,1279.21,5.49,0.43,1565.15,-18.27,True,1,14151,-1279.21,-5997041.93,18102100.71,12105058.78
20898,2011-03-21,1298.38,19.17,1.5,1565.15,-17.04,True,1,14152,-1298.38,-5998340.31,18374673.76,12376333.45
20899,2011-03-22,1293.77,-4.61,-0.36,1565.15,-17.34,True,1,14153,-1293.77,-5999634.08,18310726.81,12311092.73
20900,2011-03-23,1297.54,3.77,0.29,1565.15,-17.1,True,1,14154,-1297.54,-6000931.62,18365381.16,12364449.54
20901,2011-03-24,1309.66,12.12,0.93,1565.15,-16.32,True,1,14155,-1309.66,-6002241.28,18538237.3,12535996.02
20902,2011-03-25,1313.8,4.14,0.32,1565.15,-16.06,True,1,14156,-1313.8,-6003555.08,18598152.8,12594597.72
20903,2011-03-28,1310.19,-3.61,-0.28,1565.15,-16.29,True,1,14157,-1310.19,-6004865.27,18548359.83,12543494.56
20904,2011-03-29,1319.44,9.25,0.71,1565.15,-15.7,True,1,14158,-1319.44,-6006184.71,18680631.52,12674446.81
20905,2011-03-30,1328.26,8.82,0.67,1565.15,-15.14,True,1,14159,-1328.26,-6007512.97,18806833.34,12799320.37
20906,2011-03-31,1325.83,-2.43,-0.18,1565.15,-15.29,True,1,14160,-1325.83,-6008838.8,18773752.8,12764914.0
20907,2011-04-01,1332.41,6.58,0.5,1565.15,-14.87,True,1,14161,-1332.41,-6010171.21,18868258.01,12858086.8
20908,2011-04-04,1332.87,0.46,0.04,1565.15,-14.84,True,1,14162,-1332.87,-6011504.08,18876104.94,12864600.86
20909,2011-04-05,1332.63,-0.24,-0.02,1565.15,-14.86,True,1,14163,-1332.63,-6012836.71,18874038.69,12861201.98
20910,2011-04-06,1335.54,2.91,0.22,1565.15,-14.67,True,1,14164,-1335.54,-6014172.25,18916588.56,12902416.31
20911,2011-04-07,1333.51,-2.03,-0.15,1565.15,-14.8,True,1,14165,-1333.51,-6015505.76,18889169.15,12873663.39
20912,2011-04-08,1328.17,-5.34,-0.4,1565.15,-15.14,True,1,14166,-1328.17,-6016833.93,18814856.22,12798022.29
20913,2011-04-11,1324.46,-3.71,-0.28,1565.15,-15.38,True,1,14167,-1324.46,-6018158.39,18763624.82,12745466.43
20914,2011-04-12,1314.16,-10.3,-0.78,1565.15,-16.04,True,1,14168,-1314.16,-6019472.55,18619018.88,12599546.33
20915,2011-04-13,1314.41,0.25,0.02,1565.15,-16.02,True,1,14169,-1314.41,-6020786.96,18623875.29,12603088.33
20916,2011-04-14,1314.52,0.11,0.01,1565.15,-16.01,True,1,14170,-1314.52,-6022101.48,18626748.4,12604646.92
20917,2011-04-15,1319.68,5.16,0.39,1565.15,-15.68,True,1,14171,-1319.68,-6023421.16,18701185.28,12677764.12
20918,2011-04-18,1305.14,-14.54,-1.1,1565.15,-16.61,True,1,14172,-1305.14,-6024726.3,18496444.08,12471717.78
20919,2011-04-19,1312.62,7.48,0.57,1565.15,-16.14,True,1,14173,-1312.62,-6026038.92,18603763.26,12577724.34
20920,2011-04-20,1330.36,17.74,1.35,1565.15,-15.0,True,1,14174,-1330.36,-6027369.28,18856522.64,12829153.36
20921,2011-04-21,1337.38,7.02,0.53,1565.15,-14.55,True,1,14175,-1337.38,-6028706.66,18957361.5,12928654.84
20922,2011-04-25,1335.25,-2.13,-0.16,1565.15,-14.69,True,1,14176,-1335.25,-6030041.91,18928504.0,12898462.09
20923,2011-04-26,1347.24,11.99,0.9,1565.15,-13.92,True,1,14177,-1347.24,-6031389.15,19099821.48,13068432.33
20924,2011-04-27,1355.66,8.42,0.62,1565.15,-13.38,True,1,14178,-1355.66,-6032744.81,19220547.48,13187802.67
20925,2011-04-28,1360.48,4.82,0.36,1565.15,-13.08,True,1,14179,-1360.48,-6034105.29,19290245.92,13256140.63
20926,2011-04-29,1363.61,3.13,0.23,1565.15,-12.88,True,1,14180,-1363.61,-6035468.9,19335989.8,13300520.9
20927,2011-05-02,1361.22,-2.39,-0.18,1565.15,-13.03,True,1,14181,-1361.22,-6036830.12,19303460.82,13266630.7
20928,2011-05-03,1356.62,-4.6,-0.34,1565.15,-13.32,True,1,14182,-1356.62,-6038186.74,19239584.84,13201398.1
20929,2011-05-04,1347.32,-9.3,-0.69,1565.15,-13.92,True,1,14183,-1347.32,-6039534.06,19109039.56,13069505.5
20930,2011-05-05,1335.1,-12.22,-0.91,1565.15,-14.7,True,1,14184,-1335.1,-6040869.16,18937058.4,12896189.24
20931,2011-05-06,1340.2,5.1,0.38,1565.15,-14.37,True,1,14185,-1340.2,-6042209.36,19010737.0,12968527.64
20932,2011-05-09,1346.29,6.09,0.45,1565.15,-13.98,True,1,14186,-1346.29,-6043555.65,19098469.94,13054914.29
20933,2011-05-10,1357.16,10.87,0.81,1565.15,-13.29,True,1,14187,-1357.16,-6044912.81,19254028.92,13209116.11
20934,2011-05-11,1342.08,-15.08,-1.11,1565.15,-14.25,True,1,14188,-1342.08,-6046254.89,19041431.04,12995176.15
20935,2011-05-12,1348.65,6.57,0.49,1565.15,-13.83,True,1,14189,-1348.65,-6047603.54,19135994.85,13088391.31
20936,2011-05-13,1337.77,-10.88,-0.81,1565.15,-14.53,True,1,14190,-1337.77,-6048941.31,18982956.3,12934014.99
20937,2011-05-16,1329.47,-8.3,-0.62,1565.15,-15.06,True,1,14191,-1329.47,-6050270.78,18866508.77,12816237.99
20938,2011-05-17,1328.98,-0.49,-0.04,1565.15,-15.09,True,1,14192,-1328.98,-6051599.76,18860884.16,12809284.4
20939,2011-05-18,1340.68,11.7,0.88,1565.15,-14.34,True,1,14193,-1340.68,-6052940.44,19028271.24,12975330.8
20940,2011-05-19,1343.6,2.92,0.22,1565.15,-14.16,True,1,14194,-1343.6,-6054284.04,19071058.4,13016774.36
20941,2011-05-20,1333.27,-10.33,-0.77,1565.15,-14.82,True,1,14195,-1333.27,-6055617.31,18925767.65,12870150.34
20942,2011-05-23,1317.37,-15.9,-1.19,1565.15,-15.83,True,1,14196,-1317.37,-6056934.68,18701384.52,12644449.84
20943,2011-05-24,1316.28,-1.09,-0.08,1565.15,-15.9,True,1,14197,-1316.28,-6058250.96,18687227.16,12628976.2
20944,2011-05-25,1320.47,4.19,0.32,1565.15,-15.63,True,1,14198,-1320.47,-6059571.43,18748033.06,12688461.63
20945,2011-05-26,1325.69,5.22,0.4,1565.15,-15.3,True,1,14199,-1325.69,-6060897.12,18823472.31,12762575.19
20946,2011-05-27,1331.1,5.41,0.41,1565.15,-14.95,True,1,14200,-1331.1,-6062228.22,18901620.0,12839391.78
20947,2011-05-31,1345.2,14.1,1.06,1565.15,-14.05,True,1,14201,-1345.2,-6063573.42,19103185.2,13039611.78
20948,2011-06-01,1314.55,-30.65,-2.28,1565.15,-16.01,True,1,14202,-1314.55,-6064887.97,18669239.1,12604351.13
20949,2011-06-02,1312.94,-1.61,-0.12,1565.15,-16.11,True,1,14203,-1312.94,-6066200.91,18647686.82,12581485.91
20950,2011-06-03,1300.16,-12.78,-0.97,1565.15,-16.93,True,1,14204,-1300.16,-6067501.07,18467472.64,12399971.57
20951,2011-06-06,1286.17,-13.99,-1.08,1565.15,-17.82,True,1,14205,-1286.17,-6068787.24,18270044.85,12201257.61
20952,2011-06-07,1284.94,-1.23,-0.1,1565.15,-17.9,True,1,14206,-1284.94,-6070072.18,18253857.64,12183785.46
20953,2011-06-08,1279.56,-5.38,-0.42,1565.15,-18.25,True,1,14207,-1279.56,-6071351.74,18178708.92,12107357.18
20954,2011-06-09,1289.0,9.44,0.74,1565.15,-17.64,True,1,14208,-1289.0,-6072640.74,18314112.0,12241471.26
20955,2011-06-10,1270.98,-18.02,-1.4,1565.15,-18.8,True,1,14209,-1270.98,-6073911.72,18059354.82,11985443.1
20956,2011-06-13,1271.83,0.85,0.07,1565.15,-18.74,True,1,14210,-1271.83,-6075183.55,18072704.3,11997520.75
20957,2011-06-14,1287.87,16.04,1.26,1565.15,-17.72,True,1,14211,-1287.87,-6076471.42,18301920.57,12225449.15
20958,2011-06-15,1265.42,-22.45,-1.74,1565.15,-19.15,True,1,14212,-1265.42,-6077736.84,17984149.04,11906412.2
20959,2011-06-16,1267.64,2.22,0.18,1565.15,-19.01,True,1,14213,-1267.64,-6079004.48,18016967.32,11937962.84
20960,2011-06-17,1271.5,3.86,0.3,1565.15,-18.76,True,1,14214,-1271.5,-6080275.98,18073101.0,11992825.02
20961,2011-06-20,1278.36,6.86,0.54,1565.15,-18.32,True,1,14215,-1278.36,-6081554.34,18171887.4,12090333.06
20962,2011-06-21,1295.52,17.16,1.34,1565.15,-17.23,True,1,14216,-1295.52,-6082849.86,18417112.32,12334262.46
20963,2011-06-22,1287.14,-8.38,-0.65,1565.15,-17.76,True,1,14217,-1287.14,-6084137.0,18299269.38,12215132.38
20964,2011-06-23,1283.5,-3.64,-0.28,1565.15,-18.0,True,1,14218,-1283.5,-6085420.5,18248803.0,12163382.5
20965,2011-06-24,1268.45,-15.05,-1.17,1565.15,-18.96,True,1,14219,-1268.45,-6086688.95,18036090.55,11949401.6
20966,2011-06-27,1280.1,11.65,0.92,1565.15,-18.21,True,1,14220,-1280.1,-6087969.05,18203022.0,12115052.95
20967,2011-06-28,1296.67,16.57,1.29,1565.15,-17.15,True,1,14221,-1296.67,-6089265.72,18439944.07,12350678.35
20968,2011-06-29,1307.41,10.74,0.83,1565.15,-16.47,True,1,14222,-1307.41,-6090573.13,18593985.02,12503411.89
20969,2011-06-30,1320.64,13.23,1.01,1565.15,-15.62,True,1,14223,-1320.64,-6091893.77,18783462.72,12691568.95
20970,2011-07-01,1339.67,19.03,1.44,1565.15,-14.41,True,1,14224,-1339.67,-6093233.44,19055466.08,12962232.64
20971,2011-07-05,1337.88,-1.79,-0.13,1565.15,-14.52,True,1,14225,-1337.88,-6094571.32,19031343.0,12936771.68
20972,2011-07-06,1339.22,1.34,0.1,1565.15,-14.44,True,1,14226,-1339.22,-6095910.54,19051743.72,12955833.18
20973,2011-07-07,1353.22,14.0,1.04,1565.15,-13.54,True,1,14227,-1353.22,-6097263.76,19252260.94,13154997.18
20974,2011-07-08,1343.8,-9.42,-0.7,1565.15,-14.14,True,1,14228,-1343.8,-6098607.56,19119586.4,13020978.84
20975,2011-07-11,1319.49,-24.31,-1.81,1565.15,-15.7,True,1,14229,-1319.49,-6099927.05,18775023.21,12675096.16
20976,2011-07-12,1313.64,-5.85,-0.44,1565.15,-16.07,True,1,14230,-1313.64,-6101240.69,18693097.2,12591856.51
20977,2011-07-13,1317.72,4.08,0.31,1565.15,-15.81,True,1,14231,-1317.72,-6102558.41,18752473.32,12649914.91
20978,2011-07-14,1308.87,-8.85,-0.67,1565.15,-16.37,True,1,14232,-1308.87,-6103867.28,18627837.84,12523970.56
20979,2011-07-15,1316.14,7.27,0.56,1565.15,-15.91,True,1,14233,-1316.14,-6105183.42,18732620.62,12627437.2
20980,2011-07-18,1305.44,-10.7,-0.81,1565.15,-16.59,True,1,14234,-1305.44,-6106488.86,18581632.96,12475144.1
20981,2011-07-19,1326.73,21.29,1.63,1565.15,-15.23,True,1,14235,-1326.73,-6107815.59,18886001.55,12778185.96
20982,2011-07-20,1325.84,-0.89,-0.07,1565.15,-15.29,True,1,14236,-1325.84,-6109141.43,18874658.24,12765516.81
20983,2011-07-21,1343.8,17.96,1.36,1565.15,-14.14,True,1,14237,-1343.8,-6110485.23,19131680.6,13021195.37
20984,2011-07-22,1345.02,1.22,0.09,1565.15,-14.06,True,1,14238,-1345.02,-6111830.25,19150394.76,13038564.51
20985,2011-07-25,1337.43,-7.59,-0.56,1565.15,-14.55,True,1,14239,-1337.43,-6113167.68,19043665.77,12930498.09
20986,2011-07-26,1331.94,-5.49,-0.41,1565.15,-14.9,True,1,14240,-1331.94,-6114499.62,18966825.6,12852325.98
20987,2011-07-27,1304.89,-27.05,-2.03,1565.15,-16.63,True,1,14241,-1304.89,-6115804.51,18582938.49,12467133.98
20988,2011-07-28,1300.67,-4.22,-0.32,1565.15,-16.9,True,1,14242,-1300.67,-6117105.18,18524142.14,12407036.96
20989,2011-07-29,1292.28,-8.39,-0.64,1565.15,-17.43,True,1,14243,-1292.28,-6118397.46,18405944.04,12287546.58
20990,2011-08-01,1286.94,-5.34,-0.41,1565.15,-17.77,True,1,14244,-1286.94,-6119684.4,18331173.36,12211488.96
20991,2011-08-02,1254.05,-32.89,-2.56,1565.15,-19.88,True,1,14245,-1254.05,-6120938.45,17863942.25,11743003.8
20992,2011-08-03,1260.34,6.29,0.5,1565.15,-19.48,True,1,14246,-1260.34,-6122198.79,17954803.64,11832604.85
20993,2011-08-04,1200.07,-60.27,-4.78,1565.15,-23.33,True,1,14247,-1200.07,-6123398.86,17097397.29,10973998.43
20994,2011-08-05,1199.38,-0.69,-0.06,1565.15,-23.37,True,1,14248,-1199.38,-6124598.24,17088766.24,10964168.0
20995,2011-08-08,1119.46,-79.92,-6.66,1565.15,-28.48,True,1,14249,-1119.46,-6125717.7,15951185.54,9825467.84
20996,2011-08-09,1172.53,53.07,4.74,1565.15,-25.08,True,1,14250,-1172.53,-6126890.23,16708552.5,10581662.27
20997,2011-08-10,1120.76,-51.77,-4.42,1565.15,-28.39,True,1,14251,-1120.76,-6128010.99,15971950.76,9843939.77
20998,2011-08-11,1172.64,51.88,4.63,1565.15,-25.08,True,1,14252,-1172.64,-6129183.63,16712465.28,10583281.65
20999,2011-08-12,1178.81,6.17,0.53,1565.15,-24.68,True,1,14253,-1178.81,-6130362.44,16801578.93,10671216.49
21000,2011-08-15,1204.49,25.68,2.18,1565.15,-23.04,True,1,14254,-1204.49,-6131566.93,17168800.46,11037233.53
21001,2011-08-16,1192.76,-11.73,-0.97,1565.15,-23.79,True,1,14255,-1192.76,-6132759.69,17002793.8,10870034.11
21002,2011-08-17,1193.89,1.13,0.1,1565.15,-23.72,True,1,14256,-1193.89,-6133953.58,17020095.84,10886142.26
21003,2011-08-18,1140.65,-53.24,-4.46,1565.15,-27.12,True,1,14257,-1140.65,-6135094.23,16262247.05,10127152.82
21004,2011-08-19,1123.53,-17.12,-1.5,1565.15,-28.22,True,1,14258,-1123.53,-6136217.76,16019290.74,9883072.98
21005,2011-08-22,1123.82,0.29,0.03,1565.15,-28.2,True,1,14259,-1123.82,-6137341.58,16024549.38,9887207.8
21006,2011-08-23,1162.35,38.53,3.43,1565.15,-25.74,True,1,14260,-1162.35,-6138503.93,16575111.0,10436607.07
21007,2011-08-24,1177.6,15.25,1.31,1565.15,-24.76,True,1,14261,-1177.6,-6139681.53,16793753.6,10654072.07
21008,2011-08-25,1159.27,-18.33,-1.56,1565.15,-25.93,True,1,14262,-1159.27,-6140840.8,16533508.74,10392667.94
21009,2011-08-26,1176.8,17.53,1.51,1565.15,-24.81,True,1,14263,-1176.8,-6142017.6,16784698.4,10642680.8
21010,2011-08-29,1210.08,33.28,2.83,1565.15,-22.69,True,1,14264,-1210.08,-6143227.68,17260581.12,11117353.44
21011,2011-08-30,1212.92,2.84,0.24,1565.15,-22.5,True,1,14265,-1212.92,-6144440.6,17302303.8,11157863.2
21012,2011-08-31,1218.89,5.97,0.49,1565.15,-22.12,True,1,14266,-1218.89,-6145659.49,17388684.74,11243025.25
21013,2011-09-01,1204.42,-14.47,-1.19,1565.15,-23.05,True,1,14267,-1204.42,-6146863.91,17183460.14,11036596.23
21014,2011-09-02,1173.97,-30.45,-2.53,1565.15,-24.99,True,1,14268,-1173.97,-6148037.88,16750203.96,10602166.08
21015,2011-09-06,1165.24,-8.73,-0.74,1565.15,-25.55,True,1,14269,-1165.24,-6149203.12,16626809.56,10477606.44
21016,2011-09-07,1198.62,33.38,2.86,1565.15,-23.42,True,1,14270,-1198.62,-6150401.74,17104307.4,10953905.66
21017,2011-09-08,1185.9,-12.72,-1.06,1565.15,-24.23,True,1,14271,-1185.9,-6151587.64,16923978.9,10772391.26
21018,2011-09-09,1154.23,-31.67,-2.67,1565.15,-26.25,True,1,14272,-1154.23,-6152741.87,16473170.56,10320428.69
21019,2011-09-12,1162.27,8.04,0.7,1565.15,-25.74,True,1,14273,-1162.27,-6153904.14,16589079.71,10435175.57
21020,2011-09-13,1172.87,10.6,0.91,1565.15,-25.06,True,1,14274,-1172.87,-6155077.01,16741546.38,10586469.37
21021,2011-09-14,1188.68,15.81,1.35,1565.15,-24.05,True,1,14275,-1188.68,-6156265.69,16968407.0,10812141.31
21022,2011-09-15,1209.11,20.43,1.72,1565.15,-22.75,True,1,14276,-1209.11,-6157474.8,17261254.36,11103779.56
21023,2011-09-16,1216.01,6.9,0.57,1565.15,-22.31,True,1,14277,-1216.01,-6158690.81,17360974.77,11202283.96
21024,2011-09-19,1204.09,-11.92,-0.98,1565.15,-23.07,True,1,14278,-1204.09,-6159894.9,17191997.02,11032102.12
21025,2011-09-20,1202.09,-2.0,-0.17,1565.15,-23.2,True,1,14279,-1202.09,-6161096.99,17164643.11,11003546.12
21026,2011-09-21,1166.76,-35.33,-2.94,1565.15,-25.45,True,1,14280,-1166.76,-6162263.75,16661332.8,10499069.05
21027,2011-09-22,1129.56,-37.2,-3.19,1565.15,-27.83,True,1,14281,-1129.56,-6163393.31,16131246.36,9967853.05
21028,2011-09-23,1136.43,6.87,0.61,1565.15,-27.39,True,1,14282,-1136.43,-6164529.74,16230493.26,10065963.52
21029,2011-09-26,1162.95,26.52,2.33,1565.15,-25.7,True,1,14283,-1162.95,-6165692.69,16610414.85,10444722.16
21030,2011-09-27,1175.38,12.43,1.07,1565.15,-24.9,True,1,14284,-1175.38,-6166868.07,16789127.92,10622259.85
21031,2011-09-28,1151.06,-24.32,-2.07,1565.15,-26.46,True,1,14285,-1151.06,-6168019.13,16442892.1,10274872.97
21032,2011-09-29,1160.4,9.34,0.81,1565.15,-25.86,True,1,14286,-1160.4,-6169179.53,16577474.4,10408294.87
21033,2011-09-30,1131.42,-28.98,-2.5,1565.15,-27.71,True,1,14287,-1131.42,-6170310.95,16164597.54,9994286.59
21034,2011-10-03,1099.23,-32.19,-2.84,1565.15,-29.77,True,1,14288,-1099.23,-6171410.18,15705798.24,9534388.06
21035,2011-10-04,1123.95,24.72,2.25,1565.15,-28.19,True,1,14289,-1123.95,-6172534.13,16060121.55,9887587.42
21036,2011-10-05,1144.03,20.08,1.79,1565.15,-26.91,True,1,14290,-1144.03,-6173678.16,16348188.7,10174510.54
21037,2011-10-06,1164.97,20.94,1.83,1565.15,-25.57,True,1,14291,-1164.97,-6174843.13,16648586.27,10473743.14
21038,2011-10-07,1155.46,-9.51,-0.82,1565.15,-26.18,True,1,14292,-1155.46,-6175998.59,16513834.32,10337835.73
21039,2011-10-10,1194.89,39.43,3.41,1565.15,-23.66,True,1,14293,-1194.89,-6177193.48,17078562.77,10901369.29
21040,2011-10-11,1195.54,0.65,0.05,1565.15,-23.62,True,1,14294,-1195.54,-6178389.02,17089048.76,10910659.74
21041,2011-10-12,1207.25,11.71,0.98,1565.15,-22.87,True,1,14295,-1207.25,-6179596.27,17257638.75,11078042.48
21042,2011-10-13,1203.66,-3.59,-0.3,1565.15,-23.1,True,1,14296,-1203.66,-6180799.93,17207523.36,11026723.43
21043,2011-10-14,1224.58,20.92,1.74,1565.15,-21.76,True,1,14297,-1224.58,-6182024.51,17507820.26,11325795.75
21044,2011-10-17,1200.86,-23.72,-1.94,1565.15,-23.28,True,1,14298,-1200.86,-6183225.37,17169896.28,10986670.91
21045,2011-10-18,1225.38,24.52,2.04,1565.15,-21.71,True,1,14299,-1225.38,-6184450.75,17521708.62,11337257.87
21046,2011-10-19,1209.88,-15.5,-1.26,1565.15,-22.7,True,1,14300,-1209.88,-6185660.63,17301284.0,11115623.37
21047,2011-10-20,1215.39,5.51,0.46,1565.15,-22.35,True,1,14301,-1215.39,-6186876.02,17381292.39,11194416.37
21048,2011-10-21,1238.25,22.86,1.88,1565.15,-20.89,True,1,14302,-1238.25,-6188114.27,17709451.5,11521337.23
21049,2011-10-24,1254.19,15.94,1.29,1565.15,-19.87,True,1,14303,-1254.19,-6189368.46,17938679.57,11749311.11
21050,2011-10-25,1229.05,-25.14,-2.0,1565.15,-21.47,True,1,14304,-1229.05,-6190597.51,17580331.2,11389733.69
21051,2011-10-26,1242.0,12.95,1.05,1565.15,-20.65,True,1,14305,-1242.0,-6191839.51,17766810.0,11574970.49
21052,2011-10-27,1284.59,42.59,3.43,1565.15,-17.92,True,1,14306,-1284.59,-6193124.1,18377344.54,12184220.44
21053,2011-10-28,1285.09,0.5,0.04,1565.15,-17.89,True,1,14307,-1285.09,-6194409.19,18385782.63,12191373.44
21054,2011-10-31,1253.3,-31.79,-2.47,1565.15,-19.92,True,1,14308,-1253.3,-6195662.49,17932216.4,11736553.91
21055,2011-11-01,1218.28,-35.02,-2.79,1565.15,-22.16,True,1,14309,-1218.28,-6196880.77,17432368.52,11235487.75
21056,2011-11-02,1237.9,19.62,1.61,1565.15,-20.91,True,1,14310,-1237.9,-6198118.67,17714349.0,11516230.33
21057,2011-11-03,1261.15,23.25,1.88,1565.15,-19.42,True,1,14311,-1261.15,-6199379.82,18048317.65,11848937.83
21058,2011-11-04,1253.23,-7.92,-0.63,1565.15,-19.93,True,1,14312,-1253.23,-6200633.05,17936227.76,11735594.71
21059,2011-11-07,1261.12,7.89,0.63,1565.15,-19.42,True,1,14313,-1261.12,-6201894.17,18050410.56,11848516.39
21060,2011-11-08,1275.92,14.8,1.17,1565.15,-18.48,True,1,14314,-1275.92,-6203170.09,18263518.88,12060348.79
21061,2011-11-09,1229.1,-46.82,-3.67,1565.15,-21.47,True,1,14315,-1229.1,-6204399.19,17594566.5,11390167.31
21062,2011-11-10,1239.7,10.6,0.86,1565.15,-20.79,True,1,14316,-1239.7,-6205638.89,17747545.2,11541906.31
21063,2011-11-11,1263.85,24.15,1.95,1565.15,-19.25,True,1,14317,-1263.85,-6206902.74,18094540.45,11887637.71
21064,2011-11-14,1251.78,-12.07,-0.96,1565.15,-20.02,True,1,14318,-1251.78,-6208154.52,17922986.04,11714831.52
21065,2011-11-15,1257.81,6.03,0.48,1565.15,-19.64,True,1,14319,-1257.81,-6209412.33,18010581.39,11801169.06
21066,2011-11-16,1236.91,-20.9,-1.66,1565.15,-20.97,True,1,14320,-1236.91,-6210649.24,17712551.2,11501901.96
21067,2011-11-17,1216.13,-20.78,-1.68,1565.15,-22.3,True,1,14321,-1216.13,-6211865.37,17416197.73,11204332.36
21068,2011-11-18,1215.65,-0.48,-0.04,1565.15,-22.33,True,1,14322,-1215.65,-6213081.02,17410539.3,11197458.28
21069,2011-11-21,1192.98,-22.67,-1.86,1565.15,-23.78,True,1,14323,-1192.98,-6214274.0,17087052.54,10872778.54
21070,2011-11-22,1188.04,-4.94,-0.41,1565.15,-24.09,True,1,14324,-1188.04,-6215462.04,17017484.96,10802022.92
21071,2011-11-23,1161.79,-26.25,-2.21,1565.15,-25.77,True,1,14325,-1161.79,-6216623.83,16642641.75,10426017.92
21072,2011-11-25,1158.67,-3.12,-0.27,1565.15,-25.97,True,1,14326,-1158.67,-6217782.5,16599106.42,10381323.92
21073,2011-11-28,1192.55,33.88,2.92,1565.15,-23.81,True,1,14327,-1192.55,-6218975.05,17085663.85,10866688.8
21074,2011-11-29,1195.19,2.64,0.22,1565.15,-23.64,True,1,14328,-1195.19,-6220170.24,17124682.32,10904512.08
21075,2011-11-30,1246.96,51.77,4.33,1565.15,-20.33,True,1,14329,-1246.96,-6221417.2,17867689.84,11646272.64
21076,2011-12-01,1244.58,-2.38,-0.19,1565.15,-20.48,True,1,14330,-1244.58,-6222661.78,17834831.4,11612169.62
21077,2011-12-02,1244.28,-0.3,-0.02,1565.15,-20.5,True,1,14331,-1244.28,-6223906.06,17831776.68,11607870.62
21078,2011-12-05,1257.08,12.8,1.03,1565.15,-19.68,True,1,14332,-1257.08,-6225163.14,18016470.56,11791307.42
21079,2011-12-06,1258.47,1.39,0.11,1565.15,-19.59,True,1,14333,-1258.47,-6226421.61,18037650.51,11811228.9
21080,2011-12-07,1261.01,2.54,0.2,1565.15,-19.43,True,1,14334,-1261.01,-6227682.62,18075317.34,11847634.72
21081,2011-12-08,1234.35,-26.66,-2.11,1565.15,-21.14,True,1,14335,-1234.35,-6228916.97,17694407.25,11465490.28
21082,2011-12-09,1255.19,20.84,1.69,1565.15,-19.8,True,1,14336,-1255.19,-6230172.16,17994403.84,11764231.68
21083,2011-12-12,1236.47,-18.72,-1.49,1565.15,-21.0,True,1,14337,-1236.47,-6231408.63,17727270.39,11495861.76
21084,2011-12-13,1225.73,-10.74,-0.87,1565.15,-21.69,True,1,14338,-1225.73,-6232634.36,17574516.74,11341882.38
21085,2011-12-14,1211.82,-13.91,-1.14,1565.15,-22.58,True,1,14339,-1211.82,-6233846.18,17376286.98,11142440.8
21086,2011-12-15,1215.75,3.93,0.32,1565.15,-22.32,True,1,14340,-1215.75,-6235061.93,17433855.0,11198793.07
21087,2011-12-16,1219.66,3.91,0.32,1565.15,-22.07,True,1,14341,-1219.66,-6236281.59,17491144.06,11254862.47
21088,2011-12-19,1205.35,-14.31,-1.17,1565.15,-22.99,True,1,14342,-1205.35,-6237486.94,17287129.7,11049642.76
21089,2011-12-20,1241.3,35.95,2.98,1565.15,-20.69,True,1,14343,-1241.3,-6238728.24,17803965.9,11565237.66
21090,2011-12-21,1243.72,2.42,0.2,1565.15,-20.54,True,1,14344,-1243.72,-6239971.96,17839919.68,11599947.72
21091,2011-12-22,1254.0,10.28,0.83,1565.15,-19.88,True,1,14345,-1254.0,-6241225.96,17988630.0,11747404.04
21092,2011-12-23,1265.33,11.33,0.9,1565.15,-19.16,True,1,14346,-1265.33,-6242491.29,18152424.18,11909932.89
21093,2011-12-27,1265.43,0.1,0.01,1565.15,-19.15,True,1,14347,-1265.43,-6243756.72,18155124.21,11911367.49
21094,2011-12-28,1249.64,-15.79,-1.25,1565.15,-20.16,True,1,14348,-1249.64,-6245006.36,17929834.72,11684828.36
21095,2011-12-29,1263.02,13.38,1.07,1565.15,-19.3,True,1,14349,-1263.02,-6246269.38,18123073.98,11876804.6
21096,2011-12-30,1257.6,-5.42,-0.43,1565.15,-19.65,True,1,14350,-1257.6,-6247526.98,18046560.0,11799033.02
21097,2012-01-03,1277.06,19.46,1.55,1565.15,-18.41,True,1,14351,-1277.06,-6248804.04,18327088.06,12078284.02
21098,2012-01-04,1277.3,0.24,0.02,1565.15,-18.39,True,1,14352,-1277.3,-6250081.34,18331809.6,12081728.26
21099,2012-01-05,1281.06,3.76,0.29,1565.15,-18.15,True,1,14353,-1281.06,-6251362.4,18387054.18,12135691.78
21100,2012-01-06,1277.81,-3.25,-0.25,1565.15,-18.36,True,1,14354,-1277.81,-6252640.21,18341684.74,12089044.53
21101,2012-01-09,1280.7,2.89,0.23,1565.15,-18.17,True,1,14355,-1280.7,-6253920.91,18384448.5,12130527.59
21102,2012-01-10,1292.08,11.38,0.89,1565.15,-17.45,True,1,14356,-1292.08,-6255212.99,18549100.48,12293887.49
21103,2012-01-11,1292.48,0.4,0.03,1565.15,-17.42,True,1,14357,-1292.48,-6256505.47,18556135.36,12299629.89
21104,2012-01-12,1295.5,3.02,0.23,1565.15,-17.23,True,1,14358,-1295.5,-6257800.97,18600789.0,12342988.03
21105,2012-01-13,1289.09,-6.41,-0.5,1565.15,-17.64,True,1,14359,-1289.09,-6259090.06,18510043.31,12250953.25
21106,2012-01-17,1293.67,4.58,0.36,1565.15,-17.34,True,1,14360,-1293.67,-6260383.73,18577101.2,12316717.47
21107,2012-01-18,1308.04,14.37,1.11,1565.15,-16.43,True,1,14361,-1308.04,-6261691.77,18784762.44,12523070.67
21108,2012-01-19,1314.5,6.46,0.49,1565.15,-16.01,True,1,14362,-1314.5,-6263006.27,18878849.0,12615842.73
21109,2012-01-20,1315.38,0.88,0.07,1565.15,-15.96,True,1,14363,-1315.38,-6264321.65,18892802.94,12628481.29
21110,2012-01-23,1316.0,0.62,0.05,1565.15,-15.92,True,1,14364,-1316.0,-6265637.65,18903024.0,12637386.35
21111,2012-01-24,1314.65,-1.35,-0.1,1565.15,-16.0,True,1,14365,-1314.65,-6266952.3,18884947.25,12617994.95
21112,2012-01-25,1326.06,11.41,0.87,1565.15,-15.28,True,1,14366,-1326.06,-6268278.36,19050177.96,12781899.6
21113,2012-01-26,1318.43,-7.63,-0.57,1565.15,-15.76,True,1,14367,-1318.43,-6269596.79,18941883.81,12672287.02
21114,2012-01-27,1316.33,-2.1,-0.16,1565.15,-15.9,True,1,14368,-1316.33,-6270913.12,18913029.44,12642116.32
21115,2012-01-30,1313.01,-3.32,-0.25,1565.15,-16.11,True,1,14369,-1313.01,-6272226.13,18866640.69,12594414.56
21116,2012-01-31,1312.41,-0.6,-0.05,1565.15,-16.15,True,1,14370,-1312.41,-6273538.54,18859331.7,12585793.16
21117,2012-02-01,1324.09,11.68,0.89,1565.15,-15.4,True,1,14371,-1324.09,-6274862.63,19028497.39,12753634.76
21118,2012-02-02,1325.54,1.45,0.11,1565.15,-15.31,True,1,14372,-1325.54,-6276188.17,19050660.88,12774472.71
21119,2012-02-03,1344.9,19.36,1.46,1565.15,-14.07,True,1,14373,-1344.9,-6277533.07,19330247.7,13052714.63
21120,2012-02-06,1344.33,-0.57,-0.04,1565.15,-14.11,True,1,14374,-1344.33,-6278877.4,19323399.42,13044522.02
21121,2012-02-07,1347.05,2.72,0.2,1565.15,-13.94,True,1,14375,-1347.05,-6280224.45,19363843.75,13083619.3
21122,2012-02-08,1349.96,2.91,0.22,1565.15,-13.75,True,1,14376,-1349.96,-6281574.41,19407024.96,13125450.55
21123,2012-02-09,1351.95,1.99,0.15,1565.15,-13.62,True,1,14377,-1351.95,-6282926.36,19436985.15,13154058.79
21124,2012-02-10,1342.64,-9.31,-0.69,1565.15,-14.22,True,1,14378,-1342.64,-6284269.0,19304477.92,13020208.92
21125,2012-02-13,1351.77,9.13,0.68,1565.15,-13.63,True,1,14379,-1351.77,-6285620.77,19437100.83,13151480.06
21126,2012-02-14,1350.5,-1.27,-0.09,1565.15,-13.71,True,1,14380,-1350.5,-6286971.27,19420190.0,13133218.73
21127,2012-02-15,1343.23,-7.27,-0.54,1565.15,-14.18,True,1,14381,-1343.23,-6288314.5,19316990.63,13028676.13
21128,2012-02-16,1358.04,14.81,1.1,1565.15,-13.23,True,1,14382,-1358.04,-6289672.54,19531331.28,13241658.74
21129,2012-02-17,1361.23,3.19,0.24,1565.15,-13.03,True,1,14383,-1361.23,-6291033.77,19578571.09,13287537.32
21130,2012-02-21,1362.21,0.98,0.07,1565.15,-12.97,True,1,14384,-1362.21,-6292395.98,19594028.64,13301632.66
21131,2012-02-22,1357.66,-4.55,-0.33,1565.15,-13.26,True,1,14385,-1357.66,-6293753.64,19529939.1,13236185.46
21132,2012-02-23,1363.46,5.8,0.43,1565.15,-12.89,True,1,14386,-1363.46,-6295117.1,19614735.56,13319618.46
21133,2012-02-24,1365.74,2.28,0.17,1565.15,-12.74,True,1,14387,-1365.74,-6296482.84,19648901.38,13352418.54
21134,2012-02-27,1367.59,1.85,0.14,1565.15,-12.62,True,1,14388,-1367.59,-6297850.43,19676884.92,13379034.49
21135,2012-02-28,1372.18,4.59,0.34,1565.15,-12.33,True,1,14389,-1372.18,-6299222.61,19744298.02,13445075.41
21136,2012-02-29,1365.68,-6.5,-0.47,1565.15,-12.74,True,1,14390,-1365.68,-6300588.29,19652135.2,13351546.91
21137,2012-03-01,1374.09,8.41,0.62,1565.15,-12.21,True,1,14391,-1374.09,-6301962.38,19774529.19,13472566.81
21138,2012-03-02,1369.63,-4.46,-0.32,1565.15,-12.49,True,1,14392,-1369.63,-6303332.01,19711714.96,13408382.95
21139,2012-03-05,1364.33,-5.3,-0.39,1565.15,-12.83,True,1,14393,-1364.33,-6304696.34,19636801.69,13332105.35
21140,2012-03-06,1343.36,-20.97,-1.54,1565.15,-14.17,True,1,14394,-1343.36,-6306039.7,19336323.84,13030284.14
21141,2012-03-07,1352.63,9.27,0.69,1565.15,-13.58,True,1,14395,-1352.63,-6307392.33,19471108.85,13163716.52
21142,2012-03-08,1365.91,13.28,0.98,1565.15,-12.73,True,1,14396,-1365.91,-6308758.24,19663640.36,13354882.12
21143,2012-03-09,1370.87,4.96,0.36,1565.15,-12.41,True,1,14397,-1370.87,-6310129.11,19736415.39,13426286.28
21144,2012-03-12,1371.09,0.22,0.02,1565.15,-12.4,True,1,14398,-1371.09,-6311500.2,19740953.82,13429453.62
21145,2012-03-13,1395.95,24.86,1.81,1565.15,-10.81,True,1,14399,-1395.95,-6312896.15,20100284.05,13787387.9
21146,2012-03-14,1394.28,-1.67,-0.12,1565.15,-10.92,True,1,14400,-1394.28,-6314290.43,20077632.0,13763341.57
21147,2012-03-15,1402.6,8.32,0.6,1565.15,-10.39,True,1,14401,-1402.6,-6315693.03,20198842.6,13883149.57
21148,2012-03-16,1404.17,1.57,0.11,1565.15,-10.28,True,1,14402,-1404.17,-6317097.2,20222856.34,13905759.14
21149,2012-03-19,1409.75,5.58,0.4,1565.15,-9.93,True,1,14403,-1409.75,-6318506.95,20304629.25,13986122.3
21150,2012-03-20,1405.52,-4.23,-0.3,1565.15,-10.2,True,1,14404,-1405.52,-6319912.47,20245110.08,13925197.61
21151,2012-03-21,1402.89,-2.63,-0.19,1565.15,-10.37,True,1,14405,-1402.89,-6321315.36,20208630.45,13887315.09
21152,2012-03-22,1392.78,-10.11,-0.72,1565.15,-11.01,True,1,14406,-1392.78,-6322708.14,20064388.68,13741680.54
21153,2012-03-23,1397.11,4.33,0.31,1565.15,-10.74,True,1,14407,-1397.11,-6324105.25,20128163.77,13804058.52
21154,2012-03-26,1416.51,19.4,1.39,1565.15,-9.5,True,1,14408,-1416.51,-6325521.76,20409076.08,14083554.32
21155,2012-03-27,1412.52,-3.99,-0.28,1565.15,-9.75,True,1,14409,-1412.52,-6326934.28,20353000.68,14026066.4
21156,2012-03-28,1405.54,-6.98,-0.49,1565.15,-10.2,True,1,14410,-1405.54,-6328339.82,20253831.4,13925491.58
21157,2012-03-29,1403.28,-2.26,-0.16,1565.15,-10.34,True,1,14411,-1403.28,-6329743.1,20222668.08,13892924.98
21158,2012-03-30,1408.47,5.19,0.37,1565.15,-10.01,True,1,14412,-1408.47,-6331151.57,20298869.64,13967718.07
21159,2012-04-02,1419.04,10.57,0.75,1565.15,-9.34,True,1,14413,-1419.04,-6332570.61,20452623.52,14120052.91
21160,2012-04-03,1413.38,-5.66,-0.4,1565.15,-9.7,True,1,14414,-1413.38,-6333983.99,20372459.32,14038475.33
21161,2012-04-04,1398.96,-14.42,-1.02,1565.15,-10.62,True,1,14415,-1398.96,-6335382.95,20166008.4,13830625.45
21162,2012-04-05,1398.08,-0.88,-0.06,1565.15,-10.67,True,1,14416,-1398.08,-6336781.03,20154721.28,13817940.25
21163,2012-04-09,1382.2,-15.88,-1.14,1565.15,-11.69,True,1,14417,-1382.2,-6338163.23,19927177.4,13589014.17
21164,2012-04-10,1358.59,-23.61,-1.71,1565.15,-13.2,True,1,14418,-1358.59,-6339521.82,19588150.62,13248628.8
21165,2012-04-11,1368.71,10.12,0.74,1565.15,-12.55,True,1,14419,-1368.71,-6340890.53,19735429.49,13394538.96
21166,2012-04-12,1387.57,18.86,1.38,1565.15,-11.35,True,1,14420,-1387.57,-6342278.1,20008759.4,13666481.3
21167,2012-04-13,1370.26,-17.31,-1.25,1565.15,-12.45,True,1,14421,-1370.26,-6343648.36,19760519.46,13416871.1
21168,2012-04-16,1369.57,-0.69,-0.05,1565.15,-12.5,True,1,14422,-1369.57,-6345017.93,19751938.54,13406920.61
21169,2012-04-17,1390.78,21.21,1.55,1565.15,-11.14,True,1,14423,-1390.78,-6346408.71,20059219.94,13712811.23
21170,2012-04-18,1385.14,-5.64,-0.41,1565.15,-11.5,True,1,14424,-1385.14,-6347793.85,19979259.36,13631465.51
21171,2012-04-19,1376.92,-8.22,-0.59,1565.15,-12.03,True,1,14425,-1376.92,-6349170.77,19862071.0,13512900.23
21172,2012-04-20,1378.53,1.61,0.12,1565.15,-11.92,True,1,14426,-1378.53,-6350549.3,19886673.78,13536124.48
21173,2012-04-23,1366.94,-11.59,-0.84,1565.15,-12.66,True,1,14427,-1366.94,-6351916.24,19720843.38,13368927.14
21174,2012-04-24,1371.97,5.03,0.37,1565.15,-12.34,True,1,14428,-1371.97,-6353288.21,19794783.16,13441494.95
21175,2012-04-25,1390.69,18.72,1.36,1565.15,-11.15,True,1,14429,-1390.69,-6354678.9,20066266.01,13711587.11
21176,2012-04-26,1399.98,9.29,0.67,1565.15,-10.55,True,1,14430,-1399.98,-6356078.88,20201711.4,13845632.52
21177,2012-04-27,1403.36,3.38,0.24,1565.15,-10.34,True,1,14431,-1403.36,-6357482.24,20251888.16,13894405.92
21178,2012-04-30,1397.91,-5.45,-0.39,1565.15,-10.68,True,1,14432,-1397.91,-6358880.15,20174637.12,13815756.97
21179,2012-05-01,1405.82,7.91,0.57,1565.15,-10.18,True,1,14433,-1405.82,-6360285.97,20290200.06,13929914.09
21180,2012-05-02,1402.31,-3.51,-0.25,1565.15,-10.4,True,1,14434,-1402.31,-6361688.28,20240942.54,13879254.26
21181,2012-05-03,1391.57,-10.74,-0.77,1565.15,-11.09,True,1,14435,-1391.57,-6363079.85,20087312.95,13724233.1
21182,2012-05-04,1369.1,-22.47,-1.62,1565.15,-12.53,True,1,14436,-1369.1,-6364448.95,19764327.6,13399878.65
21183,2012-05-07,1369.58,0.48,0.04,1565.15,-12.5,True,1,14437,-1369.58,-6365818.53,19772626.46,13406807.93
21184,2012-05-08,1363.72,-5.86,-0.43,1565.15,-12.87,True,1,14438,-1363.72,-6367182.25,19689389.36,13322207.11
21185,2012-05-09,1354.58,-9.14,-0.67,1565.15,-13.45,True,1,14439,-1354.58,-6368536.83,19558780.62,13190243.79
21186,2012-05-10,1357.99,3.41,0.25,1565.15,-13.24,True,1,14440,-1357.99,-6369894.82,19609375.6,13239480.78
21187,2012-05-11,1353.39,-4.6,-0.34,1565.15,-13.53,True,1,14441,-1353.39,-6371248.21,19544304.99,13173056.78
21188,2012-05-14,1338.35,-15.04,-1.11,1565.15,-14.49,True,1,14442,-1338.35,-6372586.56,19328450.7,12955864.14
21189,2012-05-15,1330.66,-7.69,-0.57,1565.15,-14.98,True,1,14443,-1330.66,-6373917.22,19218722.38,12844805.16
21190,2012-05-16,1324.8,-5.86,-0.44,1565.15,-15.36,True,1,14444,-1324.8,-6375242.02,19135411.2,12760169.18
21191,2012-05-17,1304.86,-19.94,-1.5,1565.15,-16.63,True,1,14445,-1304.86,-6376546.88,18848702.7,12472155.82
21192,2012-05-18,1295.22,-9.64,-0.74,1565.15,-17.25,True,1,14446,-1295.22,-6377842.1,18710748.12,12332906.02
21193,2012-05-21,1315.99,20.77,1.6,1565.15,-15.92,True,1,14447,-1315.99,-6379158.09,19012107.53,12632949.44
21194,2012-05-22,1316.63,0.64,0.05,1565.15,-15.88,True,1,14448,-1316.63,-6380474.72,19022670.24,12642195.52
21195,2012-05-23,1318.86,2.23,0.17,1565.15,-15.74,True,1,14449,-1318.86,-6381793.58,19056208.14,12674414.56
21196,2012-05-24,1320.68,1.82,0.14,1565.15,-15.62,True,1,14450,-1320.68,-6383114.26,19083826.0,12700711.74
21197,2012-05-25,1317.82,-2.86,-0.22,1565.15,-15.8,True,1,14451,-1317.82,-6384432.08,19043816.82,12659384.74
21198,2012-05-29,1332.42,14.6,1.11,1565.15,-14.87,True,1,14452,-1332.42,-6385764.5,19256133.84,12870369.34
21199,2012-05-30,1313.32,-19.1,-1.43,1565.15,-16.09,True,1,14453,-1313.32,-6387077.82,18981413.96,12594336.14
21200,2012-05-31,1310.33,-2.99,-0.23,1565.15,-16.28,True,1,14454,-1310.33,-6388388.15,18939509.82,12551121.67
21201,2012-06-01,1278.04,-32.29,-2.46,1565.15,-18.34,True,1,14455,-1278.04,-6389666.19,18474068.2,12084402.01
21202,2012-06-04,1278.18,0.14,0.01,1565.15,-18.34,True,1,14456,-1278.18,-6390944.37,18477370.08,12086425.71
21203,2012-06-05,1285.5,7.32,0.57,1565.15,-17.87,True,1,14457,-1285.5,-6392229.87,18584473.5,12192243.63
21204,2012-06-06,1315.13,29.63,2.31,1565.15,-15.97,True,1,14458,-1315.13,-6393545.0,19014149.54,12620604.54
21205,2012-06-07,1314.99,-0.14,-0.01,1565.15,-15.98,True,1,14459,-1314.99,-6394859.99,19013440.41,12618580.42
21206,2012-06-08,1325.66,10.67,0.81,1565.15,-15.3,True,1,14460,-1325.66,-6396185.65,19169043.6,12772857.95
21207,2012-06-11,1308.93,-16.73,-1.26,1565.15,-16.37,True,1,14461,-1308.93,-6397494.58,18928436.73,12530942.15
21208,2012-06-12,1324.18,15.25,1.16,1565.15,-15.4,True,1,14462,-1324.18,-6398818.76,19150291.16,12751472.4
21209,2012-06-13,1314.88,-9.3,-0.7,1565.15,-15.99,True,1,14463,-1314.88,-6400133.64,19017109.44,12616975.8
21210,2012-06-14,1329.1,14.22,1.08,1565.15,-15.08,True,1,14464,-1329.1,-6401462.74,19224102.4,12822639.66
21211,2012-06-15,1342.84,13.74,1.03,1565.15,-14.2,True,1,14465,-1342.84,-6402805.58,19424180.6,13021375.02
21212,2012-06-18,1344.78,1.94,0.14,1565.15,-14.08,True,1,14466,-1344.78,-6404150.36,19453587.48,13049437.12
21213,2012-06-19,1357.98,13.2,0.98,1565.15,-13.24,True,1,14467,-1357.98,-6405508.34,19645896.66,13240388.32
21214,2012-06-20,1355.69,-2.29,-0.17,1565.15,-13.38,True,1,14468,-1355.69,-6406864.03,19614122.92,13207258.89
21215,2012-06-21,1325.51,-30.18,-2.23,1565.15,-15.31,True,1,14469,-1325.51,-6408189.54,19178804.19,12770614.65
21216,2012-06-22,1335.02,9.51,0.72,1565.15,-14.7,True,1,14470,-1335.02,-6409524.56,19317739.4,12908214.84
21217,2012-06-25,1313.72,-21.3,-1.6,1565.15,-16.06,True,1,14471,-1313.72,-6410838.28,19010842.12,12600003.84
21218,2012-06-26,1319.99,6.27,0.48,1565.15,-15.66,True,1,14472,-1319.99,-6412158.27,19102895.28,12690737.01
21219,2012-06-27,1331.85,11.86,0.9,1565.15,-14.91,True,1,14473,-1331.85,-6413490.12,19275865.05,12862374.93
21220,2012-06-28,1329.04,-2.81,-0.21,1565.15,-15.08,True,1,14474,-1329.04,-6414819.16,19236524.96,12821705.8
21221,2012-06-29,1362.16,33.12,2.49,1565.15,-12.97,True,1,14475,-1362.16,-6416181.32,19717266.0,13301084.68
21222,2012-07-02,1365.51,3.35,0.25,1565.15,-12.76,True,1,14476,-1365.51,-6417546.83,19767122.76,13349575.93
21223,2012-07-03,1374.02,8.51,0.62,1565.15,-12.21,True,1,14477,-1374.02,-6418920.85,19891687.54,13472766.69
21224,2012-07-05,1367.58,-6.44,-0.47,1565.15,-12.62,True,1,14478,-1367.58,-6420288.43,19799823.24,13379534.81
21225,2012-07-06,1354.68,-12.9,-0.94,1565.15,-13.45,True,1,14479,-1354.68,-6421643.11,19614411.72,13192768.61
21226,2012-07-09,1352.46,-2.22,-0.16,1565.15,-13.59,True,1,14480,-1352.46,-6422995.57,19583620.8,13160625.23
21227,2012-07-10,1341.47,-10.99,-0.81,1565.15,-14.29,True,1,14481,-1341.47,-6424337.04,19425827.07,13001490.03
21228,2012-07-11,1341.45,-0.02,-0.0,1565.15,-14.29,True,1,14482,-1341.45,-6425678.49,19426878.9,13001200.41
21229,2012-07-12,1334.76,-6.69,-0.5,1565.15,-14.72,True,1,14483,-1334.76,-6427013.25,19331329.08,12904315.83
21230,2012-07-13,1356.78,22.02,1.65,1565.15,-13.31,True,1,14484,-1356.78,-6428370.03,19651601.52,13223231.49
21231,2012-07-16,1353.64,-3.14,-0.23,1565.15,-13.51,True,1,14485,-1353.64,-6429723.67,19607475.4,13177751.73
21232,2012-07-17,1363.67,10.03,0.74,1565.15,-12.87,True,1,14486,-1363.67,-6431087.34,19754123.62,13323036.28
21233,2012-07-18,1372.78,9.11,0.67,1565.15,-12.29,True,1,14487,-1372.78,-6432460.12,19887463.86,13455003.74
21234,2012-07-19,1376.51,3.73,0.27,1565.15,-12.05,True,1,14488,-1376.51,-6433836.63,19942876.88,13509040.25
21235,2012-07-20,1362.66,-13.85,-1.01,1565.15,-12.94,True,1,14489,-1362.66,-6435199.29,19743580.74,13308381.45
21236,2012-07-23,1350.52,-12.14,-0.89,1565.15,-13.71,True,1,14490,-1350.52,-6436549.81,19569034.8,13132484.99
21237,2012-07-24,1338.31,-12.21,-0.9,1565.15,-14.49,True,1,14491,-1338.31,-6437888.12,19393450.21,12955562.09
21238,2012-07-25,1337.89,-0.42,-0.03,1565.15,-14.52,True,1,14492,-1337.89,-6439226.01,19388701.88,12949475.87
21239,2012-07-26,1360.02,22.13,1.65,1565.15,-13.11,True,1,14493,-1360.02,-6440586.03,19710769.86,13270183.83
21240,2012-07-27,1385.97,25.95,1.91,1565.15,-11.45,True,1,14494,-1385.97,-6441972.0,20088249.18,13646277.18
21241,2012-07-30,1385.3,-0.67,-0.05,1565.15,-11.49,True,1,14495,-1385.3,-6443357.3,20079923.5,13636566.2
21242,2012-07-31,1379.32,-5.98,-0.43,1565.15,-11.87,True,1,14496,-1379.32,-6444736.62,19994622.72,13549886.1
21243,2012-08-01,1375.32,-4.0,-0.29,1565.15,-12.13,True,1,14497,-1375.32,-6446111.94,19938014.04,13491902.1
21244,2012-08-02,1365.0,-10.32,-0.75,1565.15,-12.79,True,1,14498,-1365.0,-6447476.94,19789770.0,13342293.06
21245,2012-08-03,1390.99,25.99,1.9,1565.15,-11.13,True,1,14499,-1390.99,-6448867.93,20167964.01,13719096.08
21246,2012-08-06,1394.23,3.24,0.23,1565.15,-10.92,True,1,14500,-1394.23,-6450262.16,20216335.0,13766072.84
21247,2012-08-07,1401.35,7.12,0.51,1565.15,-10.46,True,1,14501,-1401.35,-6451663.51,20320976.35,13869312.84
21248,2012-08-08,1402.22,0.87,0.06,1565.15,-10.41,True,1,14502,-1402.22,-6453065.73,20334994.44,13881928.71
21249,2012-08-09,1402.8,0.58,0.04,1565.15,-10.37,True,1,14503,-1402.8,-6454468.53,20344808.4,13890339.87
21250,2012-08-10,1405.87,3.07,0.22,1565.15,-10.18,True,1,14504,-1405.87,-6455874.4,20390738.48,13934864.08
21251,2012-08-13,1404.11,-1.76,-0.12,1565.15,-10.29,True,1,14505,-1404.11,-6457278.51,20366615.55,13909337.04
21252,2012-08-14,1403.93,-0.18,-0.01,1565.15,-10.3,True,1,14506,-1403.93,-6458682.44,20365408.58,13906726.14
21253,2012-08-15,1405.53,1.6,0.11,1565.15,-10.2,True,1,14507,-1405.53,-6460087.97,20390023.71,13929935.74
21254,2012-08-16,1415.51,9.98,0.71,1565.15,-9.56,True,1,14508,-1415.51,-6461503.48,20536219.08,14074715.6
21255,2012-08-17,1418.16,2.65,0.19,1565.15,-9.39,True,1,14509,-1418.16,-6462921.64,20576083.44,14113161.8
21256,2012-08-20,1418.13,-0.03,-0.0,1565.15,-9.39,True,1,14510,-1418.13,-6464339.77,20577066.3,14112726.53
21257,2012-08-21,1413.17,-4.96,-0.35,1565.15,-9.71,True,1,14511,-1413.17,-6465752.94,20506509.87,14040756.93
21258,2012-08-22,1413.49,0.32,0.02,1565.15,-9.69,True,1,14512,-1413.49,-6467166.43,20512566.88,14045400.45
21259,2012-08-23,1402.08,-11.41,-0.81,1565.15,-10.42,True,1,14513,-1402.08,-6468568.51,20348387.04,13879818.53
21260,2012-08-24,1411.13,9.05,0.64,1565.15,-9.84,True,1,14514,-1411.13,-6469979.64,20481140.82,14011161.18
21261,2012-08-27,1410.44,-0.69,-0.05,1565.15,-9.88,True,1,14515,-1410.44,-6471390.08,20472536.6,14001146.52
21262,2012-08-28,1409.3,-1.14,-0.08,1565.15,-9.96,True,1,14516,-1409.3,-6472799.38,20457398.8,13984599.42
21263,2012-08-29,1410.49,1.19,0.08,1565.15,-9.88,True,1,14517,-1410.49,-6474209.87,20476083.33,14001873.46
21264,2012-08-30,1399.48,-11.01,-0.78,1565.15,-10.58,True,1,14518,-1399.48,-6475609.35,20317650.64,13842041.29
21265,2012-08-31,1406.58,7.1,0.51,1565.15,-10.13,True,1,14519,-1406.58,-6477015.93,20422135.02,13945119.09
21266,2012-09-04,1404.94,-1.64,-0.12,1565.15,-10.24,True,1,14520,-1404.94,-6478420.87,20399728.8,13921307.93
21267,2012-09-05,1403.44,-1.5,-0.11,1565.15,-10.33,True,1,14521,-1403.44,-6479824.31,20379352.24,13899527.93
21268,2012-09-06,1432.12,28.68,2.04,1565.15,-8.5,True,1,14522,-1432.12,-6481256.43,20797246.64,14315990.21
21269,2012-09-07,1437.92,5.8,0.4,1565.15,-8.13,True,1,14523,-1437.92,-6482694.35,20882912.16,14400217.81
21270,2012-09-10,1429.08,-8.84,-0.62,1565.15,-8.69,True,1,14524,-1429.08,-6484123.43,20755957.92,14271834.49
21271,2012-09-11,1433.56,4.48,0.31,1565.15,-8.41,True,1,14525,-1433.56,-6485556.99,20822459.0,14336902.01
21272,2012-09-12,1436.56,3.0,0.21,1565.15,-8.22,True,1,14526,-1436.56,-6486993.55,20867470.56,14380477.01
21273,2012-09-13,1459.99,23.43,1.63,1565.15,-6.72,True,1,14527,-1459.99,-6488453.54,21209274.73,14720821.19
21274,2012-09-14,1465.77,5.78,0.4,1565.15,-6.35,True,1,14528,-1465.77,-6489919.31,21294706.56,14804787.25
21275,2012-09-17,1461.19,-4.58,-0.31,1565.15,-6.64,True,1,14529,-1461.19,-6491380.5,21229629.51,14738249.01
21276,2012-09-18,1459.32,-1.87,-0.13,1565.15,-6.76,True,1,14530,-1459.32,-6492839.82,21203919.6,14711079.78
21277,2012-09-19,1461.05,1.73,0.12,1565.15,-6.65,True,1,14531,-1461.05,-6494300.87,21230517.55,14736216.68
21278,2012-09-20,1460.26,-0.79,-0.05,1565.15,-6.7,True,1,14532,-1460.26,-6495761.13,21220498.32,14724737.19
21279,2012-09-21,1460.15,-0.11,-0.01,1565.15,-6.71,True,1,14533,-1460.15,-6497221.28,21220359.95,14723138.67
21280,2012-09-24,1456.89,-3.26,-0.22,1565.15,-6.92,True,1,14534,-1456.89,-6498678.17,21174439.26,14675761.09
21281,2012-09-25,1441.59,-15.3,-1.05,1565.15,-7.89,True,1,14535,-1441.59,-6500119.76,20953510.65,14453390.89
21282,2012-09-26,1433.32,-8.27,-0.57,1565.15,-8.42,True,1,14536,-1433.32,-6501553.08,20834739.52,14333186.44
21283,2012-09-27,1447.15,13.83,0.96,1565.15,-7.54,True,1,14537,-1447.15,-6503000.23,21037219.55,14534219.32
21284,2012-09-28,1440.67,-6.48,-0.45,1565.15,-7.95,True,1,14538,-1440.67,-6504440.9,20944460.46,14440019.56
21285,2012-10-01,1444.49,3.82,0.26,1565.15,-7.71,True,1,14539,-1444.49,-6505885.39,21001440.11,14495554.72
21286,2012-10-02,1445.75,1.26,0.09,1565.15,-7.63,True,1,14540,-1445.75,-6507331.14,21021205.0,14513873.86
21287,2012-10-03,1450.99,5.24,0.36,1565.15,-7.29,True,1,14541,-1450.99,-6508782.13,21098845.59,14590063.46
21288,2012-10-04,1461.4,10.41,0.72,1565.15,-6.63,True,1,14542,-1461.4,-6510243.53,21251678.8,14741435.27
21289,2012-10-05,1460.93,-0.47,-0.03,1565.15,-6.66,True,1,14543,-1460.93,-6511704.46,21246304.99,14734600.53
21290,2012-10-08,1455.88,-5.05,-0.35,1565.15,-6.98,True,1,14544,-1455.88,-6513160.34,21174318.72,14661158.38
21291,2012-10-09,1441.48,-14.4,-0.99,1565.15,-7.9,True,1,14545,-1441.48,-6514601.82,20966326.6,14451724.78
21292,2012-10-10,1432.56,-8.92,-0.62,1565.15,-8.47,True,1,14546,-1432.56,-6516034.38,20838017.76,14321983.38
21293,2012-10-11,1432.84,0.28,0.02,1565.15,-8.45,True,1,14547,-1432.84,-6517467.22,20843523.48,14326056.26
21294,2012-10-12,1428.59,-4.25,-0.3,1565.15,-8.72,True,1,14548,-1428.59,-6518895.81,20783127.32,14264231.51
21295,2012-10-15,1440.13,11.54,0.81,1565.15,-7.99,True,1,14549,-1440.13,-6520335.94,20952451.37,14432115.43
21296,2012-10-16,1454.92,14.79,1.03,1565.15,-7.04,True,1,14550,-1454.92,-6521790.86,21169086.0,14647295.14
21297,2012-10-17,1460.91,5.99,0.41,1565.15,-6.66,True,1,14551,-1460.91,-6523251.77,21257701.41,14734449.64
21298,2012-10-18,1457.34,-3.57,-0.24,1565.15,-6.89,True,1,14552,-1457.34,-6524709.11,21207211.68,14682502.57
21299,2012-10-19,1433.19,-24.15,-1.66,1565.15,-8.43,True,1,14553,-1433.19,-6526142.3,20857214.07,14331071.77
21300,2012-10-22,1433.82,0.63,0.04,1565.15,-8.39,True,1,14554,-1433.82,-6527576.12,20867816.28,14340240.16
21301,2012-10-23,1413.11,-20.71,-1.44,1565.15,-9.71,True,1,14555,-1413.11,-6528989.23,20567816.05,14038826.82
21302,2012-10-24,1408.75,-4.36,-0.31,1565.15,-9.99,True,1,14556,-1408.75,-6530397.98,20505765.0,13975367.02
21303,2012-10-25,1412.97,4.22,0.3,1565.15,-9.72,True,1,14557,-1412.97,-6531810.95,20568604.29,14036793.34
21304,2012-10-26,1411.94,-1.03,-0.07,1565.15,-9.79,True,1,14558,-1411.94,-6533222.89,20555022.52,14021799.63
21305,2012-10-31,1412.16,0.22,0.02,1565.15,-9.78,True,1,14559,-1412.16,-6534635.05,20559637.44,14025002.39
21306,2012-11-01,1427.59,15.43,1.09,1565.15,-8.79,True,1,14560,-1427.59,-6536062.64,20785710.4,14249647.76
21307,2012-11-02,1414.2,-13.39,-0.94,1565.15,-9.64,True,1,14561,-1414.2,-6537476.84,20592166.2,14054689.36
21308,2012-11-05,1417.26,3.06,0.22,1565.15,-9.45,True,1,14562,-1417.26,-6538894.1,20638140.12,14099246.02
21309,2012-11-06,1428.39,11.13,0.78,1565.15,-8.74,True,1,14563,-1428.39,-6540322.49,20801643.57,14261321.08
21310,2012-11-07,1394.53,-33.86,-2.37,1565.15,-10.9,True,1,14564,-1394.53,-6541717.02,20309934.92,13768217.9
21311,2012-11-08,1377.51,-17.02,-1.22,1565.15,-11.99,True,1,14565,-1377.51,-6543094.53,20063433.15,13520338.62
21312,2012-11-09,1379.85,2.34,0.17,1565.15,-11.84,True,1,14566,-1379.85,-6544474.38,20098895.1,13554420.72
21313,2012-11-12,1380.03,0.18,0.01,1565.15,-11.83,True,1,14567,-1380.03,-6545854.41,20102897.01,13557042.6
21314,2012-11-13,1374.53,-5.5,-0.4,1565.15,-12.18,True,1,14568,-1374.53,-6547228.94,20024153.04,13476924.1
21315,2012-11-14,1355.49,-19.04,-1.38,1565.15,-13.4,True,1,14569,-1355.49,-6548584.43,19748133.81,13199549.38
21316,2012-11-15,1353.33,-2.16,-0.16,1565.15,-13.53,True,1,14570,-1353.33,-6549937.76,19718018.1,13168080.34
21317,2012-11-16,1359.88,6.55,0.48,1565.15,-13.12,True,1,14571,-1359.88,-6551297.64,19814811.48,13263513.84
21318,2012-11-19,1386.89,27.01,1.99,1565.15,-11.39,True,1,14572,-1386.89,-6552684.53,20209761.08,13657076.55
21319,2012-11-20,1387.81,0.92,0.07,1565.15,-11.33,True,1,14573,-1387.81,-6554072.34,20224555.13,13670482.79
21320,2012-11-21,1391.03,3.22,0.23,1565.15,-11.12,True,1,14574,-1391.03,-6555463.37,20272871.22,13717407.85
21321,2012-11-23,1409.15,18.12,1.3,1565.15,-9.97,True,1,14575,-1409.15,-6556872.52,20538361.25,13981488.73
21322,2012-11-26,1406.29,-2.86,-0.2,1565.15,-10.15,True,1,14576,-1406.29,-6558278.81,20498083.04,13939804.23
21323,2012-11-27,1398.94,-7.35,-0.52,1565.15,-10.62,True,1,14577,-1398.94,-6559677.75,20392348.38,13832670.63
21324,2012-11-28,1409.93,10.99,0.79,1565.15,-9.92,True,1,14578,-1409.93,-6561087.68,20553959.54,13992871.86
21325,2012-11-29,1415.95,6.02,0.43,1565.15,-9.53,True,1,14579,-1415.95,-6562503.63,20643135.05,14080631.42
21326,2012-11-30,1416.18,0.23,0.02,1565.15,-9.52,True,1,14580,-1416.18,-6563919.81,20647904.4,14083984.59
21327,2012-12-03,1409.46,-6.72,-0.48,1565.15,-9.95,True,1,14581,-1409.46,-6565329.27,20551336.26,13986006.99
21328,2012-12-04,1407.05,-2.41,-0.17,1565.15,-10.1,True,1,14582,-1407.05,-6566736.32,20517603.1,13950866.78
21329,2012-12-05,1409.28,2.23,0.16,1565.15,-9.96,True,1,14583,-1409.28,-6568145.6,20551530.24,13983384.64
21330,2012-12-06,1413.94,4.66,0.33,1565.15,-9.66,True,1,14584,-1413.94,-6569559.54,20620900.96,14051341.42
21331,2012-12-07,1418.07,4.13,0.29,1565.15,-9.4,True,1,14585,-1418.07,-6570977.61,20682550.95,14111573.34
21332,2012-12-10,1418.55,0.48,0.03,1565.15,-9.37,True,1,14586,-1418.55,-6572396.16,20690970.3,14118574.14
21333,2012-12-11,1427.84,9.29,0.66,1565.15,-8.77,True,1,14587,-1427.84,-6573824.0,20827902.08,14254078.08
21334,2012-12-12,1428.48,0.64,0.04,1565.15,-8.73,True,1,14588,-1428.48,-6575252.48,20838666.24,14263413.76
21335,2012-12-13,1419.45,-9.03,-0.63,1565.15,-9.31,True,1,14589,-1419.45,-6576671.93,20708356.05,14131684.12
21336,2012-12-14,1413.58,-5.87,-0.41,1565.15,-9.68,True,1,14590,-1413.58,-6578085.51,20624132.2,14046046.69
21337,2012-12-17,1430.36,16.78,1.19,1565.15,-8.61,True,1,14591,-1430.36,-6579515.87,20870382.76,14290866.89
21338,2012-12-18,1446.79,16.43,1.15,1565.15,-7.56,True,1,14592,-1446.79,-6580962.66,21111559.68,14530597.02
21339,2012-12-19,1435.81,-10.98,-0.76,1565.15,-8.26,True,1,14593,-1435.81,-6582398.47,20952775.33,14370376.86
21340,2012-12-20,1443.69,7.88,0.55,1565.15,-7.76,True,1,14594,-1443.69,-6583842.16,21069211.86,14485369.7
21341,2012-12-21,1430.15,-13.54,-0.94,1565.15,-8.62,True,1,14595,-1430.15,-6585272.31,20873039.25,14287766.94
21342,2012-12-24,1426.66,-3.49,-0.24,1565.15,-8.85,True,1,14596,-1426.66,-6586698.97,20823529.36,14236830.39
21343,2012-12-26,1419.83,-6.83,-0.48,1565.15,-9.28,True,1,14597,-1419.83,-6588118.8,20725258.51,14137139.71
21344,2012-12-27,1418.1,-1.73,-0.12,1565.15,-9.4,True,1,14598,-1418.1,-6589536.9,20701423.8,14111886.9
21345,2012-12-28,1402.43,-15.67,-1.1,1565.15,-10.4,True,1,14599,-1402.43,-6590939.33,20474075.57,13883136.24
21346,2012-12-31,1426.19,23.76,1.69,1565.15,-8.88,True,1,14600,-1426.19,-6592365.52,20822374.0,14230008.48
21347,2013-01-02,1462.42,36.23,2.54,1565.15,-6.56,True,1,14601,-1462.42,-6593827.94,21352794.42,14758966.48
21348,2013-01-03,1459.37,-3.05,-0.21,1565.15,-6.76,True,1,14602,-1459.37,-6595287.31,21309720.74,14714433.43
21349,2013-01-04,1466.47,7.1,0.49,1565.15,-6.3,True,1,14603,-1466.47,-6596753.78,21414861.41,14818107.63
21350,2013-01-07,1461.89,-4.58,-0.31,1565.15,-6.6,True,1,14604,-1461.89,-6598215.67,21349441.56,14751225.89
21351,2013-01-08,1457.15,-4.74,-0.32,1565.15,-6.9,True,1,14605,-1457.15,-6599672.82,21281675.75,14682002.93
21352,2013-01-09,1461.02,3.87,0.27,1565.15,-6.65,True,1,14606,-1461.02,-6601133.84,21339658.12,14738524.28
21353,2013-01-10,1472.12,11.1,0.76,1565.15,-5.94,True,1,14607,-1472.12,-6602605.96,21503256.84,14900650.88
21354,2013-01-11,1472.05,-0.07,-0.0,1565.15,-5.95,True,1,14608,-1472.05,-6604078.01,21503706.4,14899628.39
21355,2013-01-14,1470.68,-1.37,-0.09,1565.15,-6.04,True,1,14609,-1470.68,-6605548.69,21485164.12,14879615.43
21356,2013-01-15,1472.34,1.66,0.11,1565.15,-5.93,True,1,14610,-1472.34,-6607021.03,21510887.4,14903866.37
21357,2013-01-16,1472.63,0.29,0.02,1565.15,-5.91,True,1,14611,-1472.63,-6608493.66,21516596.93,14908103.27
21358,2013-01-17,1480.94,8.31,0.56,1565.15,-5.38,True,1,14612,-1480.94,-6609974.6,21639495.28,15029520.68
21359,2013-01-18,1485.98,5.04,0.34,1565.15,-5.06,True,1,14613,-1485.98,-6611460.58,21714625.74,15103165.16
21360,2013-01-22,1492.56,6.58,0.44,1565.15,-4.64,True,1,14614,-1492.56,-6612953.14,21812271.84,15199318.7
21361,2013-01-23,1494.81,2.25,0.15,1565.15,-4.49,True,1,14615,-1494.81,-6614447.95,21846648.15,15232200.2
21362,2013-01-24,1494.82,0.01,0.0,1565.15,-4.49,True,1,14616,-1494.82,-6615942.77,21848289.12,15232346.35
21363,2013-01-25,1502.96,8.14,0.55,1565.15,-3.97,True,1,14617,-1502.96,-6617445.73,21968766.32,15351320.59
21364,2013-01-28,1500.18,-2.78,-0.18,1565.15,-4.15,True,1,14618,-1500.18,-6618945.91,21929631.24,15310685.33
21365,2013-01-29,1507.84,7.66,0.51,1565.15,-3.66,True,1,14619,-1507.84,-6620453.75,22043112.96,15422659.21
21366,2013-01-30,1501.96,-5.88,-0.39,1565.15,-4.04,True,1,14620,-1501.96,-6621955.71,21958655.2,15336699.49
21367,2013-01-31,1498.11,-3.85,-0.26,1565.15,-4.28,True,1,14621,-1498.11,-6623453.82,21903866.31,15280412.49
21368,2013-02-01,1513.17,15.06,1.0,1565.15,-3.32,True,1,14622,-1513.17,-6624966.99,22125571.74,15500604.75
21369,2013-02-04,1495.71,-17.46,-1.15,1565.15,-4.44,True,1,14623,-1495.71,-6626462.7,21871767.33,15245304.63
21370,2013-02-05,1511.29,15.58,1.04,1565.15,-3.44,True,1,14624,-1511.29,-6627973.99,22101104.96,15473130.97
21371,2013-02-06,1512.12,0.83,0.06,1565.15,-3.39,True,1,14625,-1512.12,-6629486.11,22114755.0,15485268.89
21372,2013-02-07,1509.39,-2.73,-0.18,1565.15,-3.56,True,1,14626,-1509.39,-6630995.5,22076338.14,15445342.64
21373,2013-02-08,1517.93,8.54,0.57,1565.15,-3.02,True,1,14627,-1517.93,-6632513.43,22202762.11,15570248.68
21374,2013-02-11,1517.01,-0.92,-0.06,1565.15,-3.08,True,1,14628,-1517.01,-6634030.44,22190822.28,15556791.84
21375,2013-02-12,1519.43,2.42,0.16,1565.15,-2.92,True,1,14629,-1519.43,-6635549.87,22227741.47,15592191.6
21376,2013-02-13,1520.33,0.9,0.06,1565.15,-2.86,True,1,14630,-1520.33,-6637070.2,22242427.9,15605357.7
21377,2013-02-14,1521.38,1.05,0.07,1565.15,-2.8,True,1,14631,-1521.38,-6638591.58,22259310.78,15620719.2
21378,2013-02-15,1519.79,-1.59,-0.1,1565.15,-2.9,True,1,14632,-1519.79,-6640111.37,22237567.28,15597455.91
21379,2013-02-19,1530.94,11.15,0.73,1565.15,-2.19,True,1,14633,-1530.94,-6641642.31,22402245.02,15760602.71
21380,2013-02-20,1511.95,-18.99,-1.24,1565.15,-3.4,True,1,14634,-1511.95,-6643154.26,22125876.3,15482722.04
21381,2013-02-21,1502.42,-9.53,-0.63,1565.15,-4.01,True,1,14635,-1502.42,-6644656.68,21987916.7,15343260.02
21382,2013-02-22,1515.6,13.18,0.88,1565.15,-3.17,True,1,14636,-1515.6,-6646172.28,22182321.6,15536149.32
21383,2013-02-25,1487.85,-27.75,-1.83,1565.15,-4.94,True,1,14637,-1487.85,-6647660.13,21777660.45,15130000.32
21384,2013-02-26,1496.94,9.09,0.61,1565.15,-4.36,True,1,14638,-1496.94,-6649157.07,21912207.72,15263050.65
21385,2013-02-27,1515.99,19.05,1.27,1565.15,-3.14,True,1,14639,-1515.99,-6650673.06,22192577.61,15541904.55
21386,2013-02-28,1514.68,-1.31,-0.09,1565.15,-3.22,True,1,14640,-1514.68,-6652187.74,22174915.2,15522727.46
21387,2013-03-01,1518.2,3.52,0.23,1565.15,-3.0,True,1,14641,-1518.2,-6653705.94,22227966.2,15574260.26
21388,2013-03-04,1525.2,7.0,0.46,1565.15,-2.55,True,1,14642,-1525.2,-6655231.14,22331978.4,15676747.26
21389,2013-03-05,1539.79,14.59,0.96,1565.15,-1.62,True,1,14643,-1539.79,-6656770.93,22547144.97,15890374.04
21390,2013-03-06,1541.46,1.67,0.11,1565.15,-1.51,True,1,14644,-1541.46,-6658312.39,22573140.24,15914827.85
21391,2013-03-07,1544.26,2.8,0.18,1565.15,-1.34,True,1,14645,-1544.26,-6659856.65,22615687.7,15955831.05
21392,2013-03-08,1551.18,6.92,0.45,1565.15,-0.89,True,1,14646,-1551.18,-6661407.83,22718582.28,16057174.45
21393,2013-03-11,1556.22,5.04,0.32,1565.15,-0.57,True,1,14647,-1556.22,-6662964.05,22793954.34,16130990.29
21394,2013-03-12,1552.48,-3.74,-0.24,1565.15,-0.81,True,1,14648,-1552.48,-6664516.53,22740727.04,16076210.51
21395,2013-03-13,1554.52,2.04,0.13,1565.15,-0.68,True,1,14649,-1554.52,-6666071.05,22772163.48,16106092.43
21396,2013-03-14,1563.23,8.71,0.56,1565.15,-0.12,True,1,14650,-1563.23,-6667634.28,22901319.5,16233685.22
21397,2013-03-15,1560.7,-2.53,-0.16,1565.15,-0.28,True,1,14651,-1560.7,-6669194.98,22865815.7,16196620.72
21398,2013-03-18,1552.1,-8.6,-0.55,1565.15,-0.83,True,1,14652,-1552.1,-6670747.08,22741369.2,16070622.12
21399,2013-03-19,1548.34,-3.76,-0.24,1565.15,-1.07,True,1,14653,-1548.34,-6672295.42,22687826.02,16015530.6
21400,2013-03-20,1558.71,10.37,0.67,1565.15,-0.41,True,1,14654,-1558.71,-6673854.13,22841336.34,16167482.21
21401,2013-03-21,1545.8,-12.91,-0.83,1565.15,-1.24,True,1,14655,-1545.8,-6675399.93,22653699.0,15978299.07
21402,2013-03-22,1556.89,11.09,0.72,1565.15,-0.53,True,1,14656,-1556.89,-6676956.82,22817779.84,16140823.02
21403,2013-03-25,1551.69,-5.2,-0.33,1565.15,-0.86,True,1,14657,-1551.69,-6678508.51,22743120.33,16064611.82
21404,2013-03-26,1563.77,12.08,0.78,1565.15,-0.09,True,1,14658,-1563.77,-6680072.28,22921740.66,16241668.38
21405,2013-03-27,1562.85,-0.92,-0.06,1565.15,-0.15,True,1,14659,-1562.85,-6681635.13,22909818.15,16228183.02
21406,2013-03-28,1569.19,6.34,0.41,1569.19,0.0,True,1,14660,-1569.19,-6683204.32,23004325.4,16321121.08
21407,2013-04-01,1562.17,-7.02,-0.45,1569.19,-0.45,True,1,14661,-1562.17,-6684766.49,22902974.37,16218207.88
21408,2013-04-02,1570.25,8.08,0.52,1570.25,0.0,True,1,14662,-1570.25,-6686336.74,23023005.5,16336668.76
21409,2013-04-03,1553.69,-16.56,-1.06,1570.25,-1.06,True,1,14663,-1553.69,-6687890.43,22781756.47,16093866.04
21410,2013-04-04,1559.98,6.29,0.4,1570.25,-0.65,True,1,14664,-1559.98,-6689450.41,22875546.72,16186096.31
21411,2013-04-05,1553.28,-6.7,-0.43,1570.25,-1.08,True,1,14665,-1553.28,-6691003.69,22778851.2,16087847.51
21412,2013-04-08,1563.07,9.79,0.63,1570.25,-0.46,True,1,14666,-1563.07,-6692566.76,22923984.62,16231417.86
21413,2013-04-09,1568.61,5.54,0.35,1570.25,-0.1,True,1,14667,-1568.61,-6694135.37,23006802.87,16312667.5
21414,2013-04-10,1587.73,19.12,1.22,1587.73,0.0,True,1,14668,-1587.73,-6695723.1,23288823.64,16593100.54
21415,2013-04-11,1593.37,5.64,0.36,1593.37,0.0,True,1,14669,-1593.37,-6697316.47,23373144.53,16675828.06
21416,2013-04-12,1588.85,-4.52,-0.28,1593.37,-0.28,True,1,14670,-1588.85,-6698905.32,23308429.5,16609524.18
21417,2013-04-15,1552.36,-36.49,-2.3,1593.37,-2.57,True,1,14671,-1552.36,-6700457.68,22774673.56,16074215.88
21418,2013-04-16,1574.57,22.21,1.43,1593.37,-1.18,True,1,14672,-1574.57,-6702032.25,23102091.04,16400058.79
21419,2013-04-17,1552.01,-22.56,-1.43,1593.37,-2.6,True,1,14673,-1552.01,-6703584.26,22772642.73,16069058.47
21420,2013-04-18,1541.61,-10.4,-0.67,1593.37,-3.25,True,1,14674,-1541.61,-6705125.87,22621585.14,15916459.27
21421,2013-04-19,1555.25,13.64,0.88,1593.37,-2.39,True,1,14675,-1555.25,-6706681.12,22823293.75,16116612.63
21422,2013-04-22,1562.5,7.25,0.47,1593.37,-1.94,True,1,14676,-1562.5,-6708243.62,22931250.0,16223006.38
21423,2013-04-23,1578.78,16.28,1.04,1593.37,-0.92,True,1,14677,-1578.78,-6709822.4,23171754.06,16461931.66
21424,2013-04-24,1578.79,0.01,0.0,1593.37,-0.92,True,1,14678,-1578.79,-6711401.19,23173479.62,16462078.43
21425,2013-04-25,1585.16,6.37,0.4,1593.37,-0.52,True,1,14679,-1585.16,-6712986.35,23268563.64,16555577.29
21426,2013-04-26,1582.24,-2.92,-0.18,1593.37,-0.7,True,1,14680,-1582.24,-6714568.59,23227283.2,16512714.61
21427,2013-04-29,1593.61,11.37,0.72,1593.61,0.0,True,1,14681,-1593.61,-6716162.2,23395788.41,16679626.21
21428,2013-04-30,1597.57,3.96,0.25,1597.57,0.0,True,1,14682,-1597.57,-6717759.77,23455522.74,16737762.97
21429,2013-05-01,1582.7,-14.87,-0.93,1597.57,-0.93,True,1,14683,-1582.7,-6719342.47,23238784.1,16519441.63
21430,2013-05-02,1597.59,14.89,0.94,1597.59,0.0,True,1,14684,-1597.59,-6720940.06,23459011.56,16738071.5
21431,2013-05-03,1614.42,16.83,1.05,1614.42,0.0,True,1,14685,-1614.42,-6722554.48,23707757.7,16985203.22
21432,2013-05-06,1617.5,3.08,0.19,1617.5,0.0,True,1,14686,-1617.5,-6724171.98,23754605.0,17030433.02
21433,2013-05-07,1625.96,8.46,0.52,1625.96,0.0,True,1,14687,-1625.96,-6725797.94,23880474.52,17154676.58
21434,2013-05-08,1632.69,6.73,0.41,1632.69,0.0,True,1,14688,-1632.69,-6727430.63,23980950.72,17253520.09
21435,2013-05-09,1626.67,-6.02,-0.37,1632.69,-0.37,True,1,14689,-1626.67,-6729057.3,23894155.63,17165098.33
21436,2013-05-10,1633.7,7.03,0.43,1633.7,0.0,True,1,14690,-1633.7,-6730691.0,23999053.0,17268362.0
21437,2013-05-13,1633.77,0.07,0.0,1633.77,0.0,True,1,14691,-1633.77,-6732324.77,24001715.07,17269390.3
21438,2013-05-14,1650.34,16.57,1.01,1650.34,0.0,True,1,14692,-1650.34,-6733975.11,24246795.28,17512820.17
21439,2013-05-15,1658.78,8.44,0.51,1658.78,0.0,True,1,14693,-1658.78,-6735633.89,24372454.54,17636820.65
21440,2013-05-16,1650.47,-8.31,-0.5,1658.78,-0.5,True,1,14694,-1650.47,-6737284.36,24252006.18,17514721.82
21441,2013-05-17,1667.47,17.0,1.03,1667.47,0.0,True,1,14695,-1667.47,-6738951.83,24503471.65,17764519.82
21442,2013-05-20,1666.29,-1.18,-0.07,1667.47,-0.07,True,1,14696,-1666.29,-6740618.12,24487797.84,17747179.72
21443,2013-05-21,1669.16,2.87,0.17,1669.16,0.0,True,1,14697,-1669.16,-6742287.28,24531644.52,17789357.24
21444,2013-05-22,1655.35,-13.81,-0.83,1669.16,-0.83,True,1,14698,-1655.35,-6743942.63,24330334.3,17586391.67
21445,2013-05-23,1650.51,-4.84,-0.29,1669.16,-1.12,True,1,14699,-1650.51,-6745593.14,24260846.49,17515253.35
21446,2013-05-24,1649.6,-0.91,-0.06,1669.16,-1.17,True,1,14700,-1649.6,-6747242.74,24249120.0,17501877.26
21447,2013-05-28,1660.06,10.46,0.63,1669.16,-0.55,True,1,14701,-1660.06,-6748902.8,24404542.06,17655639.26
21448,2013-05-29,1648.36,-11.7,-0.7,1669.16,-1.25,True,1,14702,-1648.36,-6750551.16,24234188.72,17483637.56
21449,2013-05-30,1654.41,6.05,0.37,1669.16,-0.88,True,1,14703,-1654.41,-6752205.57,24324790.23,17572584.66
21450,2013-05-31,1630.74,-23.67,-1.43,1669.16,-2.3,True,1,14704,-1630.74,-6753836.31,23978400.96,17224564.65
21451,2013-06-03,1640.42,9.68,0.59,1669.16,-1.72,True,1,14705,-1640.42,-6755476.73,24122376.1,17366899.37
21452,2013-06-04,1631.38,-9.04,-0.55,1669.16,-2.26,True,1,14706,-1631.38,-6757108.11,23991074.28,17233966.17
21453,2013-06-05,1608.9,-22.48,-1.38,1669.16,-3.61,True,1,14707,-1608.9,-6758717.01,23662092.3,16903375.29
21454,2013-06-06,1622.56,13.66,0.85,1669.16,-2.79,True,1,14708,-1622.56,-6760339.57,23864612.48,17104272.91
21455,2013-06-07,1643.38,20.82,1.28,1669.16,-1.54,True,1,14709,-1643.38,-6761982.95,24172476.42,17410493.47
21456,2013-06-10,1642.81,-0.57,-0.04,1669.16,-1.58,True,1,14710,-1642.81,-6763625.76,24165735.1,17402109.34
21457,2013-06-11,1626.13,-16.68,-1.01,1669.16,-2.58,True,1,14711,-1626.13,-6765251.89,23921998.43,17156746.54
21458,2013-06-12,1612.52,-13.61,-0.84,1669.16,-3.39,True,1,14712,-1612.52,-6766864.41,23723394.24,16956529.83
21459,2013-06-13,1636.36,23.84,1.48,1669.16,-1.96,True,1,14713,-1636.36,-6768500.77,24075764.68,17307263.91
21460,2013-06-14,1626.73,-9.63,-0.59,1669.16,-2.54,True,1,14714,-1626.73,-6770127.5,23935705.22,17165577.72
21461,2013-06-17,1639.04,12.31,0.76,1669.16,-1.8,True,1,14715,-1639.04,-6771766.54,24118473.6,17346707.06
21462,2013-06-18,1651.81,12.77,0.78,1669.16,-1.04,True,1,14716,-1651.81,-6773418.35,24308035.96,17534617.61
21463,2013-06-19,1628.93,-22.88,-1.38,1669.16,-2.41,True,1,14717,-1628.93,-6775047.28,23972962.81,17197915.53
21464,2013-06-20,1588.19,-40.74,-2.5,1669.16,-4.85,True,1,14718,-1588.19,-6776635.47,23374980.42,16598344.95
21465,2013-06-21,1592.43,4.24,0.27,1669.16,-4.6,True,1,14719,-1592.43,-6778227.9,23438977.17,16660749.27
21466,2013-06-24,1573.09,-19.34,-1.22,1669.16,-5.76,True,1,14720,-1573.09,-6779800.99,23155884.8,16376083.81
21467,2013-06-25,1588.03,14.94,0.95,1669.16,-4.86,True,1,14721,-1588.03,-6781389.02,23377389.63,16596000.61
21468,2013-06-26,1603.26,15.23,0.96,1669.16,-3.95,True,1,14722,-1603.26,-6782992.28,23603193.72,16820201.44
21469,2013-06-27,1613.2,9.94,0.62,1669.16,-3.35,True,1,14723,-1613.2,-6784605.48,23751143.6,16966538.12
21470,2013-06-28,1606.28,-6.92,-0.43,1669.16,-3.77,True,1,14724,-1606.28,-6786211.76,23650866.72,16864654.96
21471,2013-07-01,1614.96,8.68,0.54,1669.16,-3.25,True,1,14725,-1614.96,-6787826.72,23780286.0,16992459.28
21472,2013-07-02,1614.08,-0.88,-0.05,1669.16,-3.3,True,1,14726,-1614.08,-6789440.8,23768942.08,16979501.28
21473,2013-07-03,1615.41,1.33,0.08,1669.16,-3.22,True,1,14727,-1615.41,-6791056.21,23790143.07,16999086.86
21474,2013-07-05,1631.89,16.48,1.02,1669.16,-2.23,True,1,14728,-1631.89,-6792688.1,24034475.92,17241787.82
21475,2013-07-08,1640.46,8.57,0.52,1669.16,-1.72,True,1,14729,-1640.46,-6794328.56,24162335.34,17368006.78
21476,2013-07-09,1652.32,11.86,0.72,1669.16,-1.01,True,1,14730,-1652.32,-6795980.88,24338673.6,17542692.72
21477,2013-07-10,1652.62,0.3,0.02,1669.16,-0.99,True,1,14731,-1652.62,-6797633.5,24344745.22,17547111.72
21478,2013-07-11,1675.02,22.4,1.36,1675.02,0.0,True,1,14732,-1675.02,-6799308.52,24676394.64,17877086.12
21479,2013-07-12,1680.19,5.17,0.31,1680.19,0.0,True,1,14733,-1680.19,-6800988.71,24754239.27,17953250.56
21480,2013-07-15,1682.5,2.31,0.14,1682.5,0.0,True,1,14734,-1682.5,-6802671.21,24789955.0,17987283.79
21481,2013-07-16,1676.26,-6.24,-0.37,1682.5,-0.37,True,1,14735,-1676.26,-6804347.47,24699691.1,17895343.63
21482,2013-07-17,1680.91,4.65,0.28,1682.5,-0.1,True,1,14736,-1680.91,-6806028.38,24769889.76,17963861.38
21483,2013-07-18,1689.37,8.46,0.5,1689.37,0.0,True,1,14737,-1689.37,-6807717.75,24896245.69,18088527.94
21484,2013-07-19,1692.09,2.72,0.16,1692.09,0.0,True,1,14738,-1692.09,-6809409.84,24938022.42,18128612.58
21485,2013-07-22,1695.53,3.44,0.2,1695.53,0.0,True,1,14739,-1695.53,-6811105.37,24990416.67,18179311.3
21486,2013-07-23,1692.39,-3.14,-0.18,1695.53,-0.18,True,1,14740,-1692.39,-6812797.76,24945828.6,18133030.84
21487,2013-07-24,1685.94,-6.45,-0.38,1695.53,-0.57,True,1,14741,-1685.94,-6814483.7,24852441.54,18037957.84
21488,2013-07-25,1690.25,4.31,0.26,1695.53,-0.31,True,1,14742,-1690.25,-6816173.95,24917665.5,18101491.55
21489,2013-07-26,1691.65,1.4,0.08,1695.53,-0.23,True,1,14743,-1691.65,-6817865.6,24939995.95,18122130.35
21490,2013-07-29,1685.33,-6.32,-0.37,1695.53,-0.6,True,1,14744,-1685.33,-6819550.93,24848505.52,18028954.59
21491,2013-07-30,1685.96,0.63,0.04,1695.53,-0.56,True,1,14745,-1685.96,-6821236.89,24859480.2,18038243.31
21492,2013-07-31,1685.73,-0.23,-0.01,1695.53,-0.58,True,1,14746,-1685.73,-6822922.62,24857774.58,18034851.96
21493,2013-08-01,1706.87,21.14,1.25,1706.87,0.0,True,1,14747,-1706.87,-6824629.49,25171211.89,18346582.4
21494,2013-08-02,1709.67,2.8,0.16,1709.67,0.0,True,1,14748,-1709.67,-6826339.16,25214213.16,18387874.0
21495,2013-08-05,1707.14,-2.53,-0.15,1709.67,-0.15,True,1,14749,-1707.14,-6828046.3,25178607.86,18350561.56
21496,2013-08-06,1697.37,-9.77,-0.57,1709.67,-0.72,True,1,14750,-1697.37,-6829743.67,25036207.5,18206463.83
21497,2013-08-07,1690.91,-6.46,-0.38,1709.67,-1.1,True,1,14751,-1690.91,-6831434.58,24942613.41,18111178.83
21498,2013-08-08,1697.48,6.57,0.39,1709.67,-0.71,True,1,14752,-1697.48,-6833132.06,25041224.96,18208092.9
21499,2013-08-09,1691.42,-6.06,-0.36,1709.67,-1.07,True,1,14753,-1691.42,-6834823.48,24953519.26,18118695.78
21500,2013-08-12,1689.47,-1.95,-0.12,1709.67,-1.18,True,1,14754,-1689.47,-6836512.95,24926440.38,18089927.43
21501,2013-08-13,1694.16,4.69,0.28,1709.67,-0.91,True,1,14755,-1694.16,-6838207.11,24997330.8,18159123.69
21502,2013-08-14,1685.39,-8.77,-0.52,1709.67,-1.42,True,1,14756,-1685.39,-6839892.5,24869614.84,18029722.34
21503,2013-08-15,1661.32,-24.07,-1.43,1709.67,-2.83,True,1,14757,-1661.32,-6841553.82,24516099.24,17674545.42
21504,2013-08-16,1655.83,-5.49,-0.33,1709.67,-3.15,True,1,14758,-1655.83,-6843209.65,24436739.14,17593529.49
21505,2013-08-19,1646.06,-9.77,-0.59,1709.67,-3.72,True,1,14759,-1646.06,-6844855.71,24294199.54,17449343.83
21506,2013-08-20,1652.35,6.29,0.38,1709.67,-3.35,True,1,14760,-1652.35,-6846508.06,24388686.0,17542177.94
21507,2013-08-21,1642.8,-9.55,-0.58,1709.67,-3.91,True,1,14761,-1642.8,-6848150.86,24249370.8,17401219.94
21508,2013-08-22,1656.96,14.16,0.86,1709.67,-3.08,True,1,14762,-1656.96,-6849807.82,24460043.52,17610235.7
21509,2013-08-23,1663.5,6.54,0.4,1709.67,-2.7,True,1,14763,-1663.5,-6851471.32,24558250.5,17706779.18
21510,2013-08-26,1656.78,-6.72,-0.4,1709.67,-3.09,True,1,14764,-1656.78,-6853128.1,24460699.92,17607571.82
21511,2013-08-27,1630.48,-26.3,-1.59,1709.67,-4.63,True,1,14765,-1630.48,-6854758.58,24074037.2,17219278.62
21512,2013-08-28,1634.96,4.48,0.28,1709.67,-4.37,True,1,14766,-1634.96,-6856393.54,24141819.36,17285425.82
21513,2013-08-29,1638.17,3.21,0.2,1709.67,-4.18,True,1,14767,-1638.17,-6858031.71,24190856.39,17332824.68
21514,2013-08-30,1632.97,-5.2,-0.32,1709.67,-4.49,True,1,14768,-1632.97,-6859664.68,24115700.96,17256036.28
21515,2013-09-03,1639.77,6.8,0.42,1709.67,-4.09,True,1,14769,-1639.77,-6861304.45,24217763.13,17356458.68
21516,2013-09-04,1653.08,13.31,0.81,1709.67,-3.31,True,1,14770,-1653.08,-6862957.53,24415991.6,17553034.07
21517,2013-09-05,1655.08,2.0,0.12,1709.67,-3.19,True,1,14771,-1655.08,-6864612.61,24447186.68,17582574.07
21518,2013-09-06,1655.17,0.09,0.0,1709.67,-3.19,True,1,14772,-1655.17,-6866267.78,24450171.24,17583903.46
21519,2013-09-09,1671.71,16.54,1.0,1709.67,-2.22,True,1,14773,-1671.71,-6867939.49,24696171.83,17828232.34
21520,2013-09-10,1683.99,12.28,0.74,1709.67,-1.5,True,1,14774,-1683.99,-6869623.48,24879268.26,18009644.78
21521,2013-09-11,1689.13,5.14,0.3,1709.67,-1.2,True,1,14775,-1689.13,-6871312.61,24956895.75,18085583.14
21522,2013-09-12,1683.42,-5.71,-0.34,1709.67,-1.54,True,1,14776,-1683.42,-6872996.03,24874213.92,18001217.89
21523,2013-09-13,1687.99,4.57,0.27,1709.67,-1.27,True,1,14777,-1687.99,-6874684.02,24943428.23,18068744.21
21524,2013-09-16,1697.6,9.61,0.57,1709.67,-0.71,True,1,14778,-1697.6,-6876381.62,25087132.8,18210751.18
21525,2013-09-17,1704.76,7.16,0.42,1709.67,-0.29,True,1,14779,-1704.76,-6878086.38,25194648.04,18316561.66
21526,2013-09-18,1725.52,20.76,1.22,1725.52,0.0,True,1,14780,-1725.52,-6879811.9,25503185.6,18623373.7
21527,2013-09-19,1722.34,-3.18,-0.18,1725.52,-0.18,True,1,14781,-1722.34,-6881534.24,25457907.54,18576373.3
21528,2013-09-20,1709.91,-12.43,-0.72,1725.52,-0.9,True,1,14782,-1709.91,-6883244.15,25275889.62,18392645.47
21529,2013-09-23,1701.84,-8.07,-0.47,1725.52,-1.37,True,1,14783,-1701.84,-6884945.99,25158300.72,18273354.73
21530,2013-09-24,1697.42,-4.42,-0.26,1725.52,-1.63,True,1,14784,-1697.42,-6886643.41,25094657.28,18208013.87
21531,2013-09-25,1692.77,-4.65,-0.27,1725.52,-1.9,True,1,14785,-1692.77,-6888336.18,25027604.45,18139268.27
21532,2013-09-26,1698.67,5.9,0.35,1725.52,-1.56,True,1,14786,-1698.67,-6890034.85,25116534.62,18226499.77
21533,2013-09-27,1691.75,-6.92,-0.41,1725.52,-1.96,True,1,14787,-1691.75,-6891726.6,25015907.25,18124180.65
21534,2013-09-30,1681.55,-10.2,-0.6,1725.52,-2.55,True,1,14788,-1681.55,-6893408.15,24866761.4,17973353.25
21535,2013-10-01,1695.0,13.45,0.8,1725.52,-1.77,True,1,14789,-1695.0,-6895103.15,25067355.0,18172251.85
21536,2013-10-02,1693.87,-1.13,-0.07,1725.52,-1.83,True,1,14790,-1693.87,-6896797.02,25052337.3,18155540.28
21537,2013-10-03,1678.66,-15.21,-0.9,1725.52,-2.72,True,1,14791,-1678.66,-6898475.68,24829060.06,17930584.38
21538,2013-10-04,1690.5,11.84,0.7,1725.52,-2.03,True,1,14792,-1690.5,-6900166.18,25005876.0,18105709.82
21539,2013-10-07,1676.12,-14.38,-0.85,1725.52,-2.86,True,1,14793,-1676.12,-6901842.3,24794843.16,17893000.86
21540,2013-10-08,1655.45,-20.67,-1.23,1725.52,-4.06,True,1,14794,-1655.45,-6903497.75,24490727.3,17587229.55
21541,2013-10-09,1656.4,0.95,0.06,1725.52,-4.01,True,1,14795,-1656.4,-6905154.15,24506438.0,17601283.85
21542,2013-10-10,1692.56,36.16,2.18,1725.52,-1.91,True,1,14796,-1692.56,-6906846.71,25043117.76,18136271.05
21543,2013-10-11,1703.2,10.64,0.63,1725.52,-1.29,True,1,14797,-1703.2,-6908549.91,25202250.4,18293700.49
21544,2013-10-14,1710.14,6.94,0.41,1725.52,-0.89,True,1,14798,-1710.14,-6910260.05,25306651.72,18396391.67
21545,2013-10-15,1698.06,-12.08,-0.71,1725.52,-1.59,True,1,14799,-1698.06,-6911958.11,25129589.94,18217631.83
21546,2013-10-16,1721.54,23.48,1.38,1725.52,-0.23,True,1,14800,-1721.54,-6913679.65,25478792.0,18565112.35
21547,2013-10-17,1733.15,11.61,0.67,1733.15,0.0,True,1,14801,-1733.15,-6915412.8,25652353.15,18736940.35
21548,2013-10-18,1744.5,11.35,0.66,1744.5,0.0,True,1,14802,-1744.5,-6917157.3,25822089.0,18904931.7
21549,2013-10-21,1744.66,0.16,0.01,1744.66,0.0,True,1,14803,-1744.66,-6918901.96,25826201.98,18907300.02
21550,2013-10-22,1754.67,10.01,0.57,1754.67,0.0,True,1,14804,-1754.67,-6920656.63,25976134.68,19055478.05
21551,2013-10-23,1746.38,-8.29,-0.47,1754.67,-0.47,True,1,14805,-1746.38,-6922403.01,25855155.9,18932752.89
21552,2013-10-24,1752.07,5.69,0.33,1754.67,-0.15,True,1,14806,-1752.07,-6924155.08,25941148.42,19016993.34
21553,2013-10-25,1759.77,7.7,0.44,1759.77,0.0,True,1,14807,-1759.77,-6925914.85,26056914.39,19130999.54
21554,2013-10-28,1762.11,2.34,0.13,1762.11,0.0,True,1,14808,-1762.11,-6927676.96,26093324.88,19165647.92
21555,2013-10-29,1771.95,9.84,0.56,1771.95,0.0,True,1,14809,-1771.95,-6929448.91,26240807.55,19311358.64
21556,2013-10-30,1763.31,-8.64,-0.49,1771.95,-0.49,True,1,14810,-1763.31,-6931212.22,26114621.1,19183408.88
21557,2013-10-31,1756.54,-6.77,-0.38,1771.95,-0.87,True,1,14811,-1756.54,-6932968.76,26016113.94,19083145.18
21558,2013-11-01,1761.64,5.1,0.29,1771.95,-0.58,True,1,14812,-1761.64,-6934730.4,26093411.68,19158681.28
21559,2013-11-04,1767.93,6.29,0.36,1771.95,-0.23,True,1,14813,-1767.93,-6936498.33,26188347.09,19251848.76
21560,2013-11-05,1762.97,-4.96,-0.28,1771.95,-0.51,True,1,14814,-1762.97,-6938261.3,26116637.58,19178376.28
21561,2013-11-06,1770.49,7.52,0.43,1771.95,-0.08,True,1,14815,-1770.49,-6940031.79,26229809.35,19289777.56
21562,2013-11-07,1747.15,-23.34,-1.32,1771.95,-1.4,True,1,14816,-1747.15,-6941778.94,25885774.4,18943995.46
21563,2013-11-08,1770.61,23.46,1.34,1771.95,-0.08,True,1,14817,-1770.61,-6943549.55,26235128.37,19291578.82
21564,2013-11-11,1771.89,1.28,0.07,1771.95,-0.0,True,1,14818,-1771.89,-6945321.44,26255866.02,19310544.58
21565,2013-11-12,1767.69,-4.2,-0.24,1771.95,-0.24,True,1,14819,-1767.69,-6947089.13,26195398.11,19248308.98
21566,2013-11-13,1782.0,14.31,0.81,1782.0,0.0,True,1,14820,-1782.0,-6948871.13,26409240.0,19460368.87
21567,2013-11-14,1790.62,8.62,0.48,1790.62,0.0,True,1,14821,-1790.62,-6950661.75,26538779.02,19588117.27
21568,2013-11-15,1798.18,7.56,0.42,1798.18,0.0,True,1,14822,-1798.18,-6952459.93,26652623.96,19700164.03
21569,2013-11-18,1791.53,-6.65,-0.37,1798.18,-0.37,True,1,14823,-1791.53,-6954251.46,26555849.19,19601597.73
21570,2013-11-19,1787.87,-3.66,-0.2,1798.18,-0.57,True,1,14824,-1787.87,-6956039.33,26503384.88,19547345.55
21571,2013-11-20,1781.37,-6.5,-0.36,1798.18,-0.94,True,1,14825,-1781.37,-6957820.7,26408810.25,19450989.55
21572,2013-11-21,1795.85,14.48,0.81,1798.18,-0.13,True,1,14826,-1795.85,-6959616.55,26625272.1,19665655.55
21573,2013-11-22,1804.76,8.91,0.5,1804.76,0.0,True,1,14827,-1804.76,-6961421.31,26759176.52,19797755.21
21574,2013-11-25,1802.48,-2.28,-0.13,1804.76,-0.13,True,1,14828,-1802.48,-6963223.79,26727173.44,19763949.65
21575,2013-11-26,1802.75,0.27,0.02,1804.76,-0.11,True,1,14829,-1802.75,-6965026.54,26732979.75,19767953.21
21576,2013-11-27,1807.23,4.48,0.25,1807.23,0.0,True,1,14830,-1807.23,-6966833.77,26801220.9,19834387.13
21577,2013-11-29,1805.81,-1.42,-0.08,1807.23,-0.08,True,1,14831,-1805.81,-6968639.58,26781968.11,19813328.53
21578,2013-12-02,1800.9,-4.91,-0.27,1807.23,-0.35,True,1,14832,-1800.9,-6970440.48,26710948.8,19740508.32
21579,2013-12-03,1795.15,-5.75,-0.32,1807.23,-0.67,True,1,14833,-1795.15,-6972235.63,26627459.95,19655224.32
21580,2013-12-04,1792.81,-2.34,-0.13,1807.23,-0.8,True,1,14834,-1792.81,-6974028.44,26594543.54,19620515.1
21581,2013-12-05,1785.03,-7.78,-0.43,1807.23,-1.23,True,1,14835,-1785.03,-6975813.47,26480920.05,19505106.58
21582,2013-12-06,1805.09,20.06,1.12,1807.23,-0.12,True,1,14836,-1805.09,-6977618.56,26780315.24,19802696.68
21583,2013-12-09,1808.37,3.28,0.18,1808.37,0.0,True,1,14837,-1808.37,-6979426.93,26830785.69,19851358.76
21584,2013-12-10,1802.62,-5.75,-0.32,1808.37,-0.32,True,1,14838,-1802.62,-6981229.55,26747275.56,19766046.01
21585,2013-12-11,1782.22,-20.4,-1.13,1808.37,-1.45,True,1,14839,-1782.22,-6983011.77,26446362.58,19463350.81
21586,2013-12-12,1775.5,-6.72,-0.38,1808.37,-1.82,True,1,14840,-1775.5,-6984787.27,26348420.0,19363632.73
21587,2013-12-13,1775.32,-0.18,-0.01,1808.37,-1.83,True,1,14841,-1775.32,-6986562.59,26347524.12,19360961.53
21588,2013-12-16,1786.54,11.22,0.63,1808.37,-1.21,True,1,14842,-1786.54,-6988349.13,26515826.68,19527477.55
21589,2013-12-17,1781.0,-5.54,-0.31,1808.37,-1.51,True,1,14843,-1781.0,-6990130.13,26435383.0,19445252.87
21590,2013-12-18,1810.65,29.65,1.66,1810.65,0.0,True,1,14844,-1810.65,-6991940.78,26877288.6,19885347.82
21591,2013-12-19,1809.6,-1.05,-0.06,1810.65,-0.06,True,1,14845,-1809.6,-6993750.38,26863512.0,19869761.62
21592,2013-12-20,1818.32,8.72,0.48,1818.32,0.0,True,1,14846,-1818.32,-6995568.7,26994778.72,19999210.02
21593,2013-12-23,1827.99,9.67,0.53,1827.99,0.0,True,1,14847,-1827.99,-6997396.69,27140167.53,20142770.84
21594,2013-12-24,1833.32,5.33,0.29,1833.32,0.0,True,1,14848,-1833.32,-6999230.01,27221135.36,20221905.35
21595,2013-12-26,1842.02,8.7,0.48,1842.02,0.0,True,1,14849,-1842.02,-7001072.03,27352154.98,20351082.95
21596,2013-12-27,1841.4,-0.62,-0.03,1842.02,-0.03,True,1,14850,-1841.4,-7002913.43,27344790.0,20341876.57
21597,2013-12-30,1841.07,-0.33,-0.02,1842.02,-0.05,True,1,14851,-1841.07,-7004754.5,27341730.57,20336976.07
21598,2013-12-31,1848.36,7.29,0.4,1848.36,0.0,True,1,14852,-1848.36,-7006602.86,27451842.72,20445239.86
21599,2014-01-02,1831.98,-16.38,-0.89,1848.36,-0.89,True,1,14853,-1831.98,-7008434.84,27210398.94,20201964.1
21600,2014-01-03,1831.37,-0.61,-0.03,1848.36,-0.92,True,1,14854,-1831.37,-7010266.21,27203169.98,20192903.77
21601,2014-01-06,1826.77,-4.6,-0.25,1848.36,-1.17,True,1,14855,-1826.77,-7012092.98,27136668.35,20124575.37
21602,2014-01-07,1837.88,11.11,0.61,1848.36,-0.57,True,1,14856,-1837.88,-7013930.86,27303545.28,20289614.42
21603,2014-01-08,1837.49,-0.39,-0.02,1848.36,-0.59,True,1,14857,-1837.49,-7015768.35,27299588.93,20283820.58
21604,2014-01-09,1838.13,0.64,0.04,1848.36,-0.55,True,1,14858,-1838.13,-7017606.48,27310935.54,20293329.06
21605,2014-01-10,1842.37,4.24,0.23,1848.36,-0.32,True,1,14859,-1842.37,-7019448.85,27375775.83,20356326.98
21606,2014-01-13,1819.2,-23.17,-1.26,1848.36,-1.58,True,1,14860,-1819.2,-7021268.05,27033312.0,20012043.95
21607,2014-01-14,1838.88,19.68,1.08,1848.36,-0.51,True,1,14861,-1838.88,-7023106.93,27327595.68,20304488.75
21608,2014-01-15,1848.38,9.5,0.52,1848.38,0.0,True,1,14862,-1848.38,-7024955.31,27470623.56,20445668.25
21609,2014-01-16,1845.89,-2.49,-0.14,1848.38,-0.14,True,1,14863,-1845.89,-7026801.2,27435463.07,20408661.87
21610,2014-01-17,1838.7,-7.19,-0.39,1848.38,-0.52,True,1,14864,-1838.7,-7028639.9,27330436.8,20301796.9
21611,2014-01-21,1843.8,5.1,0.28,1848.38,-0.25,True,1,14865,-1843.8,-7030483.7,27408087.0,20377603.3
21612,2014-01-22,1844.86,1.06,0.06,1848.38,-0.19,True,1,14866,-1844.86,-7032328.56,27425688.76,20393360.2
21613,2014-01-23,1828.46,-16.4,-0.89,1848.38,-1.08,True,1,14867,-1828.46,-7034157.02,27183714.82,20149557.8
21614,2014-01-24,1790.29,-38.17,-2.09,1848.38,-3.14,True,1,14868,-1790.29,-7035947.31,26618031.72,19582084.41
21615,2014-01-27,1781.56,-8.73,-0.49,1848.38,-3.62,True,1,14869,-1781.56,-7037728.87,26490015.64,19452286.77
21616,2014-01-28,1792.5,10.94,0.61,1848.38,-3.02,True,1,14870,-1792.5,-7039521.37,26654475.0,19614953.63
21617,2014-01-29,1774.2,-18.3,-1.02,1848.38,-4.01,True,1,14871,-1774.2,-7041295.57,26384128.2,19342832.63
21618,2014-01-30,1794.19,19.99,1.13,1848.38,-2.93,True,1,14872,-1794.19,-7043089.76,26683193.68,19640103.92
21619,2014-01-31,1782.59,-11.6,-0.65,1848.38,-3.56,True,1,14873,-1782.59,-7044872.35,26512461.07,19467588.72
21620,2014-02-03,1741.89,-40.7,-2.28,1848.38,-5.76,True,1,14874,-1741.89,-7046614.24,25908871.86,18862257.62
21621,2014-02-04,1755.2,13.31,0.76,1848.38,-5.04,True,1,14875,-1755.2,-7048369.44,26108600.0,19060230.56
21622,2014-02-05,1751.64,-3.56,-0.2,1848.38,-5.23,True,1,14876,-1751.64,-7050121.08,26057396.64,19007275.56
21623,2014-02-06,1773.43,21.79,1.24,1848.38,-4.06,True,1,14877,-1773.43,-7051894.51,26383318.11,19331423.6
21624,2014-02-07,1797.02,23.59,1.33,1848.38,-2.78,True,1,14878,-1797.02,-7053691.53,26736063.56,19682372.03
21625,2014-02-10,1799.84,2.82,0.16,1848.38,-2.63,True,1,14879,-1799.84,-7055491.37,26779819.36,19724327.99
21626,2014-02-11,1819.75,19.91,1.11,1848.38,-1.55,True,1,14880,-1819.75,-7057311.12,27077880.0,20020568.88
21627,2014-02-12,1819.26,-0.49,-0.03,1848.38,-1.58,True,1,14881,-1819.26,-7059130.38,27072408.06,20013277.68
21628,2014-02-13,1829.83,10.57,0.58,1848.38,-1.0,True,1,14882,-1829.83,-7060960.21,27231530.06,20170569.85
21629,2014-02-14,1838.63,8.8,0.48,1848.38,-0.53,True,1,14883,-1838.63,-7062798.84,27364330.29,20301531.45
21630,2014-02-18,1840.76,2.13,0.12,1848.38,-0.41,True,1,14884,-1840.76,-7064639.6,27397871.84,20333232.24
21631,2014-02-19,1828.75,-12.01,-0.65,1848.38,-1.06,True,1,14885,-1828.75,-7066468.35,27220943.75,20154475.4
21632,2014-02-20,1839.78,11.03,0.6,1848.38,-0.46,True,1,14886,-1839.78,-7068308.13,27386965.08,20318656.95
21633,2014-02-21,1836.25,-3.53,-0.19,1848.38,-0.66,True,1,14887,-1836.25,-7070144.38,27336253.75,20266109.37
21634,2014-02-24,1847.61,11.36,0.62,1848.38,-0.04,True,1,14888,-1847.61,-7071991.99,27507217.68,20435225.69
21635,2014-02-25,1845.12,-2.49,-0.14,1848.38,-0.18,True,1,14889,-1845.12,-7073837.11,27471991.68,20398154.57
21636,2014-02-26,1845.16,0.04,0.0,1848.38,-0.17,True,1,14890,-1845.16,-7075682.27,27474432.4,20398750.13
21637,2014-02-27,1854.29,9.13,0.5,1854.29,0.0,True,1,14891,-1854.29,-7077536.56,27612232.39,20534695.83
21638,2014-02-28,1859.45,5.16,0.28,1859.45,0.0,True,1,14892,-1859.45,-7079396.01,27690929.4,20611533.39
21639,2014-03-03,1845.73,-13.72,-0.74,1859.45,-0.74,True,1,14893,-1845.73,-7081241.74,27488456.89,20407215.15
21640,2014-03-04,1873.91,28.18,1.53,1873.91,0.0,True,1,14894,-1873.91,-7083115.65,27910015.54,20826899.89
21641,2014-03-05,1873.81,-0.1,-0.0,1873.91,-0.0,True,1,14895,-1873.81,-7084989.46,27910399.95,20825410.49
21642,2014-03-06,1877.03,3.22,0.17,1877.03,0.0,True,1,14896,-1877.03,-7086866.49,27960238.88,20873372.39
21643,2014-03-07,1878.04,1.01,0.05,1878.04,0.0,True,1,14897,-1878.04,-7088744.53,27977161.88,20888417.35
21644,2014-03-10,1877.17,-0.87,-0.05,1878.04,-0.05,True,1,14898,-1877.17,-7090621.7,27966078.66,20875456.96
21645,2014-03-11,1867.63,-9.54,-0.51,1878.04,-0.55,True,1,14899,-1867.63,-7092489.33,27825819.37,20733330.04
21646,2014-03-12,1868.2,0.57,0.03,1878.04,-0.52,True,1,14900,-1868.2,-7094357.53,27836180.0,20741822.47
21647,2014-03-13,1846.34,-21.86,-1.17,1878.04,-1.69,True,1,14901,-1846.34,-7096203.87,27512312.34,20416108.47
21648,2014-03-14,1841.13,-5.21,-0.28,1878.04,-1.96,True,1,14902,-1841.13,-7098045.0,27436519.26,20338474.26
21649,2014-03-17,1858.83,17.7,0.96,1878.04,-1.02,True,1,14903,-1858.83,-7099903.83,27702143.49,20602239.66
21650,2014-03-18,1872.25,13.42,0.72,1878.04,-0.31,True,1,14904,-1872.25,-7101776.08,27904014.0,20802237.92
21651,2014-03-19,1860.77,-11.48,-0.61,1878.04,-0.92,True,1,14905,-1860.77,-7103636.85,27734776.85,20631140.0
21652,2014-03-20,1872.01,11.24,0.6,1878.04,-0.32,True,1,14906,-1872.01,-7105508.86,27904181.06,20798672.2
21653,2014-03-21,1866.52,-5.49,-0.29,1878.04,-0.61,True,1,14907,-1866.52,-7107375.38,27824213.64,20716838.26
21654,2014-03-24,1857.44,-9.08,-0.49,1878.04,-1.1,True,1,14908,-1857.44,-7109232.82,27690715.52,20581482.7
21655,2014-03-25,1865.62,8.18,0.44,1878.04,-0.66,True,1,14909,-1865.62,-7111098.44,27814528.58,20703430.14
21656,2014-03-26,1852.56,-13.06,-0.7,1878.04,-1.36,True,1,14910,-1852.56,-7112951.0,27621669.6,20508718.6
21657,2014-03-27,1849.04,-3.52,-0.19,1878.04,-1.54,True,1,14911,-1849.04,-7114800.04,27571035.44,20456235.4
21658,2014-03-28,1857.62,8.58,0.46,1878.04,-1.09,True,1,14912,-1857.62,-7116657.66,27700829.44,20584171.78
21659,2014-03-31,1872.34,14.72,0.79,1878.04,-0.3,True,1,14913,-1872.34,-7118530.0,27922206.42,20803676.42
21660,2014-04-01,1885.52,13.18,0.7,1885.52,0.0,True,1,14914,-1885.52,-7120415.52,28120645.28,21000229.76
21661,2014-04-02,1890.9,5.38,0.28,1890.9,0.0,True,1,14915,-1890.9,-7122306.42,28202773.5,21080467.08
21662,2014-04-03,1888.77,-2.13,-0.11,1890.9,-0.11,True,1,14916,-1888.77,-7124195.19,28172893.32,21048698.13
21663,2014-04-04,1865.09,-23.68,-1.25,1890.9,-1.36,True,1,14917,-1865.09,-7126060.28,27821547.53,20695487.25
21664,2014-04-07,1845.04,-20.05,-1.08,1890.9,-2.42,True,1,14918,-1845.04,-7127905.32,27524306.72,20396401.4
21665,2014-04-08,1851.96,6.92,0.38,1890.9,-2.06,True,1,14919,-1851.96,-7129757.28,27629391.24,20499633.96
21666,2014-04-09,1872.18,20.22,1.09,1890.9,-0.99,True,1,14920,-1872.18,-7131629.46,27932925.6,20801296.14
21667,2014-04-10,1833.08,-39.1,-2.09,1890.9,-3.06,True,1,14921,-1833.08,-7133462.54,27351386.68,20217924.14
21668,2014-04-11,1815.69,-17.39,-0.95,1890.9,-3.98,True,1,14922,-1815.69,-7135278.23,27093726.18,19958447.95
21669,2014-04-14,1830.61,14.92,0.82,1890.9,-3.19,True,1,14923,-1830.61,-7137108.84,27318193.03,20181084.19
21670,2014-04-15,1842.98,12.37,0.68,1890.9,-2.53,True,1,14924,-1842.98,-7138951.82,27504633.52,20365681.7
21671,2014-04-16,1862.31,19.33,1.05,1890.9,-1.51,True,1,14925,-1862.31,-7140814.13,27794976.75,20654162.62
21672,2014-04-17,1864.85,2.54,0.14,1890.9,-1.38,True,1,14926,-1864.85,-7142678.98,27834751.1,20692072.12
21673,2014-04-21,1871.89,7.04,0.38,1890.9,-1.0,True,1,14927,-1871.89,-7144550.87,27941702.03,20797151.16
21674,2014-04-22,1879.55,7.66,0.41,1890.9,-0.6,True,1,14928,-1879.55,-7146430.42,28057922.4,20911491.98
21675,2014-04-23,1875.39,-4.16,-0.22,1890.9,-0.82,True,1,14929,-1875.39,-7148305.81,27997697.31,20849391.5
21676,2014-04-24,1878.61,3.22,0.17,1890.9,-0.65,True,1,14930,-1878.61,-7150184.42,28047647.3,20897462.88
21677,2014-04-25,1863.4,-15.21,-0.81,1890.9,-1.45,True,1,14931,-1863.4,-7152047.82,27822425.4,20670377.58
21678,2014-04-28,1869.43,6.03,0.32,1890.9,-1.14,True,1,14932,-1869.43,-7153917.25,27914328.76,20760411.51
21679,2014-04-29,1878.33,8.9,0.48,1890.9,-0.66,True,1,14933,-1878.33,-7155795.58,28049101.89,20893306.31
21680,2014-04-30,1883.95,5.62,0.3,1890.9,-0.37,True,1,14934,-1883.95,-7157679.53,28134909.3,20977229.77
21681,2014-05-01,1883.68,-0.27,-0.01,1890.9,-0.38,True,1,14935,-1883.68,-7159563.21,28132760.8,20973197.59
21682,2014-05-02,1881.14,-2.54,-0.14,1890.9,-0.52,True,1,14936,-1881.14,-7161444.35,28096707.04,20935262.69
21683,2014-05-05,1884.66,3.52,0.19,1890.9,-0.33,True,1,14937,-1884.66,-7163329.01,28151166.42,20987837.41
21684,2014-05-06,1867.72,-16.94,-0.9,1890.9,-1.23,True,1,14938,-1867.72,-7165196.73,27900001.36,20734804.63
21685,2014-05-07,1878.21,10.49,0.56,1890.9,-0.67,True,1,14939,-1878.21,-7167074.94,28058579.19,20891504.25
21686,2014-05-08,1875.63,-2.58,-0.14,1890.9,-0.81,True,1,14940,-1875.63,-7168950.57,28021912.2,20852961.63
21687,2014-05-09,1878.48,2.85,0.15,1890.9,-0.66,True,1,14941,-1878.48,-7170829.05,28066369.68,20895540.63
21688,2014-05-12,1896.65,18.17,0.97,1896.65,0.0,True,1,14942,-1896.65,-7172725.7,28339744.3,21167018.6
21689,2014-05-13,1897.45,0.8,0.04,1897.45,0.0,True,1,14943,-1897.45,-7174623.15,28353595.35,21178972.2
21690,2014-05-14,1888.53,-8.92,-0.47,1897.45,-0.47,True,1,14944,-1888.53,-7176511.68,28222192.32,21045680.64
21691,2014-05-15,1870.85,-17.68,-0.94,1897.45,-1.4,True,1,14945,-1870.85,-7178382.53,27959853.25,20781470.72
21692,2014-05-16,1877.86,7.01,0.38,1897.45,-1.03,True,1,14946,-1877.86,-7180260.39,28066495.56,20886235.17
21693,2014-05-19,1885.08,7.22,0.38,1897.45,-0.65,True,1,14947,-1885.08,-7182145.47,28176290.76,20994145.29
21694,2014-05-20,1872.83,-12.25,-0.65,1897.45,-1.3,True,1,14948,-1872.83,-7184018.3,27995062.84,20811044.54
21695,2014-05-21,1888.03,15.2,0.81,1897.45,-0.5,True,1,14949,-1888.03,-7185906.33,28224160.47,21038254.14
21696,2014-05-22,1892.49,4.46,0.24,1897.45,-0.26,True,1,14950,-1892.49,-7187798.82,28292725.5,21104926.68
21697,2014-05-23,1900.53,8.04,0.42,1900.53,0.0,True,1,14951,-1900.53,-7189699.35,28414824.03,21225124.68
21698,2014-05-27,1911.91,11.38,0.6,1911.91,0.0,True,1,14952,-1911.91,-7191611.26,28586878.32,21395267.06
21699,2014-05-28,1909.78,-2.13,-0.11,1911.91,-0.11,True,1,14953,-1909.78,-7193521.04,28556940.34,21363419.3
21700,2014-05-29,1920.03,10.25,0.54,1920.03,0.0,True,1,14954,-1920.03,-7195441.07,28712128.62,21516687.55
21701,2014-05-30,1923.57,3.54,0.18,1923.57,0.0,True,1,14955,-1923.57,-7197364.64,28766989.35,21569624.71
21702,2014-06-02,1924.97,1.4,0.07,1924.97,0.0,True,1,14956,-1924.97,-7199289.61,28789851.32,21590561.71
21703,2014-06-03,1924.24,-0.73,-0.04,1924.97,-0.04,True,1,14957,-1924.24,-7201213.85,28780857.68,21579643.83
21704,2014-06-04,1927.88,3.64,0.19,1927.88,0.0,True,1,14958,-1927.88,-7203141.73,28837229.04,21634087.31
21705,2014-06-05,1940.46,12.58,0.65,1940.46,0.0,True,1,14959,-1940.46,-7205082.19,29027341.14,21822258.95
21706,2014-06-06,1949.44,8.98,0.46,1949.44,0.0,True,1,14960,-1949.44,-7207031.63,29163622.4,21956590.77
21707,2014-06-09,1951.27,1.83,0.09,1951.27,0.0,True,1,14961,-1951.27,-7208982.9,29192950.47,21983967.57
21708,2014-06-10,1950.79,-0.48,-0.02,1951.27,-0.02,True,1,14962,-1950.79,-7210933.69,29187719.98,21976786.29
21709,2014-06-11,1943.89,-6.9,-0.35,1951.27,-0.38,True,1,14963,-1943.89,-7212877.58,29086426.07,21873548.49
21710,2014-06-12,1930.11,-13.78,-0.71,1951.27,-1.08,True,1,14964,-1930.11,-7214807.69,28882166.04,21667358.35
21711,2014-06-13,1936.16,6.05,0.31,1951.27,-0.77,True,1,14965,-1936.16,-7216743.85,28974634.4,21757890.55
21712,2014-06-16,1937.78,1.62,0.08,1951.27,-0.69,True,1,14966,-1937.78,-7218681.63,29000815.48,21782133.85
21713,2014-06-17,1941.99,4.21,0.22,1951.27,-0.48,True,1,14967,-1941.99,-7220623.62,29065764.33,21845140.71
21714,2014-06-18,1956.98,14.99,0.77,1956.98,0.0,True,1,14968,-1956.98,-7222580.6,29292076.64,22069496.04
21715,2014-06-19,1959.48,2.5,0.13,1959.48,0.0,True,1,14969,-1959.48,-7224540.08,29331456.12,22106916.04
21716,2014-06-20,1962.87,3.39,0.17,1962.87,0.0,True,1,14970,-1962.87,-7226502.95,29384163.9,22157660.95
21717,2014-06-23,1962.61,-0.26,-0.01,1962.87,-0.01,True,1,14971,-1962.61,-7228465.56,29382234.31,22153768.75
21718,2014-06-24,1949.98,-12.63,-0.64,1962.87,-0.66,True,1,14972,-1949.98,-7230415.54,29195100.56,21964685.02
21719,2014-06-25,1959.53,9.55,0.49,1962.87,-0.17,True,1,14973,-1959.53,-7232375.07,29340042.69,22107667.62
21720,2014-06-26,1957.22,-2.31,-0.12,1962.87,-0.29,True,1,14974,-1957.22,-7234332.29,29307412.28,22073079.99
21721,2014-06-27,1960.96,3.74,0.19,1962.87,-0.1,True,1,14975,-1960.96,-7236293.25,29365376.0,22129082.75
21722,2014-06-30,1960.23,-0.73,-0.04,1962.87,-0.13,True,1,14976,-1960.23,-7238253.48,29356404.48,22118151.0
21723,2014-07-01,1973.32,13.09,0.67,1973.32,0.0,True,1,14977,-1973.32,-7240226.8,29554413.64,22314186.84
21724,2014-07-02,1974.62,1.3,0.07,1974.62,0.0,True,1,14978,-1974.62,-7242201.42,29575858.36,22333656.94
21725,2014-07-03,1985.44,10.82,0.55,1985.44,0.0,True,1,14979,-1985.44,-7244186.86,29739905.76,22495718.9
21726,2014-07-07,1977.65,-7.79,-0.39,1985.44,-0.39,True,1,14980,-1977.65,-7246164.51,29625197.0,22379032.49
21727,2014-07-08,1963.71,-13.94,-0.7,1985.44,-1.09,True,1,14981,-1963.71,-7248128.22,29418339.51,22170211.29
21728,2014-07-09,1972.83,9.12,0.46,1985.44,-0.64,True,1,14982,-1972.83,-7250101.05,29556939.06,22306838.01
21729,2014-07-10,1964.68,-8.15,-0.41,1985.44,-1.05,True,1,14983,-1964.68,-7252065.73,29436800.44,22184734.71
21730,2014-07-11,1967.57,2.89,0.15,1985.44,-0.9,True,1,14984,-1967.57,-7254033.3,29482068.88,22228035.58
21731,2014-07-14,1977.1,9.53,0.48,1985.44,-0.42,True,1,14985,-1977.1,-7256010.4,29626843.5,22370833.1
21732,2014-07-15,1973.28,-3.82,-0.19,1985.44,-0.61,True,1,14986,-1973.28,-7257983.68,29571574.08,22313590.4
21733,2014-07-16,1981.57,8.29,0.42,1985.44,-0.2,True,1,14987,-1981.57,-7259965.25,29697789.59,22437824.34
21734,2014-07-17,1958.12,-23.45,-1.18,1985.44,-1.38,True,1,14988,-1958.12,-7261923.37,29348302.56,22086379.19
21735,2014-07-18,1978.22,20.1,1.03,1985.44,-0.36,True,1,14989,-1978.22,-7263901.59,29651539.58,22387637.99
21736,2014-07-21,1973.63,-4.59,-0.23,1985.44,-0.6,True,1,14990,-1973.63,-7265875.22,29584713.7,22318838.48
21737,2014-07-22,1983.53,9.9,0.5,1985.44,-0.1,True,1,14991,-1983.53,-7267858.75,29735098.23,22467239.48
21738,2014-07-23,1987.01,3.48,0.18,1987.01,0.0,True,1,14992,-1987.01,-7269845.76,29789253.92,22519408.16
21739,2014-07-24,1987.98,0.97,0.05,1987.98,0.0,True,1,14993,-1987.98,-7271833.74,29805784.14,22533950.4
21740,2014-07-25,1978.34,-9.64,-0.48,1987.98,-0.48,True,1,14994,-1978.34,-7273812.08,29663229.96,22389417.88
21741,2014-07-28,1978.91,0.57,0.03,1987.98,-0.46,True,1,14995,-1978.91,-7275790.99,29673755.45,22397964.46
21742,2014-07-29,1969.95,-8.96,-0.45,1987.98,-0.91,True,1,14996,-1969.95,-7277760.94,29541370.2,22263609.26
21743,2014-07-30,1970.07,0.12,0.01,1987.98,-0.9,True,1,14997,-1970.07,-7279731.01,29545139.79,22265408.78
21744,2014-07-31,1930.67,-39.4,-2.0,1987.98,-2.88,True,1,14998,-1930.67,-7281661.68,28956188.66,21674526.98
21745,2014-08-01,1925.15,-5.52,-0.29,1987.98,-3.16,True,1,14999,-1925.15,-7283586.83,28875324.85,21591738.02
21746,2014-08-04,1938.99,13.84,0.72,1987.98,-2.46,True,1,15000,-1938.99,-7285525.82,29084850.0,21799324.18
21747,2014-08-05,1920.21,-18.78,-0.97,1987.98,-3.41,True,1,15001,-1920.21,-7287446.03,28805070.21,21517624.18
21748,2014-08-06,1920.24,0.03,0.0,1987.98,-3.41,True,1,15002,-1920.24,-7289366.27,28807440.48,21518074.21
21749,2014-08-07,1909.57,-10.67,-0.56,1987.98,-3.94,True,1,15003,-1909.57,-7291275.84,28649278.71,21358002.87
21750,2014-08-08,1931.59,22.02,1.15,1987.98,-2.84,True,1,15004,-1931.59,-7293207.43,28981576.36,21688368.93
21751,2014-08-11,1936.92,5.33,0.28,1987.98,-2.57,True,1,15005,-1936.92,-7295144.35,29063484.6,21768340.25
21752,2014-08-12,1933.75,-3.17,-0.16,1987.98,-2.73,True,1,15006,-1933.75,-7297078.1,29017852.5,21720774.4
21753,2014-08-13,1946.72,12.97,0.67,1987.98,-2.08,True,1,15007,-1946.72,-7299024.82,29214427.04,21915402.22
21754,2014-08-14,1955.18,8.46,0.44,1987.98,-1.65,True,1,15008,-1955.18,-7300980.0,29343341.44,22042361.44
21755,2014-08-15,1955.06,-0.12,-0.01,1987.98,-1.66,True,1,15009,-1955.06,-7302935.06,29343495.54,22040560.48
21756,2014-08-18,1971.74,16.68,0.85,1987.98,-0.82,True,1,15010,-1971.74,-7304906.8,29595817.4,22290910.6
21757,2014-08-19,1981.6,9.86,0.5,1987.98,-0.32,True,1,15011,-1981.6,-7306888.4,29745797.6,22438909.2
21758,2014-08-20,1986.51,4.91,0.25,1987.98,-0.07,True,1,15012,-1986.51,-7308874.91,29821488.12,22512613.21
21759,2014-08-21,1992.37,5.86,0.3,1992.37,0.0,True,1,15013,-1992.37,-7310867.28,29911450.81,22600583.53
21760,2014-08-22,1988.4,-3.97,-0.2,1992.37,-0.2,True,1,15014,-1988.4,-7312855.68,29853837.6,22540981.92
21761,2014-08-25,1997.92,9.52,0.48,1997.92,0.0,True,1,15015,-1997.92,-7314853.6,29998768.8,22683915.2
21762,2014-08-26,2000.02,2.1,0.1,2000.02,0.0,True,1,15016,-2000.02,-7316853.62,30032300.32,22715446.7
21763,2014-08-27,2000.12,0.1,0.0,2000.12,0.0,True,1,15017,-2000.12,-7318853.74,30035802.04,22716948.3
21764,2014-08-28,1996.74,-3.38,-0.17,2000.12,-0.17,True,1,15018,-1996.74,-7320850.48,29987041.32,22666190.84
21765,2014-08-29,2003.37,6.63,0.33,2003.37,0.0,True,1,15019,-2003.37,-7322853.85,30088614.03,22765760.18
21766,2014-09-02,2002.28,-1.09,-0.05,2003.37,-0.05,True,1,15020,-2002.28,-7324856.13,30074245.6,22749389.47
21767,2014-09-03,2000.72,-1.56,-0.08,2003.37,-0.13,True,1,15021,-2000.72,-7326856.85,30052815.12,22725958.27
21768,2014-09-04,1997.65,-3.07,-0.15,2003.37,-0.29,True,1,15022,-1997.65,-7328854.5,30008698.3,22679843.8
21769,2014-09-05,2007.71,10.06,0.5,2007.71,0.0,True,1,15023,-2007.71,-7330862.21,30161827.33,22830965.12
21770,2014-09-08,2001.54,-6.17,-0.31,2007.71,-0.31,True,1,15024,-2001.54,-7332863.75,30071136.96,22738273.21
21771,2014-09-09,1988.44,-13.1,-0.66,2007.71,-0.96,True,1,15025,-1988.44,-7334852.19,29876311.0,22541458.81
21772,2014-09-10,1995.69,7.25,0.36,2007.71,-0.6,True,1,15026,-1995.69,-7336847.88,29987237.94,22650390.06
21773,2014-09-11,1997.45,1.76,0.09,2007.71,-0.51,True,1,15027,-1997.45,-7338845.33,30015681.15,22676835.82
21774,2014-09-12,1985.54,-11.91,-0.6,2007.71,-1.1,True,1,15028,-1985.54,-7340830.87,29838695.12,22497864.25
21775,2014-09-15,1984.13,-1.41,-0.07,2007.71,-1.17,True,1,15029,-1984.13,-7342815.0,29819489.77,22476674.77
21776,2014-09-16,1998.98,14.85,0.75,2007.71,-0.44,True,1,15030,-1998.98,-7344813.98,30044669.4,22699855.42
21777,2014-09-17,2001.57,2.59,0.13,2007.71,-0.31,True,1,15031,-2001.57,-7346815.55,30085598.67,22738783.12
21778,2014-09-18,2011.36,9.79,0.49,2011.36,0.0,True,1,15032,-2011.36,-7348826.91,30234763.52,22885936.61
21779,2014-09-19,2010.4,-0.96,-0.05,2011.36,-0.05,True,1,15033,-2010.4,-7350837.31,30222343.2,22871505.89
21780,2014-09-22,1994.29,-16.11,-0.8,2011.36,-0.85,True,1,15034,-1994.29,-7352831.6,29982155.86,22629324.26
21781,2014-09-23,1982.77,-11.52,-0.58,2011.36,-1.42,True,1,15035,-1982.77,-7354814.37,29810946.95,22456132.58
21782,2014-09-24,1998.3,15.53,0.78,2011.36,-0.65,True,1,15036,-1998.3,-7356812.67,30046438.8,22689626.13
21783,2014-09-25,1965.99,-32.31,-1.62,2011.36,-2.26,True,1,15037,-1965.99,-7358778.66,29562591.63,22203812.97
21784,2014-09-26,1982.85,16.86,0.86,2011.36,-1.42,True,1,15038,-1982.85,-7360761.51,29818098.3,22457336.79
21785,2014-09-29,1977.8,-5.05,-0.26,2011.36,-1.67,True,1,15039,-1977.8,-7362739.31,29744134.2,22381394.89
21786,2014-09-30,1972.29,-5.51,-0.28,2011.36,-1.94,True,1,15040,-1972.29,-7364711.6,29663241.6,22298530.0
21787,2014-10-01,1946.16,-26.13,-1.32,2011.36,-3.24,True,1,15041,-1946.16,-7366657.76,29272192.56,21905534.8
21788,2014-10-02,1946.17,0.01,0.0,2011.36,-3.24,True,1,15042,-1946.17,-7368603.93,29274289.14,21905685.21
21789,2014-10-03,1967.9,21.73,1.12,2011.36,-2.16,True,1,15043,-1967.9,-7370571.83,29603119.7,22232547.87
21790,2014-10-06,1964.82,-3.08,-0.16,2011.36,-2.31,True,1,15044,-1964.82,-7372536.65,29558752.08,22186215.43
21791,2014-10-07,1935.1,-29.72,-1.51,2011.36,-3.79,True,1,15045,-1935.1,-7374471.75,29113579.5,21739107.75
21792,2014-10-08,1968.89,33.79,1.75,2011.36,-2.11,True,1,15046,-1968.89,-7376440.64,29623918.94,22247478.3
21793,2014-10-09,1928.21,-40.68,-2.07,2011.36,-4.13,True,1,15047,-1928.21,-7378368.85,29013775.87,21635407.02
21794,2014-10-10,1906.13,-22.08,-1.14,2011.36,-5.23,True,1,15048,-1906.13,-7380274.98,28683444.24,21303169.26
21795,2014-10-13,1874.74,-31.39,-1.65,2011.36,-6.79,True,1,15049,-1874.74,-7382149.72,28212962.26,20830812.54
21796,2014-10-14,1877.7,2.96,0.16,2011.36,-6.64,True,1,15050,-1877.7,-7384027.42,28259385.0,20875357.58
21797,2014-10-15,1862.49,-15.21,-0.81,2011.36,-7.4,True,1,15051,-1862.49,-7385889.91,28032336.99,20646447.08
21798,2014-10-16,1862.76,0.27,0.01,2011.36,-7.39,True,1,15052,-1862.76,-7387752.67,28038263.52,20650510.85
21799,2014-10-17,1886.76,24.0,1.29,2011.36,-6.2,True,1,15053,-1886.76,-7389639.43,28401398.28,21011758.85
21800,2014-10-20,1904.01,17.25,0.91,2011.36,-5.34,True,1,15054,-1904.01,-7391543.44,28662966.54,21271423.1
21801,2014-10-21,1941.28,37.27,1.96,2011.36,-3.48,True,1,15055,-1941.28,-7393484.72,29225970.4,21832485.68
21802,2014-10-22,1927.11,-14.17,-0.73,2011.36,-4.19,True,1,15056,-1927.11,-7395411.83,29014568.16,21619156.33
21803,2014-10-23,1950.82,23.71,1.23,2011.36,-3.01,True,1,15057,-1950.82,-7397362.65,29373496.74,21976134.09
21804,2014-10-24,1964.58,13.76,0.7,2011.36,-2.33,True,1,15058,-1964.58,-7399327.23,29582645.64,22183318.41
21805,2014-10-27,1961.63,-2.95,-0.15,2011.36,-2.47,True,1,15059,-1961.63,-7401288.86,29540186.17,22138897.31
21806,2014-10-28,1985.05,23.42,1.19,2011.36,-1.31,True,1,15060,-1985.05,-7403273.91,29894853.0,22491579.09
21807,2014-10-29,1982.3,-2.75,-0.14,2011.36,-1.44,True,1,15061,-1982.3,-7405256.21,29855420.3,22450164.09
21808,2014-10-30,1994.65,12.35,0.62,2011.36,-0.83,True,1,15062,-1994.65,-7407250.86,30043418.3,22636167.44
21809,2014-10-31,2018.05,23.4,1.17,2018.05,0.0,True,1,15063,-2018.05,-7409268.91,30397887.15,22988618.24
21810,2014-11-03,2017.81,-0.24,-0.01,2018.05,-0.01,True,1,15064,-2017.81,-7411286.72,30396289.84,22985003.12
21811,2014-11-04,2012.1,-5.71,-0.28,2018.05,-0.3,True,1,15065,-2012.1,-7413298.82,30312286.5,22898987.68
21812,2014-11-05,2023.57,11.47,0.57,2023.57,0.0,True,1,15066,-2023.57,-7415322.39,30487105.62,23071783.23
21813,2014-11-06,2031.21,7.64,0.38,2031.21,0.0,True,1,15067,-2031.21,-7417353.6,30604241.07,23186887.47
21814,2014-11-07,2031.92,0.71,0.04,2031.92,0.0,True,1,15068,-2031.92,-7419385.52,30616970.56,23197585.04
21815,2014-11-10,2038.26,6.34,0.31,2038.26,0.0,True,1,15069,-2038.26,-7421423.78,30714539.94,23293116.16
21816,2014-11-11,2039.68,1.42,0.07,2039.68,0.0,True,1,15070,-2039.68,-7423463.46,30737977.6,23314514.14
21817,2014-11-12,2038.25,-1.43,-0.07,2039.68,-0.07,True,1,15071,-2038.25,-7425501.71,30718465.75,23292964.04
21818,2014-11-13,2039.33,1.08,0.05,2039.68,-0.02,True,1,15072,-2039.33,-7427541.04,30736781.76,23309240.72
21819,2014-11-14,2039.82,0.49,0.02,2039.82,0.0,True,1,15073,-2039.82,-7429580.86,30746206.86,23316626.0
21820,2014-11-17,2041.32,1.5,0.07,2041.32,0.0,True,1,15074,-2041.32,-7431622.18,30770857.68,23339235.5
21821,2014-11-18,2051.8,10.48,0.51,2051.8,0.0,True,1,15075,-2051.8,-7433673.98,30930885.0,23497211.02
21822,2014-11-19,2048.72,-3.08,-0.15,2051.8,-0.15,True,1,15076,-2048.72,-7435722.7,30886502.72,23450780.02
21823,2014-11-20,2052.75,4.03,0.2,2052.75,0.0,True,1,15077,-2052.75,-7437775.45,30949311.75,23511536.3
21824,2014-11-21,2063.5,10.75,0.52,2063.5,0.0,True,1,15078,-2063.5,-7439838.95,31113453.0,23673614.05
21825,2014-11-24,2069.41,5.91,0.29,2069.41,0.0,True,1,15079,-2069.41,-7441908.36,31204633.39,23762725.03
21826,2014-11-25,2067.03,-2.38,-0.12,2069.41,-0.12,True,1,15080,-2067.03,-7443975.39,31170812.4,23726837.01
21827,2014-11-26,2072.83,5.8,0.28,2072.83,0.0,True,1,15081,-2072.83,-7446048.22,31260349.23,23814301.01
21828,2014-11-28,2067.56,-5.27,-0.25,2072.83,-0.25,True,1,15082,-2067.56,-7448115.78,31182939.92,23734824.14
21829,2014-12-01,2053.44,-14.12,-0.68,2072.83,-0.94,True,1,15083,-2053.44,-7450169.22,30972035.52,23521866.3
21830,2014-12-02,2066.55,13.11,0.64,2072.83,-0.3,True,1,15084,-2066.55,-7452235.77,31171840.2,23719604.43
21831,2014-12-03,2074.33,7.78,0.38,2074.33,0.0,True,1,15085,-2074.33,-7454310.1,31291268.05,23836957.95
21832,2014-12-04,2071.92,-2.41,-0.12,2074.33,-0.12,True,1,15086,-2071.92,-7456382.02,31256985.12,23800603.1
21833,2014-12-05,2075.37,3.45,0.17,2075.37,0.0,True,1,15087,-2075.37,-7458457.39,31311107.19,23852649.8
21834,2014-12-08,2060.31,-15.06,-0.73,2075.37,-0.73,True,1,15088,-2060.31,-7460517.7,31085957.28,23625439.58
21835,2014-12-09,2059.82,-0.49,-0.02,2075.37,-0.75,True,1,15089,-2059.82,-7462577.52,31080623.98,23618046.46
21836,2014-12-10,2026.14,-33.68,-1.64,2075.37,-2.37,True,1,15090,-2026.14,-7464603.66,30574452.6,23109848.94
21837,2014-12-11,2035.33,9.19,0.45,2075.37,-1.93,True,1,15091,-2035.33,-7466638.99,30715165.03,23248526.04
21838,2014-12-12,2002.33,-33.0,-1.62,2075.37,-3.52,True,1,15092,-2002.33,-7468641.32,30219164.36,22750523.04
21839,2014-12-15,1989.63,-12.7,-0.63,2075.37,-4.13,True,1,15093,-1989.63,-7470630.95,30029485.59,22558854.64
21840,2014-12-16,1972.74,-16.89,-0.85,2075.37,-4.94,True,1,15094,-1972.74,-7472603.69,29776537.56,22303933.87
21841,2014-12-17,2012.89,40.15,2.04,2075.37,-3.01,True,1,15095,-2012.89,-7474616.58,30384574.55,22909957.97
21842,2014-12-18,2061.23,48.34,2.4,2075.37,-0.68,True,1,15096,-2061.23,-7476677.81,31116328.08,23639650.27
21843,2014-12-19,2070.65,9.42,0.46,2075.37,-0.23,True,1,15097,-2070.65,-7478748.46,31260603.05,23781854.59
21844,2014-12-22,2078.54,7.89,0.38,2078.54,0.0,True,1,15098,-2078.54,-7480827.0,31381796.92,23900969.92
21845,2014-12-23,2082.17,3.63,0.18,2082.17,0.0,True,1,15099,-2082.17,-7482909.17,31438684.83,23955775.66
21846,2014-12-24,2081.88,-0.29,-0.01,2082.17,-0.01,True,1,15100,-2081.88,-7484991.05,31436388.0,23951396.95
21847,2014-12-26,2088.77,6.89,0.33,2088.77,0.0,True,1,15101,-2088.77,-7487079.82,31542515.77,24055435.95
21848,2014-12-29,2090.57,1.8,0.09,2090.57,0.0,True,1,15102,-2090.57,-7489170.39,31571788.14,24082617.75
21849,2014-12-30,2080.35,-10.22,-0.49,2090.57,-0.49,True,1,15103,-2080.35,-7491250.74,31419526.05,23928275.31
21850,2014-12-31,2058.9,-21.45,-1.03,2090.57,-1.52,True,1,15104,-2058.9,-7493309.64,31097625.6,23604315.96
21851,2015-01-02,2058.2,-0.7,-0.03,2090.57,-1.55,True,1,15105,-2058.2,-7495367.84,31089111.0,23593743.16
21852,2015-01-05,2020.58,-37.62,-1.83,2090.57,-3.35,True,1,15106,-2020.58,-7497388.42,30522881.48,23025493.06
21853,2015-01-06,2002.61,-17.97,-0.89,2090.57,-4.21,True,1,15107,-2002.61,-7499391.03,30253429.27,22754038.24
21854,2015-01-07,2025.9,23.29,1.16,2090.57,-3.09,True,1,15108,-2025.9,-7501416.93,30607297.2,23105880.27
21855,2015-01-08,2062.14,36.24,1.79,2090.57,-1.36,True,1,15109,-2062.14,-7503479.07,31156873.26,23653394.19
21856,2015-01-09,2044.81,-17.33,-0.84,2090.57,-2.19,True,1,15110,-2044.81,-7505523.88,30897079.1,23391555.22
21857,2015-01-12,2028.26,-16.55,-0.81,2090.57,-2.98,True,1,15111,-2028.26,-7507552.14,30649036.86,23141484.72
21858,2015-01-13,2023.03,-5.23,-0.26,2090.57,-3.23,True,1,15112,-2023.03,-7509575.17,30572029.36,23062454.19
21859,2015-01-14,2011.27,-11.76,-0.58,2090.57,-3.79,True,1,15113,-2011.27,-7511586.44,30396323.51,22884737.07
21860,2015-01-15,1992.67,-18.6,-0.92,2090.57,-4.68,True,1,15114,-1992.67,-7513579.11,30117214.38,22603635.27
21861,2015-01-16,2019.42,26.75,1.34,2090.57,-3.4,True,1,15115,-2019.42,-7515598.53,30523533.3,23007934.77
21862,2015-01-20,2022.55,3.13,0.16,2090.57,-3.25,True,1,15116,-2022.55,-7517621.08,30572865.8,23055244.72
21863,2015-01-21,2032.12,9.57,0.47,2090.57,-2.8,True,1,15117,-2032.12,-7519653.2,30719558.04,23199904.84
21864,2015-01-22,2063.15,31.03,1.53,2090.57,-1.31,True,1,15118,-2063.15,-7521716.35,31190701.7,23668985.35
21865,2015-01-23,2051.82,-11.33,-0.55,2090.57,-1.85,True,1,15119,-2051.82,-7523768.17,31021466.58,23497698.41
21866,2015-01-26,2057.09,5.27,0.26,2090.57,-1.6,True,1,15120,-2057.09,-7525825.26,31103200.8,23577375.54
21867,2015-01-27,2029.55,-27.54,-1.34,2090.57,-2.92,True,1,15121,-2029.55,-7527854.81,30688825.55,23160970.74
21868,2015-01-28,2002.16,-27.39,-1.35,2090.57,-4.23,True,1,15122,-2002.16,-7529856.97,30276663.52,22746806.55
21869,2015-01-29,2021.25,19.09,0.95,2090.57,-3.32,True,1,15123,-2021.25,-7531878.22,30567363.75,23035485.53
21870,2015-01-30,1994.99,-26.26,-1.3,2090.57,-4.57,True,1,15124,-1994.99,-7533873.21,30172228.76,22638355.55
21871,2015-02-02,2020.85,25.86,1.3,2090.57,-3.34,True,1,15125,-2020.85,-7535894.06,30565356.25,23029462.19
21872,2015-02-03,2050.03,29.18,1.44,2090.57,-1.94,True,1,15126,-2050.03,-7537944.09,31008753.78,23470809.69
21873,2015-02-04,2041.51,-8.52,-0.42,2090.57,-2.35,True,1,15127,-2041.51,-7539985.6,30881921.77,23341936.17
21874,2015-02-05,2062.52,21.01,1.03,2090.57,-1.34,True,1,15128,-2062.52,-7542048.12,31201802.56,23659754.44
21875,2015-02-06,2055.47,-7.05,-0.34,2090.57,-1.68,True,1,15129,-2055.47,-7544103.59,31097205.63,23553102.04
21876,2015-02-09,2046.74,-8.73,-0.42,2090.57,-2.1,True,1,15130,-2046.74,-7546150.33,30967176.2,23421025.87
21877,2015-02-10,2068.59,21.85,1.07,2090.57,-1.05,True,1,15131,-2068.59,-7548218.92,31299835.29,23751616.37
21878,2015-02-11,2068.53,-0.06,-0.0,2090.57,-1.05,True,1,15132,-2068.53,-7550287.45,31300995.96,23750708.51
21879,2015-02-12,2088.48,19.95,0.96,2090.57,-0.1,True,1,15133,-2088.48,-7552375.93,31604967.84,24052591.91
21880,2015-02-13,2096.99,8.51,0.41,2096.99,0.0,True,1,15134,-2096.99,-7554472.92,31735846.66,24181373.74
21881,2015-02-17,2100.34,3.35,0.16,2100.34,0.0,True,1,15135,-2100.34,-7556573.26,31788645.9,24232072.64
21882,2015-02-18,2099.68,-0.66,-0.03,2100.34,-0.03,True,1,15136,-2099.68,-7558672.94,31780756.48,24222083.54
21883,2015-02-19,2097.45,-2.23,-0.11,2100.34,-0.14,True,1,15137,-2097.45,-7560770.39,31749100.65,24188330.26
21884,2015-02-20,2110.3,12.85,0.61,2110.3,0.0,True,1,15138,-2110.3,-7562880.69,31945721.4,24382840.71
21885,2015-02-23,2109.66,-0.64,-0.03,2110.3,-0.03,True,1,15139,-2109.66,-7564990.35,31938142.74,24373152.39
21886,2015-02-24,2115.48,5.82,0.28,2115.48,0.0,True,1,15140,-2115.48,-7567105.83,32028367.2,24461261.37
21887,2015-02-25,2113.86,-1.62,-0.08,2115.48,-0.08,True,1,15141,-2113.86,-7569219.69,32005954.26,24436734.57
21888,2015-02-26,2110.74,-3.12,-0.15,2115.48,-0.22,True,1,15142,-2110.74,-7571330.43,31960825.08,24389494.65
21889,2015-02-27,2104.5,-6.24,-0.3,2115.48,-0.52,True,1,15143,-2104.5,-7573434.93,31868443.5,24295008.57
21890,2015-03-02,2117.39,12.89,0.61,2117.39,0.0,True,1,15144,-2117.39,-7575552.32,32065754.16,24490201.84
21891,2015-03-03,2107.78,-9.61,-0.45,2117.39,-0.45,True,1,15145,-2107.78,-7577660.1,31922328.1,24344668.0
21892,2015-03-04,2098.53,-9.25,-0.44,2117.39,-0.89,True,1,15146,-2098.53,-7579758.63,31784335.38,24204576.75
21893,2015-03-05,2101.04,2.51,0.12,2117.39,-0.77,True,1,15147,-2101.04,-7581859.67,31824452.88,24242593.21
21894,2015-03-06,2071.26,-29.78,-1.42,2117.39,-2.18,True,1,15148,-2071.26,-7583930.93,31375446.48,23791515.55
21895,2015-03-09,2079.43,8.17,0.39,2117.39,-1.79,True,1,15149,-2079.43,-7586010.36,31501285.07,23915274.71
21896,2015-03-10,2044.16,-35.27,-1.7,2117.39,-3.46,True,1,15150,-2044.16,-7588054.52,30969024.0,23380969.48
21897,2015-03-11,2040.24,-3.92,-0.19,2117.39,-3.64,True,1,15151,-2040.24,-7590094.76,30911676.24,23321581.48
21898,2015-03-12,2065.95,25.71,1.26,2117.39,-2.43,True,1,15152,-2065.95,-7592160.71,31303274.4,23711113.69
21899,2015-03-13,2053.4,-12.55,-0.61,2117.39,-3.02,True,1,15153,-2053.4,-7594214.11,31115170.2,23520956.09
21900,2015-03-16,2081.19,27.79,1.35,2117.39,-1.71,True,1,15154,-2081.19,-7596295.3,31538353.26,23942057.96
21901,2015-03-17,2074.28,-6.91,-0.33,2117.39,-2.04,True,1,15155,-2074.28,-7598369.58,31435713.4,23837343.82
21902,2015-03-18,2099.5,25.22,1.22,2117.39,-0.84,True,1,15156,-2099.5,-7600469.08,31820022.0,24219552.92
21903,2015-03-19,2089.27,-10.23,-0.49,2117.39,-1.33,True,1,15157,-2089.27,-7602558.35,31667065.39,24064507.04
21904,2015-03-20,2108.1,18.83,0.9,2117.39,-0.44,True,1,15158,-2108.1,-7604666.45,31954579.8,24349913.35
21905,2015-03-23,2104.42,-3.68,-0.18,2117.39,-0.61,True,1,15159,-2104.42,-7606770.87,31900902.78,24294131.91
21906,2015-03-24,2091.5,-12.92,-0.61,2117.39,-1.22,True,1,15160,-2091.5,-7608862.37,31707140.0,24098277.63
21907,2015-03-25,2061.05,-30.45,-1.46,2117.39,-2.66,True,1,15161,-2061.05,-7610923.42,31247579.05,23636655.63
21908,2015-03-26,2056.15,-4.9,-0.24,2117.39,-2.89,True,1,15162,-2056.15,-7612979.57,31175346.3,23562366.73
21909,2015-03-27,2061.02,4.87,0.24,2117.39,-2.66,True,1,15163,-2061.02,-7615040.59,31251246.26,23636205.67
21910,2015-03-30,2086.24,25.22,1.22,2117.39,-1.47,True,1,15164,-2086.24,-7617126.83,31635743.36,24018616.53
21911,2015-03-31,2067.89,-18.35,-0.88,2117.39,-2.34,True,1,15165,-2067.89,-7619194.72,31359551.85,23740357.13
21912,2015-04-01,2059.69,-8.2,-0.4,2117.39,-2.72,True,1,15166,-2059.69,-7621254.41,31237258.54,23616004.13
21913,2015-04-02,2066.96,7.27,0.35,2117.39,-2.38,True,1,15167,-2066.96,-7623321.37,31349582.32,23726260.95
21914,2015-04-06,2080.62,13.66,0.66,2117.39,-1.74,True,1,15168,-2080.62,-7625401.99,31558844.16,23933442.17
21915,2015-04-07,2076.33,-4.29,-0.21,2117.39,-1.94,True,1,15169,-2076.33,-7627478.32,31495849.77,23868371.45
21916,2015-04-08,2081.9,5.57,0.27,2117.39,-1.68,True,1,15170,-2081.9,-7629560.22,31582423.0,23952862.78
21917,2015-04-09,2091.18,9.28,0.45,2117.39,-1.24,True,1,15171,-2091.18,-7631651.4,31725291.78,24093640.38
21918,2015-04-10,2102.06,10.88,0.52,2117.39,-0.72,True,1,15172,-2102.06,-7633753.46,31892454.32,24258700.86
21919,2015-04-13,2092.43,-9.63,-0.46,2117.39,-1.18,True,1,15173,-2092.43,-7635845.89,31748440.39,24112594.5
21920,2015-04-14,2095.84,3.41,0.16,2117.39,-1.02,True,1,15174,-2095.84,-7637941.73,31802276.16,24164334.43
21921,2015-04-15,2106.63,10.79,0.52,2117.39,-0.51,True,1,15175,-2106.63,-7640048.36,31968110.25,24328061.89
21922,2015-04-16,2104.99,-1.64,-0.08,2117.39,-0.59,True,1,15176,-2104.99,-7642153.35,31945328.24,24303174.89
21923,2015-04-17,2081.18,-23.81,-1.13,2117.39,-1.71,True,1,15177,-2081.18,-7644234.53,31586068.86,23941834.33
21924,2015-04-20,2100.4,19.22,0.92,2117.39,-0.8,True,1,15178,-2100.4,-7646334.93,31879871.2,24233536.27
21925,2015-04-21,2097.29,-3.11,-0.15,2117.39,-0.95,True,1,15179,-2097.29,-7648432.22,31834764.91,24186332.69
21926,2015-04-22,2107.96,10.67,0.51,2117.39,-0.44,True,1,15180,-2107.96,-7650540.18,31998832.8,24348292.62
21927,2015-04-23,2112.93,4.97,0.24,2117.39,-0.21,True,1,15181,-2112.93,-7652653.11,32076390.33,24423737.22
21928,2015-04-24,2117.69,4.76,0.22,2117.69,0.0,True,1,15182,-2117.69,-7654770.8,32150769.58,24495998.78
21929,2015-04-27,2108.92,-8.77,-0.41,2117.69,-0.41,True,1,15183,-2108.92,-7656879.72,32019732.36,24362852.64
21930,2015-04-28,2114.76,5.84,0.28,2117.69,-0.14,True,1,15184,-2114.76,-7658994.48,32110515.84,24451521.36
21931,2015-04-29,2106.85,-7.91,-0.37,2117.69,-0.51,True,1,15185,-2106.85,-7661101.33,31992517.25,24331415.92
21932,2015-04-30,2085.51,-21.34,-1.01,2117.69,-1.52,True,1,15186,-2085.51,-7663186.84,31670554.86,24007368.02
21933,2015-05-01,2108.29,22.78,1.09,2117.69,-0.44,True,1,15187,-2108.29,-7665295.13,32018600.23,24353305.1
21934,2015-05-04,2114.49,6.2,0.29,2117.69,-0.15,True,1,15188,-2114.49,-7667409.62,32114874.12,24447464.5
21935,2015-05-05,2089.46,-25.03,-1.18,2117.69,-1.33,True,1,15189,-2089.46,-7669499.08,31736807.94,24067308.86
21936,2015-05-06,2080.15,-9.31,-0.45,2117.69,-1.77,True,1,15190,-2080.15,-7671579.23,31597478.5,23925899.27
21937,2015-05-07,2088.0,7.85,0.38,2117.69,-1.4,True,1,15191,-2088.0,-7673667.23,31718808.0,24045140.77
21938,2015-05-08,2116.1,28.1,1.35,2117.69,-0.08,True,1,15192,-2116.1,-7675783.33,32147791.2,24472007.87
21939,2015-05-11,2105.33,-10.77,-0.51,2117.69,-0.58,True,1,15193,-2105.33,-7677888.66,31986278.69,24308390.03
21940,2015-05-12,2099.12,-6.21,-0.3,2117.69,-0.88,True,1,15194,-2099.12,-7679987.78,31894029.28,24214041.5
21941,2015-05-13,2098.48,-0.64,-0.03,2117.69,-0.91,True,1,15195,-2098.48,-7682086.26,31886403.6,24204317.34
21942,2015-05-14,2121.1,22.62,1.08,2121.1,0.0,True,1,15196,-2121.1,-7684207.36,32232235.6,24548028.24
21943,2015-05-15,2122.73,1.63,0.08,2122.73,0.0,True,1,15197,-2122.73,-7686330.09,32259127.81,24572797.72
21944,2015-05-18,2129.2,6.47,0.3,2129.2,0.0,True,1,15198,-2129.2,-7688459.29,32359581.6,24671122.31
21945,2015-05-19,2127.83,-1.37,-0.06,2129.2,-0.06,True,1,15199,-2127.83,-7690587.12,32340888.17,24650301.05
21946,2015-05-20,2125.85,-1.98,-0.09,2129.2,-0.16,True,1,15200,-2125.85,-7692712.97,32312920.0,24620207.03
21947,2015-05-21,2130.82,4.97,0.23,2130.82,0.0,True,1,15201,-2130.82,-7694843.79,32390594.82,24695751.03
21948,2015-05-22,2126.06,-4.76,-0.22,2130.82,-0.22,True,1,15202,-2126.06,-7696969.85,32320364.12,24623394.27
21949,2015-05-26,2104.2,-21.86,-1.03,2130.82,-1.25,True,1,15203,-2104.2,-7699074.05,31990152.6,24291078.55
21950,2015-05-27,2123.48,19.28,0.92,2130.82,-0.34,True,1,15204,-2123.48,-7701197.53,32285389.92,24584192.39
21951,2015-05-28,2120.79,-2.69,-0.13,2130.82,-0.47,True,1,15205,-2120.79,-7703318.32,32246611.95,24543293.63
21952,2015-05-29,2107.39,-13.4,-0.63,2130.82,-1.1,True,1,15206,-2107.39,-7705425.71,32044972.34,24339546.63
21953,2015-06-01,2111.73,4.34,0.21,2130.82,-0.9,True,1,15207,-2111.73,-7707537.44,32113078.11,24405540.67
21954,2015-06-02,2109.6,-2.13,-0.1,2130.82,-1.0,True,1,15208,-2109.6,-7709647.04,32082796.8,24373149.76
21955,2015-06-03,2114.07,4.47,0.21,2130.82,-0.79,True,1,15209,-2114.07,-7711761.11,32152890.63,24441129.52
21956,2015-06-04,2095.84,-18.23,-0.86,2130.82,-1.64,True,1,15210,-2095.84,-7713856.95,31877726.4,24163869.45
21957,2015-06-05,2092.83,-3.01,-0.14,2130.82,-1.78,True,1,15211,-2092.83,-7715949.78,31834037.13,24118087.35
21958,2015-06-08,2079.28,-13.55,-0.65,2130.82,-2.42,True,1,15212,-2079.28,-7718029.06,31630007.36,23911978.3
21959,2015-06-09,2080.15,0.87,0.04,2130.82,-2.38,True,1,15213,-2080.15,-7720109.21,31645321.95,23925212.74
21960,2015-06-10,2105.2,25.05,1.2,2130.82,-1.2,True,1,15214,-2105.2,-7722214.41,32028512.8,24306298.39
21961,2015-06-11,2108.86,3.66,0.17,2130.82,-1.03,True,1,15215,-2108.86,-7724323.27,32086304.9,24361981.63
21962,2015-06-12,2094.11,-14.75,-0.7,2130.82,-1.72,True,1,15216,-2094.11,-7726417.38,31863977.76,24137560.38
21963,2015-06-15,2084.43,-9.68,-0.46,2130.82,-2.18,True,1,15217,-2084.43,-7728501.81,31718771.31,23990269.5
21964,2015-06-16,2096.29,11.86,0.57,2130.82,-1.62,True,1,15218,-2096.29,-7730598.1,31901341.22,24170743.12
21965,2015-06-17,2100.44,4.15,0.2,2130.82,-1.43,True,1,15219,-2100.44,-7732698.54,31966596.36,24233897.82
21966,2015-06-18,2121.24,20.8,0.99,2130.82,-0.45,True,1,15220,-2121.24,-7734819.78,32285272.8,24550453.02
21967,2015-06-19,2109.99,-11.25,-0.53,2130.82,-0.98,True,1,15221,-2109.99,-7736929.77,32116157.79,24379228.02
21968,2015-06-22,2122.85,12.86,0.61,2130.82,-0.37,True,1,15222,-2122.85,-7739052.62,32314022.7,24574970.08
21969,2015-06-23,2124.2,1.35,0.06,2130.82,-0.31,True,1,15223,-2124.2,-7741176.82,32336696.6,24595519.78
21970,2015-06-24,2108.58,-15.62,-0.74,2130.82,-1.04,True,1,15224,-2108.58,-7743285.4,32101021.92,24357736.52
21971,2015-06-25,2102.31,-6.27,-0.3,2130.82,-1.34,True,1,15225,-2102.31,-7745387.71,32007669.75,24262282.04
21972,2015-06-26,2101.49,-0.82,-0.04,2130.82,-1.38,True,1,15226,-2101.49,-7747489.2,31997286.74,24249797.54
21973,2015-06-29,2057.64,-43.85,-2.09,2130.82,-3.43,True,1,15227,-2057.64,-7749546.84,31331684.28,23582137.44
21974,2015-06-30,2063.11,5.47,0.27,2130.82,-3.18,True,1,15228,-2063.11,-7751609.95,31417039.08,23665429.13
21975,2015-07-01,2077.42,14.31,0.69,2130.82,-2.51,True,1,15229,-2077.42,-7753687.37,31637029.18,23883341.81
21976,2015-07-02,2076.78,-0.64,-0.03,2130.82,-2.54,True,1,15230,-2076.78,-7755764.15,31629359.4,23873595.25
21977,2015-07-06,2068.76,-8.02,-0.39,2130.82,-2.91,True,1,15231,-2068.76,-7757832.91,31509283.56,23751450.65
21978,2015-07-07,2081.34,12.58,0.61,2130.82,-2.32,True,1,15232,-2081.34,-7759914.25,31702970.88,23943056.63
21979,2015-07-08,2046.68,-34.66,-1.66,2130.82,-3.95,True,1,15233,-2046.68,-7761960.93,31177076.44,23415115.51
21980,2015-07-09,2051.31,4.63,0.23,2130.82,-3.73,True,1,15234,-2051.31,-7764012.24,31249656.54,23485644.3
21981,2015-07-10,2076.62,25.31,1.23,2130.82,-2.54,True,1,15235,-2076.62,-7766088.86,31637305.7,23871216.84
21982,2015-07-13,2099.6,22.98,1.11,2130.82,-1.46,True,1,15236,-2099.6,-7768188.46,31989505.6,24221317.14
21983,2015-07-14,2108.95,9.35,0.44,2130.82,-1.03,True,1,15237,-2108.95,-7770297.41,32134071.15,24363773.74
21984,2015-07-15,2107.4,-1.55,-0.07,2130.82,-1.1,True,1,15238,-2107.4,-7772404.81,32112561.2,24340156.39
21985,2015-07-16,2124.29,16.89,0.8,2130.82,-0.31,True,1,15239,-2124.29,-7774529.1,32372055.31,24597526.21
21986,2015-07-17,2126.64,2.35,0.11,2130.82,-0.2,True,1,15240,-2126.64,-7776655.74,32409993.6,24633337.86
21987,2015-07-20,2128.28,1.64,0.08,2130.82,-0.12,True,1,15241,-2128.28,-7778784.02,32437115.48,24658331.46
21988,2015-07-21,2119.21,-9.07,-0.43,2130.82,-0.55,True,1,15242,-2119.21,-7780903.23,32300998.82,24520095.59
21989,2015-07-22,2114.15,-5.06,-0.24,2130.82,-0.78,True,1,15243,-2114.15,-7783017.38,32225988.45,24442971.07
21990,2015-07-23,2102.15,-12.0,-0.57,2130.82,-1.34,True,1,15244,-2102.15,-7785119.53,32045174.6,24260055.07
21991,2015-07-24,2079.65,-22.5,-1.07,2130.82,-2.4,True,1,15245,-2079.65,-7787199.18,31704264.25,23917065.07
21992,2015-07-27,2067.64,-12.01,-0.58,2130.82,-2.96,True,1,15246,-2067.64,-7789266.82,31523239.44,23733972.62
21993,2015-07-28,2093.25,25.61,1.24,2130.82,-1.76,True,1,15247,-2093.25,-7791360.07,31915782.75,24124422.68
21994,2015-07-29,2108.57,15.32,0.73,2130.82,-1.04,True,1,15248,-2108.57,-7793468.64,32151475.36,24358006.72
21995,2015-07-30,2108.63,0.06,0.0,2130.82,-1.04,True,1,15249,-2108.63,-7795577.27,32154498.87,24358921.6
21996,2015-07-31,2103.84,-4.79,-0.23,2130.82,-1.27,True,1,15250,-2103.84,-7797681.11,32083560.0,24285878.89
21997,2015-08-03,2098.04,-5.8,-0.28,2130.82,-1.54,True,1,15251,-2098.04,-7799779.15,31997208.04,24197428.89
21998,2015-08-04,2093.32,-4.72,-0.22,2130.82,-1.76,True,1,15252,-2093.32,-7801872.47,31927316.64,24125444.17
21999,2015-08-05,2099.84,6.52,0.31,2130.82,-1.45,True,1,15253,-2099.84,-7803972.31,32028859.52,24224887.21
22000,2015-08-06,2083.56,-16.28,-0.78,2130.82,-2.22,True,1,15254,-2083.56,-7806055.87,31782624.24,23976568.37
22001,2015-08-07,2077.57,-5.99,-0.29,2130.82,-2.5,True,1,15255,-2077.57,-7808133.44,31693330.35,23885196.91
22002,2015-08-10,2104.18,26.61,1.28,2130.82,-1.25,True,1,15256,-2104.18,-7810237.62,32101370.08,24291132.46
22003,2015-08-11,2084.07,-20.11,-0.96,2130.82,-2.19,True,1,15257,-2084.07,-7812321.69,31796655.99,23984334.3
22004,2015-08-12,2086.05,1.98,0.1,2130.82,-2.1,True,1,15258,-2086.05,-7814407.74,31828950.9,24014543.16
22005,2015-08-13,2083.39,-2.66,-0.13,2130.82,-2.23,True,1,15259,-2083.39,-7816491.13,31790448.01,23973956.88
22006,2015-08-14,2091.54,8.15,0.39,2130.82,-1.84,True,1,15260,-2091.54,-7818582.67,31916900.4,24098317.73
22007,2015-08-17,2102.44,10.9,0.52,2130.82,-1.33,True,1,15261,-2102.44,-7820685.11,32085336.84,24264651.73
22008,2015-08-18,2096.92,-5.52,-0.26,2130.82,-1.59,True,1,15262,-2096.92,-7822782.03,32003193.04,24180411.01
22009,2015-08-19,2079.61,-17.31,-0.82,2130.82,-2.4,True,1,15263,-2079.61,-7824861.64,31741087.43,23916225.79
22010,2015-08-20,2035.73,-43.88,-2.11,2130.82,-4.46,True,1,15264,-2035.73,-7826897.37,31073382.72,23246485.35
22011,2015-08-21,1970.89,-64.84,-3.18,2130.82,-7.51,True,1,15265,-1970.89,-7828868.26,30085635.85,22256767.59
22012,2015-08-24,1893.21,-77.68,-3.94,2130.82,-11.15,True,1,15266,-1893.21,-7830761.47,28901743.86,21070982.39
22013,2015-08-25,1867.61,-25.6,-1.35,2130.82,-12.35,True,1,15267,-1867.61,-7832629.08,28512801.87,20680172.79
22014,2015-08-26,1940.51,72.9,3.9,2130.82,-8.93,True,1,15268,-1940.51,-7834569.59,29627706.68,21793137.09
22015,2015-08-27,1987.66,47.15,2.43,2130.82,-6.72,True,1,15269,-1987.66,-7836557.25,30349580.54,22513023.29
22016,2015-08-28,1988.87,1.21,0.06,2130.82,-6.66,True,1,15270,-1988.87,-7838546.12,30370044.9,22531498.78
22017,2015-08-31,1972.18,-16.69,-0.84,2130.82,-7.44,True,1,15271,-1972.18,-7840518.3,30117160.78,22276642.48
22018,2015-09-01,1913.85,-58.33,-2.96,2130.82,-10.18,True,1,15272,-1913.85,-7842432.15,29228317.2,21385885.05
22019,2015-09-02,1948.86,35.01,1.83,2130.82,-8.54,True,1,15273,-1948.86,-7844381.01,29764938.78,21920557.77
22020,2015-09-03,1951.13,2.27,0.12,2130.82,-8.43,True,1,15274,-1951.13,-7846332.14,29801559.62,21955227.48
22021,2015-09-04,1921.22,-29.91,-1.53,2130.82,-9.84,True,1,15275,-1921.22,-7848253.36,29346635.5,21498382.14
22022,2015-09-08,1969.41,48.19,2.51,2130.82,-7.58,True,1,15276,-1969.41,-7850222.77,30084707.16,22234484.39
22023,2015-09-09,1942.04,-27.37,-1.39,2130.82,-8.86,True,1,15277,-1942.04,-7852164.81,29668545.08,21816380.27
22024,2015-09-10,1952.29,10.25,0.53,2130.82,-8.38,True,1,15278,-1952.29,-7854117.1,29827086.62,21972969.52
22025,2015-09-11,1961.05,8.76,0.45,2130.82,-7.97,True,1,15279,-1961.05,-7856078.15,29962882.95,22106804.8
22026,2015-09-14,1953.03,-8.02,-0.41,2130.82,-8.34,True,1,15280,-1953.03,-7858031.18,29842298.4,21984267.22
22027,2015-09-15,1978.09,25.06,1.28,2130.82,-7.17,True,1,15281,-1978.09,-7860009.27,30227193.29,22367184.02
22028,2015-09-16,1995.31,17.22,0.87,2130.82,-6.36,True,1,15282,-1995.31,-7862004.58,30492327.42,22630322.84
22029,2015-09-17,1990.2,-5.11,-0.26,2130.82,-6.6,True,1,15283,-1990.2,-7863994.78,30416226.6,22552231.82
22030,2015-09-18,1958.03,-32.17,-1.62,2130.82,-8.11,True,1,15284,-1958.03,-7865952.81,29926530.52,22060577.71
22031,2015-09-21,1966.97,8.94,0.46,2130.82,-7.69,True,1,15285,-1966.97,-7867919.78,30065136.45,22197216.67
22032,2015-09-22,1942.74,-24.23,-1.23,2130.82,-8.83,True,1,15286,-1942.74,-7869862.52,29696723.64,21826861.12
22033,2015-09-23,1938.76,-3.98,-0.2,2130.82,-9.01,True,1,15287,-1938.76,-7871801.28,29637824.12,21766022.84
22034,2015-09-24,1932.24,-6.52,-0.34,2130.82,-9.32,True,1,15288,-1932.24,-7873733.52,29540085.12,21666351.6
22035,2015-09-25,1931.34,-0.9,-0.05,2130.82,-9.36,True,1,15289,-1931.34,-7875664.86,29528257.26,21652592.4
22036,2015-09-28,1881.77,-49.57,-2.57,2130.82,-11.69,True,1,15290,-1881.77,-7877546.63,28772263.3,20894716.67
22037,2015-09-29,1884.09,2.32,0.12,2130.82,-11.58,True,1,15291,-1884.09,-7879430.72,28809620.19,20930189.47
22038,2015-09-30,1920.03,35.94,1.91,2130.82,-9.89,True,1,15292,-1920.03,-7881350.75,29361098.76,21479748.01
22039,2015-10-01,1923.82,3.79,0.2,2130.82,-9.72,True,1,15293,-1923.82,-7883274.57,29420979.26,21537704.69
22040,2015-10-02,1951.36,27.54,1.43,2130.82,-8.42,True,1,15294,-1951.36,-7885225.93,29844099.84,21958873.91
22041,2015-10-05,1987.05,35.69,1.83,2130.82,-6.75,True,1,15295,-1987.05,-7887212.98,30391929.75,22504716.77
22042,2015-10-06,1979.92,-7.13,-0.36,2130.82,-7.08,True,1,15296,-1979.92,-7889192.9,30284856.32,22395663.42
22043,2015-10-07,1995.83,15.91,0.8,2130.82,-6.34,True,1,15297,-1995.83,-7891188.73,30530211.51,22639022.78
22044,2015-10-08,2013.43,17.6,0.88,2130.82,-5.51,True,1,15298,-2013.43,-7893202.16,30801452.14,22908249.98
22045,2015-10-09,2014.89,1.46,0.07,2130.82,-5.44,True,1,15299,-2014.89,-7895217.05,30825802.11,22930585.06
22046,2015-10-12,2017.46,2.57,0.13,2130.82,-5.32,True,1,15300,-2017.46,-7897234.51,30867138.0,22969903.49
22047,2015-10-13,2003.69,-13.77,-0.68,2130.82,-5.97,True,1,15301,-2003.69,-7899238.2,30658460.69,22759222.49
22048,2015-10-14,1994.24,-9.45,-0.47,2130.82,-6.41,True,1,15302,-1994.24,-7901232.44,30515860.48,22614628.04
22049,2015-10-15,2023.86,29.62,1.48,2130.82,-5.02,True,1,15303,-2023.86,-7903256.3,30971129.58,23067873.28
22050,2015-10-16,2033.11,9.25,0.46,2130.82,-4.59,True,1,15304,-2033.11,-7905289.41,31114715.44,23209426.03
22051,2015-10-19,2033.66,0.55,0.03,2130.82,-4.56,True,1,15305,-2033.66,-7907323.07,31125166.3,23217843.23
22052,2015-10-20,2030.77,-2.89,-0.14,2130.82,-4.7,True,1,15306,-2030.77,-7909353.84,31082965.62,23173611.78
22053,2015-10-21,2018.94,-11.83,-0.58,2130.82,-5.25,True,1,15307,-2018.94,-7911372.78,30903914.58,22992541.8
22054,2015-10-22,2052.51,33.57,1.66,2130.82,-3.68,True,1,15308,-2052.51,-7913425.29,31419823.08,23506397.79
22055,2015-10-23,2075.15,22.64,1.1,2130.82,-2.61,True,1,15309,-2075.15,-7915500.44,31768471.35,23852970.91
22056,2015-10-26,2071.18,-3.97,-0.19,2130.82,-2.8,True,1,15310,-2071.18,-7917571.62,31709765.8,23792194.18
22057,2015-10-27,2065.89,-5.29,-0.26,2130.82,-3.05,True,1,15311,-2065.89,-7919637.51,31630841.79,23711204.28
22058,2015-10-28,2090.35,24.46,1.18,2130.82,-1.9,True,1,15312,-2090.35,-7921727.86,32007439.2,24085711.34
22059,2015-10-29,2089.41,-0.94,-0.04,2130.82,-1.94,True,1,15313,-2089.41,-7923817.27,31995135.33,24071318.06
22060,2015-10-30,2079.36,-10.05,-0.48,2130.82,-2.42,True,1,15314,-2079.36,-7925896.63,31843319.04,23917422.41
22061,2015-11-02,2104.05,24.69,1.19,2130.82,-1.26,True,1,15315,-2104.05,-7928000.68,32223525.75,24295525.07
22062,2015-11-03,2109.79,5.74,0.27,2130.82,-0.99,True,1,15316,-2109.79,-7930110.47,32313543.64,24383433.17
22063,2015-11-04,2102.31,-7.48,-0.36,2130.82,-1.34,True,1,15317,-2102.31,-7932212.78,32201082.27,24268869.49
22064,2015-11-05,2099.93,-2.38,-0.11,2130.82,-1.45,True,1,15318,-2099.93,-7934312.71,32166727.74,24232415.03
22065,2015-11-06,2099.2,-0.73,-0.04,2130.82,-1.48,True,1,15319,-2099.2,-7936411.91,32157644.8,24221232.89
22066,2015-11-09,2078.58,-20.62,-0.98,2130.82,-2.45,True,1,15320,-2078.58,-7938490.49,31843845.6,23905355.11
22067,2015-11-10,2081.72,3.14,0.15,2130.82,-2.3,True,1,15321,-2081.72,-7940572.21,31894032.12,23953459.91
22068,2015-11-11,2075.0,-6.72,-0.32,2130.82,-2.62,True,1,15322,-2075.0,-7942647.21,31793150.0,23850502.79
22069,2015-11-12,2045.97,-29.03,-1.4,2130.82,-3.98,True,1,15323,-2045.97,-7944693.18,31350398.31,23405705.13
22070,2015-11-13,2023.04,-22.93,-1.12,2130.82,-5.06,True,1,15324,-2023.04,-7946716.22,31001064.96,23054348.74
22071,2015-11-16,2053.19,30.15,1.49,2130.82,-3.64,True,1,15325,-2053.19,-7948769.41,31465136.75,23516367.34
22072,2015-11-17,2050.44,-2.75,-0.13,2130.82,-3.77,True,1,15326,-2050.44,-7950819.85,31425043.44,23474223.59
22073,2015-11-18,2083.58,33.14,1.62,2130.82,-2.22,True,1,15327,-2083.58,-7952903.43,31935030.66,23982127.23
22074,2015-11-19,2081.24,-2.34,-0.11,2130.82,-2.33,True,1,15328,-2081.24,-7954984.67,31901246.72,23946262.05
22075,2015-11-20,2089.17,7.93,0.38,2130.82,-1.96,True,1,15329,-2089.17,-7957073.84,32024886.93,24067813.09
22076,2015-11-23,2086.59,-2.58,-0.12,2130.82,-2.08,True,1,15330,-2086.59,-7959160.43,31987424.7,24028264.27
22077,2015-11-24,2089.14,2.55,0.12,2130.82,-1.96,True,1,15331,-2089.14,-7961249.57,32028605.34,24067355.77
22078,2015-11-25,2088.87,-0.27,-0.01,2130.82,-1.97,True,1,15332,-2088.87,-7963338.44,32026554.84,24063216.4
22079,2015-11-27,2090.11,1.24,0.06,2130.82,-1.91,True,1,15333,-2090.11,-7965428.55,32047656.63,24082228.08
22080,2015-11-30,2080.41,-9.7,-0.46,2130.82,-2.37,True,1,15334,-2080.41,-7967508.96,31901006.94,23933497.98
22081,2015-12-01,2102.63,22.22,1.07,2130.82,-1.32,True,1,15335,-2102.63,-7969611.59,32243831.05,24274219.46
22082,2015-12-02,2079.51,-23.12,-1.1,2130.82,-2.41,True,1,15336,-2079.51,-7971691.1,31891365.36,23919674.26
22083,2015-12-03,2049.62,-29.89,-1.44,2130.82,-3.81,True,1,15337,-2049.62,-7973740.72,31435021.94,23461281.22
22084,2015-12-04,2091.69,42.07,2.05,2130.82,-1.84,True,1,15338,-2091.69,-7975832.41,32082341.22,24106508.81
22085,2015-12-07,2077.07,-14.62,-0.7,2130.82,-2.52,True,1,15339,-2077.07,-7977909.48,31860176.73,23882267.25
22086,2015-12-08,2063.59,-13.48,-0.65,2130.82,-3.16,True,1,15340,-2063.59,-7979973.07,31655470.6,23675497.53
22087,2015-12-09,2047.62,-15.97,-0.77,2130.82,-3.9,True,1,15341,-2047.62,-7982020.69,31412538.42,23430517.73
22088,2015-12-10,2052.23,4.61,0.22,2130.82,-3.69,True,1,15342,-2052.23,-7984072.92,31485312.66,23501239.74
22089,2015-12-11,2012.37,-39.86,-1.94,2130.82,-5.56,True,1,15343,-2012.37,-7986085.29,30875792.91,22889707.62
22090,2015-12-14,2021.94,9.57,0.48,2130.82,-5.11,True,1,15344,-2021.94,-7988107.23,31024647.36,23036540.13
22091,2015-12-15,2043.41,21.47,1.06,2130.82,-4.1,True,1,15345,-2043.41,-7990150.64,31356126.45,23365975.81
22092,2015-12-16,2073.07,29.66,1.45,2130.82,-2.71,True,1,15346,-2073.07,-7992223.71,31813332.22,23821108.51
22093,2015-12-17,2041.89,-31.18,-1.5,2130.82,-4.17,True,1,15347,-2041.89,-7994265.6,31336885.83,23342620.23
22094,2015-12-18,2005.55,-36.34,-1.78,2130.82,-5.88,True,1,15348,-2005.55,-7996271.15,30781181.4,22784910.25
22095,2015-12-21,2021.15,15.6,0.78,2130.82,-5.15,True,1,15349,-2021.15,-7998292.3,31022631.35,23024339.05
22096,2015-12-22,2038.97,17.82,0.88,2130.82,-4.31,True,1,15350,-2038.97,-8000331.27,31298189.5,23297858.23
22097,2015-12-23,2064.29,25.32,1.24,2130.82,-3.12,True,1,15351,-2064.29,-8002395.56,31688915.79,23686520.23
22098,2015-12-24,2060.99,-3.3,-0.16,2130.82,-3.28,True,1,15352,-2060.99,-8004456.55,31640318.48,23635861.93
22099,2015-12-28,2056.5,-4.49,-0.22,2130.82,-3.49,True,1,15353,-2056.5,-8006513.05,31573444.5,23566931.45
22100,2015-12-29,2078.36,21.86,1.06,2130.82,-2.46,True,1,15354,-2078.36,-8008591.41,31911139.44,23902548.03
22101,2015-12-30,2063.36,-15.0,-0.72,2130.82,-3.17,True,1,15355,-2063.36,-8010654.77,31682892.8,23672238.03
22102,2015-12-31,2043.94,-19.42,-0.94,2130.82,-4.08,True,1,15356,-2043.94,-8012698.71,31386742.64,23374043.93
22103,2016-01-04,2012.66,-31.28,-1.53,2130.82,-5.54,True,1,15357,-2012.66,-8014711.37,30908419.62,22893708.25
22104,2016-01-05,2016.71,4.05,0.2,2130.82,-5.36,True,1,15358,-2016.71,-8016728.08,30972632.18,22955904.1
22105,2016-01-06,1990.26,-26.45,-1.31,2130.82,-6.6,True,1,15359,-1990.26,-8018718.34,30568403.34,22549685.0
22106,2016-01-07,1943.09,-47.17,-2.37,2130.82,-8.81,True,1,15360,-1943.09,-8020661.43,29845862.4,21825200.97
22107,2016-01-08,1922.03,-21.06,-1.08,2130.82,-9.8,True,1,15361,-1922.03,-8022583.46,29524302.83,21501719.37
22108,2016-01-11,1923.67,1.64,0.08,2130.82,-9.72,True,1,15362,-1923.67,-8024507.13,29551418.54,21526911.41
22109,2016-01-12,1938.68,15.01,0.78,2130.82,-9.02,True,1,15363,-1938.68,-8026445.81,29783940.84,21757495.03
22110,2016-01-13,1890.28,-48.4,-2.5,2130.82,-11.29,True,1,15364,-1890.28,-8028336.09,29042261.92,21013925.83
22111,2016-01-14,1921.84,31.56,1.67,2130.82,-9.81,True,1,15365,-1921.84,-8030257.93,29529071.6,21498813.67
22112,2016-01-15,1880.33,-41.51,-2.16,2130.82,-11.76,True,1,15366,-1880.33,-8032138.26,28893150.78,20861012.52
22113,2016-01-19,1881.33,1.0,0.05,2130.82,-11.71,True,1,15367,-1881.33,-8034019.59,28910398.11,20876378.52
22114,2016-01-20,1859.33,-22.0,-1.17,2130.82,-12.74,True,1,15368,-1859.33,-8035878.92,28574183.44,20538304.52
22115,2016-01-21,1868.99,9.66,0.52,2130.82,-12.29,True,1,15369,-1868.99,-8037747.91,28724507.31,20686759.4
22116,2016-01-22,1906.9,37.91,2.03,2130.82,-10.51,True,1,15370,-1906.9,-8039654.81,29309053.0,21269398.19
22117,2016-01-25,1877.08,-29.82,-1.56,2130.82,-11.91,True,1,15371,-1877.08,-8041531.89,28852596.68,20811064.79
22118,2016-01-26,1903.63,26.55,1.41,2130.82,-10.66,True,1,15372,-1903.63,-8043435.52,29262600.36,21219164.84
22119,2016-01-27,1882.95,-20.68,-1.09,2130.82,-11.63,True,1,15373,-1882.95,-8045318.47,28946590.35,20901271.88
22120,2016-01-28,1893.36,10.41,0.55,2130.82,-11.14,True,1,15374,-1893.36,-8047211.83,29108516.64,21061304.81
22121,2016-01-29,1940.24,46.88,2.48,2130.82,-8.94,True,1,15375,-1940.24,-8049152.07,29831190.0,21782037.93
22122,2016-02-01,1939.38,-0.86,-0.04,2130.82,-8.98,True,1,15376,-1939.38,-8051091.45,29819906.88,21768815.43
22123,2016-02-02,1903.03,-36.35,-1.87,2130.82,-10.69,True,1,15377,-1903.03,-8052994.48,29262892.31,21209897.83
22124,2016-02-03,1912.53,9.5,0.5,2130.82,-10.24,True,1,15378,-1912.53,-8054907.01,29410886.34,21355979.33
22125,2016-02-04,1915.45,2.92,0.15,2130.82,-10.11,True,1,15379,-1915.45,-8056822.46,29457705.55,21400883.09
22126,2016-02-05,1880.05,-35.4,-1.85,2130.82,-11.77,True,1,15380,-1880.05,-8058702.51,28915169.0,20856466.49
22127,2016-02-08,1853.44,-26.61,-1.42,2130.82,-13.02,True,1,15381,-1853.44,-8060555.95,28507760.64,20447204.69
22128,2016-02-09,1852.21,-1.23,-0.07,2130.82,-13.08,True,1,15382,-1852.21,-8062408.16,28490694.22,20428286.06
22129,2016-02-10,1851.86,-0.35,-0.02,2130.82,-13.09,True,1,15383,-1851.86,-8064260.02,28487162.38,20422902.36
22130,2016-02-11,1829.08,-22.78,-1.23,2130.82,-14.16,True,1,15384,-1829.08,-8066089.1,28138566.72,20072477.62
22131,2016-02-12,1864.78,35.7,1.95,2130.82,-12.48,True,1,15385,-1864.78,-8067953.88,28689640.3,20621686.42
22132,2016-02-16,1895.58,30.8,1.65,2130.82,-11.04,True,1,15386,-1895.58,-8069849.46,29165393.88,21095544.42
22133,2016-02-17,1926.82,31.24,1.65,2130.82,-9.57,True,1,15387,-1926.82,-8071776.28,29647979.34,21576203.06
22134,2016-02-18,1917.83,-8.99,-0.47,2130.82,-10.0,True,1,15388,-1917.83,-8073694.11,29511568.04,21437873.93
22135,2016-02-19,1917.78,-0.05,-0.0,2130.82,-10.0,True,1,15389,-1917.78,-8075611.89,29512716.42,21437104.53
22136,2016-02-22,1945.5,27.72,1.44,2130.82,-8.7,True,1,15390,-1945.5,-8077557.39,29941245.0,21863687.61
22137,2016-02-23,1921.27,-24.23,-1.25,2130.82,-9.83,True,1,15391,-1921.27,-8079478.66,29570266.57,21490787.91
22138,2016-02-24,1929.8,8.53,0.44,2130.82,-9.43,True,1,15392,-1929.8,-8081408.46,29703481.6,21622073.14
22139,2016-02-25,1951.7,21.9,1.14,2130.82,-8.41,True,1,15393,-1951.7,-8083360.16,30042518.1,21959157.94
22140,2016-02-26,1948.05,-3.65,-0.19,2130.82,-8.58,True,1,15394,-1948.05,-8085308.21,29988281.7,21902973.49
22141,2016-02-29,1932.23,-15.82,-0.81,2130.82,-9.32,True,1,15395,-1932.23,-8087240.44,29746680.85,21659440.41
22142,2016-03-01,1978.35,46.12,2.39,2130.82,-7.16,True,1,15396,-1978.35,-8089218.79,30458676.6,22369457.81
22143,2016-03-02,1986.45,8.1,0.41,2130.82,-6.78,True,1,15397,-1986.45,-8091205.24,30585370.65,22494165.41
22144,2016-03-03,1993.4,6.95,0.35,2130.82,-6.45,True,1,15398,-1993.4,-8093198.64,30694373.2,22601174.56
22145,2016-03-04,1999.99,6.59,0.33,2130.82,-6.14,True,1,15399,-1999.99,-8095198.63,30797846.01,22702647.38
22146,2016-03-07,2001.76,1.77,0.09,2130.82,-6.06,True,1,15400,-2001.76,-8097200.39,30827104.0,22729903.61
22147,2016-03-08,1979.26,-22.5,-1.12,2130.82,-7.11,True,1,15401,-1979.26,-8099179.65,30482583.26,22383403.61
22148,2016-03-09,1989.26,10.0,0.5,2130.82,-6.64,True,1,15402,-1989.26,-8101168.91,30638582.52,22537413.61
22149,2016-03-10,1989.57,0.31,0.02,2130.82,-6.63,True,1,15403,-1989.57,-8103158.48,30645346.71,22542188.23
22150,2016-03-11,2022.19,32.62,1.64,2130.82,-5.1,True,1,15404,-2022.19,-8105180.67,31149814.76,23044634.09
22151,2016-03-14,2019.64,-2.55,-0.13,2130.82,-5.22,True,1,15405,-2019.64,-8107200.31,31112554.2,23005353.89
22152,2016-03-15,2015.93,-3.71,-0.18,2130.82,-5.39,True,1,15406,-2015.93,-8109216.24,31057417.58,22948201.34
22153,2016-03-16,2027.22,11.29,0.56,2130.82,-4.86,True,1,15407,-2027.22,-8111243.46,31233378.54,23122135.08
22154,2016-03-17,2040.59,13.37,0.66,2130.82,-4.24,True,1,15408,-2040.59,-8113284.05,31441410.72,23328126.67
22155,2016-03-18,2049.58,8.99,0.44,2130.82,-3.81,True,1,15409,-2049.58,-8115333.63,31581978.22,23466644.59
22156,2016-03-21,2051.6,2.02,0.1,2130.82,-3.72,True,1,15410,-2051.6,-8117385.23,31615156.0,23497770.77
22157,2016-03-22,2049.8,-1.8,-0.09,2130.82,-3.8,True,1,15411,-2049.8,-8119435.03,31589467.8,23470032.77
22158,2016-03-23,2036.71,-13.09,-0.64,2130.82,-4.42,True,1,15412,-2036.71,-8121471.74,31389774.52,23268302.78
22159,2016-03-24,2035.94,-0.77,-0.04,2130.82,-4.45,True,1,15413,-2035.94,-8123507.68,31379943.22,23256435.54
22160,2016-03-28,2037.05,1.11,0.06,2130.82,-4.4,True,1,15414,-2037.05,-8125544.73,31399088.7,23273543.97
22161,2016-03-29,2055.01,17.96,0.88,2130.82,-3.56,True,1,15415,-2055.01,-8127599.74,31677979.15,23550379.41
22162,2016-03-30,2063.95,8.94,0.44,2130.82,-3.14,True,1,15416,-2063.95,-8129663.69,31817853.2,23688189.51
22163,2016-03-31,2059.74,-4.21,-0.2,2130.82,-3.34,True,1,15417,-2059.74,-8131723.43,31755011.58,23623288.15
22164,2016-04-01,2072.78,13.04,0.63,2130.82,-2.72,True,1,15418,-2072.78,-8133796.21,31958122.04,23824325.83
22165,2016-04-04,2066.13,-6.65,-0.32,2130.82,-3.04,True,1,15419,-2066.13,-8135862.34,31857658.47,23721796.13
22166,2016-04-05,2045.17,-20.96,-1.01,2130.82,-4.02,True,1,15420,-2045.17,-8137907.51,31536521.4,23398613.89
22167,2016-04-06,2066.66,21.49,1.05,2130.82,-3.01,True,1,15421,-2066.66,-8139974.17,31869963.86,23729989.69
22168,2016-04-07,2041.91,-24.75,-1.2,2130.82,-4.17,True,1,15422,-2041.91,-8142016.08,31490336.02,23348319.94
22169,2016-04-08,2047.6,5.69,0.28,2130.82,-3.91,True,1,15423,-2047.6,-8144063.68,31580134.8,23436071.12
22170,2016-04-11,2041.99,-5.61,-0.27,2130.82,-4.17,True,1,15424,-2041.99,-8146105.67,31495653.76,23349548.09
22171,2016-04-12,2061.72,19.73,0.97,2130.82,-3.24,True,1,15425,-2061.72,-8148167.39,31802031.0,23653863.61
22172,2016-04-13,2082.42,20.7,1.0,2130.82,-2.27,True,1,15426,-2082.42,-8150249.81,32123410.92,23973161.11
22173,2016-04-14,2082.78,0.36,0.02,2130.82,-2.26,True,1,15427,-2082.78,-8152332.59,32131047.06,23978714.47
22174,2016-04-15,2080.73,-2.05,-0.1,2130.82,-2.35,True,1,15428,-2080.73,-8154413.32,32101502.44,23947089.12
22175,2016-04-18,2094.34,13.61,0.65,2130.82,-1.71,True,1,15429,-2094.34,-8156507.66,32313571.86,24157064.2
22176,2016-04-19,2100.8,6.46,0.31,2130.82,-1.41,True,1,15430,-2100.8,-8158608.46,32415344.0,24256735.54
22177,2016-04-20,2102.4,1.6,0.08,2130.82,-1.33,True,1,15431,-2102.4,-8160710.86,32442134.4,24281423.54
22178,2016-04-21,2091.48,-10.92,-0.52,2130.82,-1.85,True,1,15432,-2091.48,-8162802.34,32275719.36,24112917.02
22179,2016-04-22,2091.58,0.1,0.0,2130.82,-1.84,True,1,15433,-2091.58,-8164893.92,32279354.14,24114460.22
22180,2016-04-25,2087.79,-3.79,-0.18,2130.82,-2.02,True,1,15434,-2087.79,-8166981.71,32222950.86,24055969.15
22181,2016-04-26,2091.7,3.91,0.19,2130.82,-1.84,True,1,15435,-2091.7,-8169073.41,32285389.5,24116316.09
22182,2016-04-27,2095.15,3.45,0.16,2130.82,-1.67,True,1,15436,-2095.15,-8171168.56,32340735.4,24169566.84
22183,2016-04-28,2075.81,-19.34,-0.92,2130.82,-2.58,True,1,15437,-2075.81,-8173244.37,32044278.97,23871034.6
22184,2016-04-29,2065.3,-10.51,-0.51,2130.82,-3.08,True,1,15438,-2065.3,-8175309.67,31884101.4,23708791.73
22185,2016-05-02,2081.43,16.13,0.78,2130.82,-2.32,True,1,15439,-2081.43,-8177391.1,32135197.77,23957806.67
22186,2016-05-03,2063.37,-18.06,-0.87,2130.82,-3.16,True,1,15440,-2063.37,-8179454.47,31858432.8,23678978.33
22187,2016-05-04,2051.12,-12.25,-0.59,2130.82,-3.74,True,1,15441,-2051.12,-8181505.59,31671343.92,23489838.33
22188,2016-05-05,2050.63,-0.49,-0.02,2130.82,-3.76,True,1,15442,-2050.63,-8183556.22,31665828.46,23482272.24
22189,2016-05-06,2057.14,6.51,0.32,2130.82,-3.46,True,1,15443,-2057.14,-8185613.36,31768413.02,23582799.66
22190,2016-05-09,2058.69,1.55,0.08,2130.82,-3.38,True,1,15444,-2058.69,-8187672.05,31794408.36,23606736.31
22191,2016-05-10,2084.39,25.7,1.25,2130.82,-2.18,True,1,15445,-2084.39,-8189756.44,32193403.55,24003647.11
22192,2016-05-11,2064.46,-19.93,-0.96,2130.82,-3.11,True,1,15446,-2064.46,-8191820.9,31887649.16,23695828.26
22193,2016-05-12,2064.11,-0.35,-0.02,2130.82,-3.13,True,1,15447,-2064.11,-8193885.01,31884307.17,23690422.16
22194,2016-05-13,2046.61,-17.5,-0.85,2130.82,-3.95,True,1,15448,-2046.61,-8195931.62,31616031.28,23420099.66
22195,2016-05-16,2066.66,20.05,0.98,2130.82,-3.01,True,1,15449,-2066.66,-8197998.28,31927830.34,23729832.06
22196,2016-05-17,2047.21,-19.45,-0.94,2130.82,-3.92,True,1,15450,-2047.21,-8200045.49,31629394.5,23429349.01
22197,2016-05-18,2047.63,0.42,0.02,2130.82,-3.9,True,1,15451,-2047.63,-8202093.12,31637931.13,23435838.01
22198,2016-05-19,2040.04,-7.59,-0.37,2130.82,-4.26,True,1,15452,-2040.04,-8204133.16,31522698.08,23318564.92
22199,2016-05-20,2052.32,12.28,0.6,2130.82,-3.68,True,1,15453,-2052.32,-8206185.48,31714500.96,23508315.48
22200,2016-05-23,2048.04,-4.28,-0.21,2130.82,-3.88,True,1,15454,-2048.04,-8208233.52,31650410.16,23442176.64
22201,2016-05-24,2076.06,28.02,1.37,2130.82,-2.57,True,1,15455,-2076.06,-8210309.58,32085507.3,23875197.72
22202,2016-05-25,2090.54,14.48,0.7,2130.82,-1.89,True,1,15456,-2090.54,-8212400.12,32311386.24,24098986.12
22203,2016-05-26,2090.1,-0.44,-0.02,2130.82,-1.91,True,1,15457,-2090.1,-8214490.22,32306675.7,24092185.48
22204,2016-05-27,2099.06,8.96,0.43,2130.82,-1.49,True,1,15458,-2099.06,-8216589.28,32447269.48,24230680.2
22205,2016-05-31,2096.95,-2.11,-0.1,2130.82,-1.59,True,1,15459,-2096.95,-8218686.23,32416750.05,24198063.82
22206,2016-06-01,2099.33,2.38,0.11,2130.82,-1.48,True,1,15460,-2099.33,-8220785.56,32455641.8,24234856.24
22207,2016-06-02,2105.26,5.93,0.28,2130.82,-1.2,True,1,15461,-2105.26,-8222890.82,32549424.86,24326534.04
22208,2016-06-03,2099.13,-6.13,-0.29,2130.82,-1.49,True,1,15462,-2099.13,-8224989.95,32456748.06,24231758.11
22209,2016-06-06,2109.41,10.28,0.49,2130.82,-1.0,True,1,15463,-2109.41,-8227099.36,32617806.83,24390707.47
22210,2016-06-07,2112.13,2.72,0.13,2130.82,-0.88,True,1,15464,-2112.13,-8229211.49,32661978.32,24432766.83
22211,2016-06-08,2119.12,6.99,0.33,2130.82,-0.55,True,1,15465,-2119.12,-8231330.61,32772190.8,24540860.19
22212,2016-06-09,2115.48,-3.64,-0.17,2130.82,-0.72,True,1,15466,-2115.48,-8233446.09,32718013.68,24484567.59
22213,2016-06-10,2096.07,-19.41,-0.92,2130.82,-1.63,True,1,15467,-2096.07,-8235542.16,32419914.69,24184372.53
22214,2016-06-13,2079.06,-17.01,-0.81,2130.82,-2.43,True,1,15468,-2079.06,-8237621.22,32158900.08,23921278.86
22215,2016-06-14,2075.32,-3.74,-0.18,2130.82,-2.6,True,1,15469,-2075.32,-8239696.54,32103125.08,23863428.54
22216,2016-06-15,2071.5,-3.82,-0.18,2130.82,-2.78,True,1,15470,-2071.5,-8241768.04,32046105.0,23804336.96
22217,2016-06-16,2077.99,6.49,0.31,2130.82,-2.48,True,1,15471,-2077.99,-8243846.03,32148583.29,23904737.26
22218,2016-06-17,2071.22,-6.77,-0.33,2130.82,-2.8,True,1,15472,-2071.22,-8245917.25,32045915.84,23799998.59
22219,2016-06-20,2083.25,12.03,0.58,2130.82,-2.23,True,1,15473,-2083.25,-8248000.5,32234127.25,23986126.75
22220,2016-06-21,2088.9,5.65,0.27,2130.82,-1.97,True,1,15474,-2088.9,-8250089.4,32323638.6,24073549.2
22221,2016-06-22,2085.45,-3.45,-0.16,2130.82,-2.13,True,1,15475,-2085.45,-8252174.85,32272338.75,24020163.9
22222,2016-06-23,2113.32,27.87,1.34,2130.82,-0.82,True,1,15476,-2113.32,-8254288.17,32705740.32,24451452.15
22223,2016-06-24,2037.41,-75.91,-3.59,2130.82,-4.38,True,1,15477,-2037.41,-8256325.58,31532994.57,23276668.99
22224,2016-06-27,2000.54,-36.87,-1.81,2130.82,-6.11,True,1,15478,-2000.54,-8258326.12,30964358.12,22706032.0
22225,2016-06-28,2036.09,35.55,1.78,2130.82,-4.45,True,1,15479,-2036.09,-8260362.21,31516637.11,23256274.9
22226,2016-06-29,2070.77,34.68,1.7,2130.82,-2.82,True,1,15480,-2070.77,-8262432.98,32055519.6,23793086.62
22227,2016-06-30,2098.86,28.09,1.36,2130.82,-1.5,True,1,15481,-2098.86,-8264531.84,32492451.66,24227919.82
22228,2016-07-01,2102.95,4.09,0.2,2130.82,-1.31,True,1,15482,-2102.95,-8266634.79,32557871.9,24291237.11
22229,2016-07-05,2088.55,-14.4,-0.68,2130.82,-1.98,True,1,15483,-2088.55,-8268723.34,32337019.65,24068296.31
22230,2016-07-06,2099.73,11.18,0.54,2130.82,-1.46,True,1,15484,-2099.73,-8270823.07,32512219.32,24241396.25
22231,2016-07-07,2097.9,-1.83,-0.09,2130.82,-1.54,True,1,15485,-2097.9,-8272920.97,32485981.5,24213060.53
22232,2016-07-08,2129.9,32.0,1.52,2130.82,-0.04,True,1,15486,-2129.9,-8275050.87,32983631.4,24708580.53
22233,2016-07-11,2137.16,7.26,0.34,2137.16,0.0,True,1,15487,-2137.16,-8277188.03,33098196.92,24821008.89
22234,2016-07-12,2152.14,14.98,0.7,2152.14,0.0,True,1,15488,-2152.14,-8279340.17,33332344.32,25053004.15
22235,2016-07-13,2152.43,0.29,0.01,2152.43,0.0,True,1,15489,-2152.43,-8281492.6,33338988.27,25057495.67
22236,2016-07-14,2163.75,11.32,0.53,2163.75,0.0,True,1,15490,-2163.75,-8283656.35,33516487.5,25232831.15
22237,2016-07-15,2161.74,-2.01,-0.09,2163.75,-0.09,True,1,15491,-2161.74,-8285818.09,33487514.34,25201696.25
22238,2016-07-18,2166.89,5.15,0.24,2166.89,0.0,True,1,15492,-2166.89,-8287984.98,33569459.88,25281474.9
22239,2016-07-19,2163.78,-3.11,-0.14,2166.89,-0.14,True,1,15493,-2163.78,-8290148.76,33523443.54,25233294.78
22240,2016-07-20,2173.02,9.24,0.43,2173.02,0.0,True,1,15494,-2173.02,-8292321.78,33668771.88,25376450.1
22241,2016-07-21,2165.17,-7.85,-0.36,2173.02,-0.36,True,1,15495,-2165.17,-8294486.95,33549309.15,25254822.2
22242,2016-07-22,2175.03,9.86,0.46,2175.03,0.0,True,1,15496,-2175.03,-8296661.98,33704264.88,25407602.9
22243,2016-07-25,2168.48,-6.55,-0.3,2175.03,-0.3,True,1,15497,-2168.48,-8298830.46,33604934.56,25306104.1
22244,2016-07-26,2169.18,0.7,0.03,2175.03,-0.27,True,1,15498,-2169.18,-8300999.64,33617951.64,25316952.0
22245,2016-07-27,2166.58,-2.6,-0.12,2175.03,-0.39,True,1,15499,-2166.58,-8303166.22,33579823.42,25276657.2
22246,2016-07-28,2170.06,3.48,0.16,2175.03,-0.23,True,1,15500,-2170.06,-8305336.28,33635930.0,25330593.72
22247,2016-07-29,2173.6,3.54,0.16,2175.03,-0.07,True,1,15501,-2173.6,-8307509.88,33692973.6,25385463.72
22248,2016-08-01,2170.84,-2.76,-0.13,2175.03,-0.19,True,1,15502,-2170.84,-8309680.72,33652361.68,25342680.96
22249,2016-08-02,2157.03,-13.81,-0.64,2175.03,-0.83,True,1,15503,-2157.03,-8311837.75,33440436.09,25128598.34
22250,2016-08-03,2163.79,6.76,0.31,2175.03,-0.52,True,1,15504,-2163.79,-8314001.54,33547400.16,25233398.62
22251,2016-08-04,2164.25,0.46,0.02,2175.03,-0.5,True,1,15505,-2164.25,-8316165.79,33556696.25,25240530.46
22252,2016-08-05,2182.87,18.62,0.86,2182.87,0.0,True,1,15506,-2182.87,-8318348.66,33847582.22,25529233.56
22253,2016-08-08,2180.89,-1.98,-0.09,2182.87,-0.09,True,1,15507,-2180.89,-8320529.55,33819061.23,25498531.68
22254,2016-08-09,2181.74,0.85,0.04,2182.87,-0.05,True,1,15508,-2181.74,-8322711.29,33834423.92,25511712.63
22255,2016-08-10,2175.49,-6.25,-0.29,2182.87,-0.34,True,1,15509,-2175.49,-8324886.78,33739674.41,25414787.63
22256,2016-08-11,2185.79,10.3,0.47,2185.79,0.0,True,1,15510,-2185.79,-8327072.57,33901602.9,25574530.33
22257,2016-08-12,2184.05,-1.74,-0.08,2185.79,-0.08,True,1,15511,-2184.05,-8329256.62,33876799.55,25547542.93
22258,2016-08-15,2190.15,6.1,0.28,2190.15,0.0,True,1,15512,-2190.15,-8331446.77,33973606.8,25642160.03
22259,2016-08-16,2178.15,-12.0,-0.55,2190.15,-0.55,True,1,15513,-2178.15,-8333624.92,33789640.95,25456016.03
22260,2016-08-17,2182.22,4.07,0.19,2190.15,-0.36,True,1,15514,-2182.22,-8335807.14,33854961.08,25519153.94
22261,2016-08-18,2187.02,4.8,0.22,2190.15,-0.14,True,1,15515,-2187.02,-8337994.16,33931615.3,25593621.14
22262,2016-08-19,2183.87,-3.15,-0.14,2190.15,-0.29,True,1,15516,-2183.87,-8340178.03,33884926.92,25544748.89
22263,2016-08-22,2182.64,-1.23,-0.06,2190.15,-0.34,True,1,15517,-2182.64,-8342360.67,33868024.88,25525664.21
22264,2016-08-23,2186.9,4.26,0.2,2190.15,-0.15,True,1,15518,-2186.9,-8344547.57,33936314.2,25591766.63
22265,2016-08-24,2175.44,-11.46,-0.52,2190.15,-0.67,True,1,15519,-2175.44,-8346723.01,33760653.36,25413930.35
22266,2016-08-25,2172.47,-2.97,-0.14,2190.15,-0.81,True,1,15520,-2172.47,-8348895.48,33716734.4,25367838.92
22267,2016-08-26,2169.04,-3.43,-0.16,2190.15,-0.96,True,1,15521,-2169.04,-8351064.52,33665669.84,25314605.32
22268,2016-08-29,2180.38,11.34,0.52,2190.15,-0.45,True,1,15522,-2180.38,-8353244.9,33843858.36,25490613.46
22269,2016-08-30,2176.12,-4.26,-0.2,2190.15,-0.64,True,1,15523,-2176.12,-8355421.02,33779910.76,25424489.74
22270,2016-08-31,2170.95,-5.17,-0.24,2190.15,-0.88,True,1,15524,-2170.95,-8357591.97,33701827.8,25344235.83
22271,2016-09-01,2170.86,-0.09,-0.0,2190.15,-0.88,True,1,15525,-2170.86,-8359762.83,33702601.5,25342838.67
22272,2016-09-02,2179.98,9.12,0.42,2190.15,-0.46,True,1,15526,-2179.98,-8361942.81,33846369.48,25484426.67
22273,2016-09-06,2186.48,6.5,0.3,2190.15,-0.17,True,1,15527,-2186.48,-8364129.29,33949474.96,25585345.67
22274,2016-09-07,2186.16,-0.32,-0.02,2190.15,-0.18,True,1,15528,-2186.16,-8366315.45,33946692.48,25580377.03
22275,2016-09-08,2181.3,-4.86,-0.22,2190.15,-0.4,True,1,15529,-2181.3,-8368496.75,33873407.7,25504910.95
22276,2016-09-09,2127.81,-53.49,-2.45,2190.15,-2.85,True,1,15530,-2127.81,-8370624.56,33044889.3,24674264.74
22277,2016-09-12,2159.04,31.23,1.47,2190.15,-1.42,True,1,15531,-2159.04,-8372783.6,33532050.24,25159266.64
22278,2016-09-13,2127.02,-32.02,-1.48,2190.15,-2.88,True,1,15532,-2127.02,-8374910.62,33036874.64,24661964.02
22279,2016-09-14,2125.77,-1.25,-0.06,2190.15,-2.94,True,1,15533,-2125.77,-8377036.39,33019585.41,24642549.02
22280,2016-09-15,2147.26,21.49,1.01,2190.15,-1.96,True,1,15534,-2147.26,-8379183.65,33355536.84,24976353.19
22281,2016-09-16,2139.16,-8.1,-0.38,2190.15,-2.33,True,1,15535,-2139.16,-8381322.81,33231850.6,24850527.79
22282,2016-09-19,2139.12,-0.04,-0.0,2190.15,-2.33,True,1,15536,-2139.12,-8383461.93,33233368.32,24849906.39
22283,2016-09-20,2139.76,0.64,0.03,2190.15,-2.3,True,1,15537,-2139.76,-8385601.69,33245451.12,24859849.43
22284,2016-09-21,2163.12,23.36,1.09,2190.15,-1.23,True,1,15538,-2163.12,-8387764.81,33610558.56,25222793.75
22285,2016-09-22,2177.18,14.06,0.65,2190.15,-0.59,True,1,15539,-2177.18,-8389941.99,33831200.02,25441258.03
22286,2016-09-23,2164.69,-12.49,-0.57,2190.15,-1.16,True,1,15540,-2164.69,-8392106.68,33639282.6,25247175.92
22287,2016-09-26,2146.1,-18.59,-0.86,2190.15,-2.01,True,1,15541,-2146.1,-8394252.78,33352540.1,24958287.32
22288,2016-09-27,2159.93,13.83,0.64,2190.15,-1.38,True,1,15542,-2159.93,-8396412.71,33569632.06,25173219.35
22289,2016-09-28,2171.37,11.44,0.53,2190.15,-0.86,True,1,15543,-2171.37,-8398584.08,33749603.91,25351019.83
22290,2016-09-29,2151.13,-20.24,-0.93,2190.15,-1.78,True,1,15544,-2151.13,-8400735.21,33437164.72,25036429.51
22291,2016-09-30,2168.27,17.14,0.8,2190.15,-1.0,True,1,15545,-2168.27,-8402903.48,33705757.15,25302853.67
22292,2016-10-03,2161.2,-7.07,-0.33,2190.15,-1.32,True,1,15546,-2161.2,-8405064.68,33598015.2,25192950.52
22293,2016-10-04,2150.49,-10.71,-0.5,2190.15,-1.81,True,1,15547,-2150.49,-8407215.17,33433668.03,25026452.86
22294,2016-10-05,2159.73,9.24,0.43,2190.15,-1.39,True,1,15548,-2159.73,-8409374.9,33579482.04,25170107.14
22295,2016-10-06,2160.77,1.04,0.05,2190.15,-1.34,True,1,15549,-2160.77,-8411535.67,33597812.73,25186277.06
22296,2016-10-07,2153.74,-7.03,-0.32,2190.15,-1.66,True,1,15550,-2153.74,-8413689.41,33490657.0,25076967.59
22297,2016-10-10,2163.66,9.92,0.46,2190.15,-1.21,True,1,15551,-2163.66,-8415853.07,33647076.66,25231223.59
22298,2016-10-11,2136.73,-26.93,-1.25,2190.15,-2.44,True,1,15552,-2136.73,-8417989.8,33230424.96,24812435.16
22299,2016-10-12,2139.18,2.45,0.12,2190.15,-2.33,True,1,15553,-2139.18,-8420128.98,33270666.54,24850537.56
22300,2016-10-13,2132.55,-6.63,-0.31,2190.15,-2.63,True,1,15554,-2132.55,-8422261.53,33169682.7,24747421.17
22301,2016-10-14,2132.98,0.43,0.02,2190.15,-2.61,True,1,15555,-2132.98,-8424394.51,33178503.9,24754109.39
22302,2016-10-17,2126.5,-6.48,-0.3,2190.15,-2.91,True,1,15556,-2126.5,-8426521.01,33079834.0,24653312.99
22303,2016-10-18,2139.6,13.1,0.62,2190.15,-2.31,True,1,15557,-2139.6,-8428660.61,33285757.2,24857096.59
22304,2016-10-19,2144.29,4.69,0.22,2190.15,-2.09,True,1,15558,-2144.29,-8430804.9,33360863.82,24930058.92
22305,2016-10-20,2141.34,-2.95,-0.14,2190.15,-2.23,True,1,15559,-2141.34,-8432946.24,33317109.06,24884162.82
22306,2016-10-21,2141.16,-0.18,-0.01,2190.15,-2.24,True,1,15560,-2141.16,-8435087.4,33316449.6,24881362.2
22307,2016-10-24,2151.33,10.17,0.48,2190.15,-1.77,True,1,15561,-2151.33,-8437238.73,33476846.13,25039607.4
22308,2016-10-25,2143.16,-8.17,-0.38,2190.15,-2.15,True,1,15562,-2143.16,-8439381.89,33351855.92,24912474.03
22309,2016-10-26,2139.43,-3.73,-0.17,2190.15,-2.32,True,1,15563,-2139.43,-8441521.32,33295949.09,24854427.77
22310,2016-10-27,2133.04,-6.39,-0.3,2190.15,-2.61,True,1,15564,-2133.04,-8443654.36,33198634.56,24754980.2
22311,2016-10-28,2126.41,-6.63,-0.31,2190.15,-2.91,True,1,15565,-2126.41,-8445780.77,33097571.65,24651790.88
22312,2016-10-31,2126.15,-0.26,-0.01,2190.15,-2.92,True,1,15566,-2126.15,-8447906.92,33095650.9,24647743.98
22313,2016-11-01,2111.72,-14.43,-0.68,2190.15,-3.58,True,1,15567,-2111.72,-8450018.64,32873145.24,24423126.6
22314,2016-11-02,2097.94,-13.78,-0.65,2190.15,-4.21,True,1,15568,-2097.94,-8452116.58,32660729.92,24208613.34
22315,2016-11-03,2088.66,-9.28,-0.44,2190.15,-4.63,True,1,15569,-2088.66,-8454205.24,32518347.54,24064142.3
22316,2016-11-04,2085.18,-3.48,-0.17,2190.15,-4.79,True,1,15570,-2085.18,-8456290.42,32466252.6,24009962.18
22317,2016-11-07,2131.52,46.34,2.22,2190.15,-2.68,True,1,15571,-2131.52,-8458421.94,33189897.92,24731475.98
22318,2016-11-08,2139.56,8.04,0.38,2190.15,-2.31,True,1,15572,-2139.56,-8460561.5,33317228.32,24856666.82
22319,2016-11-09,2163.26,23.7,1.11,2190.15,-1.23,True,1,15573,-2163.26,-8462724.76,33688447.98,25225723.22
22320,2016-11-10,2167.48,4.22,0.2,2190.15,-1.03,True,1,15574,-2167.48,-8464892.24,33756333.52,25291441.28
22321,2016-11-11,2164.45,-3.03,-0.14,2190.15,-1.17,True,1,15575,-2164.45,-8467056.69,33711308.75,25244252.06
22322,2016-11-14,2164.2,-0.25,-0.01,2190.15,-1.18,True,1,15576,-2164.2,-8469220.89,33709579.2,25240358.31
22323,2016-11-15,2180.39,16.19,0.75,2190.15,-0.45,True,1,15577,-2180.39,-8471401.28,33963935.03,25492533.75
22324,2016-11-16,2176.94,-3.45,-0.16,2190.15,-0.6,True,1,15578,-2176.94,-8473578.22,33912371.32,25438793.1
22325,2016-11-17,2187.12,10.18,0.47,2190.15,-0.14,True,1,15579,-2187.12,-8475765.34,34073142.48,25597377.14
22326,2016-11-18,2181.9,-5.22,-0.24,2190.15,-0.38,True,1,15580,-2181.9,-8477947.24,33994002.0,25516054.76
22327,2016-11-21,2198.18,16.28,0.75,2198.18,0.0,True,1,15581,-2198.18,-8480145.42,34249842.58,25769697.16
22328,2016-11-22,2202.94,4.76,0.22,2202.94,0.0,True,1,15582,-2202.94,-8482348.36,34326211.08,25843862.72
22329,2016-11-23,2204.72,1.78,0.08,2204.72,0.0,True,1,15583,-2204.72,-8484553.08,34356151.76,25871598.68
22330,2016-11-25,2213.35,8.63,0.39,2213.35,0.0,True,1,15584,-2213.35,-8486766.43,34492846.4,26006079.97
22331,2016-11-28,2201.72,-11.63,-0.52,2213.35,-0.52,True,1,15585,-2201.72,-8488968.15,34313806.2,25824838.05
22332,2016-11-29,2204.66,2.94,0.13,2213.35,-0.39,True,1,15586,-2204.66,-8491172.81,34361830.76,25870657.95
22333,2016-11-30,2198.81,-5.85,-0.26,2213.35,-0.66,True,1,15587,-2198.81,-8493371.62,34272851.47,25779479.85
22334,2016-12-01,2191.08,-7.73,-0.35,2213.35,-1.01,True,1,15588,-2191.08,-8495562.7,34154555.04,25658992.34
22335,2016-12-02,2191.95,0.87,0.04,2213.35,-0.97,True,1,15589,-2191.95,-8497754.65,34170308.55,25672553.9
22336,2016-12-05,2204.71,12.76,0.58,2213.35,-0.39,True,1,15590,-2204.71,-8499959.36,34371428.9,25871469.54
22337,2016-12-06,2212.23,7.52,0.34,2213.35,-0.05,True,1,15591,-2212.23,-8502171.59,34490877.93,25988706.34
22338,2016-12-07,2241.35,29.12,1.32,2241.35,0.0,True,1,15592,-2241.35,-8504412.94,34947129.2,26442716.26
22339,2016-12-08,2246.19,4.84,0.22,2246.19,0.0,True,1,15593,-2246.19,-8506659.13,35024840.67,26518181.54
22340,2016-12-09,2259.53,13.34,0.59,2259.53,0.0,True,1,15594,-2259.53,-8508918.66,35235110.82,26726192.16
22341,2016-12-12,2256.96,-2.57,-0.11,2259.53,-0.11,True,1,15595,-2256.96,-8511175.62,35197291.2,26686115.58
22342,2016-12-13,2271.72,14.76,0.65,2271.72,0.0,True,1,15596,-2271.72,-8513447.34,35429745.12,26916297.78
22343,2016-12-14,2253.28,-18.44,-0.81,2271.72,-0.81,True,1,15597,-2253.28,-8515700.62,35144408.16,26628707.54
22344,2016-12-15,2262.03,8.75,0.39,2271.72,-0.43,True,1,15598,-2262.03,-8517962.65,35283143.94,26765181.29
22345,2016-12-16,2258.07,-3.96,-0.18,2271.72,-0.6,True,1,15599,-2258.07,-8520220.72,35223633.93,26703413.21
22346,2016-12-19,2262.53,4.46,0.2,2271.72,-0.4,True,1,15600,-2262.53,-8522483.25,35295468.0,26772984.75
22347,2016-12-20,2270.76,8.23,0.36,2271.72,-0.04,True,1,15601,-2270.76,-8524754.01,35426126.76,26901372.75
22348,2016-12-21,2265.18,-5.58,-0.25,2271.72,-0.29,True,1,15602,-2265.18,-8527019.19,35341338.36,26814319.17
22349,2016-12-22,2260.96,-4.22,-0.19,2271.72,-0.47,True,1,15603,-2260.96,-8529280.15,35277758.88,26748478.73
22350,2016-12-23,2263.79,2.83,0.12,2271.72,-0.35,True,1,15604,-2263.79,-8531543.94,35324179.16,26792635.22
22351,2016-12-27,2268.88,5.09,0.22,2271.72,-0.12,True,1,15605,-2268.88,-8533812.82,35405872.4,26872059.58
22352,2016-12-28,2249.92,-18.96,-0.84,2271.72,-0.96,True,1,15606,-2249.92,-8536062.74,35112251.52,26576188.78
22353,2016-12-29,2249.26,-0.66,-0.03,2271.72,-0.99,True,1,15607,-2249.26,-8538312.0,35104200.82,26565888.82
22354,2016-12-30,2238.83,-10.43,-0.46,2271.72,-1.45,True,1,15608,-2238.83,-8540550.83,34943658.64,26403107.81
22355,2017-01-03,2257.83,19.0,0.85,2271.72,-0.61,True,1,15609,-2257.83,-8542808.66,35242468.47,26699659.81
22356,2017-01-04,2270.75,12.92,0.57,2271.72,-0.04,True,1,15610,-2270.75,-8545079.41,35446407.5,26901328.09
22357,2017-01-05,2269.0,-1.75,-0.08,2271.72,-0.12,True,1,15611,-2269.0,-8547348.41,35421359.0,26874010.59
22358,2017-01-06,2276.98,7.98,0.35,2276.98,0.0,True,1,15612,-2276.98,-8549625.39,35548211.76,26998586.37
22359,2017-01-09,2268.9,-8.08,-0.36,2276.98,-0.36,True,1,15613,-2268.9,-8551894.29,35424335.7,26872441.41
22360,2017-01-10,2268.9,0.0,0.0,2276.98,-0.36,True,1,15614,-2268.9,-8554163.19,35426604.6,26872441.41
22361,2017-01-11,2275.32,6.42,0.28,2276.98,-0.07,True,1,15615,-2275.32,-8556438.51,35529121.8,26972683.29
22362,2017-01-12,2270.44,-4.88,-0.21,2276.98,-0.29,True,1,15616,-2270.44,-8558708.95,35455191.04,26896482.09
22363,2017-01-13,2274.64,4.2,0.18,2276.98,-0.1,True,1,15617,-2274.64,-8560983.59,35523052.88,26962069.29
22364,2017-01-17,2267.89,-6.75,-0.3,2276.98,-0.4,True,1,15618,-2267.89,-8563251.48,35419906.02,26856654.54
22365,2017-01-18,2271.89,4.0,0.18,2276.98,-0.22,True,1,15619,-2271.89,-8565523.37,35484649.91,26919126.54
22366,2017-01-19,2263.69,-8.2,-0.36,2276.98,-0.58,True,1,15620,-2263.69,-8567787.06,35358837.8,26791050.74
22367,2017-01-20,2271.31,7.62,0.34,2276.98,-0.25,True,1,15621,-2271.31,-8570058.37,35480133.51,26910075.14
22368,2017-01-23,2265.2,-6.11,-0.27,2276.98,-0.52,True,1,15622,-2265.2,-8572323.57,35386954.4,26814630.83
22369,2017-01-24,2280.07,14.87,0.66,2280.07,0.0,True,1,15623,-2280.07,-8574603.64,35621533.61,27046929.97
22370,2017-01-25,2298.37,18.3,0.8,2298.37,0.0,True,1,15624,-2298.37,-8576902.01,35909732.88,27332830.87
22371,2017-01-26,2296.68,-1.69,-0.07,2298.37,-0.07,True,1,15625,-2296.68,-8579198.69,35885625.0,27306426.31
22372,2017-01-27,2294.69,-1.99,-0.09,2298.37,-0.16,True,1,15626,-2294.69,-8581493.38,35856825.94,27275332.56
22373,2017-01-30,2280.9,-13.79,-0.6,2298.37,-0.76,True,1,15627,-2280.9,-8583774.28,35643624.3,27059850.02
22374,2017-01-31,2278.87,-2.03,-0.09,2298.37,-0.85,True,1,15628,-2278.87,-8586053.15,35614180.36,27028127.21
22375,2017-02-01,2279.55,0.68,0.03,2298.37,-0.82,True,1,15629,-2279.55,-8588332.7,35627086.95,27038754.25
22376,2017-02-02,2280.85,1.3,0.06,2298.37,-0.76,True,1,15630,-2280.85,-8590613.55,35649685.5,27059071.95
22377,2017-02-03,2297.42,16.57,0.73,2298.37,-0.04,True,1,15631,-2297.42,-8592910.97,35910972.02,27318061.05
22378,2017-02-06,2292.56,-4.86,-0.21,2298.37,-0.25,True,1,15632,-2292.56,-8595203.53,35837297.92,27242094.39
22379,2017-02-07,2293.08,0.52,0.02,2298.37,-0.23,True,1,15633,-2293.08,-8597496.61,35847719.64,27250223.03
22380,2017-02-08,2294.67,1.59,0.07,2298.37,-0.16,True,1,15634,-2294.67,-8599791.28,35874870.78,27275079.5
22381,2017-02-09,2307.87,13.2,0.57,2307.87,0.0,True,1,15635,-2307.87,-8602099.15,36083547.45,27481448.3
22382,2017-02-10,2316.1,8.23,0.36,2316.1,0.0,True,1,15636,-2316.1,-8604415.25,36214539.6,27610124.35
22383,2017-02-13,2328.25,12.15,0.52,2328.25,0.0,True,1,15637,-2328.25,-8606743.5,36406845.25,27800101.75
22384,2017-02-14,2337.58,9.33,0.4,2337.58,0.0,True,1,15638,-2337.58,-8609081.08,36555076.04,27945994.96
22385,2017-02-15,2349.25,11.67,0.5,2349.25,0.0,True,1,15639,-2349.25,-8611430.33,36739920.75,28128490.42
22386,2017-02-16,2347.22,-2.03,-0.09,2349.25,-0.09,True,1,15640,-2347.22,-8613777.55,36710520.8,28096743.25
22387,2017-02-17,2351.16,3.94,0.17,2351.16,0.0,True,1,15641,-2351.16,-8616128.71,36774493.56,28158364.85
22388,2017-02-21,2365.38,14.22,0.6,2365.38,0.0,True,1,15642,-2365.38,-8618494.09,36999273.96,28380779.87
22389,2017-02-22,2362.82,-2.56,-0.11,2365.38,-0.11,True,1,15643,-2362.82,-8620856.91,36961593.26,28340736.35
22390,2017-02-23,2363.81,0.99,0.04,2365.38,-0.07,True,1,15644,-2363.81,-8623220.72,36979443.64,28356222.92
22391,2017-02-24,2367.34,3.53,0.15,2367.34,0.0,True,1,15645,-2367.34,-8625588.06,37037034.3,28411446.24
22392,2017-02-27,2369.75,2.41,0.1,2369.75,0.0,True,1,15646,-2369.75,-8627957.81,37077108.5,28449150.69
22393,2017-02-28,2363.64,-6.11,-0.26,2369.75,-0.26,True,1,15647,-2363.64,-8630321.45,36983875.08,28353553.63
22394,2017-03-01,2395.96,32.32,1.37,2395.96,0.0,True,1,15648,-2395.96,-8632717.41,37491982.08,28859264.67
22395,2017-03-02,2381.92,-14.04,-0.59,2395.96,-0.59,True,1,15649,-2381.92,-8635099.33,37274666.08,28639566.75
22396,2017-03-03,2383.12,1.2,0.05,2395.96,-0.54,True,1,15650,-2383.12,-8637482.45,37295828.0,28658345.55
22397,2017-03-06,2375.31,-7.81,-0.33,2395.96,-0.86,True,1,15651,-2375.31,-8639857.76,37175976.81,28536119.05
22398,2017-03-07,2368.39,-6.92,-0.29,2395.96,-1.15,True,1,15652,-2368.39,-8642226.15,37070040.28,28427814.13
22399,2017-03-08,2362.98,-5.41,-0.23,2395.96,-1.38,True,1,15653,-2362.98,-8644589.13,36987725.94,28343136.81
22400,2017-03-09,2364.87,1.89,0.08,2395.96,-1.3,True,1,15654,-2364.87,-8646954.0,37019674.98,28372720.98
22401,2017-03-10,2372.6,7.73,0.33,2395.96,-0.98,True,1,15655,-2372.6,-8649326.6,37143053.0,28493726.4
22402,2017-03-13,2373.47,0.87,0.04,2395.96,-0.94,True,1,15656,-2373.47,-8651700.07,37159046.32,28507346.25
22403,2017-03-14,2365.45,-8.02,-0.34,2395.96,-1.27,True,1,15657,-2365.45,-8654065.52,37035850.65,28381785.13
22404,2017-03-15,2385.26,19.81,0.84,2395.96,-0.45,True,1,15658,-2385.26,-8656450.78,37348401.08,28691950.3
22405,2017-03-16,2381.38,-3.88,-0.16,2395.96,-0.61,True,1,15659,-2381.38,-8658832.16,37290029.42,28631197.26
22406,2017-03-17,2378.25,-3.13,-0.13,2395.96,-0.74,True,1,15660,-2378.25,-8661210.41,37243395.0,28582184.59
22407,2017-03-20,2373.47,-4.78,-0.2,2395.96,-0.94,True,1,15661,-2373.47,-8663583.88,37170913.67,28507329.79
22408,2017-03-21,2344.02,-29.45,-1.24,2395.96,-2.17,True,1,15662,-2344.02,-8665927.9,36712041.24,28046113.34
22409,2017-03-22,2348.45,4.43,0.19,2395.96,-1.98,True,1,15663,-2348.45,-8668276.35,36783772.35,28115496.0
22410,2017-03-23,2345.96,-2.49,-0.11,2395.96,-2.09,True,1,15664,-2345.96,-8670622.31,36747117.44,28076495.13
22411,2017-03-24,2343.98,-1.98,-0.08,2395.96,-2.17,True,1,15665,-2343.98,-8672966.29,36718446.7,28045480.41
22412,2017-03-27,2341.59,-2.39,-0.1,2395.96,-2.27,True,1,15666,-2341.59,-8675307.88,36683348.94,28008041.06
22413,2017-03-28,2358.57,16.98,0.72,2395.96,-1.56,True,1,15667,-2358.57,-8677666.45,36951716.19,28274049.74
22414,2017-03-29,2361.13,2.56,0.11,2395.96,-1.45,True,1,15668,-2361.13,-8680027.58,36994184.84,28314157.26
22415,2017-03-30,2368.06,6.93,0.29,2395.96,-1.16,True,1,15669,-2368.06,-8682395.64,37105132.14,28422736.5
22416,2017-03-31,2362.72,-5.34,-0.23,2395.96,-1.39,True,1,15670,-2362.72,-8684758.36,37023822.4,28339064.04
22417,2017-04-03,2358.84,-3.88,-0.16,2395.96,-1.55,True,1,15671,-2358.84,-8687117.2,36965381.64,28278264.44
22418,2017-04-04,2360.16,1.32,0.06,2395.96,-1.49,True,1,15672,-2360.16,-8689477.36,36988427.52,28298950.16
22419,2017-04-05,2352.95,-7.21,-0.3,2395.96,-1.8,True,1,15673,-2352.95,-8691830.31,36877785.35,28185955.04
22420,2017-04-06,2357.49,4.54,0.19,2395.96,-1.61,True,1,15674,-2357.49,-8694187.8,36951298.26,28257110.46
22421,2017-04-07,2355.54,-1.95,-0.08,2395.96,-1.69,True,1,15675,-2355.54,-8696543.34,36923089.5,28226546.16
22422,2017-04-10,2357.16,1.62,0.07,2395.96,-1.62,True,1,15676,-2357.16,-8698900.5,36950840.16,28251939.66
22423,2017-04-11,2353.78,-3.38,-0.14,2395.96,-1.76,True,1,15677,-2353.78,-8701254.28,36900209.06,28198954.78
22424,2017-04-12,2344.93,-8.85,-0.38,2395.96,-2.13,True,1,15678,-2344.93,-8703599.21,36763812.54,28060213.33
22425,2017-04-13,2328.95,-15.98,-0.68,2395.96,-2.8,True,1,15679,-2328.95,-8705928.16,36515607.05,27809678.89
22426,2017-04-17,2349.01,20.06,0.86,2395.96,-1.96,True,1,15680,-2349.01,-8708277.17,36832476.8,28124199.63
22427,2017-04-18,2342.19,-6.82,-0.29,2395.96,-2.24,True,1,15681,-2342.19,-8710619.36,36727881.39,28017262.03
22428,2017-04-19,2338.17,-4.02,-0.17,2395.96,-2.41,True,1,15682,-2338.17,-8712957.53,36667181.94,27954224.41
22429,2017-04-20,2355.84,17.67,0.76,2395.96,-1.67,True,1,15683,-2355.84,-8715313.37,36946638.72,28231325.35
22430,2017-04-21,2348.69,-7.15,-0.3,2395.96,-1.97,True,1,15684,-2348.69,-8717662.06,36836853.96,28119191.9
22431,2017-04-24,2374.15,25.46,1.08,2395.96,-0.91,True,1,15685,-2374.15,-8720036.21,37238542.75,28518506.54
22432,2017-04-25,2388.61,14.46,0.61,2395.96,-0.31,True,1,15686,-2388.61,-8722424.82,37467736.46,28745311.64
22433,2017-04-26,2387.45,-1.16,-0.05,2395.96,-0.36,True,1,15687,-2387.45,-8724812.27,37451928.15,28727115.88
22434,2017-04-27,2388.77,1.32,0.06,2395.96,-0.3,True,1,15688,-2388.77,-8727201.04,37475023.76,28747822.72
22435,2017-04-28,2384.2,-4.57,-0.19,2395.96,-0.49,True,1,15689,-2384.2,-8729585.24,37405713.8,28676128.56
22436,2017-05-01,2388.33,4.13,0.17,2395.96,-0.32,True,1,15690,-2388.33,-8731973.57,37472897.7,28740924.13
22437,2017-05-02,2391.17,2.84,0.12,2395.96,-0.2,True,1,15691,-2391.17,-8734364.74,37519848.47,28785483.73
22438,2017-05-03,2388.13,-3.04,-0.13,2395.96,-0.33,True,1,15692,-2388.13,-8736752.87,37474535.96,28737783.09
22439,2017-05-04,2389.52,1.39,0.06,2395.96,-0.27,True,1,15693,-2389.52,-8739142.39,37498737.36,28759594.97
22440,2017-05-05,2399.29,9.77,0.41,2399.29,0.0,True,1,15694,-2399.29,-8741541.68,37654457.26,28912915.58
22441,2017-05-08,2399.38,0.09,0.0,2399.38,0.0,True,1,15695,-2399.38,-8743941.06,37658269.1,28914328.04
22442,2017-05-09,2396.92,-2.46,-0.1,2399.38,-0.1,True,1,15696,-2396.92,-8746337.98,37622056.32,28875718.34
22443,2017-05-10,2399.63,2.71,0.11,2399.63,0.0,True,1,15697,-2399.63,-8748737.61,37666992.11,28918254.5
22444,2017-05-11,2394.44,-5.19,-0.22,2399.63,-0.22,True,1,15698,-2394.44,-8751132.05,37587919.12,28836787.07
22445,2017-05-12,2390.9,-3.54,-0.15,2399.63,-0.36,True,1,15699,-2390.9,-8753522.95,37534739.1,28781216.15
22446,2017-05-15,2402.32,11.42,0.48,2402.32,0.0,True,1,15700,-2402.32,-8755925.27,37716424.0,28960498.73
22447,2017-05-16,2400.67,-1.65,-0.07,2402.32,-0.07,True,1,15701,-2400.67,-8758325.94,37692919.67,28934593.73
22448,2017-05-17,2357.03,-43.64,-1.82,2402.32,-1.88,True,1,15702,-2357.03,-8760682.97,37010085.06,28249402.09
22449,2017-05-18,2365.72,8.69,0.37,2402.32,-1.52,True,1,15703,-2365.72,-8763048.69,37148901.16,28385852.47
22450,2017-05-19,2381.73,16.01,0.68,2402.32,-0.86,True,1,15704,-2381.73,-8765430.42,37402687.92,28637257.5
22451,2017-05-22,2394.02,12.29,0.52,2402.32,-0.35,True,1,15705,-2394.02,-8767824.44,37598084.1,28830259.66
22452,2017-05-23,2398.42,4.4,0.18,2402.32,-0.16,True,1,15706,-2398.42,-8770222.86,37669584.52,28899361.66
22453,2017-05-24,2404.39,5.97,0.25,2404.39,0.0,True,1,15707,-2404.39,-8772627.25,37765753.73,28993126.48
22454,2017-05-25,2415.07,10.68,0.44,2415.07,0.0,True,1,15708,-2415.07,-8775042.32,37935919.56,29160877.24
22455,2017-05-26,2415.82,0.75,0.03,2415.82,0.0,True,1,15709,-2415.82,-8777458.14,37950116.38,29172658.24
22456,2017-05-30,2412.91,-2.91,-0.12,2415.82,-0.12,True,1,15710,-2412.91,-8779871.05,37906816.1,29126945.05
22457,2017-05-31,2411.8,-1.11,-0.05,2415.82,-0.17,True,1,15711,-2411.8,-8782282.85,37891789.8,29109506.95
22458,2017-06-01,2430.06,18.26,0.76,2430.06,0.0,True,1,15712,-2430.06,-8784712.91,38181102.72,29396389.81
22459,2017-06-02,2439.07,9.01,0.37,2439.07,0.0,True,1,15713,-2439.07,-8787151.98,38325106.91,29537954.93
22460,2017-06-05,2436.1,-2.97,-0.12,2439.07,-0.12,True,1,15714,-2436.1,-8789588.08,38280875.4,29491287.32
22461,2017-06-06,2429.33,-6.77,-0.28,2439.07,-0.4,True,1,15715,-2429.33,-8792017.41,38176920.95,29384903.54
22462,2017-06-07,2433.14,3.81,0.16,2439.07,-0.24,True,1,15716,-2433.14,-8794450.55,38239228.24,29444777.69
22463,2017-06-08,2433.79,0.65,0.03,2439.07,-0.22,True,1,15717,-2433.79,-8796884.34,38251877.43,29454993.09
22464,2017-06-09,2431.77,-2.02,-0.08,2439.07,-0.3,True,1,15718,-2431.77,-8799316.11,38222560.86,29423244.75
22465,2017-06-12,2429.39,-2.38,-0.1,2439.07,-0.4,True,1,15719,-2429.39,-8801745.5,38187581.41,29385835.91
22466,2017-06-13,2440.35,10.96,0.45,2440.35,0.0,True,1,15720,-2440.35,-8804185.85,38362302.0,29558116.15
22467,2017-06-14,2437.92,-2.43,-0.1,2440.35,-0.1,True,1,15721,-2437.92,-8806623.77,38326540.32,29519916.55
22468,2017-06-15,2432.46,-5.46,-0.22,2440.35,-0.32,True,1,15722,-2432.46,-8809056.23,38243136.12,29434079.89
22469,2017-06-16,2433.15,0.69,0.03,2440.35,-0.3,True,1,15723,-2433.15,-8811489.38,38256417.45,29444928.07
22470,2017-06-19,2453.46,20.31,0.84,2453.46,0.0,True,1,15724,-2453.46,-8813942.84,38578205.04,29764262.2
22471,2017-06-20,2437.03,-16.43,-0.67,2453.46,-0.67,True,1,15725,-2437.03,-8816379.87,38322296.75,29505916.88
22472,2017-06-21,2435.61,-1.42,-0.06,2453.46,-0.73,True,1,15726,-2435.61,-8818815.48,38302402.86,29483587.38
22473,2017-06-22,2434.5,-1.11,-0.05,2453.46,-0.77,True,1,15727,-2434.5,-8821249.98,38287381.5,29466131.52
22474,2017-06-23,2438.3,3.8,0.16,2453.46,-0.62,True,1,15728,-2438.3,-8823688.28,38349582.4,29525894.12
22475,2017-06-26,2439.07,0.77,0.03,2453.46,-0.59,True,1,15729,-2439.07,-8826127.35,38364132.03,29538004.68
22476,2017-06-27,2419.38,-19.69,-0.81,2453.46,-1.39,True,1,15730,-2419.38,-8828546.73,38056847.4,29228300.67
22477,2017-06-28,2440.69,21.31,0.88,2453.46,-0.52,True,1,15731,-2440.69,-8830987.42,38394494.39,29563506.97
22478,2017-06-29,2419.7,-20.99,-0.86,2453.46,-1.38,True,1,15732,-2419.7,-8833407.12,38066720.4,29233313.28
22479,2017-06-30,2423.41,3.71,0.15,2453.46,-1.23,True,1,15733,-2423.41,-8835830.53,38127509.53,29291679.0
22480,2017-07-03,2429.01,5.6,0.23,2453.46,-1.0,True,1,15734,-2429.01,-8838259.54,38218043.34,29379783.8
22481,2017-07-05,2432.54,3.53,0.14,2453.46,-0.85,True,1,15735,-2432.54,-8840692.08,38276016.9,29435324.82
22482,2017-07-06,2409.75,-22.79,-0.94,2453.46,-1.78,True,1,15736,-2409.75,-8843101.83,37919826.0,29076724.17
22483,2017-07-07,2425.18,15.43,0.64,2453.46,-1.15,True,1,15737,-2425.18,-8845527.01,38165057.66,29319530.65
22484,2017-07-10,2427.43,2.25,0.09,2453.46,-1.06,True,1,15738,-2427.43,-8847954.44,38202893.34,29354938.9
22485,2017-07-11,2425.53,-1.9,-0.08,2453.46,-1.14,True,1,15739,-2425.53,-8850379.97,38175416.67,29325036.7
22486,2017-07-12,2443.25,17.72,0.73,2453.46,-0.42,True,1,15740,-2443.25,-8852823.22,38456755.0,29603931.78
22487,2017-07-13,2447.83,4.58,0.19,2453.46,-0.23,True,1,15741,-2447.83,-8855271.05,38531292.03,29676020.98
22488,2017-07-14,2459.27,11.44,0.47,2459.27,0.0,True,1,15742,-2459.27,-8857730.32,38713828.34,29856098.02
22489,2017-07-17,2459.14,-0.13,-0.0,2459.27,-0.0,True,1,15743,-2459.14,-8860189.46,38714241.02,29854051.56
22490,2017-07-18,2460.61,1.47,0.06,2460.61,0.0,True,1,15744,-2460.61,-8862650.07,38739843.84,29877193.77
22491,2017-07-19,2473.83,13.22,0.54,2473.83,0.0,True,1,15745,-2473.83,-8865123.9,38950453.35,30085329.45
22492,2017-07-20,2473.45,-0.38,-0.02,2473.83,-0.02,True,1,15746,-2473.45,-8867597.35,38946943.7,30079346.35
22493,2017-07-21,2472.54,-0.91,-0.04,2473.83,-0.05,True,1,15747,-2472.54,-8870069.89,38935087.38,30065017.49
22494,2017-07-24,2469.91,-2.63,-0.11,2473.83,-0.16,True,1,15748,-2469.91,-8872539.8,38896142.68,30023602.88
22495,2017-07-25,2477.13,7.22,0.29,2477.13,0.0,True,1,15749,-2477.13,-8875016.93,39012320.37,30137303.44
22496,2017-07-26,2477.83,0.7,0.03,2477.83,0.0,True,1,15750,-2477.83,-8877494.76,39025822.5,30148327.74
22497,2017-07-27,2475.42,-2.41,-0.1,2477.83,-0.1,True,1,15751,-2475.42,-8879970.18,38990340.42,30110370.24
22498,2017-07-28,2472.1,-3.32,-0.13,2477.83,-0.23,True,1,15752,-2472.1,-8882442.28,38940519.2,30058076.92
22499,2017-07-31,2470.3,-1.8,-0.07,2477.83,-0.3,True,1,15753,-2470.3,-8884912.58,38914635.9,30029723.32
22500,2017-08-01,2476.35,6.05,0.24,2477.83,-0.06,True,1,15754,-2476.35,-8887388.93,39012417.9,30125028.97
22501,2017-08-02,2477.57,1.22,0.05,2477.83,-0.01,True,1,15755,-2477.57,-8889866.5,39034115.35,30144248.85
22502,2017-08-03,2472.16,-5.41,-0.22,2477.83,-0.23,True,1,15756,-2472.16,-8892338.66,38951352.96,30059014.3
22503,2017-08-04,2476.83,4.67,0.19,2477.83,-0.04,True,1,15757,-2476.83,-8894815.49,39027410.31,30132594.82
22504,2017-08-07,2480.91,4.08,0.16,2480.91,0.0,True,1,15758,-2480.91,-8897296.4,39094179.78,30196883.38
22505,2017-08-08,2474.92,-5.99,-0.24,2480.91,-0.24,True,1,15759,-2474.92,-8899771.32,39002264.28,30102492.96
22506,2017-08-09,2474.02,-0.9,-0.04,2480.91,-0.28,True,1,15760,-2474.02,-8902245.34,38990555.2,30088309.86
22507,2017-08-10,2438.21,-35.81,-1.45,2480.91,-1.72,True,1,15761,-2438.21,-8904683.55,38428627.81,29523944.26
22508,2017-08-11,2441.32,3.11,0.13,2480.91,-1.6,True,1,15762,-2441.32,-8907124.87,38480085.84,29572960.97
22509,2017-08-14,2465.84,24.52,1.0,2480.91,-0.61,True,1,15763,-2465.84,-8909590.71,38869035.92,29959445.21
22510,2017-08-15,2464.61,-1.23,-0.05,2480.91,-0.66,True,1,15764,-2464.61,-8912055.32,38852112.04,29940056.72
22511,2017-08-16,2468.11,3.5,0.14,2480.91,-0.52,True,1,15765,-2468.11,-8914523.43,38909754.15,29995230.72
22512,2017-08-17,2430.01,-38.1,-1.54,2480.91,-2.05,True,1,15766,-2430.01,-8916953.44,38311537.66,29394584.22
22513,2017-08-18,2425.55,-4.46,-0.18,2480.91,-2.23,True,1,15767,-2425.55,-8919378.99,38243646.85,29324267.86
22514,2017-08-21,2428.37,2.82,0.12,2480.91,-2.12,True,1,15768,-2428.37,-8921807.36,38290538.16,29368730.8
22515,2017-08-22,2452.51,24.14,0.99,2480.91,-1.14,True,1,15769,-2452.51,-8924259.87,38673630.19,29749370.32
22516,2017-08-23,2444.04,-8.47,-0.34,2480.91,-1.49,True,1,15770,-2444.04,-8926703.91,38542510.8,29615806.89
22517,2017-08-24,2438.97,-5.07,-0.21,2480.91,-1.69,True,1,15771,-2438.97,-8929142.88,38464995.87,29535852.99
22518,2017-08-25,2443.05,4.08,0.17,2480.91,-1.53,True,1,15772,-2443.05,-8931585.93,38531784.6,29600198.67
22519,2017-08-28,2444.24,1.19,0.05,2480.91,-1.48,True,1,15773,-2444.24,-8934030.17,38552997.52,29618967.35
22520,2017-08-29,2446.3,2.06,0.08,2480.91,-1.4,True,1,15774,-2446.3,-8936476.47,38587936.2,29651459.73
22521,2017-08-30,2457.59,11.29,0.46,2480.91,-0.94,True,1,15775,-2457.59,-8938934.06,38768482.25,29829548.19
22522,2017-08-31,2471.65,14.06,0.57,2480.91,-0.37,True,1,15776,-2471.65,-8941405.71,38992750.4,30051344.69
22523,2017-09-01,2476.55,4.9,0.2,2480.91,-0.18,True,1,15777,-2476.55,-8943882.26,39072529.35,30128647.09
22524,2017-09-05,2457.85,-18.7,-0.76,2480.91,-0.93,True,1,15778,-2457.85,-8946340.11,38779957.3,29833617.19
22525,2017-09-06,2465.54,7.69,0.31,2480.91,-0.62,True,1,15779,-2465.54,-8948805.65,38903755.66,29954950.01
22526,2017-09-07,2465.1,-0.44,-0.02,2480.91,-0.64,True,1,15780,-2465.1,-8951270.75,38899278.0,29948007.25
22527,2017-09-08,2461.43,-3.67,-0.15,2480.91,-0.78,True,1,15781,-2461.43,-8953732.18,38843826.83,29890094.65
22528,2017-09-11,2488.11,26.68,1.08,2488.11,0.0,True,1,15782,-2488.11,-8956220.29,39267352.02,30311131.73
22529,2017-09-12,2496.48,8.37,0.34,2496.48,0.0,True,1,15783,-2496.48,-8958716.77,39401943.84,30443227.07
22530,2017-09-13,2498.37,1.89,0.08,2498.37,0.0,True,1,15784,-2498.37,-8961215.14,39434272.08,30473056.94
22531,2017-09-14,2495.62,-2.75,-0.11,2498.37,-0.11,True,1,15785,-2495.62,-8963710.76,39393361.7,30429650.94
22532,2017-09-15,2500.23,4.61,0.18,2500.23,0.0,True,1,15786,-2500.23,-8966210.99,39468630.78,30502419.79
22533,2017-09-18,2503.87,3.64,0.15,2503.87,0.0,True,1,15787,-2503.87,-8968714.86,39528595.69,30559880.83
22534,2017-09-19,2506.65,2.78,0.11,2506.65,0.0,True,1,15788,-2506.65,-8971221.51,39574990.2,30603768.69
22535,2017-09-20,2508.24,1.59,0.06,2508.24,0.0,True,1,15789,-2508.24,-8973729.75,39602601.36,30628871.61
22536,2017-09-21,2500.6,-7.64,-0.3,2508.24,-0.3,True,1,15790,-2500.6,-8976230.35,39484474.0,30508243.65
22537,2017-09-22,2502.22,1.62,0.06,2508.24,-0.24,True,1,15791,-2502.22,-8978732.57,39512556.02,30533823.45
22538,2017-09-25,2496.66,-5.56,-0.22,2508.24,-0.46,True,1,15792,-2496.66,-8981229.23,39427254.72,30446025.49
22539,2017-09-26,2496.84,0.18,0.01,2508.24,-0.45,True,1,15793,-2496.84,-8983726.07,39432594.12,30448868.05
22540,2017-09-27,2507.04,10.2,0.41,2508.24,-0.05,True,1,15794,-2507.04,-8986233.11,39596189.76,30609956.65
22541,2017-09-28,2510.06,3.02,0.12,2510.06,0.0,True,1,15795,-2510.06,-8988743.17,39646397.7,30657654.53
22542,2017-09-29,2519.36,9.3,0.37,2519.36,0.0,True,1,15796,-2519.36,-8991262.53,39795810.56,30804548.03
22543,2017-10-02,2529.12,9.76,0.39,2529.12,0.0,True,1,15797,-2529.12,-8993791.65,39952508.64,30958716.99
22544,2017-10-03,2534.58,5.46,0.22,2534.58,0.0,True,1,15798,-2534.58,-8996326.23,40041294.84,31044968.61
22545,2017-10-04,2537.74,3.16,0.12,2537.74,0.0,True,1,15799,-2537.74,-8998863.97,40093754.26,31094890.29
22546,2017-10-05,2552.07,14.33,0.56,2552.07,0.0,True,1,15800,-2552.07,-9001416.04,40322706.0,31321289.96
22547,2017-10-06,2549.33,-2.74,-0.11,2552.07,-0.11,True,1,15801,-2549.33,-9003965.37,40281963.33,31277997.96
22548,2017-10-09,2544.73,-4.6,-0.18,2552.07,-0.29,True,1,15802,-2544.73,-9006510.1,40211823.46,31205313.36
22549,2017-10-10,2550.64,5.91,0.23,2552.07,-0.06,True,1,15803,-2550.64,-9009060.74,40307763.92,31298703.18
22550,2017-10-11,2555.24,4.6,0.18,2555.24,0.0,True,1,15804,-2555.24,-9011615.98,40383012.96,31371396.98
22551,2017-10-12,2550.93,-4.31,-0.17,2555.24,-0.17,True,1,15805,-2550.93,-9014166.91,40317448.65,31303281.74
22552,2017-10-13,2553.17,2.24,0.09,2555.24,-0.08,True,1,15806,-2553.17,-9016720.08,40355405.02,31338684.94
22553,2017-10-16,2557.64,4.47,0.18,2557.64,0.0,True,1,15807,-2557.64,-9019277.72,40428615.48,31409337.76
22554,2017-10-17,2559.36,1.72,0.07,2559.36,0.0,True,1,15808,-2559.36,-9021837.08,40458362.88,31436525.8
22555,2017-10-18,2561.26,1.9,0.07,2561.26,0.0,True,1,15809,-2561.26,-9024398.34,40490959.34,31466561.0
22556,2017-10-19,2562.1,0.84,0.03,2562.1,0.0,True,1,15810,-2562.1,-9026960.44,40506801.0,31479840.56
22557,2017-10-20,2575.21,13.11,0.51,2575.21,0.0,True,1,15811,-2575.21,-9029535.65,40716645.31,31687109.66
22558,2017-10-23,2564.98,-10.23,-0.4,2575.21,-0.4,True,1,15812,-2564.98,-9032100.63,40557463.76,31525363.13
22559,2017-10-24,2569.13,4.15,0.16,2575.21,-0.24,True,1,15813,-2569.13,-9034669.76,40625652.69,31590982.93
22560,2017-10-25,2557.15,-11.98,-0.47,2575.21,-0.7,True,1,15814,-2557.15,-9037226.91,40438770.1,31401543.19
22561,2017-10-26,2560.4,3.25,0.13,2575.21,-0.57,True,1,15815,-2560.4,-9039787.31,40492726.0,31452938.69
22562,2017-10-27,2581.07,20.67,0.81,2581.07,0.0,True,1,15816,-2581.07,-9042368.38,40822203.12,31779834.74
22563,2017-10-30,2572.83,-8.24,-0.32,2581.07,-0.32,True,1,15817,-2572.83,-9044941.21,40694452.11,31649510.9
22564,2017-10-31,2575.26,2.43,0.09,2581.07,-0.22,True,1,15818,-2575.26,-9047516.47,40735462.68,31687946.21
22565,2017-11-01,2579.36,4.1,0.16,2581.07,-0.07,True,1,15819,-2579.36,-9050095.83,40802895.84,31752800.01
22566,2017-11-02,2579.85,0.49,0.02,2581.07,-0.05,True,1,15820,-2579.85,-9052675.68,40813227.0,31760551.32
22567,2017-11-03,2587.84,7.99,0.31,2587.84,0.0,True,1,15821,-2587.84,-9055263.52,40942216.64,31886953.12
22568,2017-11-06,2591.13,3.29,0.13,2591.13,0.0,True,1,15822,-2591.13,-9057854.65,40996858.86,31939004.21
22569,2017-11-07,2590.64,-0.49,-0.02,2591.13,-0.02,True,1,15823,-2590.64,-9060445.29,40991696.72,31931251.43
22570,2017-11-08,2594.38,3.74,0.14,2594.38,0.0,True,1,15824,-2594.38,-9063039.67,41053469.12,31990429.45
22571,2017-11-09,2584.62,-9.76,-0.38,2594.38,-0.38,True,1,15825,-2584.62,-9065624.29,40901611.5,31835987.21
22572,2017-11-10,2582.3,-2.32,-0.09,2594.38,-0.47,True,1,15826,-2582.3,-9068206.59,40867479.8,31799273.21
22573,2017-11-13,2584.84,2.54,0.1,2594.38,-0.37,True,1,15827,-2584.84,-9070791.43,40910262.68,31839471.25
22574,2017-11-14,2578.87,-5.97,-0.23,2594.38,-0.6,True,1,15828,-2578.87,-9073370.3,40818354.36,31744984.06
22575,2017-11-15,2564.62,-14.25,-0.55,2594.38,-1.15,True,1,15829,-2564.62,-9075934.92,40595369.98,31519435.06
22576,2017-11-16,2585.64,21.02,0.82,2594.38,-0.34,True,1,15830,-2585.64,-9078520.56,40930681.2,31852160.64
22577,2017-11-17,2578.85,-6.79,-0.26,2594.38,-0.6,True,1,15831,-2578.85,-9081099.41,40825774.35,31744674.94
22578,2017-11-20,2582.14,3.29,0.13,2594.38,-0.47,True,1,15832,-2582.14,-9083681.55,40880440.48,31796758.93
22579,2017-11-21,2599.03,16.89,0.65,2599.03,0.0,True,1,15833,-2599.03,-9086280.58,41150441.99,32064161.41
22580,2017-11-22,2597.08,-1.95,-0.08,2599.03,-0.08,True,1,15834,-2597.08,-9088877.66,41122164.72,32033287.06
22581,2017-11-24,2602.42,5.34,0.21,2602.42,0.0,True,1,15835,-2602.42,-9091480.08,41209320.7,32117840.62
22582,2017-11-27,2601.42,-1.0,-0.04,2602.42,-0.04,True,1,15836,-2601.42,-9094081.5,41196087.12,32102005.62
22583,2017-11-28,2627.04,25.62,0.98,2627.04,0.0,True,1,15837,-2627.04,-9096708.54,41604432.48,32507723.94
22584,2017-11-29,2626.07,-0.97,-0.04,2627.04,-0.04,True,1,15838,-2626.07,-9099334.61,41591696.66,32492362.05
22585,2017-11-30,2647.58,21.51,0.82,2647.58,0.0,True,1,15839,-2647.58,-9101982.19,41935019.62,32833037.43
22586,2017-12-01,2642.22,-5.36,-0.2,2647.58,-0.2,True,1,15840,-2642.22,-9104624.41,41852764.8,32748140.39
22587,2017-12-04,2639.44,-2.78,-0.1,2647.58,-0.31,True,1,15841,-2639.44,-9107263.85,41811369.04,32704105.19
22588,2017-12-05,2629.57,-9.87,-0.37,2647.58,-0.68,True,1,15842,-2629.57,-9109893.42,41657647.94,32547754.52
22589,2017-12-06,2629.27,-0.3,-0.01,2647.58,-0.69,True,1,15843,-2629.27,-9112522.69,41655524.61,32543001.92
22590,2017-12-07,2636.98,7.71,0.29,2647.58,-0.4,True,1,15844,-2636.98,-9115159.67,41780311.12,32665151.45
22591,2017-12-08,2651.5,14.52,0.55,2651.5,0.0,True,1,15845,-2651.5,-9117811.17,42013017.5,32895206.33
22592,2017-12-11,2659.99,8.49,0.32,2659.99,0.0,True,1,15846,-2659.99,-9120471.16,42150201.54,33029730.38
22593,2017-12-12,2664.11,4.12,0.16,2664.11,0.0,True,1,15847,-2664.11,-9123135.27,42218151.17,33095015.9
22594,2017-12-13,2662.85,-1.26,-0.05,2664.11,-0.05,True,1,15848,-2662.85,-9125798.12,42200846.8,33075048.68
22595,2017-12-14,2652.01,-10.84,-0.41,2664.11,-0.45,True,1,15849,-2652.01,-9128450.13,42031706.49,32903256.36
22596,2017-12-15,2675.81,23.8,0.9,2675.81,0.0,True,1,15850,-2675.81,-9131125.94,42411588.5,33280462.56
22597,2017-12-18,2690.16,14.35,0.54,2690.16,0.0,True,1,15851,-2690.16,-9133816.1,42641726.16,33507910.06
22598,2017-12-19,2681.47,-8.69,-0.32,2690.16,-0.32,True,1,15852,-2681.47,-9136497.57,42506662.44,33370164.87
22599,2017-12-20,2679.25,-2.22,-0.08,2690.16,-0.41,True,1,15853,-2679.25,-9139176.82,42474150.25,33334973.43
22600,2017-12-21,2684.57,5.32,0.2,2690.16,-0.21,True,1,15854,-2684.57,-9141861.39,42561172.78,33419311.39
22601,2017-12-22,2683.34,-1.23,-0.05,2690.16,-0.25,True,1,15855,-2683.34,-9144544.73,42544355.7,33399810.97
22602,2017-12-26,2680.5,-2.84,-0.11,2690.16,-0.36,True,1,15856,-2680.5,-9147225.23,42502008.0,33354782.77
22603,2017-12-27,2682.62,2.12,0.08,2690.16,-0.28,True,1,15857,-2682.62,-9149907.85,42538305.34,33388397.49
22604,2017-12-28,2687.54,4.92,0.18,2690.16,-0.1,True,1,15858,-2687.54,-9152595.39,42619009.32,33466413.93
22605,2017-12-29,2673.61,-13.93,-0.52,2690.16,-0.62,True,1,15859,-2673.61,-9155269.0,42400780.99,33245511.99
22606,2018-01-02,2695.81,22.2,0.83,2695.81,0.0,True,1,15860,-2695.81,-9157964.81,42755546.6,33597581.79
22607,2018-01-03,2713.06,17.25,0.64,2713.06,0.0,True,1,15861,-2713.06,-9160677.87,43031844.66,33871166.79
22608,2018-01-04,2723.99,10.93,0.4,2723.99,0.0,True,1,15862,-2723.99,-9163401.86,43207929.38,34044527.52
22609,2018-01-05,2743.15,19.16,0.7,2743.15,0.0,True,1,15863,-2743.15,-9166145.01,43514588.45,34348443.44
22610,2018-01-08,2747.71,4.56,0.17,2747.71,0.0,True,1,15864,-2747.71,-9168892.72,43589671.44,34420778.72
22611,2018-01-09,2751.29,3.58,0.13,2751.29,0.0,True,1,15865,-2751.29,-9171644.01,43649215.85,34477571.84
22612,2018-01-10,2748.23,-3.06,-0.11,2751.29,-0.11,True,1,15866,-2748.23,-9174392.24,43603417.18,34429024.94
22613,2018-01-11,2767.56,19.33,0.7,2767.56,0.0,True,1,15867,-2767.56,-9177159.8,43912874.52,34735714.72
22614,2018-01-12,2786.24,18.68,0.68,2786.24,0.0,True,1,15868,-2786.24,-9179946.04,44212056.32,35032110.28
22615,2018-01-16,2776.42,-9.82,-0.35,2786.24,-0.35,True,1,15869,-2776.42,-9182722.46,44059008.98,34876286.52
22616,2018-01-17,2802.56,26.14,0.94,2802.56,0.0,True,1,15870,-2802.56,-9185525.02,44476627.2,35291102.18
22617,2018-01-18,2798.03,-4.53,-0.16,2802.56,-0.16,True,1,15871,-2798.03,-9188323.05,44407534.13,35219211.08
22618,2018-01-19,2810.3,12.27,0.44,2810.3,0.0,True,1,15872,-2810.3,-9191133.35,44605081.6,35413948.25
22619,2018-01-22,2832.97,22.67,0.81,2832.97,0.0,True,1,15873,-2832.97,-9193966.32,44967732.81,35773766.49
22620,2018-01-23,2839.13,6.16,0.22,2839.13,0.0,True,1,15874,-2839.13,-9196805.45,45068349.62,35871544.17
22621,2018-01-24,2837.54,-1.59,-0.06,2839.13,-0.06,True,1,15875,-2837.54,-9199642.99,45045947.5,35846304.51
22622,2018-01-25,2839.25,1.71,0.06,2839.25,0.0,True,1,15876,-2839.25,-9202482.24,45075933.0,35873450.76
22623,2018-01-26,2872.87,33.62,1.18,2872.87,0.0,True,1,15877,-2872.87,-9205355.11,45612556.99,36407201.88
22624,2018-01-29,2853.53,-19.34,-0.67,2872.87,-0.67,True,1,15878,-2853.53,-9208208.64,45308349.34,36100140.7
22625,2018-01-30,2822.43,-31.1,-1.09,2872.87,-1.76,True,1,15879,-2822.43,-9211031.07,44817365.97,35606334.9
22626,2018-01-31,2823.81,1.38,0.05,2872.87,-1.71,True,1,15880,-2823.81,-9213854.88,44842102.8,35628247.92
22627,2018-02-01,2821.98,-1.83,-0.06,2872.87,-1.77,True,1,15881,-2821.98,-9216676.86,44815864.38,35599187.52
22628,2018-02-02,2762.13,-59.85,-2.12,2872.87,-3.86,True,1,15882,-2762.13,-9219438.99,43868148.66,34648709.67
22629,2018-02-05,2648.94,-113.19,-4.1,2872.87,-7.8,True,1,15883,-2648.94,-9222087.93,42073114.02,32851026.09
22630,2018-02-06,2695.14,46.2,1.74,2872.87,-6.19,True,1,15884,-2695.14,-9224783.07,42809603.76,33584820.69
22631,2018-02-07,2681.66,-13.48,-0.5,2872.87,-6.66,True,1,15885,-2681.66,-9227464.73,42598169.1,33370704.37
22632,2018-02-08,2581.0,-100.66,-3.75,2872.87,-10.16,True,1,15886,-2581.0,-9230045.73,41001766.0,31771720.27
22633,2018-02-09,2619.55,38.55,1.49,2872.87,-8.82,True,1,15887,-2619.55,-9232665.28,41616790.85,32384125.57
22634,2018-02-12,2656.0,36.45,1.39,2872.87,-7.55,True,1,15888,-2656.0,-9235321.28,42198528.0,32963206.72
22635,2018-02-13,2662.94,6.94,0.26,2872.87,-7.31,True,1,15889,-2662.94,-9237984.22,42311453.66,33073469.44
22636,2018-02-14,2698.63,35.69,1.34,2872.87,-6.06,True,1,15890,-2698.63,-9240682.85,42881230.7,33640547.85
22637,2018-02-15,2731.2,32.57,1.21,2872.87,-4.93,True,1,15891,-2731.2,-9243414.05,43401499.2,34158085.15
22638,2018-02-16,2732.22,1.02,0.04,2872.87,-4.9,True,1,15892,-2732.22,-9246146.27,43420440.24,34174293.97
22639,2018-02-20,2716.26,-15.96,-0.58,2872.87,-5.45,True,1,15893,-2716.26,-9248862.53,43169520.18,33920657.65
22640,2018-02-21,2701.33,-14.93,-0.55,2872.87,-5.97,True,1,15894,-2701.33,-9251563.86,42934939.02,33683375.16
22641,2018-02-22,2703.96,2.63,0.1,2872.87,-5.88,True,1,15895,-2703.96,-9254267.82,42979444.2,33725176.38
22642,2018-02-23,2747.3,43.34,1.6,2872.87,-4.37,True,1,15896,-2747.3,-9257015.12,43671080.8,34414065.68
22643,2018-02-26,2779.6,32.3,1.18,2872.87,-3.25,True,1,15897,-2779.6,-9259794.72,44187301.2,34927506.48
22644,2018-02-27,2744.28,-35.32,-1.27,2872.87,-4.48,True,1,15898,-2744.28,-9262539.0,43628563.44,34366024.44
22645,2018-02-28,2713.83,-30.45,-1.11,2872.87,-5.54,True,1,15899,-2713.83,-9265252.83,43147183.17,33881930.34
22646,2018-03-01,2677.67,-36.16,-1.33,2872.87,-6.8,True,1,15900,-2677.67,-9267930.5,42574953.0,33307022.5
22647,2018-03-02,2691.25,13.58,0.51,2872.87,-6.32,True,1,15901,-2691.25,-9270621.75,42793566.25,33522944.5
22648,2018-03-05,2720.94,29.69,1.1,2872.87,-5.29,True,1,15902,-2720.94,-9273342.69,43268387.88,33995045.19
22649,2018-03-06,2728.12,7.18,0.26,2872.87,-5.04,True,1,15903,-2728.12,-9276070.81,43385292.36,34109221.55
22650,2018-03-07,2726.8,-1.32,-0.05,2872.87,-5.08,True,1,15904,-2726.8,-9278797.61,43367027.2,34088229.59
22651,2018-03-08,2738.97,12.17,0.45,2872.87,-4.66,True,1,15905,-2738.97,-9281536.58,43563317.85,34281781.27
22652,2018-03-09,2786.57,47.6,1.74,2872.87,-3.0,True,1,15906,-2786.57,-9284323.15,44323182.42,35038859.27
22653,2018-03-12,2783.02,-3.55,-0.13,2872.87,-3.13,True,1,15907,-2783.02,-9287106.17,44269499.14,34982392.97
22654,2018-03-13,2765.31,-17.71,-0.64,2872.87,-3.74,True,1,15908,-2765.31,-9289871.48,43990551.48,34700680.0
22655,2018-03-14,2749.48,-15.83,-0.57,2872.87,-4.3,True,1,15909,-2749.48,-9292620.96,43741477.32,34448856.36
22656,2018-03-15,2747.33,-2.15,-0.08,2872.87,-4.37,True,1,15910,-2747.33,-9295368.29,43710020.3,34414652.01
22657,2018-03-16,2752.01,4.68,0.17,2872.87,-4.21,True,1,15911,-2752.01,-9298120.3,43787231.11,34489110.81
22658,2018-03-19,2712.92,-39.09,-1.42,2872.87,-5.57,True,1,15912,-2712.92,-9300833.22,43167983.04,33867149.82
22659,2018-03-20,2716.94,4.02,0.15,2872.87,-5.43,True,1,15913,-2716.94,-9303550.16,43234666.22,33931116.06
22660,2018-03-21,2711.93,-5.01,-0.18,2872.87,-5.6,True,1,15914,-2711.93,-9306262.09,43157654.02,33851391.93
22661,2018-03-22,2643.69,-68.24,-2.52,2872.87,-7.98,True,1,15915,-2643.69,-9308905.78,42074326.35,32765420.57
22662,2018-03-23,2588.26,-55.43,-2.1,2872.87,-9.91,True,1,15916,-2588.26,-9311494.04,41194746.16,31883252.12
22663,2018-03-26,2658.55,70.29,2.72,2872.87,-7.46,True,1,15917,-2658.55,-9314152.59,42316140.35,33001987.76
22664,2018-03-27,2612.62,-45.93,-1.73,2872.87,-9.06,True,1,15918,-2612.62,-9316765.21,41587685.16,32270919.95
22665,2018-03-28,2605.0,-7.62,-0.29,2872.87,-9.32,True,1,15919,-2605.0,-9319370.21,41468995.0,32149624.79
22666,2018-03-29,2640.87,35.87,1.38,2872.87,-8.08,True,1,15920,-2640.87,-9322011.08,42042650.4,32720639.32
22667,2018-04-02,2581.88,-58.99,-2.23,2872.87,-10.13,True,1,15921,-2581.88,-9324592.96,41106111.48,31781518.52
22668,2018-04-03,2614.45,32.57,1.26,2872.87,-8.99,True,1,15922,-2614.45,-9327207.41,41627272.9,32300065.49
22669,2018-04-04,2644.69,30.24,1.16,2872.87,-7.94,True,1,15923,-2644.69,-9329852.1,42111398.87,32781546.77
22670,2018-04-05,2662.84,18.15,0.69,2872.87,-7.31,True,1,15924,-2662.84,-9332514.94,42403064.16,33070549.22
22671,2018-04-06,2604.47,-58.37,-2.19,2872.87,-9.34,True,1,15925,-2604.47,-9335119.41,41476184.75,32141065.34
22672,2018-04-09,2613.16,8.69,0.33,2872.87,-9.04,True,1,15926,-2613.16,-9337732.57,41617186.16,32279453.59
22673,2018-04-10,2656.87,43.71,1.67,2872.87,-7.52,True,1,15927,-2656.87,-9340389.44,42315968.49,32975579.05
22674,2018-04-11,2642.19,-14.68,-0.55,2872.87,-8.03,True,1,15928,-2642.19,-9343031.63,42084802.32,32741770.69
22675,2018-04-12,2663.99,21.8,0.82,2872.87,-7.27,True,1,15929,-2663.99,-9345695.62,42434696.71,33089001.09
22676,2018-04-13,2656.3,-7.69,-0.29,2872.87,-7.54,True,1,15930,-2656.3,-9348351.92,42314859.0,32966507.08
22677,2018-04-16,2677.84,21.54,0.81,2872.87,-6.79,True,1,15931,-2677.84,-9351029.76,42660669.04,33309639.28
22678,2018-04-17,2706.39,28.55,1.07,2872.87,-5.8,True,1,15932,-2706.39,-9353736.15,43118205.48,33764469.33
22679,2018-04-18,2708.64,2.25,0.08,2872.87,-5.72,True,1,15933,-2708.64,-9356444.79,43156761.12,33800316.33
22680,2018-04-19,2693.13,-15.51,-0.57,2872.87,-6.26,True,1,15934,-2693.13,-9359137.92,42912333.42,33553195.5
22681,2018-04-20,2670.14,-22.99,-0.85,2872.87,-7.06,True,1,15935,-2670.14,-9361808.06,42548680.9,33186872.84
22682,2018-04-23,2670.29,0.15,0.01,2872.87,-7.05,True,1,15936,-2670.29,-9364478.35,42553741.44,33189263.09
22683,2018-04-24,2634.56,-35.73,-1.34,2872.87,-8.3,True,1,15937,-2634.56,-9367112.91,41986982.72,32619869.81
22684,2018-04-25,2639.4,4.84,0.18,2872.87,-8.13,True,1,15938,-2639.4,-9369752.31,42066757.2,32697004.89
22685,2018-04-26,2666.94,27.54,1.04,2872.87,-7.17,True,1,15939,-2666.94,-9372419.25,42508356.66,33135937.41
22686,2018-04-27,2669.91,2.97,0.11,2872.87,-7.06,True,1,15940,-2669.91,-9375089.16,42558365.4,33183276.24
22687,2018-04-30,2648.05,-21.86,-0.82,2872.87,-7.83,True,1,15941,-2648.05,-9377737.21,42212565.05,32834827.84
22688,2018-05-01,2654.8,6.75,0.26,2872.87,-7.59,True,1,15942,-2654.8,-9380392.01,42322821.6,32942429.59
22689,2018-05-02,2635.67,-19.13,-0.72,2872.87,-8.26,True,1,15943,-2635.67,-9383027.68,42020486.81,32637459.13
22690,2018-05-03,2629.73,-5.94,-0.22,2872.87,-8.46,True,1,15944,-2629.73,-9385657.41,41928415.12,32542757.71
22691,2018-05-04,2663.42,33.69,1.28,2872.87,-7.29,True,1,15945,-2663.42,-9388320.83,42468231.9,33079911.07
22692,2018-05-07,2672.63,9.21,0.35,2872.87,-6.97,True,1,15946,-2672.63,-9390993.46,42617757.98,33226764.52
22693,2018-05-08,2671.92,-0.71,-0.03,2872.87,-7.0,True,1,15947,-2671.92,-9393665.38,42609108.24,33215442.86
22694,2018-05-09,2697.79,25.87,0.97,2872.87,-6.09,True,1,15948,-2697.79,-9396363.17,43024354.92,33627991.75
22695,2018-05-10,2723.07,25.28,0.94,2872.87,-5.21,True,1,15949,-2723.07,-9399086.24,43430243.43,34031157.19
22696,2018-05-11,2727.72,4.65,0.17,2872.87,-5.05,True,1,15950,-2727.72,-9401813.96,43507134.0,34105320.04
22697,2018-05-14,2730.13,2.41,0.09,2872.87,-4.97,True,1,15951,-2730.13,-9404544.09,43548303.63,34143759.54
22698,2018-05-15,2711.45,-18.68,-0.68,2872.87,-5.62,True,1,15952,-2711.45,-9407255.54,43253050.4,33845794.86
22699,2018-05-16,2722.46,11.01,0.41,2872.87,-5.24,True,1,15953,-2722.46,-9409978.0,43431404.38,34021426.38
22700,2018-05-17,2720.13,-2.33,-0.09,2872.87,-5.32,True,1,15954,-2720.13,-9412698.13,43396954.02,33984255.89
22701,2018-05-18,2712.97,-7.16,-0.26,2872.87,-5.57,True,1,15955,-2712.97,-9415411.1,43285436.35,33870025.25
22702,2018-05-21,2733.01,20.04,0.74,2872.87,-4.87,True,1,15956,-2733.01,-9418144.11,43607907.56,34189763.45
22703,2018-05-22,2724.44,-8.57,-0.31,2872.87,-5.17,True,1,15957,-2724.44,-9420868.55,43473889.08,34053020.53
22704,2018-05-23,2733.29,8.85,0.32,2872.87,-4.86,True,1,15958,-2733.29,-9423601.84,43617841.82,34194239.98
22705,2018-05-24,2727.76,-5.53,-0.2,2872.87,-5.05,True,1,15959,-2727.76,-9426329.6,43532321.84,34105992.24
22706,2018-05-25,2721.33,-6.43,-0.24,2872.87,-5.28,True,1,15960,-2721.33,-9429050.93,43432426.8,34003375.87
22707,2018-05-29,2689.86,-31.47,-1.16,2872.87,-6.37,True,1,15961,-2689.86,-9431740.79,42932855.46,33501114.67
22708,2018-05-30,2724.01,34.15,1.27,2872.87,-5.18,True,1,15962,-2724.01,-9434464.8,43480647.62,34046182.82
22709,2018-05-31,2705.27,-18.74,-0.69,2872.87,-5.83,True,1,15963,-2705.27,-9437170.07,43184225.01,33747054.94
22710,2018-06-01,2734.62,29.35,1.08,2872.87,-4.81,True,1,15964,-2734.62,-9439904.69,43655473.68,34215568.99
22711,2018-06-04,2746.87,12.25,0.45,2872.87,-4.39,True,1,15965,-2746.87,-9442651.56,43853779.55,34411127.99
22712,2018-06-05,2748.8,1.93,0.07,2872.87,-4.32,True,1,15966,-2748.8,-9445400.36,43887340.8,34441940.44
22713,2018-06-06,2772.35,23.55,0.86,2872.87,-3.5,True,1,15967,-2772.35,-9448172.71,44266112.45,34817939.74
22714,2018-06-07,2770.37,-1.98,-0.07,2872.87,-3.57,True,1,15968,-2770.37,-9450943.08,44237268.16,34786325.08
22715,2018-06-08,2779.03,8.66,0.31,2872.87,-3.27,True,1,15969,-2779.03,-9453722.11,44378330.07,34924607.96
22716,2018-06-11,2782.0,2.97,0.11,2872.87,-3.16,True,1,15970,-2782.0,-9456504.11,44428540.0,34972035.89
22717,2018-06-12,2786.85,4.85,0.17,2872.87,-2.99,True,1,15971,-2786.85,-9459290.96,44508781.35,35049490.39
22718,2018-06-13,2775.63,-11.22,-0.4,2872.87,-3.38,True,1,15972,-2775.63,-9462066.59,44332362.36,34870295.77
22719,2018-06-14,2782.49,6.86,0.25,2872.87,-3.15,True,1,15973,-2782.49,-9464849.08,44444712.77,34979863.69
22720,2018-06-15,2779.66,-2.83,-0.1,2872.87,-3.24,True,1,15974,-2779.66,-9467628.74,44402288.84,34934660.1
22721,2018-06-18,2773.75,-5.91,-0.21,2872.87,-3.45,True,1,15975,-2773.75,-9470402.49,44310656.25,34840253.76
22722,2018-06-19,2762.59,-11.16,-0.4,2872.87,-3.84,True,1,15976,-2762.59,-9473165.08,44135137.84,34661972.76
22723,2018-06-20,2767.32,4.73,0.17,2872.87,-3.67,True,1,15977,-2767.32,-9475932.4,44213471.64,34737539.24
22724,2018-06-21,2749.76,-17.56,-0.64,2872.87,-4.28,True,1,15978,-2749.76,-9478682.16,43935665.28,34456983.12
22725,2018-06-22,2754.88,5.12,0.19,2872.87,-4.11,True,1,15979,-2754.88,-9481437.04,44020227.52,34538790.48
22726,2018-06-25,2717.07,-37.81,-1.37,2872.87,-5.42,True,1,15980,-2717.07,-9484154.11,43418778.6,33934624.49
22727,2018-06-26,2723.06,5.99,0.22,2872.87,-5.22,True,1,15981,-2723.06,-9486877.17,43517221.86,34030344.69
22728,2018-06-27,2699.63,-23.43,-0.86,2872.87,-6.03,True,1,15982,-2699.63,-9489576.8,43145486.66,33655909.86
22729,2018-06-28,2716.31,16.68,0.62,2872.87,-5.45,True,1,15983,-2716.31,-9492293.11,43414782.73,33922489.62
22730,2018-06-29,2718.37,2.06,0.08,2872.87,-5.38,True,1,15984,-2718.37,-9495011.48,43450426.08,33955414.6
22731,2018-07-02,2726.71,8.34,0.31,2872.87,-5.09,True,1,15985,-2726.71,-9497738.19,43586459.35,34088721.16
22732,2018-07-03,2713.22,-13.49,-0.5,2872.87,-5.56,True,1,15986,-2713.22,-9500451.41,43373534.92,33873083.51
22733,2018-07-05,2736.61,23.39,0.86,2872.87,-4.74,True,1,15987,-2736.61,-9503188.02,43750184.07,34246996.05
22734,2018-07-06,2759.82,23.21,0.85,2872.87,-3.94,True,1,15988,-2759.82,-9505947.84,44124002.16,34618054.32
22735,2018-07-09,2784.17,24.35,0.88,2872.87,-3.09,True,1,15989,-2784.17,-9508732.01,44516094.13,35007362.12
22736,2018-07-10,2793.84,9.67,0.35,2872.87,-2.75,True,1,15990,-2793.84,-9511525.85,44673501.6,35161975.75
22737,2018-07-11,2774.02,-19.82,-0.71,2872.87,-3.44,True,1,15991,-2774.02,-9514299.87,44359353.82,34845053.95
22738,2018-07-12,2798.29,24.27,0.88,2872.87,-2.6,True,1,15992,-2798.29,-9517098.16,44750253.68,35233155.52
22739,2018-07-13,2801.31,3.02,0.11,2872.87,-2.49,True,1,15993,-2801.31,-9519899.47,44801350.83,35281451.36
22740,2018-07-16,2798.43,-2.88,-0.1,2872.87,-2.59,True,1,15994,-2798.43,-9522697.9,44758089.42,35235391.52
22741,2018-07-17,2809.55,11.12,0.4,2872.87,-2.2,True,1,15995,-2809.55,-9525507.45,44938752.25,35413244.8
22742,2018-07-18,2815.62,6.07,0.22,2872.87,-1.99,True,1,15996,-2815.62,-9528323.07,45038657.52,35510334.45
22743,2018-07-19,2804.49,-11.13,-0.4,2872.87,-2.38,True,1,15997,-2804.49,-9531127.56,44863426.53,35332298.97
22744,2018-07-20,2801.83,-2.66,-0.1,2872.87,-2.47,True,1,15998,-2801.83,-9533929.39,44823676.34,35289746.95
22745,2018-07-23,2806.98,5.15,0.18,2872.87,-2.29,True,1,15999,-2806.98,-9536736.37,44908873.02,35372136.65
22746,2018-07-24,2820.4,13.42,0.48,2872.87,-1.83,True,1,16000,-2820.4,-9539556.77,45126400.0,35586843.23
22747,2018-07-25,2846.07,25.67,0.91,2872.87,-0.93,True,1,16001,-2846.07,-9542402.84,45539966.07,35997563.23
22748,2018-07-26,2837.44,-8.63,-0.3,2872.87,-1.23,True,1,16002,-2837.44,-9545240.28,45404714.88,35859474.6
22749,2018-07-27,2818.82,-18.62,-0.66,2872.87,-1.88,True,1,16003,-2818.82,-9548059.1,45109576.46,35561517.36
22750,2018-07-30,2802.6,-16.22,-0.57,2872.87,-2.45,True,1,16004,-2802.6,-9550861.7,44852810.4,35301948.7
22751,2018-07-31,2816.29,13.69,0.49,2872.87,-1.97,True,1,16005,-2816.29,-9553677.99,45074721.45,35521043.46
22752,2018-08-01,2813.36,-2.93,-0.1,2872.87,-2.07,True,1,16006,-2813.36,-9556491.35,45030640.16,35474148.81
22753,2018-08-02,2827.22,13.86,0.49,2872.87,-1.59,True,1,16007,-2827.22,-9559318.57,45255310.54,35695991.97
22754,2018-08-03,2840.35,13.13,0.46,2872.87,-1.13,True,1,16008,-2840.35,-9562158.92,45468322.8,35906163.88
22755,2018-08-06,2850.4,10.05,0.35,2872.87,-0.78,True,1,16009,-2850.4,-9565009.32,45632053.6,36067044.28
22756,2018-08-07,2858.45,8.05,0.28,2872.87,-0.5,True,1,16010,-2858.45,-9567867.77,45763784.5,36195916.73
22757,2018-08-08,2857.7,-0.75,-0.03,2872.87,-0.53,True,1,16011,-2857.7,-9570725.47,45754634.7,36183909.23
22758,2018-08-09,2853.58,-4.12,-0.14,2872.87,-0.67,True,1,16012,-2853.58,-9573579.05,45691522.96,36117943.91
22759,2018-08-10,2833.28,-20.3,-0.71,2872.87,-1.38,True,1,16013,-2833.28,-9576412.33,45369312.64,35792900.31
22760,2018-08-13,2821.93,-11.35,-0.4,2872.87,-1.77,True,1,16014,-2821.93,-9579234.26,45190387.02,35611152.76
22761,2018-08-14,2839.96,18.03,0.64,2872.87,-1.15,True,1,16015,-2839.96,-9582074.22,45481959.4,35899885.18
22762,2018-08-15,2818.37,-21.59,-0.76,2872.87,-1.9,True,1,16016,-2818.37,-9584892.59,45139013.92,35554121.33
22763,2018-08-16,2840.69,22.32,0.79,2872.87,-1.12,True,1,16017,-2840.69,-9587733.28,45499331.73,35911598.45
22764,2018-08-17,2850.13,9.44,0.33,2872.87,-0.79,True,1,16018,-2850.13,-9590583.41,45653382.34,36062798.93
22765,2018-08-20,2857.05,6.92,0.24,2872.87,-0.55,True,1,16019,-2857.05,-9593440.46,45767083.95,36173643.49
22766,2018-08-21,2862.96,5.91,0.21,2872.87,-0.34,True,1,16020,-2862.96,-9596303.42,45864619.2,36268315.78
22767,2018-08-22,2861.82,-1.14,-0.04,2872.87,-0.38,True,1,16021,-2861.82,-9599165.24,45849218.22,36250052.98
22768,2018-08-23,2856.98,-4.84,-0.17,2872.87,-0.55,True,1,16022,-2856.98,-9602022.22,45774533.56,36172511.34
22769,2018-08-24,2874.69,17.71,0.62,2874.69,0.0,True,1,16023,-2874.69,-9604896.91,46061157.87,36456260.96
22770,2018-08-27,2896.74,22.05,0.77,2896.74,0.0,True,1,16024,-2896.74,-9607793.65,46417361.76,36809568.11
22771,2018-08-28,2897.52,0.78,0.03,2897.52,0.0,True,1,16025,-2897.52,-9610691.17,46432758.0,36822066.83
22772,2018-08-29,2914.04,16.52,0.57,2914.04,0.0,True,1,16026,-2914.04,-9613605.21,46700405.04,37086799.83
22773,2018-08-30,2901.13,-12.91,-0.44,2914.04,-0.44,True,1,16027,-2901.13,-9616506.34,46496410.51,36879904.17
22774,2018-08-31,2901.52,0.39,0.01,2914.04,-0.43,True,1,16028,-2901.52,-9619407.86,46505562.56,36886154.7
22775,2018-09-04,2896.72,-4.8,-0.16,2914.04,-0.59,True,1,16029,-2896.72,-9622304.58,46431524.88,36809220.3
22776,2018-09-05,2888.6,-8.12,-0.28,2914.04,-0.87,True,1,16030,-2888.6,-9625193.18,46304258.0,36679064.82
22777,2018-09-06,2878.05,-10.55,-0.36,2914.04,-1.24,True,1,16031,-2878.05,-9628071.23,46138019.55,36509948.32
22778,2018-09-07,2871.68,-6.37,-0.22,2914.04,-1.45,True,1,16032,-2871.68,-9630942.91,46038773.76,36407830.85
22779,2018-09-10,2877.13,5.45,0.19,2914.04,-1.27,True,1,16033,-2877.13,-9633820.04,46129025.29,36495205.25
22780,2018-09-11,2887.89,10.76,0.37,2914.04,-0.9,True,1,16034,-2887.89,-9636707.93,46304428.26,36667720.33
22781,2018-09-12,2888.92,1.03,0.04,2914.04,-0.86,True,1,16035,-2888.92,-9639596.85,46323832.2,36684235.35
22782,2018-09-13,2904.18,15.26,0.53,2914.04,-0.34,True,1,16036,-2904.18,-9642501.03,46571430.48,36928929.45
22783,2018-09-14,2904.98,0.8,0.03,2914.04,-0.31,True,1,16037,-2904.98,-9645406.01,46587164.26,36941758.25
22784,2018-09-17,2888.8,-16.18,-0.56,2914.04,-0.87,True,1,16038,-2888.8,-9648294.81,46330574.4,36682279.59
22785,2018-09-18,2904.31,15.51,0.54,2914.04,-0.33,True,1,16039,-2904.31,-9651199.12,46582228.09,36931028.97
22786,2018-09-19,2907.95,3.64,0.12,2914.04,-0.21,True,1,16040,-2907.95,-9654107.07,46643518.0,36989410.93
22787,2018-09-20,2930.75,22.8,0.78,2930.75,0.0,True,1,16041,-2930.75,-9657037.82,47012160.75,37355122.93
22788,2018-09-21,2929.67,-1.08,-0.04,2930.75,-0.04,True,1,16042,-2929.67,-9659967.49,46997766.14,37337798.65
22789,2018-09-24,2919.37,-10.3,-0.35,2930.75,-0.39,True,1,16043,-2919.37,-9662886.86,46835452.91,37172566.05
22790,2018-09-25,2915.56,-3.81,-0.13,2930.75,-0.52,True,1,16044,-2915.56,-9665802.42,46777244.64,37111442.22
22791,2018-09-26,2905.97,-9.59,-0.33,2930.75,-0.85,True,1,16045,-2905.97,-9668708.39,46626288.65,36957580.26
22792,2018-09-27,2914.0,8.03,0.28,2930.75,-0.57,True,1,16046,-2914.0,-9671622.39,46758044.0,37086421.61
22793,2018-09-28,2913.98,-0.02,-0.0,2930.75,-0.57,True,1,16047,-2913.98,-9674536.37,46760637.06,37086100.69
22794,2018-10-01,2924.59,10.61,0.36,2930.75,-0.21,True,1,16048,-2924.59,-9677460.96,46933820.32,37256359.36
22795,2018-10-02,2923.43,-1.16,-0.04,2930.75,-0.25,True,1,16049,-2923.43,-9680384.39,46918128.07,37237743.68
22796,2018-10-03,2925.51,2.08,0.07,2930.75,-0.18,True,1,16050,-2925.51,-9683309.9,46954435.5,37271125.6
22797,2018-10-04,2901.61,-23.9,-0.82,2930.75,-0.99,True,1,16051,-2901.61,-9686211.51,46573742.11,36887530.6
22798,2018-10-05,2885.57,-16.04,-0.55,2930.75,-1.54,True,1,16052,-2885.57,-9689097.08,46319169.64,36630072.56
22799,2018-10-08,2884.43,-1.14,-0.04,2930.75,-1.58,True,1,16053,-2884.43,-9691981.51,46303754.79,36611773.28
22800,2018-10-09,2880.34,-4.09,-0.14,2930.75,-1.72,True,1,16054,-2880.34,-9694861.85,46240978.36,36546116.51
22801,2018-10-10,2785.68,-94.66,-3.29,2930.75,-4.95,True,1,16055,-2785.68,-9697647.53,44724092.4,35026444.87
22802,2018-10-11,2728.37,-57.31,-2.06,2930.75,-6.9,True,1,16056,-2728.37,-9700375.9,43806708.72,34106332.82
22803,2018-10-12,2767.13,38.76,1.42,2930.75,-5.58,True,1,16057,-2767.13,-9703143.03,44431806.41,34728663.38
22804,2018-10-15,2750.79,-16.34,-0.59,2930.75,-6.14,True,1,16058,-2750.79,-9705893.82,44172185.82,34466292.0
22805,2018-10-16,2809.92,59.13,2.15,2930.75,-4.12,True,1,16059,-2809.92,-9708703.74,45124505.28,35415801.54
22806,2018-10-17,2809.21,-0.71,-0.02,2930.75,-4.15,True,1,16060,-2809.21,-9711512.95,45115912.6,35404399.65
22807,2018-10-18,2768.78,-40.43,-1.44,2930.75,-5.53,True,1,16061,-2768.78,-9714281.73,44469375.58,34755093.85
22808,2018-10-19,2767.78,-1.0,-0.04,2930.75,-5.56,True,1,16062,-2767.78,-9717049.51,44456082.36,34739032.85
22809,2018-10-22,2755.88,-11.9,-0.43,2930.75,-5.97,True,1,16063,-2755.88,-9719805.39,44267700.44,34547895.05
22810,2018-10-23,2740.69,-15.19,-0.55,2930.75,-6.48,True,1,16064,-2740.69,-9722546.08,44026444.16,34303898.08
22811,2018-10-24,2656.1,-84.59,-3.09,2930.75,-9.37,True,1,16065,-2656.1,-9725202.18,42670246.5,32945044.32
22812,2018-10-25,2705.57,49.47,1.86,2930.75,-7.68,True,1,16066,-2705.57,-9727907.75,43467687.62,33739779.87
22813,2018-10-26,2658.69,-46.88,-1.73,2930.75,-9.28,True,1,16067,-2658.69,-9730566.44,42717172.23,32986605.79
22814,2018-10-29,2641.25,-17.44,-0.66,2930.75,-9.88,True,1,16068,-2641.25,-9733207.69,42439605.0,32706397.31
22815,2018-10-30,2682.63,41.38,1.57,2930.75,-8.47,True,1,16069,-2682.63,-9735890.32,43107181.47,33371291.15
22816,2018-10-31,2711.74,29.11,1.08,2930.75,-7.47,True,1,16070,-2711.74,-9738602.06,43577661.8,33839059.74
22817,2018-11-01,2740.37,28.63,1.06,2930.75,-6.5,True,1,16071,-2740.37,-9741342.43,44040486.27,34299143.84
22818,2018-11-02,2723.06,-17.31,-0.63,2930.75,-7.09,True,1,16072,-2723.06,-9744065.49,43765020.32,34020954.83
22819,2018-11-05,2738.31,15.25,0.56,2930.75,-6.57,True,1,16073,-2738.31,-9746803.8,44012856.63,34266052.83
22820,2018-11-06,2755.45,17.14,0.63,2930.75,-5.98,True,1,16074,-2755.45,-9749559.25,44291103.3,34541544.05
22821,2018-11-07,2813.89,58.44,2.12,2930.75,-3.99,True,1,16075,-2813.89,-9752373.14,45233281.75,35480908.61
22822,2018-11-08,2806.83,-7.06,-0.25,2930.75,-4.23,True,1,16076,-2806.83,-9755179.97,45122599.08,35367419.11
22823,2018-11-09,2781.01,-25.82,-0.92,2930.75,-5.11,True,1,16077,-2781.01,-9757960.98,44710297.77,34952336.79
22824,2018-11-12,2726.22,-54.79,-1.97,2930.75,-6.98,True,1,16078,-2726.22,-9760687.2,43832165.16,34071477.96
22825,2018-11-13,2722.18,-4.04,-0.15,2930.75,-7.12,True,1,16079,-2722.18,-9763409.38,43769932.22,34006522.84
22826,2018-11-14,2701.58,-20.6,-0.76,2930.75,-7.82,True,1,16080,-2701.58,-9766110.96,43441406.4,33675295.44
22827,2018-11-15,2730.2,28.62,1.06,2930.75,-6.84,True,1,16081,-2730.2,-9768841.16,43904346.2,34135505.04
22828,2018-11-16,2736.27,6.07,0.22,2930.75,-6.64,True,1,16082,-2736.27,-9771577.43,44004694.14,34233116.71
22829,2018-11-19,2690.73,-45.54,-1.66,2930.75,-8.19,True,1,16083,-2690.73,-9774268.16,43275010.59,33500742.43
22830,2018-11-20,2641.89,-48.84,-1.82,2930.75,-9.86,True,1,16084,-2641.89,-9776910.05,42492158.76,32715248.71
22831,2018-11-21,2649.93,8.04,0.3,2930.75,-9.58,True,1,16085,-2649.93,-9779559.98,42624124.05,32844564.07
22832,2018-11-23,2632.56,-17.37,-0.66,2930.75,-10.18,True,1,16086,-2632.56,-9782192.54,42347360.16,32565167.62
22833,2018-11-26,2673.45,40.89,1.55,2930.75,-8.78,True,1,16087,-2673.45,-9784865.99,43007790.15,33222924.16
22834,2018-11-27,2682.17,8.72,0.33,2930.75,-8.48,True,1,16088,-2682.17,-9787548.16,43150750.96,33363202.8
22835,2018-11-28,2743.79,61.62,2.3,2930.75,-6.38,True,1,16089,-2743.79,-9790291.95,44144837.31,34354545.36
22836,2018-11-29,2737.8,-5.99,-0.22,2930.75,-6.58,True,1,16090,-2737.8,-9793029.75,44051202.0,34258172.25
22837,2018-11-30,2760.17,22.37,0.82,2930.75,-5.82,True,1,16091,-2760.17,-9795789.92,44413895.47,34618105.55
22838,2018-12-03,2790.37,30.2,1.09,2930.75,-4.79,True,1,16092,-2790.37,-9798580.29,44902634.04,35104053.75
22839,2018-12-04,2700.06,-90.31,-3.24,2930.75,-7.87,True,1,16093,-2700.06,-9801280.35,43452065.58,33650785.23
22840,2018-12-06,2695.95,-4.11,-0.15,2930.75,-8.01,True,1,16094,-2695.95,-9803976.3,43388619.3,33584643.0
22841,2018-12-07,2633.08,-62.87,-2.33,2930.75,-10.16,True,1,16095,-2633.08,-9806609.38,42379422.6,32572813.22
22842,2018-12-10,2637.72,4.64,0.18,2930.75,-10.0,True,1,16096,-2637.72,-9809247.1,42456741.12,32647494.02
22843,2018-12-11,2636.78,-0.94,-0.04,2930.75,-10.03,True,1,16097,-2636.78,-9811883.88,42444247.66,32632363.78
22844,2018-12-12,2651.07,14.29,0.54,2930.75,-9.54,True,1,16098,-2651.07,-9814534.95,42676924.86,32862389.91
22845,2018-12-13,2650.54,-0.53,-0.02,2930.75,-9.56,True,1,16099,-2650.54,-9817185.49,42671043.46,32853857.97
22846,2018-12-14,2599.95,-50.59,-1.91,2930.75,-11.29,True,1,16100,-2599.95,-9819785.44,41859195.0,32039409.56
22847,2018-12-17,2545.94,-54.01,-2.08,2930.75,-13.13,True,1,16101,-2545.94,-9822331.38,40992179.94,31169848.56
22848,2018-12-18,2546.16,0.22,0.01,2930.75,-13.12,True,1,16102,-2546.16,-9824877.54,40998268.32,31173390.78
22849,2018-12-19,2506.96,-39.2,-1.54,2930.75,-14.46,True,1,16103,-2506.96,-9827384.5,40369576.88,30542192.38
22850,2018-12-20,2467.42,-39.54,-1.58,2930.75,-15.81,True,1,16104,-2467.42,-9829851.92,39735331.68,29905479.76
22851,2018-12-21,2416.62,-50.8,-2.06,2930.75,-17.54,True,1,16105,-2416.62,-9832268.54,38919665.1,29087396.56
22852,2018-12-24,2351.1,-65.52,-2.71,2930.75,-19.78,True,1,16106,-2351.1,-9834619.64,37866816.6,28032196.96
22853,2018-12-26,2467.7,116.6,4.96,2930.75,-15.8,True,1,16107,-2467.7,-9837087.34,39747243.9,29910156.56
22854,2018-12-27,2488.83,21.13,0.86,2930.75,-15.08,True,1,16108,-2488.83,-9839576.17,40090073.64,30250497.47
22855,2018-12-28,2485.74,-3.09,-0.12,2930.75,-15.18,True,1,16109,-2485.74,-9842061.91,40042785.66,30200723.75
22856,2018-12-31,2506.85,21.11,0.85,2930.75,-14.46,True,1,16110,-2506.85,-9844568.76,40385353.5,30540784.74
22857,2019-01-02,2510.03,3.18,0.13,2930.75,-14.36,True,1,16111,-2510.03,-9847078.79,40439093.33,30592014.54
22858,2019-01-03,2447.89,-62.14,-2.48,2930.75,-16.48,True,1,16112,-2447.89,-9849526.68,39440403.68,29590877.0
22859,2019-01-04,2531.94,84.05,3.43,2930.75,-13.61,True,1,16113,-2531.94,-9852058.62,40797149.22,30945090.6
22860,2019-01-07,2549.69,17.75,0.7,2930.75,-13.0,True,1,16114,-2549.69,-9854608.31,41085704.66,31231096.35
22861,2019-01-08,2574.41,24.72,0.97,2930.75,-12.16,True,1,16115,-2574.41,-9857182.72,41486617.15,31629434.43
22862,2019-01-09,2584.96,10.55,0.41,2930.75,-11.8,True,1,16116,-2584.96,-9859767.68,41659215.36,31799447.68
22863,2019-01-10,2596.64,11.68,0.45,2930.75,-11.4,True,1,16117,-2596.64,-9862364.32,41850046.88,31987682.56
22864,2019-01-11,2596.26,-0.38,-0.02,2930.75,-11.41,True,1,16118,-2596.26,-9864960.58,41846518.68,31981558.1
22865,2019-01-14,2582.61,-13.65,-0.53,2930.75,-11.88,True,1,16119,-2582.61,-9867543.19,41629090.59,31761547.4
22866,2019-01-15,2610.3,27.69,1.07,2930.75,-10.93,True,1,16120,-2610.3,-9870153.49,42078036.0,32207882.51
22867,2019-01-16,2616.1,5.8,0.22,2930.75,-10.74,True,1,16121,-2616.1,-9872769.59,42174148.1,32301378.51
22868,2019-01-17,2635.96,19.86,0.76,2930.75,-10.06,True,1,16122,-2635.96,-9875405.55,42496947.12,32621541.57
22869,2019-01-18,2670.71,34.75,1.32,2930.75,-8.87,True,1,16123,-2670.71,-9878076.26,43059857.33,33181781.07
22870,2019-01-22,2632.9,-37.81,-1.42,2930.75,-10.16,True,1,16124,-2632.9,-9880709.16,42452879.6,32572170.44
22871,2019-01-23,2638.7,5.8,0.22,2930.75,-9.96,True,1,16125,-2638.7,-9883347.86,42549037.5,32665689.64
22872,2019-01-24,2642.33,3.63,0.14,2930.75,-9.84,True,1,16126,-2642.33,-9885990.19,42610213.58,32724223.39
22873,2019-01-25,2664.76,22.43,0.85,2930.75,-9.08,True,1,16127,-2664.76,-9888654.95,42974584.52,33085929.57
22874,2019-01-28,2643.85,-20.91,-0.78,2930.75,-9.79,True,1,16128,-2643.85,-9891298.8,42640012.8,32748714.0
22875,2019-01-29,2640.0,-3.85,-0.15,2930.75,-9.92,True,1,16129,-2640.0,-9893938.8,42580560.0,32686621.2
22876,2019-01-30,2681.05,41.05,1.56,2930.75,-8.52,True,1,16130,-2681.05,-9896619.85,43245336.5,33348716.65
22877,2019-01-31,2704.1,23.05,0.86,2930.75,-7.73,True,1,16131,-2704.1,-9899323.95,43619837.1,33720513.15
22878,2019-02-01,2706.53,2.43,0.09,2930.75,-7.65,True,1,16132,-2706.53,-9902030.48,43661741.96,33759711.48
22879,2019-02-04,2724.87,18.34,0.68,2930.75,-7.02,True,1,16133,-2724.87,-9904755.35,43960327.71,34055572.36
22880,2019-02-05,2737.7,12.83,0.47,2930.75,-6.59,True,1,16134,-2737.7,-9907493.05,44170051.8,34262558.75
22881,2019-02-06,2731.61,-6.09,-0.22,2930.75,-6.8,True,1,16135,-2731.61,-9910224.66,44074527.35,34164302.69
22882,2019-02-07,2706.05,-25.56,-0.94,2930.75,-7.67,True,1,16136,-2706.05,-9912930.71,43664822.8,33751892.09
22883,2019-02-08,2707.88,1.83,0.07,2930.75,-7.6,True,1,16137,-2707.88,-9915638.59,43697059.56,33781420.97
22884,2019-02-11,2709.8,1.92,0.07,2930.75,-7.54,True,1,16138,-2709.8,-9918348.39,43730752.4,33812404.01
22885,2019-02-12,2744.73,34.93,1.29,2930.75,-6.35,True,1,16139,-2744.73,-9921093.12,44297197.47,34376104.35
22886,2019-02-13,2753.03,8.3,0.3,2930.75,-6.06,True,1,16140,-2753.03,-9923846.15,44433904.2,34510058.05
22887,2019-02-14,2745.73,-7.3,-0.26,2930.75,-6.31,True,1,16141,-2745.73,-9926591.88,44318827.93,34392236.05
22888,2019-02-15,2775.6,29.87,1.09,2930.75,-5.29,True,1,16142,-2775.6,-9929367.48,44803735.2,34874367.72
22889,2019-02-19,2779.76,4.16,0.15,2930.75,-5.15,True,1,16143,-2779.76,-9932147.24,44873665.68,34941518.44
22890,2019-02-20,2784.7,4.94,0.18,2930.75,-4.98,True,1,16144,-2784.7,-9934931.94,44956196.8,35021264.86
22891,2019-02-21,2774.88,-9.82,-0.35,2930.75,-5.32,True,1,16145,-2774.88,-9937706.82,44800437.6,34862730.78
22892,2019-02-22,2792.67,17.79,0.64,2930.75,-4.71,True,1,16146,-2792.67,-9940499.49,45090449.82,35149950.33
22893,2019-02-25,2796.11,3.44,0.12,2930.75,-4.59,True,1,16147,-2796.11,-9943295.6,45148788.17,35205492.57
22894,2019-02-26,2793.9,-2.21,-0.08,2930.75,-4.67,True,1,16148,-2793.9,-9946089.5,45115897.2,35169807.7
22895,2019-02-27,2792.38,-1.52,-0.05,2930.75,-4.72,True,1,16149,-2792.38,-9948881.88,45094144.62,35145262.74
22896,2019-02-28,2784.49,-7.89,-0.28,2930.75,-4.99,True,1,16150,-2784.49,-9951666.37,44969513.5,35017847.13
22897,2019-03-01,2803.69,19.2,0.69,2930.75,-4.34,True,1,16151,-2803.69,-9954470.06,45282397.19,35327927.13
22898,2019-03-04,2792.81,-10.88,-0.39,2930.75,-4.71,True,1,16152,-2792.81,-9957262.87,45109467.12,35152204.25
22899,2019-03-05,2789.65,-3.16,-0.11,2930.75,-4.81,True,1,16153,-2789.65,-9960052.52,45061216.45,35101163.93
22900,2019-03-06,2771.45,-18.2,-0.65,2930.75,-5.44,True,1,16154,-2771.45,-9962823.97,44770003.3,34807179.33
22901,2019-03-07,2748.93,-22.52,-0.81,2930.75,-6.2,True,1,16155,-2748.93,-9965572.9,44408964.15,34443391.25
22902,2019-03-08,2743.07,-5.86,-0.21,2930.75,-6.4,True,1,16156,-2743.07,-9968315.97,44317038.92,34348722.95
22903,2019-03-11,2783.3,40.23,1.47,2930.75,-5.03,True,1,16157,-2783.3,-9971099.27,44969778.1,34998678.83
22904,2019-03-12,2791.52,8.22,0.3,2930.75,-4.75,True,1,16158,-2791.52,-9973890.79,45105380.16,35131489.37
22905,2019-03-13,2810.92,19.4,0.7,2930.75,-4.09,True,1,16159,-2810.92,-9976701.71,45421656.28,35444954.57
22906,2019-03-14,2808.48,-2.44,-0.09,2930.75,-4.17,True,1,16160,-2808.48,-9979510.19,45385036.8,35405526.61
22907,2019-03-15,2822.48,14.0,0.5,2930.75,-3.69,True,1,16161,-2822.48,-9982332.67,45614099.28,35631766.61
22908,2019-03-18,2832.94,10.46,0.37,2930.75,-3.34,True,1,16162,-2832.94,-9985165.61,45785976.28,35800810.67
22909,2019-03-19,2832.57,-0.37,-0.01,2930.75,-3.35,True,1,16163,-2832.57,-9987998.18,45782828.91,35794830.73
22910,2019-03-20,2824.23,-8.34,-0.29,2930.75,-3.64,True,1,16164,-2824.23,-9990822.41,45650853.72,35660031.31
22911,2019-03-21,2854.88,30.65,1.08,2930.75,-2.59,True,1,16165,-2854.88,-9993677.29,46149135.2,36155457.91
22912,2019-03-22,2800.71,-54.17,-1.9,2930.75,-4.44,True,1,16166,-2800.71,-9996478.0,45276277.86,35279799.86
22913,2019-03-25,2798.36,-2.35,-0.08,2930.75,-4.52,True,1,16167,-2798.36,-9999276.36,45241086.12,35241809.76
22914,2019-03-26,2818.46,20.1,0.72,2930.75,-3.83,True,1,16168,-2818.46,-10002094.82,45568861.28,35566766.46
22915,2019-03-27,2805.37,-13.09,-0.46,2930.75,-4.28,True,1,16169,-2805.37,-10004900.19,45360027.53,35355127.34
22916,2019-03-28,2815.44,10.07,0.36,2930.75,-3.93,True,1,16170,-2815.44,-10007715.63,45525664.8,35517949.17
22917,2019-03-29,2834.4,18.96,0.67,2930.75,-3.29,True,1,16171,-2834.4,-10010550.03,45835082.4,35824532.37
22918,2019-04-01,2867.19,32.79,1.16,2930.75,-2.17,True,1,16172,-2867.19,-10013417.22,46368196.68,36354779.46
22919,2019-04-02,2867.24,0.05,0.0,2930.75,-2.17,True,1,16173,-2867.24,-10016284.46,46371872.52,36355588.06
22920,2019-04-03,2873.4,6.16,0.22,2930.75,-1.96,True,1,16174,-2873.4,-10019157.86,46474371.6,36455213.74
22921,2019-04-04,2879.39,5.99,0.21,2930.75,-1.75,True,1,16175,-2879.39,-10022037.25,46574133.25,36552096.0
22922,2019-04-05,2892.74,13.35,0.46,2930.75,-1.3,True,1,16176,-2892.74,-10024929.99,46792962.24,36768032.25
22923,2019-04-08,2895.77,3.03,0.1,2930.75,-1.19,True,1,16177,-2895.77,-10027825.76,46844871.29,36817045.53
22924,2019-04-09,2878.2,-17.57,-0.61,2930.75,-1.79,True,1,16178,-2878.2,-10030703.96,46563519.6,36532815.64
22925,2019-04-10,2888.21,10.01,0.35,2930.75,-1.45,True,1,16179,-2888.21,-10033592.17,46728349.59,36694757.42
22926,2019-04-11,2888.32,0.11,0.0,2930.75,-1.45,True,1,16180,-2888.32,-10036480.49,46733017.6,36696537.11
22927,2019-04-12,2907.41,19.09,0.66,2930.75,-0.8,True,1,16181,-2907.41,-10039387.9,47044801.21,37005413.31
22928,2019-04-15,2905.58,-1.83,-0.06,2930.75,-0.86,True,1,16182,-2905.58,-10042293.48,47018095.56,36975802.08
22929,2019-04-16,2907.06,1.48,0.05,2930.75,-0.81,True,1,16183,-2907.06,-10045200.54,47044951.98,36999751.44
22930,2019-04-17,2900.45,-6.61,-0.23,2930.75,-1.03,True,1,16184,-2900.45,-10048100.99,46940882.8,36892781.81
22931,2019-04-18,2905.03,4.58,0.16,2930.75,-0.88,True,1,16185,-2905.03,-10051006.02,47017910.55,36966904.53
22932,2019-04-22,2907.97,2.94,0.1,2930.75,-0.78,True,1,16186,-2907.97,-10053913.99,47068402.42,37014488.43
22933,2019-04-23,2933.68,25.71,0.88,2933.68,0.0,True,1,16187,-2933.68,-10056847.67,47487478.16,37430630.49
22934,2019-04-24,2927.25,-6.43,-0.22,2933.68,-0.22,True,1,16188,-2927.25,-10059774.92,47386323.0,37326548.08
22935,2019-04-25,2926.17,-1.08,-0.04,2933.68,-0.26,True,1,16189,-2926.17,-10062701.09,47371766.13,37309065.04
22936,2019-04-26,2939.88,13.71,0.47,2939.88,0.0,True,1,16190,-2939.88,-10065640.97,47596657.2,37531016.23
22937,2019-04-29,2943.03,3.15,0.11,2943.03,0.0,True,1,16191,-2943.03,-10068584.0,47650598.73,37582014.73
22938,2019-04-30,2945.83,2.8,0.1,2945.83,0.0,True,1,16192,-2945.83,-10071529.83,47698879.36,37627349.53
22939,2019-05-01,2923.73,-22.1,-0.75,2945.83,-0.75,True,1,16193,-2923.73,-10074453.56,47343959.89,37269506.33
22940,2019-05-02,2917.52,-6.21,-0.21,2945.83,-0.96,True,1,16194,-2917.52,-10077371.08,47246318.88,37168947.8
22941,2019-05-03,2945.64,28.12,0.96,2945.83,-0.01,True,1,16195,-2945.64,-10080316.72,47704639.8,37624323.08
22942,2019-05-06,2932.47,-13.17,-0.45,2945.83,-0.45,True,1,16196,-2932.47,-10083249.19,47494284.12,37411034.93
22943,2019-05-07,2884.05,-48.42,-1.65,2945.83,-2.1,True,1,16197,-2884.05,-10086133.24,46712957.85,36626824.61
22944,2019-05-08,2879.42,-4.63,-0.16,2945.83,-2.25,True,1,16198,-2879.42,-10089012.66,46640845.16,36551832.5
22945,2019-05-09,2870.72,-8.7,-0.3,2945.83,-2.55,True,1,16199,-2870.72,-10091883.38,46502793.28,36410909.9
22946,2019-05-10,2881.4,10.68,0.37,2945.83,-2.19,True,1,16200,-2881.4,-10094764.78,46678680.0,36583915.22
22947,2019-05-13,2811.87,-69.53,-2.41,2945.83,-4.55,True,1,16201,-2811.87,-10097576.65,45555105.87,35457529.22
22948,2019-05-14,2834.41,22.54,0.8,2945.83,-3.78,True,1,16202,-2834.41,-10100411.06,45923110.82,35822699.76
22949,2019-05-15,2850.96,16.55,0.58,2945.83,-3.22,True,1,16203,-2850.96,-10103262.02,46194104.88,36090842.86
22950,2019-05-16,2876.32,25.36,0.89,2945.83,-2.36,True,1,16204,-2876.32,-10106138.34,46607889.28,36501750.94
22951,2019-05-17,2859.53,-16.79,-0.58,2945.83,-2.93,True,1,16205,-2859.53,-10108997.87,46338683.65,36229685.78
22952,2019-05-20,2840.23,-19.3,-0.68,2945.83,-3.58,True,1,16206,-2840.23,-10111838.1,46028767.38,35916929.28
22953,2019-05-21,2864.36,24.13,0.85,2945.83,-2.77,True,1,16207,-2864.36,-10114702.46,46422682.52,36307980.06
22954,2019-05-22,2856.27,-8.09,-0.28,2945.83,-3.04,True,1,16208,-2856.27,-10117558.73,46294424.16,36176865.43
22955,2019-05-23,2822.24,-34.03,-1.19,2945.83,-4.2,True,1,16209,-2822.24,-10120380.97,45745688.16,35625307.19
22956,2019-05-24,2826.06,3.82,0.14,2945.83,-4.07,True,1,16210,-2826.06,-10123207.03,45810432.6,35687225.57
22957,2019-05-28,2802.39,-23.67,-0.84,2945.83,-4.87,True,1,16211,-2802.39,-10126009.42,45429544.29,35303534.87
22958,2019-05-29,2783.02,-19.37,-0.69,2945.83,-5.53,True,1,16212,-2783.02,-10128792.44,45118320.24,34989527.8
22959,2019-05-30,2788.86,5.84,0.21,2945.83,-5.33,True,1,16213,-2788.86,-10131581.3,45215787.18,35084205.88
22960,2019-05-31,2752.06,-36.8,-1.32,2945.83,-6.58,True,1,16214,-2752.06,-10134333.36,44621900.84,34487567.48
22961,2019-06-03,2744.45,-7.61,-0.28,2945.83,-6.84,True,1,16215,-2744.45,-10137077.81,44501256.75,34364178.94
22962,2019-06-04,2803.27,58.82,2.14,2945.83,-4.84,True,1,16216,-2803.27,-10139881.08,45457826.32,35317945.24
22963,2019-06-05,2826.15,22.88,0.82,2945.83,-4.06,True,1,16217,-2826.15,-10142707.23,45831674.55,35688967.32
22964,2019-06-06,2843.49,17.34,0.61,2945.83,-3.47,True,1,16218,-2843.49,-10145550.72,46115720.82,35970170.1
22965,2019-06-07,2873.34,29.85,1.05,2945.83,-2.46,True,1,16219,-2873.34,-10148424.06,46602701.46,36454277.4
22966,2019-06-10,2886.73,13.39,0.47,2945.83,-2.01,True,1,16220,-2886.73,-10151310.79,46822760.6,36671449.81
22967,2019-06-11,2885.72,-1.01,-0.04,2945.83,-2.04,True,1,16221,-2885.72,-10154196.51,46809264.12,36655067.61
22968,2019-06-12,2879.84,-5.88,-0.2,2945.83,-2.24,True,1,16222,-2879.84,-10157076.35,46716764.48,36559688.13
22969,2019-06-13,2891.64,11.8,0.41,2945.83,-1.84,True,1,16223,-2891.64,-10159967.99,46911075.72,36751107.73
22970,2019-06-14,2886.98,-4.66,-0.16,2945.83,-2.0,True,1,16224,-2886.98,-10162854.97,46838363.52,36675508.55
22971,2019-06-17,2889.67,2.69,0.09,2945.83,-1.91,True,1,16225,-2889.67,-10165744.64,46884895.75,36719151.11
22972,2019-06-18,2917.75,28.08,0.97,2945.83,-0.95,True,1,16226,-2917.75,-10168662.39,47343411.5,37174749.11
22973,2019-06-19,2926.46,8.71,0.3,2945.83,-0.66,True,1,16227,-2926.46,-10171588.85,47487666.42,37316077.57
22974,2019-06-20,2954.18,27.72,0.95,2954.18,0.0,True,1,16228,-2954.18,-10174543.03,47940433.04,37765890.01
22975,2019-06-21,2950.46,-3.72,-0.13,2954.18,-0.13,True,1,16229,-2950.46,-10177493.49,47883015.34,37705521.85
22976,2019-06-24,2945.35,-5.11,-0.17,2954.18,-0.3,True,1,16230,-2945.35,-10180438.84,47803030.5,37622591.66
22977,2019-06-25,2917.38,-27.97,-0.95,2954.18,-1.25,True,1,16231,-2917.38,-10183356.22,47351994.78,37168638.56
22978,2019-06-26,2913.78,-3.6,-0.12,2954.18,-1.37,True,1,16232,-2913.78,-10186270.0,47296476.96,37110206.96
22979,2019-06-27,2924.92,11.14,0.38,2954.18,-0.99,True,1,16233,-2924.92,-10189194.92,47480226.36,37291031.44
22980,2019-06-28,2941.76,16.84,0.58,2954.18,-0.42,True,1,16234,-2941.76,-10192136.68,47756531.84,37564395.16
22981,2019-07-01,2964.33,22.57,0.77,2964.33,0.0,True,1,16235,-2964.33,-10195101.01,48125897.55,37930796.54
22982,2019-07-02,2973.01,8.68,0.29,2973.01,0.0,True,1,16236,-2973.01,-10198074.02,48269790.36,38071716.34
22983,2019-07-03,2995.82,22.81,0.77,2995.82,0.0,True,1,16237,-2995.82,-10201069.84,48643129.34,38442059.5
22984,2019-07-05,2990.41,-5.41,-0.18,2995.82,-0.18,True,1,16238,-2990.41,-10204060.25,48558277.58,38354217.33
22985,2019-07-08,2975.95,-14.46,-0.48,2995.82,-0.66,True,1,16239,-2975.95,-10207036.2,48326452.05,38119415.85
22986,2019-07-09,2979.63,3.68,0.12,2995.82,-0.54,True,1,16240,-2979.63,-10210015.83,48389191.2,38179175.37
22987,2019-07-10,2993.07,13.44,0.45,2995.82,-0.09,True,1,16241,-2993.07,-10213008.9,48610449.87,38397440.97
22988,2019-07-11,2999.91,6.84,0.23,2999.91,0.0,True,1,16242,-2999.91,-10216008.81,48724538.22,38508529.41
22989,2019-07-12,3013.77,13.86,0.46,3013.77,0.0,True,1,16243,-3013.77,-10219022.58,48952666.11,38733643.53
22990,2019-07-15,3014.3,0.53,0.02,3014.3,0.0,True,1,16244,-3014.3,-10222036.88,48964289.2,38742252.32
22991,2019-07-16,3004.04,-10.26,-0.34,3014.3,-0.34,True,1,16245,-3004.04,-10225040.92,48800629.8,38575588.88
22992,2019-07-17,2984.42,-19.62,-0.65,3014.3,-0.99,True,1,16246,-2984.42,-10228025.34,48484887.32,38256861.98
22993,2019-07-18,2995.11,10.69,0.36,3014.3,-0.64,True,1,16247,-2995.11,-10231020.45,48661552.17,38430531.72
22994,2019-07-19,2976.61,-18.5,-0.62,3014.3,-1.25,True,1,16248,-2976.61,-10233997.06,48363959.28,38129962.22
22995,2019-07-22,2985.03,8.42,0.28,3014.3,-0.97,True,1,16249,-2985.03,-10236982.09,48503752.47,38266770.38
22996,2019-07-23,3005.47,20.44,0.68,3014.3,-0.29,True,1,16250,-3005.47,-10239987.56,48838887.5,38598899.94
22997,2019-07-24,3019.56,14.09,0.47,3019.56,0.0,True,1,16251,-3019.56,-10243007.12,49070869.56,38827862.44
22998,2019-07-25,3003.67,-15.89,-0.53,3019.56,-0.53,True,1,16252,-3003.67,-10246010.79,48815644.84,38569634.05
22999,2019-07-26,3025.86,22.19,0.74,3025.86,0.0,True,1,16253,-3025.86,-10249036.65,49179302.58,38930265.93
23000,2019-07-29,3020.97,-4.89,-0.16,3025.86,-0.16,True,1,16254,-3020.97,-10252057.62,49102846.38,38850788.76
23001,2019-07-30,3013.18,-7.79,-0.26,3025.86,-0.42,True,1,16255,-3013.18,-10255070.8,48979240.9,38724170.1
23002,2019-07-31,2980.38,-32.8,-1.09,3025.86,-1.5,True,1,16256,-2980.38,-10258051.18,48449057.28,38191006.1
23003,2019-08-01,2953.56,-26.82,-0.9,3025.86,-2.39,True,1,16257,-2953.56,-10261004.74,48016024.92,37755020.18
23004,2019-08-02,2932.05,-21.51,-0.73,3025.86,-3.1,True,1,16258,-2932.05,-10263936.79,47669268.9,37405332.11
23005,2019-08-05,2844.74,-87.31,-2.98,3025.86,-5.99,True,1,16259,-2844.74,-10266781.53,46252627.66,35985846.13
23006,2019-08-06,2881.77,37.03,1.3,3025.86,-4.76,True,1,16260,-2881.77,-10269663.3,46857580.2,36587916.9
23007,2019-08-07,2883.98,2.21,0.08,3025.86,-4.69,True,1,16261,-2883.98,-10272547.28,46896398.78,36623851.5
23008,2019-08-08,2938.09,54.11,1.88,3025.86,-2.9,True,1,16262,-2938.09,-10275485.37,47779219.58,37503734.21
23009,2019-08-09,2918.65,-19.44,-0.66,3025.86,-3.54,True,1,16263,-2918.65,-10278404.02,47466004.95,37187600.93
23010,2019-08-12,2882.7,-35.95,-1.23,3025.86,-4.73,True,1,16264,-2882.7,-10281286.72,46884232.8,36602946.08
23011,2019-08-13,2926.32,43.62,1.51,3025.86,-3.29,True,1,16265,-2926.32,-10284213.04,47596594.8,37312381.76
23012,2019-08-14,2840.6,-85.72,-2.93,3025.86,-6.12,True,1,16266,-2840.6,-10287053.64,46205199.6,35918145.96
23013,2019-08-15,2847.6,7.0,0.25,3025.86,-5.89,True,1,16267,-2847.6,-10289901.24,46321909.2,36032007.96
23014,2019-08-16,2888.68,41.08,1.44,3025.86,-4.53,True,1,16268,-2888.68,-10292789.92,46993046.24,36700256.32
23015,2019-08-19,2923.65,34.97,1.21,3025.86,-3.38,True,1,16269,-2923.65,-10295713.57,47564861.85,37269148.28
23016,2019-08-20,2900.51,-23.14,-0.79,3025.86,-4.14,True,1,16270,-2900.51,-10298614.08,47191297.7,36892683.62
23017,2019-08-21,2924.43,23.92,0.82,3025.86,-3.35,True,1,16271,-2924.43,-10301538.51,47583400.53,37281862.02
23018,2019-08-22,2922.95,-1.48,-0.05,3025.86,-3.4,True,1,16272,-2922.95,-10304461.46,47562242.4,37257780.94
23019,2019-08-23,2847.11,-75.84,-2.6,3025.86,-5.91,True,1,16273,-2847.11,-10307308.57,46331021.03,36023712.46
23020,2019-08-26,2878.38,31.27,1.1,3025.86,-4.87,True,1,16274,-2878.38,-10310186.95,46842756.12,36532569.17
23021,2019-08-27,2869.16,-9.22,-0.32,3025.86,-5.18,True,1,16275,-2869.16,-10313056.11,46695579.0,36382522.89
23022,2019-08-28,2887.94,18.78,0.66,3025.86,-4.56,True,1,16276,-2887.94,-10315944.05,47004111.44,36688167.39
23023,2019-08-29,2924.58,36.64,1.27,3025.86,-3.35,True,1,16277,-2924.58,-10318868.63,47603388.66,37284520.03
23024,2019-08-30,2926.46,1.88,0.06,3025.86,-3.28,True,1,16278,-2926.46,-10321795.09,47636915.88,37315120.79
23025,2019-09-03,2906.27,-20.19,-0.69,3025.86,-3.95,True,1,16279,-2906.27,-10324701.36,47311169.33,36986467.97
23026,2019-09-04,2937.78,31.51,1.08,3025.86,-2.91,True,1,16280,-2937.78,-10327639.14,47827058.4,37499419.26
23027,2019-09-05,2976.0,38.22,1.3,3025.86,-1.65,True,1,16281,-2976.0,-10330615.14,48452256.0,38121640.86
23028,2019-09-06,2978.71,2.71,0.09,3025.86,-1.56,True,1,16282,-2978.71,-10333593.85,48499356.22,38165762.37
23029,2019-09-09,2978.43,-0.28,-0.01,3025.86,-1.57,True,1,16283,-2978.43,-10336572.28,48497775.69,38161203.41
23030,2019-09-10,2979.39,0.96,0.03,3025.86,-1.54,True,1,16284,-2979.39,-10339551.67,48516386.76,38176835.09
23031,2019-09-11,3000.93,21.54,0.72,3025.86,-0.82,True,1,16285,-3000.93,-10342552.6,48870145.05,38527592.45
23032,2019-09-12,3009.57,8.64,0.29,3025.86,-0.54,True,1,16286,-3009.57,-10345562.17,49013857.02,38668294.85
23033,2019-09-13,3007.39,-2.18,-0.07,3025.86,-0.61,True,1,16287,-3007.39,-10348569.56,48981360.93,38632791.37
23034,2019-09-16,2997.96,-9.43,-0.31,3025.86,-0.92,True,1,16288,-2997.96,-10351567.52,48830772.48,38479204.96
23035,2019-09-17,3005.7,7.74,0.26,3025.86,-0.67,True,1,16289,-3005.7,-10354573.22,48959847.3,38605274.08
23036,2019-09-18,3006.73,1.03,0.03,3025.86,-0.63,True,1,16290,-3006.73,-10357579.95,48979631.7,38622051.75
23037,2019-09-19,3006.79,0.06,0.0,3025.86,-0.63,True,1,16291,-3006.79,-10360586.74,48983615.89,38623029.15
23038,2019-09-20,2992.07,-14.72,-0.49,3025.86,-1.12,True,1,16292,-2992.07,-10363578.81,48746804.44,38383225.63
23039,2019-09-23,2991.78,-0.29,-0.01,3025.86,-1.13,True,1,16293,-2991.78,-10366570.59,48745071.54,38378500.95
23040,2019-09-24,2966.6,-25.18,-0.84,3025.86,-1.96,True,1,16294,-2966.6,-10369537.19,48337780.4,37968243.21
23041,2019-09-25,2984.87,18.27,0.62,3025.86,-1.36,True,1,16295,-2984.87,-10372522.06,48638456.65,38265934.59
23042,2019-09-26,2977.62,-7.25,-0.24,3025.86,-1.59,True,1,16296,-2977.62,-10375499.68,48523295.52,38147795.84
23043,2019-09-27,2961.79,-15.83,-0.53,3025.86,-2.12,True,1,16297,-2961.79,-10378461.47,48268291.63,37889830.16
23044,2019-09-30,2976.74,14.95,0.5,3025.86,-1.62,True,1,16298,-2976.74,-10381438.21,48514908.52,38133470.31
23045,2019-10-01,2940.25,-36.49,-1.23,3025.86,-2.83,True,1,16299,-2940.25,-10384378.46,47923134.75,37538756.29
23046,2019-10-02,2887.61,-52.64,-1.79,3025.86,-4.57,True,1,16300,-2887.61,-10387266.07,47068043.0,36680776.93
23047,2019-10-03,2910.63,23.02,0.8,3025.86,-3.81,True,1,16301,-2910.63,-10390176.7,47446179.63,37056002.93
23048,2019-10-04,2952.01,41.38,1.42,3025.86,-2.44,True,1,16302,-2952.01,-10393128.71,48123667.02,37730538.31
23049,2019-10-07,2938.79,-13.22,-0.45,3025.86,-2.88,True,1,16303,-2938.79,-10396067.5,47911093.37,37515025.87
23050,2019-10-08,2893.06,-45.73,-1.56,3025.86,-4.39,True,1,16304,-2893.06,-10398960.56,47168450.24,36769489.68
23051,2019-10-09,2919.4,26.34,0.91,3025.86,-3.52,True,1,16305,-2919.4,-10401879.96,47600817.0,37198937.04
23052,2019-10-10,2938.13,18.73,0.64,3025.86,-2.9,True,1,16306,-2938.13,-10404818.09,47909147.78,37504329.69
23053,2019-10-11,2970.27,32.14,1.09,3025.86,-1.84,True,1,16307,-2970.27,-10407788.36,48436192.89,38028404.53
23054,2019-10-14,2966.15,-4.12,-0.14,3025.86,-1.97,True,1,16308,-2966.15,-10410754.51,48371974.2,37961219.69
23055,2019-10-15,2995.68,29.53,1.0,3025.86,-1.0,True,1,16309,-2995.68,-10413750.19,48856545.12,38442794.93
23056,2019-10-16,2989.69,-5.99,-0.2,3025.86,-1.2,True,1,16310,-2989.69,-10416739.88,48761843.9,38345104.02
23057,2019-10-17,2997.95,8.26,0.28,3025.86,-0.92,True,1,16311,-2997.95,-10419737.83,48899562.45,38479824.62
23058,2019-10-18,2986.2,-11.75,-0.39,3025.86,-1.31,True,1,16312,-2986.2,-10422724.03,48710894.4,38288170.37
23059,2019-10-21,3006.72,20.52,0.69,3025.86,-0.63,True,1,16313,-3006.72,-10425730.75,49048623.36,38622892.61
23060,2019-10-22,2995.99,-10.73,-0.36,3025.86,-0.99,True,1,16314,-2995.99,-10428726.74,48876580.86,38447854.12
23061,2019-10-23,3004.52,8.53,0.28,3025.86,-0.7,True,1,16315,-3004.52,-10431731.26,49018743.8,38587012.54
23062,2019-10-24,3010.29,5.77,0.19,3025.86,-0.52,True,1,16316,-3010.29,-10434741.55,49115891.64,38681150.09
23063,2019-10-25,3022.55,12.26,0.41,3025.86,-0.11,True,1,16317,-3022.55,-10437764.1,49318948.35,38881184.25
23064,2019-10-28,3039.42,16.87,0.56,3039.42,0.0,True,1,16318,-3039.42,-10440803.52,49597255.56,39156452.04
23065,2019-10-29,3036.89,-2.53,-0.08,3039.42,-0.08,True,1,16319,-3036.89,-10443840.41,49559007.91,39115167.5
23066,2019-10-30,3046.77,9.88,0.32,3046.77,0.0,True,1,16320,-3046.77,-10446887.18,49723286.4,39276399.22
23067,2019-10-31,3037.56,-9.21,-0.3,3046.77,-0.3,True,1,16321,-3037.56,-10449924.74,49576016.76,39126092.02
23068,2019-11-01,3066.91,29.35,0.97,3066.91,0.0,True,1,16322,-3066.91,-10452991.65,50058105.02,39605113.37
23069,2019-11-04,3078.27,11.36,0.37,3078.27,0.0,True,1,16323,-3078.27,-10456069.92,50246601.21,39790531.29
23070,2019-11-05,3074.62,-3.65,-0.12,3078.27,-0.12,True,1,16324,-3074.62,-10459144.54,50190096.88,39730952.34
23071,2019-11-06,3076.78,2.16,0.07,3078.27,-0.05,True,1,16325,-3076.78,-10462221.32,50228433.5,39766212.18
23072,2019-11-07,3085.18,8.4,0.27,3085.18,0.0,True,1,16326,-3085.18,-10465306.5,50368648.68,39903342.18
23073,2019-11-08,3093.08,7.9,0.26,3093.08,0.0,True,1,16327,-3093.08,-10468399.58,50500717.16,40032317.58
23074,2019-11-11,3087.01,-6.07,-0.2,3093.08,-0.2,True,1,16328,-3087.01,-10471486.59,50404699.28,39933212.69
23075,2019-11-12,3091.84,4.83,0.16,3093.08,-0.04,True,1,16329,-3091.84,-10474578.43,50486655.36,40012076.93
23076,2019-11-13,3094.04,2.2,0.07,3094.04,0.0,True,1,16330,-3094.04,-10477672.47,50525673.2,40048000.73
23077,2019-11-14,3096.63,2.59,0.08,3096.63,0.0,True,1,16331,-3096.63,-10480769.1,50571064.53,40090295.43
23078,2019-11-15,3120.46,23.83,0.77,3120.46,0.0,True,1,16332,-3120.46,-10483889.56,50963352.72,40479463.16
23079,2019-11-18,3122.03,1.57,0.05,3122.03,0.0,True,1,16333,-3122.03,-10487011.59,50992115.99,40505104.4
23080,2019-11-19,3120.18,-1.85,-0.06,3122.03,-0.06,True,1,16334,-3120.18,-10490131.77,50965020.12,40474888.35
23081,2019-11-20,3108.46,-11.72,-0.38,3122.03,-0.44,True,1,16335,-3108.46,-10493240.23,50776694.1,40283453.87
23082,2019-11-21,3103.54,-4.92,-0.16,3122.03,-0.59,True,1,16336,-3103.54,-10496343.77,50699429.44,40203085.67
23083,2019-11-22,3110.29,6.75,0.22,3122.03,-0.38,True,1,16337,-3110.29,-10499454.06,50812807.73,40313353.67
23084,2019-11-25,3133.64,23.35,0.75,3133.64,0.0,True,1,16338,-3133.64,-10502587.7,51197410.32,40694822.62
23085,2019-11-26,3140.52,6.88,0.22,3140.52,0.0,True,1,16339,-3140.52,-10505728.22,51312956.28,40807228.06
23086,2019-11-27,3153.63,13.11,0.42,3153.63,0.0,True,1,16340,-3153.63,-10508881.85,51530314.2,41021432.35
23087,2019-11-29,3140.98,-12.65,-0.4,3153.63,-0.4,True,1,16341,-3140.98,-10512022.83,51326754.18,40814731.35
23088,2019-12-02,3113.87,-27.11,-0.86,3153.63,-1.26,True,1,16342,-3113.87,-10515136.7,50886863.54,40371726.84
23089,2019-12-03,3093.2,-20.67,-0.66,3153.63,-1.92,True,1,16343,-3093.2,-10518229.9,50552167.6,40033937.7
23090,2019-12-04,3112.76,19.56,0.63,3153.63,-1.3,True,1,16344,-3112.76,-10521342.66,50874949.44,40353606.78
23091,2019-12-05,3117.43,4.67,0.15,3153.63,-1.15,True,1,16345,-3117.43,-10524460.09,50954393.35,40429933.26
23092,2019-12-06,3145.91,28.48,0.91,3153.63,-0.24,True,1,16346,-3145.91,-10527606.0,51423044.86,40895438.86
23093,2019-12-09,3135.96,-9.95,-0.32,3153.63,-0.56,True,1,16347,-3135.96,-10530741.96,51263538.12,40732796.16
23094,2019-12-10,3132.52,-3.44,-0.11,3153.63,-0.67,True,1,16348,-3132.52,-10533874.48,51210436.96,40676562.48
23095,2019-12-11,3141.63,9.11,0.29,3153.63,-0.38,True,1,16349,-3141.63,-10537016.11,51362508.87,40825492.76
23096,2019-12-12,3168.57,26.94,0.86,3168.57,0.0,True,1,16350,-3168.57,-10540184.68,51806119.5,41265934.82
23097,2019-12-13,3168.8,0.23,0.01,3168.8,0.0,True,1,16351,-3168.8,-10543353.48,51813048.8,41269695.32
23098,2019-12-16,3191.45,22.65,0.72,3191.45,0.0,True,1,16352,-3191.45,-10546544.93,52186590.4,41640045.47
23099,2019-12-17,3192.52,1.07,0.03,3192.52,0.0,True,1,16353,-3192.52,-10549737.45,52207279.56,41657542.11
23100,2019-12-18,3191.14,-1.38,-0.04,3192.52,-0.04,True,1,16354,-3191.14,-10552928.59,52187903.56,41634974.97
23101,2019-12-19,3205.37,14.23,0.45,3205.37,0.0,True,1,16355,-3205.37,-10556133.96,52423826.35,41867692.39
23102,2019-12-20,3221.22,15.85,0.49,3221.22,0.0,True,1,16356,-3221.22,-10559355.18,52686274.32,42126919.14
23103,2019-12-23,3224.01,2.79,0.09,3224.01,0.0,True,1,16357,-3224.01,-10562579.19,52735131.57,42172552.38
23104,2019-12-24,3223.38,-0.63,-0.02,3224.01,-0.02,True,1,16358,-3223.38,-10565802.57,52728050.04,42162247.47
23105,2019-12-26,3239.91,16.53,0.51,3239.91,0.0,True,1,16359,-3239.91,-10569042.48,53001687.69,42432645.21
23106,2019-12-27,3240.02,0.11,0.0,3240.02,0.0,True,1,16360,-3240.02,-10572282.5,53006727.2,42434444.7
23107,2019-12-30,3221.29,-18.73,-0.58,3240.02,-0.58,True,1,16361,-3221.29,-10575503.79,52703525.69,42128021.9
23108,2019-12-31,3230.78,9.49,0.3,3240.02,-0.28,True,1,16362,-3230.78,-10578734.57,52862022.36,42283287.79
23109,2020-01-02,3257.85,27.07,0.84,3257.85,0.0,True,1,16363,-3257.85,-10581992.42,53308199.55,42726207.13
23110,2020-01-03,3234.85,-23.0,-0.71,3257.85,-0.71,True,1,16364,-3234.85,-10585227.27,52935085.4,42349858.13
23111,2020-01-06,3246.28,11.43,0.35,3257.85,-0.36,True,1,16365,-3246.28,-10588473.55,53125372.2,42536898.65
23112,2020-01-07,3237.18,-9.1,-0.28,3257.85,-0.63,True,1,16366,-3237.18,-10591710.73,52979687.88,42387977.15
23113,2020-01-08,3253.05,15.87,0.49,3257.85,-0.15,True,1,16367,-3253.05,-10594963.78,53242669.35,42647705.57
23114,2020-01-09,3274.7,21.65,0.67,3274.7,0.0,True,1,16368,-3274.7,-10598238.48,53600289.6,43002051.12
23115,2020-01-10,3265.35,-9.35,-0.29,3274.7,-0.29,True,1,16369,-3265.35,-10601503.83,53450514.15,42849010.32
23116,2020-01-13,3288.13,22.78,0.7,3288.13,0.0,True,1,16370,-3288.13,-10604791.96,53826688.1,43221896.14
23117,2020-01-14,3283.15,-4.98,-0.15,3288.13,-0.15,True,1,16371,-3283.15,-10608075.11,53748448.65,43140373.54
23118,2020-01-15,3289.29,6.14,0.19,3289.29,0.0,True,1,16372,-3289.29,-10611364.4,53852255.88,43240891.48
23119,2020-01-16,3316.81,27.52,0.84,3316.81,0.0,True,1,16373,-3316.81,-10614681.21,54306130.13,43691448.92
23120,2020-01-17,3329.62,12.81,0.39,3329.62,0.0,True,1,16374,-3329.62,-10618010.83,54519197.88,43901187.05
23121,2020-01-21,3320.79,-8.83,-0.26,3329.62,-0.26,True,1,16375,-3320.79,-10621331.62,54377936.25,43756604.63
23122,2020-01-22,3321.75,0.96,0.03,3329.62,-0.24,True,1,16376,-3321.75,-10624653.37,54396978.0,43772324.63
23123,2020-01-23,3325.54,3.79,0.11,3329.62,-0.12,True,1,16377,-3325.54,-10627978.91,54462368.58,43834389.67
23124,2020-01-24,3295.47,-30.07,-0.9,3329.62,-1.03,True,1,16378,-3295.47,-10631274.38,53973207.66,43341933.28
23125,2020-01-27,3243.63,-51.84,-1.57,3329.62,-2.58,True,1,16379,-3243.63,-10634518.01,53127415.77,42492897.76
23126,2020-01-28,3276.24,32.61,1.0,3329.62,-1.6,True,1,16380,-3276.24,-10637794.25,53664811.2,43027016.95
23127,2020-01-29,3273.4,-2.84,-0.09,3329.62,-1.69,True,1,16381,-3273.4,-10641067.65,53621565.4,42980497.75
23128,2020-01-30,3283.66,10.26,0.31,3329.62,-1.38,True,1,16382,-3283.66,-10644351.31,53792918.12,43148566.81
23129,2020-01-31,3225.52,-58.14,-1.77,3329.62,-3.13,True,1,16383,-3225.52,-10647576.83,52843694.16,42196117.33
23130,2020-02-03,3248.92,23.4,0.72,3329.62,-2.42,True,1,16384,-3248.92,-10650825.75,53230305.28,42579479.53
23131,2020-02-04,3297.59,48.67,1.5,3329.62,-0.96,True,1,16385,-3297.59,-10654123.34,54031012.15,43376888.81
23132,2020-02-05,3334.69,37.1,1.12,3334.69,0.0,True,1,16386,-3334.69,-10657458.03,54642230.34,43984772.31
23133,2020-02-06,3345.78,11.09,0.33,3345.78,0.0,True,1,16387,-3345.78,-10660803.81,54827296.86,44166493.05
23134,2020-02-07,3327.71,-18.07,-0.54,3345.78,-0.54,True,1,16388,-3327.71,-10664131.52,54534511.48,43870379.96
23135,2020-02-10,3352.09,24.38,0.73,3352.09,0.0,True,1,16389,-3352.09,-10667483.61,54937403.01,44269919.4
23136,2020-02-11,3357.75,5.66,0.17,3357.75,0.0,True,1,16390,-3357.75,-10670841.36,55033522.5,44362681.14
23137,2020-02-12,3379.45,21.7,0.65,3379.45,0.0,True,1,16391,-3379.45,-10674220.81,55392564.95,44718344.14
23138,2020-02-13,3373.94,-5.51,-0.16,3379.45,-0.16,True,1,16392,-3373.94,-10677594.75,55305624.48,44628029.73
23139,2020-02-14,3380.16,6.22,0.18,3380.16,0.0,True,1,16393,-3380.16,-10680974.91,55410962.88,44729987.97
23140,2020-02-18,3370.29,-9.87,-0.29,3380.16,-0.29,True,1,16394,-3370.29,-10684345.2,55252534.26,44568189.06
23141,2020-02-19,3386.15,15.86,0.47,3386.15,0.0,True,1,16395,-3386.15,-10687731.35,55515929.25,44828197.9
23142,2020-02-20,3373.23,-12.92,-0.38,3386.15,-0.38,True,1,16396,-3373.23,-10691104.58,55307479.08,44616374.5
23143,2020-02-21,3337.75,-35.48,-1.05,3386.15,-1.43,True,1,16397,-3337.75,-10694442.33,54729086.75,44034644.42
23144,2020-02-24,3225.89,-111.86,-3.35,3386.15,-4.73,True,1,16398,-3225.89,-10697668.22,52898144.22,42200476.0
23145,2020-02-25,3128.21,-97.68,-3.03,3386.15,-7.62,True,1,16399,-3128.21,-10700796.43,51299515.79,40598719.36
23146,2020-02-26,3116.39,-11.82,-0.38,3386.15,-7.97,True,1,16400,-3116.39,-10703912.82,51108796.0,40404883.18
23147,2020-02-27,2978.76,-137.63,-4.42,3386.15,-12.03,True,1,16401,-2978.76,-10706891.58,48854642.76,38147751.18
23148,2020-02-28,2954.22,-24.54,-0.82,3386.15,-12.76,True,1,16402,-2954.22,-10709845.8,48455116.44,37745270.64
23149,2020-03-02,3090.23,136.01,4.6,3386.15,-8.74,True,1,16403,-3090.23,-10712936.03,50689042.69,39976106.66
23150,2020-03-03,3003.37,-86.86,-2.81,3386.15,-11.3,True,1,16404,-3003.37,-10715939.4,49267281.48,38551342.08
23151,2020-03-04,3130.12,126.75,4.22,3386.15,-7.56,True,1,16405,-3130.12,-10719069.52,51349618.6,40630549.08
23152,2020-03-05,3023.94,-106.18,-3.39,3386.15,-10.7,True,1,16406,-3023.94,-10722093.46,49610759.64,38888666.18
23153,2020-03-06,2972.37,-51.57,-1.7,3386.15,-12.22,True,1,16407,-2972.37,-10725065.83,48767674.59,38042608.76
23154,2020-03-09,2746.56,-225.81,-7.6,3386.15,-18.89,True,1,16408,-2746.56,-10727812.39,45065556.48,34337744.09
23155,2020-03-10,2882.23,135.67,4.94,3386.15,-14.88,True,1,16409,-2882.23,-10730694.62,47294512.07,36563817.45
23156,2020-03-11,2741.38,-140.85,-4.89,3386.15,-19.04,True,1,16410,-2741.38,-10733436.0,44986045.8,34252609.8
23157,2020-03-12,2480.64,-260.74,-9.51,3386.15,-26.74,True,1,16411,-2480.64,-10735916.64,40709783.04,29973866.4
23158,2020-03-13,2711.02,230.38,9.29,3386.15,-19.94,True,1,16412,-2711.02,-10738627.66,44493260.24,33754632.58
23159,2020-03-16,2386.13,-324.89,-11.98,3386.15,-29.53,True,1,16413,-2386.13,-10741013.79,39163551.69,28422537.9
23160,2020-03-17,2529.19,143.06,6.0,3386.15,-25.31,True,1,16414,-2529.19,-10743542.98,41514124.66,30770581.68
23161,2020-03-18,2398.1,-131.09,-5.18,3386.15,-29.18,True,1,16415,-2398.1,-10745941.08,39364811.5,28618870.42
23162,2020-03-19,2409.39,11.29,0.47,3386.15,-28.85,True,1,16416,-2409.39,-10748350.47,39552546.24,28804195.77
23163,2020-03-20,2304.92,-104.47,-4.34,3386.15,-31.93,True,1,16417,-2304.92,-10750655.39,37839871.64,27089216.25
23164,2020-03-23,2237.4,-67.52,-2.93,3386.15,-33.92,True,1,16418,-2237.4,-10752892.79,36733633.2,25980740.41
23165,2020-03-24,2447.33,209.93,9.38,3386.15,-27.72,True,1,16419,-2447.33,-10755340.12,40182711.27,29427371.15
23166,2020-03-25,2475.56,28.23,1.15,3386.15,-26.89,True,1,16420,-2475.56,-10757815.68,40648695.2,29890879.52
23167,2020-03-26,2630.07,154.51,6.24,3386.15,-22.33,True,1,16421,-2630.07,-10760445.75,43188379.47,32427933.72
23168,2020-03-27,2541.47,-88.6,-3.37,3386.15,-24.94,True,1,16422,-2541.47,-10762987.22,41736020.34,30973033.12
23169,2020-03-30,2626.65,85.18,3.35,3386.15,-22.43,True,1,16423,-2626.65,-10765613.87,43137472.95,32371859.08
23170,2020-03-31,2584.59,-42.06,-1.6,3386.15,-23.67,True,1,16424,-2584.59,-10768198.46,42449306.16,31681107.7
23171,2020-04-01,2470.5,-114.09,-4.41,3386.15,-27.04,True,1,16425,-2470.5,-10770668.96,40577962.5,29807293.54
23172,2020-04-02,2526.9,56.4,2.28,3386.15,-25.38,True,1,16426,-2526.9,-10773195.86,41506859.4,30733663.54
23173,2020-04-03,2488.65,-38.25,-1.51,3386.15,-26.5,True,1,16427,-2488.65,-10775684.51,40881053.55,30105369.04
23174,2020-04-06,2663.68,175.03,7.03,3386.15,-21.34,True,1,16428,-2663.68,-10778348.19,43758935.04,32980586.85
23175,2020-04-07,2659.41,-4.27,-0.16,3386.15,-21.46,True,1,16429,-2659.41,-10781007.6,43691446.89,32910439.29
23176,2020-04-08,2749.98,90.57,3.41,3386.15,-18.79,True,1,16430,-2749.98,-10783757.58,45182171.4,34398413.82
23177,2020-04-09,2789.82,39.84,1.45,3386.15,-17.61,True,1,16431,-2789.82,-10786547.4,45839532.42,35052985.02
